"Cod birou electoral",Județ,Uat,Siruta,Localitate,Secție,Nr,Tip,Versiune,a,b,b1,b2,b3,c,d,e,f,g1,g2
1,ALBA,"MUNICIPIUL ALBA IULIA",1017,"ALBA IULIA","CENTRUL DE ZI PENTRU PERSOANE VÂRSTNICE",1,"Alegeri Prezidentiale",1,1622,994,925,69,0,974,20,1700,706,711,263
1,ALBA,"MUNICIPIUL ALBA IULIA",1017,"ALBA IULIA","ŞCOALA GIMNAZIALĂ „VASILE GOLDIŞ”",2,"Alegeri Prezidentiale",1,1032,660,555,105,0,650,10,1100,440,486,164
1,ALBA,"MUNICIPIUL ALBA IULIA",1017,"ALBA IULIA","ŞCOALA GIMNAZIALĂ „VASILE GOLDIŞ”",3,"Alegeri Prezidentiale",1,1365,748,698,50,0,728,20,1400,652,522,206
1,ALBA,"MUNICIPIUL ALBA IULIA",1017,"ALBA IULIA","ŞCOALĂ GIMNAZIALĂ „AVRAM IANCU”",4,"Alegeri Prezidentiale",1,1318,828,752,59,17,807,21,1400,572,562,245
1,ALBA,"MUNICIPIUL ALBA IULIA",1017,"ALBA IULIA","ŞCOALĂ GIMNAZIALĂ „AVRAM IANCU”",5,"Alegeri Prezidentiale",1,932,554,488,65,1,547,7,1000,446,421,126
1,ALBA,"MUNICIPIUL ALBA IULIA",1017,"ALBA IULIA","CASA DE CULTURĂ A STUDENŢILOR",6,"Alegeri Prezidentiale",1,637,430,317,99,14,411,19,700,270,295,116
1,ALBA,"MUNICIPIUL ALBA IULIA",1017,"ALBA IULIA","COLEGIUL ECONOMIC”DIONISIE POP MARŢIAN”",7,"Alegeri Prezidentiale",2,1358,895,813,82,0,872,23,1400,505,663,209
1,ALBA,"MUNICIPIUL ALBA IULIA",1017,"ALBA IULIA","COLEGIUL NAŢIONAL „HOREA CLOŞCA ŞI CRIŞAN”",8,"Alegeri Prezidentiale",1,1023,651,544,86,21,633,18,1100,449,417,216
1,ALBA,"MUNICIPIUL ALBA IULIA",1017,"ALBA IULIA","COLEGIUL NAŢIONAL „HOREA CLOŞCA ŞI CRIŞAN”",9,"Alegeri Prezidentiale",1,1566,997,895,102,0,977,20,1600,603,722,255
1,ALBA,"MUNICIPIUL ALBA IULIA",1017,"ALBA IULIA","COLEGIUL NAŢIONAL „HOREA CLOŞCA ŞI CRIŞAN”",10,"Alegeri Prezidentiale",1,1444,818,677,141,0,796,22,1500,682,575,221
1,ALBA,"MUNICIPIUL ALBA IULIA",1017,"ALBA IULIA","COLEGIUL NAŢIONAL „HOREA CLOŞCA ŞI CRIŞAN”",11,"Alegeri Prezidentiale",1,1006,571,463,108,0,557,14,1100,529,445,112
1,ALBA,"MUNICIPIUL ALBA IULIA",1017,"ALBA IULIA","COLEGIUL TEHNIC ”APULUM”",12,"Alegeri Prezidentiale",1,1212,588,541,47,0,578,10,1300,712,433,145
1,ALBA,"MUNICIPIUL ALBA IULIA",1017,"ALBA IULIA","COLEGIUL TEHNIC „APULUM”",13,"Alegeri Prezidentiale",1,1007,480,448,32,0,470,10,1100,620,343,127
1,ALBA,"MUNICIPIUL ALBA IULIA",1017,"ALBA IULIA","COLEGIUL TEHNIC „APULUM”",14,"Alegeri Prezidentiale",1,1153,535,489,46,0,526,9,1201,666,397,129
1,ALBA,"MUNICIPIUL ALBA IULIA",1017,"ALBA IULIA","GRĂDINIŢA CU PROGRAM PRELUNGIT NR.9",15,"Alegeri Prezidentiale",1,1376,821,622,199,0,813,8,1400,579,620,193
1,ALBA,"MUNICIPIUL ALBA IULIA",1017,"ALBA IULIA","SEMINARUL TEOLOGIC ORTODOX „SFÂNTUL SIMION ŞTEFAN”",16,"Alegeri Prezidentiale",1,1345,904,681,84,139,888,16,1400,496,668,220
1,ALBA,"MUNICIPIUL ALBA IULIA",1017,"ALBA IULIA","ŞCOALA GIMNAZIALĂ„ION AGÂRBICEANU”",17,"Alegeri Prezidentiale",1,936,533,482,51,0,517,16,1000,467,349,168
1,ALBA,"MUNICIPIUL ALBA IULIA",1017,"ALBA IULIA","ŞCOALA GIMNAZIALĂ„ION AGÂRBICEANU”",18,"Alegeri Prezidentiale",1,882,564,459,105,0,558,6,998,434,402,156
1,ALBA,"MUNICIPIUL ALBA IULIA",1017,"ALBA IULIA","GRĂDINIŢA CU PROGRAM PRELUNGIT NR.11",19,"Alegeri Prezidentiale",1,1294,755,541,213,1,740,15,1400,645,586,154
1,ALBA,"MUNICIPIUL ALBA IULIA",1017,"ALBA IULIA","GRĂDINIŢA CU PROGRAM PRELUNGIT STEP BY STEP NR.12",20,"Alegeri Prezidentiale",1,1051,602,555,47,0,594,8,1100,498,410,184
1,ALBA,"MUNICIPIUL ALBA IULIA",1017,"ALBA IULIA","GRĂDINIŢA CU PROGRAM PRELUNGIT STEP BY STEP NR.12",21,"Alegeri Prezidentiale",1,1059,610,557,53,0,596,14,1100,490,431,165
1,ALBA,"MUNICIPIUL ALBA IULIA",1017,"ALBA IULIA","ŞCOALA GIMNAZIALĂ „MIHAI EMINESCU”",22,"Alegeri Prezidentiale",1,1238,844,684,160,0,827,17,1300,456,603,224
1,ALBA,"MUNICIPIUL ALBA IULIA",1017,"ALBA IULIA","ŞCOALA GIMNAZIALĂ „MIHAI EMINESCU”",23,"Alegeri Prezidentiale",1,1693,982,890,92,0,956,26,1800,818,760,196
1,ALBA,"MUNICIPIUL ALBA IULIA",1017,"ALBA IULIA","GRĂDINIŢA CU PROGRAM PRELUNGIT NR.13",24,"Alegeri Prezidentiale",1,1099,635,574,61,0,626,9,1200,565,471,155
1,ALBA,"MUNICIPIUL ALBA IULIA",1017,"ALBA IULIA","GRĂDINIŢA CU PROGRAM PRELUNGIT NR.13",25,"Alegeri Prezidentiale",1,1230,708,656,52,0,695,13,1300,592,514,181
1,ALBA,"MUNICIPIUL ALBA IULIA",1017,"ALBA IULIA","LICEUL CU PROGRAM SPORTIV",26,"Alegeri Prezidentiale",1,1389,790,695,94,1,777,13,1500,710,592,185
1,ALBA,"MUNICIPIUL ALBA IULIA",1017,"ALBA IULIA","LICEUL CU PROGRAM SPORTIV",27,"Alegeri Prezidentiale",1,1368,855,773,82,0,840,15,1400,545,651,189
1,ALBA,"MUNICIPIUL ALBA IULIA",1017,"ALBA IULIA","LICEUL CU PROGRAM SPORTIV",28,"Alegeri Prezidentiale",1,1384,842,772,69,1,825,17,1500,658,598,227
1,ALBA,"MUNICIPIUL ALBA IULIA",1017,"ALBA IULIA","LICEUL CU PROGRAM SPORTIV",29,"Alegeri Prezidentiale",1,1082,627,565,62,0,614,13,1200,573,454,160
1,ALBA,"MUNICIPIUL ALBA IULIA",1017,"ALBA IULIA","BAZIN OLIMPIC",30,"Alegeri Prezidentiale",1,1158,684,601,83,0,675,9,1300,616,526,149
1,ALBA,"MUNICIPIUL ALBA IULIA",1017,"ALBA IULIA","BAZIN OLIMPIC",31,"Alegeri Prezidentiale",1,1401,746,614,132,0,740,6,1500,754,601,139
1,ALBA,"MUNICIPIUL ALBA IULIA",1017,"ALBA IULIA","STADION MUNICIPAL „CETATE”",32,"Alegeri Prezidentiale",2,1399,841,765,76,0,833,8,1500,659,678,155
1,ALBA,"MUNICIPIUL ALBA IULIA",1017,"ALBA IULIA","GRADINITA CU PROGRAM NORMAL NR. 10",33,"Alegeri Prezidentiale",1,1782,872,802,70,0,862,10,1900,1028,638,224
1,ALBA,"MUNICIPIUL ALBA IULIA",1017,"ALBA IULIA","GRĂDINIŢA CU PROGRAM NORMAL NR. 10",34,"Alegeri Prezidentiale",1,1494,796,723,73,0,777,19,1600,804,523,254
1,ALBA,"MUNICIPIUL ALBA IULIA",1017,"ALBA IULIA","COLEGIUL TEHNIC „DORIN PAVEL” SCOALA GENERALA NR. 9",35,"Alegeri Prezidentiale",1,1385,808,736,72,0,786,22,1500,692,573,213
1,ALBA,"MUNICIPIUL ALBA IULIA",1017,"ALBA IULIA","COLEGIUL TEHNIC „DORIN PAVEL”",36,"Alegeri Prezidentiale",1,871,530,426,104,0,525,5,908,378,412,113
1,ALBA,"MUNICIPIUL ALBA IULIA",1017,"ALBA IULIA","GRĂDINIŢA CU PROGRAM PRELUNGIT NR.16",37,"Alegeri Prezidentiale",1,1637,926,763,162,1,913,13,1800,874,757,156
1,ALBA,"MUNICIPIUL ALBA IULIA",1017,"ALBA IULIA","COLEGIUL TEHNIC „ALEXANDRU DOMSA”",38,"Alegeri Prezidentiale",1,1442,813,758,55,0,797,16,1512,699,628,169
1,ALBA,"MUNICIPIUL ALBA IULIA",1017,"ALBA IULIA","COLEGIUL TEHNIC „ALEXANDRU DOMSA”",39,"Alegeri Prezidentiale",1,1580,769,725,43,1,749,20,1700,931,604,145
1,ALBA,"MUNICIPIUL ALBA IULIA",1017,"ALBA IULIA","COLEGIUL TEHNIC „ALEXANDRU DOMSA”",40,"Alegeri Prezidentiale",1,1387,700,663,37,0,692,8,1600,900,551,141
1,ALBA,"MUNICIPIUL ALBA IULIA",1017,"ALBA IULIA","SC FLORIDA IMPEX SRL",41,"Alegeri Prezidentiale",1,1883,1111,1026,85,0,1092,19,2000,889,836,256
1,ALBA,"MUNICIPIUL ALBA IULIA",1017,"ALBA IULIA","GRĂDINIŢA CU PROGRAM NORMAL NR.5PARTOŞ",42,"Alegeri Prezidentiale",1,829,478,453,24,1,470,8,900,422,374,96
1,ALBA,"MUNICIPIUL ALBA IULIA",1017,"ALBA IULIA","CĂMINUL PENTRU PERSOANE VÂRSTNICE",43,"Alegeri Prezidentiale",1,1042,693,611,82,0,677,16,1100,407,507,170
1,ALBA,"MUNICIPIUL ALBA IULIA",1017,BĂRĂBANŢ,"GRĂDINIŢA CU PROGRAM NORMAL BĂRĂBANŢ",44,"Alegeri Prezidentiale",1,1020,548,507,41,0,542,6,1100,552,405,137
1,ALBA,"MUNICIPIUL ALBA IULIA",1017,BĂRĂBANŢ,"GRĂDINIŢA CU PROGRAM NORMAL BĂRĂBANŢ",45,"Alegeri Prezidentiale",1,1257,724,697,26,1,713,11,1300,576,541,172
1,ALBA,"MUNICIPIUL ALBA IULIA",1017,MICEŞTI,"ŞCOALA GIMNAZIALĂ MICEŞTI - SALA DE SPORT",46,"Alegeri Prezidentiale",1,1083,642,599,43,0,623,19,1100,458,482,141
1,ALBA,"MUNICIPIUL ALBA IULIA",1017,MICEŞTI,"ŞCOALA GIMNAZIALĂ MICEŞTI",47,"Alegeri Prezidentiale",1,1245,759,714,45,0,747,12,1300,541,580,167
1,ALBA,"MUNICIPIUL ALBA IULIA",1017,OARDA,"CĂMINUL CULTURAL OARDA DE JOS",48,"Alegeri Prezidentiale",1,1288,755,716,39,0,737,18,1400,645,586,151
1,ALBA,"MUNICIPIUL ALBA IULIA",1017,OARDA,"GRĂDINIŢA CU PROGRAM NORMAL OARDA DE SUS",49,"Alegeri Prezidentiale",1,722,483,396,87,0,475,8,800,317,348,127
1,ALBA,"MUNICIPIUL ALBA IULIA",1017,PÂCLIŞA,"ŞCOALA PRIMARĂ PÂCLIŞA",50,"Alegeri Prezidentiale",1,853,441,418,23,0,434,7,900,459,320,114
1,ALBA,"MUNICIPIUL AIUD",1213,AIUD,"ȘCOALA GIMNAZIALĂ ”OVIDIU HULEA” AIUD",51,"Alegeri Prezidentiale",1,1401,716,660,56,0,707,9,1500,784,471,236
1,ALBA,"MUNICIPIUL AIUD",1213,AIUD,"ŞCOALA GIMNAZIALĂ ”OVIDIU HULEA” AIUD",52,"Alegeri Prezidentiale",1,1008,505,425,80,0,495,10,1100,595,371,124
1,ALBA,"MUNICIPIUL AIUD",1213,AIUD,"ŞCOALA GIMNAZIALĂ ”OVIDIU HULEA” AIUD",53,"Alegeri Prezidentiale",1,1167,672,556,116,0,660,12,1199,527,495,165
1,ALBA,"MUNICIPIUL AIUD",1213,AIUD,"GRĂDINIŢA CU PROGRAM PRELUNGIT ”PRIMII PAŞI” AIUD",54,"Alegeri Prezidentiale",1,931,599,433,57,109,585,14,999,400,360,225
1,ALBA,"MUNICIPIUL AIUD",1213,AIUD,"GRĂDINIŢA CU PROGRAM PRELUNGIT ”PRIMII PAŞI” AIUD",55,"Alegeri Prezidentiale",1,1061,682,498,21,163,669,13,1100,418,357,312
1,ALBA,"MUNICIPIUL AIUD",1213,AIUD,"ȘCOALA GIMNAZIALĂ ”AXENTE SEVER” AIUD",56,"Alegeri Prezidentiale",1,1295,770,604,38,128,763,7,1400,630,473,290
1,ALBA,"MUNICIPIUL AIUD",1213,AIUD,"ŞCOALA GIMNAZIALĂ ”AXENTE SEVER” AIUD",57,"Alegeri Prezidentiale",1,1251,622,555,67,0,618,4,1300,678,462,156
1,ALBA,"MUNICIPIUL AIUD",1213,AIUD,"ŞCOALA GIMNAZIALĂ ”AXENTE SEVER” AIUD",58,"Alegeri Prezidentiale",1,1193,610,584,26,0,607,3,1300,690,396,211
1,ALBA,"MUNICIPIUL AIUD",1213,AIUD,"ŞCOALA GIMNAZIALĂ ”AXENTE SEVER” AIUD",59,"Alegeri Prezidentiale",1,1132,537,521,16,0,529,8,1200,663,346,183
1,ALBA,"MUNICIPIUL AIUD",1213,AIUD,"GRĂDINIŢA CU PROGRAM PRELUNGIT NR. 2 AIUD",60,"Alegeri Prezidentiale",1,1300,678,638,40,0,672,6,1400,722,395,277
1,ALBA,"MUNICIPIUL AIUD",1213,AIUD,"COLEGIUL NAŢIONAL ”TITU MAIORESCU” AIUD",61,"Alegeri Prezidentiale",1,1435,770,662,37,71,761,9,1500,730,526,235
1,ALBA,"MUNICIPIUL AIUD",1213,AIUD,"COLEGIUL TEHNIC AIUD",62,"Alegeri Prezidentiale",1,793,428,397,31,0,421,7,892,464,292,129
1,ALBA,"MUNICIPIUL AIUD",1213,AIUD,"COLEGIUL TEHNIC AIUD",63,"Alegeri Prezidentiale",1,719,374,352,22,0,370,4,800,426,260,110
1,ALBA,"MUNICIPIUL AIUD",1213,AIUD,"FOSTA GRĂDINIŢĂ NR. 1 AIUD",64,"Alegeri Prezidentiale",2,1457,740,695,44,1,729,11,1500,760,559,170
1,ALBA,"MUNICIPIUL AIUD",1213,"AIUDUL DE SUS","ŞCOALA GIMNAZIALĂ ”LIVIU REBREANU” AIUDUL DE SUS",65,"Alegeri Prezidentiale",1,905,342,319,23,0,341,1,1000,658,227,114
1,ALBA,"MUNICIPIUL AIUD",1213,"AIUDUL DE SUS","ŞCOALA GIMNAZIALĂ ”LIVIU REBREANU” AIUDUL DE SUS",66,"Alegeri Prezidentiale",1,1110,405,391,14,0,399,6,1200,795,281,118
1,ALBA,"MUNICIPIUL AIUD",1213,CIUMBRUD,"LICEUL TEHNOLOGIC AGRICOL ”ALEXANDRU BORZA” CIUMBRUD",67,"Alegeri Prezidentiale",1,1080,555,525,30,0,546,9,1200,645,375,171
1,ALBA,"MUNICIPIUL AIUD",1213,GÂMBAŞ,"FOSTA ŞCOALĂ GENERALĂ GÎMBAŞ",68,"Alegeri Prezidentiale",1,413,223,199,24,0,220,3,500,277,180,40
1,ALBA,"MUNICIPIUL AIUD",1213,"GÂRBOVA DE JOS","ŞCOALA PRIMARĂ GÎRBOVA DE JOS",69,"Alegeri Prezidentiale",1,405,197,177,20,0,195,2,500,303,149,46
1,ALBA,"MUNICIPIUL AIUD",1213,"GÂRBOVA DE SUS","FOSTA ŞCOALĂ GENERALĂ GÎRBOVA DE SUS",70,"Alegeri Prezidentiale",1,218,126,112,14,0,126,0,300,174,81,45
1,ALBA,"MUNICIPIUL AIUD",1213,GÂRBOVIŢA,"FOSTA ŞCOALĂ GENERALĂ GÎRBOVIŢA",71,"Alegeri Prezidentiale",1,96,71,55,16,0,71,0,200,129,49,22
1,ALBA,"MUNICIPIUL AIUD",1213,MĂGINA,"GRĂDINIŢA CU PROGRAM NORMAL MĂGINA",72,"Alegeri Prezidentiale",1,462,276,256,20,0,276,0,500,224,192,84
1,ALBA,"MUNICIPIUL AIUD",1213,PĂGIDA,"CĂMINUL CULTURAL PĂGIDA",73,"Alegeri Prezidentiale",1,90,53,42,11,0,52,1,100,47,42,10
1,ALBA,"MUNICIPIUL AIUD",1213,SÂNCRAI,"SALA DE FESTIVITĂŢI DIN SÎNCRAI",74,"Alegeri Prezidentiale",1,562,295,275,20,0,292,3,600,305,187,105
1,ALBA,"MUNICIPIUL BLAJ",1348,BLAJ,"PIAŢA AGROALIMENTARĂ",75,"Alegeri Prezidentiale",1,1012,529,503,25,1,521,8,1100,571,427,94
1,ALBA,"MUNICIPIUL BLAJ",1348,BLAJ,"PIAŢA AGROALIMENTARĂ",76,"Alegeri Prezidentiale",1,617,381,321,60,0,378,3,700,319,275,103
1,ALBA,"MUNICIPIUL BLAJ",1348,BLAJ,"BAZA DE AGREMENT A MUNICIPIULUI BLAJ",77,"Alegeri Prezidentiale",1,697,353,335,18,0,348,5,808,455,307,41
1,ALBA,"MUNICIPIUL BLAJ",1348,BLAJ,"AŞEZĂMÂNTUL SOCIAL - GRĂDINIŢA ”SFÂNTA IRINA”",78,"Alegeri Prezidentiale",1,1234,650,620,30,0,638,12,1300,650,488,150
1,ALBA,"MUNICIPIUL BLAJ",1348,BLAJ,"ŞCOALA GIMNAZIALĂ ”TOMA COCIŞIU” BLAJ",79,"Alegeri Prezidentiale",1,1209,625,570,55,0,617,8,1300,675,474,143
1,ALBA,"MUNICIPIUL BLAJ",1348,BLAJ,"CENTRUL CULTURAL ”IACOB MUREŞIANU’’",80,"Alegeri Prezidentiale",1,815,567,470,76,21,559,8,900,333,393,166
1,ALBA,"MUNICIPIUL BLAJ",1348,BLAJ,"LICEUL TEHNOLOGIC ”ŞTEFAN MANCIULEA” BLAJ",81,"Alegeri Prezidentiale",1,632,378,307,57,14,373,5,700,322,286,87
1,ALBA,"MUNICIPIUL BLAJ",1348,BLAJ,"SERVICIUL PUBLIC DE ASISTENŢĂ SOCIALĂ BLAJ",82,"Alegeri Prezidentiale",1,503,318,271,47,0,308,10,600,282,241,67
1,ALBA,"MUNICIPIUL BLAJ",1348,BLAJ,"ASOCIAŢIA JUDEŢEANĂ A VÂNĂTORILOR SI PESCARILOR SPORTIVI ALBA - CLUBUL BLAJ",83,"Alegeri Prezidentiale",1,340,223,190,33,0,220,3,400,177,188,32
1,ALBA,"MUNICIPIUL BLAJ",1348,BLAJ,"LICEUL TEHNOLOGIC ”TIMOTEI CIPARIU”",84,"Alegeri Prezidentiale",1,1437,916,849,67,0,901,15,1500,584,681,220
1,ALBA,"MUNICIPIUL BLAJ",1348,BLAJ,"COLEGIUL NAŢIONAL ”INOCHENTIE MICU CLAIN’’",85,"Alegeri Prezidentiale",1,1341,799,710,58,31,786,13,1400,601,618,168
1,ALBA,"MUNICIPIUL BLAJ",1348,BLAJ,"ŞCOALA GIMNAZIALĂ ”PETRU PAVEL ARON” BLAJ",86,"Alegeri Prezidentiale",1,1605,865,812,50,3,839,26,1700,835,643,196
1,ALBA,"MUNICIPIUL BLAJ",1348,BLAJ,"ŞCOALA GIMNAZIALĂ ”ION MICU MOLDOVAN” BLAJ",87,"Alegeri Prezidentiale",1,1465,641,617,24,0,634,7,1500,859,536,98
1,ALBA,"MUNICIPIUL BLAJ",1348,BLAJ,"GRĂDINIŢA CU PROGRAM NORMAL ”IZVOARELE” BLAJ",88,"Alegeri Prezidentiale",1,1314,686,664,21,1,675,11,1400,714,518,157
1,ALBA,"MUNICIPIUL BLAJ",1348,MĂNĂRADE,"ŞCOALA GIMNAZIALĂ ”AXENTE SEVER” MĂNĂRADE",89,"Alegeri Prezidentiale",1,897,417,389,28,0,412,5,1000,583,350,62
1,ALBA,"MUNICIPIUL BLAJ",1348,PETRISAT,"ŞCOALA PRIMARĂ PETRISAT",90,"Alegeri Prezidentiale",1,482,268,256,12,0,262,6,600,332,243,19
1,ALBA,"MUNICIPIUL BLAJ",1348,TIUR,"ŞCOALA GIMNAZIALĂ ”SIMION BĂRNUŢIU” TIUR",91,"Alegeri Prezidentiale",1,1293,717,697,20,0,710,7,1400,683,604,106
1,ALBA,"MUNICIPIUL SEBEŞ",1874,SEBEŞ,"SERVICIUL PUBLIC DE ADMINISTRARE A PATRIMONIULUI SEBEŞ",92,"Alegeri Prezidentiale",1,1634,935,906,27,2,924,11,1700,765,711,213
1,ALBA,"MUNICIPIUL SEBEŞ",1874,SEBEŞ,"LICEUL TEHNOLOGIC SEBEŞ",93,"Alegeri Prezidentiale",1,1431,439,399,40,0,434,5,1500,1061,333,101
1,ALBA,"MUNICIPIUL SEBEŞ",1874,SEBEŞ,"LICEUL TEHNOLOGIC SEBEŞ",94,"Alegeri Prezidentiale",1,1615,976,885,81,10,966,10,1700,724,779,187
1,ALBA,"MUNICIPIUL SEBEŞ",1874,SEBEŞ,"LICEUL TEHNOLOGIC SEBEŞ",95,"Alegeri Prezidentiale",1,1042,623,584,38,1,616,7,1100,477,445,171
1,ALBA,"MUNICIPIUL SEBEŞ",1874,SEBEŞ,"LICEUL TEHNOLOGIC SEBEŞ",96,"Alegeri Prezidentiale",1,977,514,478,36,0,506,8,1100,586,428,78
1,ALBA,"MUNICIPIUL SEBEŞ",1874,SEBEŞ,"LICEUL CU PROGRAM SPORTIV SEBEŞ",97,"Alegeri Prezidentiale",1,1515,852,775,76,1,845,7,1600,748,681,164
1,ALBA,"MUNICIPIUL SEBEŞ",1874,SEBEŞ,"LICEUL CU PROGRAM SPORTIV SEBEŞ",98,"Alegeri Prezidentiale",1,1472,846,779,60,7,834,12,1600,754,663,171
1,ALBA,"MUNICIPIUL SEBEŞ",1874,SEBEŞ,"LICEUL CU PROGRAM SPORTIV SEBEŞ",99,"Alegeri Prezidentiale",1,1403,747,680,65,2,739,8,1500,753,600,139
1,ALBA,"MUNICIPIUL SEBEŞ",1874,SEBEŞ,"ŞCOALA GIMNAZIALĂ NR. 2 SEBEŞ",100,"Alegeri Prezidentiale",1,1415,853,765,52,36,841,12,1500,647,712,129
1,ALBA,"MUNICIPIUL SEBEŞ",1874,SEBEŞ,"COLEGIUL NAŢIONAL ”LUCIAN BLAGA” SEBEŞ",101,"Alegeri Prezidentiale",1,1276,779,701,36,42,762,17,1400,621,626,136
1,ALBA,"MUNICIPIUL SEBEŞ",1874,SEBEŞ,"COLEGIUL NAŢIONAL ”LUCIAN BLAGA” SEBEŞ",102,"Alegeri Prezidentiale",1,1388,846,786,60,0,839,7,1508,662,726,113
1,ALBA,"MUNICIPIUL SEBEŞ",1874,SEBEŞ,"ŞCOALA GIMNAZIALĂ ”MIHAIL KOGĂLNICEANU” SEBEŞ",103,"Alegeri Prezidentiale",1,1115,615,546,69,0,610,5,1200,585,483,127
1,ALBA,"MUNICIPIUL SEBEŞ",1874,SEBEŞ,"ŞCOALA GIMNAZIALĂ ”MIHAIL KOGĂLNICEANU” SEBEŞ",104,"Alegeri Prezidentiale",1,1046,534,487,47,0,527,7,1100,566,447,80
1,ALBA,"MUNICIPIUL SEBEŞ",1874,SEBEŞ,"ŞCOALA GIMNAZIALĂ ”MIHAIL KOGĂLNICEANU” SEBEŞ",105,"Alegeri Prezidentiale",1,1150,535,513,22,0,533,2,1200,665,416,117
1,ALBA,"MUNICIPIUL SEBEŞ",1874,SEBEŞ,"ŞCOALA GIMNAZIALĂ ”MIHAIL KOGĂLNICEANU” SEBEŞ",106,"Alegeri Prezidentiale",1,1110,514,503,11,0,512,2,1200,686,403,109
1,ALBA,"MUNICIPIUL SEBEŞ",1874,LANCRĂM,"ŞCOALA GIMNAZIALĂ LANCRĂM",107,"Alegeri Prezidentiale",1,1429,816,742,73,1,803,13,1500,684,679,124
1,ALBA,"MUNICIPIUL SEBEŞ",1874,PETREŞTI,"ŞCOALA GIMNAZIALĂ PETREŞTI",108,"Alegeri Prezidentiale",1,1443,764,715,48,1,752,12,1500,736,632,120
1,ALBA,"MUNICIPIUL SEBEŞ",1874,PETREŞTI,"ŞCOALA GIMNAZIALĂ PETREŞTI",109,"Alegeri Prezidentiale",1,1403,687,619,68,0,676,11,1500,813,563,113
1,ALBA,"MUNICIPIUL SEBEŞ",1874,PETREŞTI,"ŞCOALA GIMNAZIALĂ PETREŞTI",110,"Alegeri Prezidentiale",1,1447,746,707,23,16,739,7,1500,754,638,101
1,ALBA,"MUNICIPIUL SEBEŞ",1874,RĂHĂU,"ŞCOALA GIMNAZIALĂ RĂHĂU",111,"Alegeri Prezidentiale",1,847,463,425,37,1,459,4,900,437,386,73
1,ALBA,"ORAŞ ABRUD",1151,ABRUD,"ŞCOALA GIMNAZIALĂ ”AVRAM IANCU” ABRUD",112,"Alegeri Prezidentiale",1,1133,583,526,57,0,569,14,1200,617,265,304
1,ALBA,"ORAŞ ABRUD",1151,ABRUD,"ŞCOALA GIMNAZIALĂ ”AVRAM IANCU” GRADINIȚA CU PROGRAM NORMAL NR. 1 ABRUD",113,"Alegeri Prezidentiale",1,1080,565,532,33,0,555,10,1200,635,244,311
1,ALBA,"ORAŞ ABRUD",1151,ABRUD,"ȘCOALA GIMNAZIALĂ ”AVRAM IANCU” GRĂDINIŢA CU PROGRAM PRELUNGIT NR.1 ABRUD",114,"Alegeri Prezidentiale",1,1313,618,564,54,0,600,18,1400,782,289,311
1,ALBA,"ORAŞ ABRUD",1151,ABRUD,"LICEUL ”HOREA, CLOŞCA ŞI CRIŞAN” ABRUD",115,"Alegeri Prezidentiale",1,1065,511,446,54,11,499,12,1100,589,264,235
1,ALBA,"ORAŞ BAIA DE ARIEŞ",2915,"BAIA DE ARIEŞ","ŞCOALA GENERALĂ CU CLASELE I-VIII",116,"Alegeri Prezidentiale",1,889,448,365,45,38,440,8,1000,552,256,184
1,ALBA,"ORAŞ BAIA DE ARIEŞ",2915,"BAIA DE ARIEŞ","ŞCOALA GENERALĂ CU CLASELE I-VIII",117,"Alegeri Prezidentiale",1,857,325,298,27,0,317,8,900,575,179,138
1,ALBA,"ORAŞ BAIA DE ARIEŞ",2915,"BAIA DE ARIEŞ","LICEUL ”DR. LAZĂR CHIRILĂ”",118,"Alegeri Prezidentiale",1,619,293,269,24,0,287,6,700,407,157,130
1,ALBA,"ORAŞ BAIA DE ARIEŞ",2915,BRĂZEŞTI,"ŞCOALA PRIMARĂ BRĂZEŞTI",119,"Alegeri Prezidentiale",1,213,122,102,20,0,122,0,300,178,65,57
1,ALBA,"ORAŞ BAIA DE ARIEŞ",2915,"CIOARA DE SUS","CĂMINUL CULTURAL CIOARA DE SUS",120,"Alegeri Prezidentiale",1,192,106,92,14,0,105,1,300,194,62,43
1,ALBA,"ORAŞ BAIA DE ARIEŞ",2915,MUNCELU,"CĂMINUL CULTURAL MUNCELU",121,"Alegeri Prezidentiale",1,300,159,144,13,2,159,0,400,241,88,71
1,ALBA,"ORAŞ BAIA DE ARIEŞ",2915,SARTĂŞ,"CĂMINUL CULTURAL SARTĂŞ",122,"Alegeri Prezidentiale",1,312,138,120,18,0,138,0,400,262,98,40
1,ALBA,"ORAŞ CÂMPENI",1455,CÂMPENI,"PRIMĂRIA ORAŞULUI CÎMPENI",123,"Alegeri Prezidentiale",1,1268,932,672,258,2,920,12,1297,365,422,498
1,ALBA,"ORAŞ CÂMPENI",1455,CÂMPENI,"ŞCOALA GIMNAZIALĂ CÎMPENI",124,"Alegeri Prezidentiale",1,886,636,464,140,32,626,10,1000,364,362,264
1,ALBA,"ORAŞ CÂMPENI",1455,CÂMPENI,"ȘCOALA GIMNAZIALĂ CÎMPENI",125,"Alegeri Prezidentiale",1,836,558,481,76,1,548,10,900,342,273,275
1,ALBA,"ORAŞ CÂMPENI",1455,CÂMPENI,"COLEGIUL NAŢIONAL ”AVRAM IANCU” CÎMPENI",126,"Alegeri Prezidentiale",1,880,566,486,79,1,551,15,900,334,272,279
1,ALBA,"ORAŞ CÂMPENI",1455,CÂMPENI,"COLEGIUL NAŢIONAL ”AVRAM IANCU” CÎMPENI",127,"Alegeri Prezidentiale",1,855,580,460,83,37,572,8,900,320,296,276
1,ALBA,"ORAŞ CÂMPENI",1455,CÂMPENI,"ŞCOALA PRIMARĂ VÎRŞI",128,"Alegeri Prezidentiale",1,549,318,261,57,0,309,9,600,282,153,156
1,ALBA,"ORAŞ CÂMPENI",1455,CERTEGE,"ŞCOALA PRIMARĂ CERTEGE",129,"Alegeri Prezidentiale",1,368,148,140,8,0,148,0,400,252,73,75
1,ALBA,"ORAŞ CÂMPENI",1455,MIHOEŞTI,"ŞCOALA PRIMARĂ MIHOEŞTI",130,"Alegeri Prezidentiale",1,270,177,146,31,0,175,2,300,123,83,92
1,ALBA,"ORAŞ CÂMPENI",1455,"VALEA BISTRII","ŞCOALA PRIMARĂ VALEA BISTRII",131,"Alegeri Prezidentiale",1,369,248,216,32,0,244,4,400,152,127,117
1,ALBA,"ORAŞ CUGIR",1696,CUGIR,"ŞCOALA GIMNAZIALĂ NR. 3 - CUGIR",132,"Alegeri Prezidentiale",1,1056,529,504,25,0,519,10,1100,571,334,185
1,ALBA,"ORAŞ CUGIR",1696,CUGIR,"ŞCOALA GIMNAZIALĂ NR. 3 - CUGIR",133,"Alegeri Prezidentiale",1,1395,645,623,21,1,639,6,1500,855,393,246
1,ALBA,"ORAŞ CUGIR",1696,CUGIR,"ŞCOALA GIMNAZIALĂ NR. 3 - CUGIR",134,"Alegeri Prezidentiale",1,1267,612,581,31,0,604,8,1300,688,384,220
1,ALBA,"ORAŞ CUGIR",1696,CUGIR,"ŞCOALA GIMNAZIALĂ NR. 3 - CUGIR",135,"Alegeri Prezidentiale",1,1126,549,527,22,0,542,7,1200,651,356,186
1,ALBA,"ORAŞ CUGIR",1696,CUGIR,"ȘCOALA GIMNAZIALĂ NR.3 CUGIR",136,"Alegeri Prezidentiale",1,1023,531,504,26,1,507,24,1100,569,330,177
1,ALBA,"ORAŞ CUGIR",1696,CUGIR,"COLEGIUL NAŢIONAL ”DAVID PRODAN” CUGIR",137,"Alegeri Prezidentiale",1,1083,563,523,40,0,556,7,1200,637,383,173
1,ALBA,"ORAŞ CUGIR",1696,CUGIR,"COLEGIUL NAŢIONAL ”DAVID PRODAN” CUGIR",138,"Alegeri Prezidentiale",1,1047,545,525,19,1,532,13,1100,555,310,222
1,ALBA,"ORAŞ CUGIR",1696,CUGIR,"ŞCOALA GIMNAZIALĂ ”SINGIDAVA” CUGIR",139,"Alegeri Prezidentiale",1,1180,560,537,23,0,553,7,1300,740,342,211
1,ALBA,"ORAŞ CUGIR",1696,CUGIR,"ŞCOALA GIMNAZIALĂ ”SINGIDAVA” CUGIR",140,"Alegeri Prezidentiale",1,1351,700,634,35,31,692,8,1400,700,450,242
1,ALBA,"ORAŞ CUGIR",1696,CUGIR,"ŞCOALA GIMNAZIALĂ ”SINGIDAVA” CUGIR",141,"Alegeri Prezidentiale",1,1156,417,392,25,0,406,11,1193,776,248,158
1,ALBA,"ORAŞ CUGIR",1696,CUGIR,"GRĂDINIŢA CU PROGRAM NORMAL ”VOINICEL” CUGIR",142,"Alegeri Prezidentiale",1,1241,665,628,37,0,649,16,1300,635,426,223
1,ALBA,"ORAŞ CUGIR",1696,CUGIR,"COLEGIUL TEHNIC ”I.D.LĂZĂRESCU” CUGIR",143,"Alegeri Prezidentiale",1,1048,481,457,24,0,467,14,1100,619,299,168
1,ALBA,"ORAŞ CUGIR",1696,CUGIR,"CASA DE CULTURĂ A ORAŞULUI CUGIR",144,"Alegeri Prezidentiale",1,1325,677,637,40,0,667,10,1400,723,455,212
1,ALBA,"ORAŞ CUGIR",1696,CUGIR,"GRĂDINIŢA CU PROGRAM NORMAL NR. 2 - CUGIR",145,"Alegeri Prezidentiale",1,1182,615,587,28,0,606,9,1300,685,418,188
1,ALBA,"ORAŞ CUGIR",1696,CUGIR,"ŞCOALA GIMNAZIALĂ ”IOSIF PERVAIN” CUGIR",146,"Alegeri Prezidentiale",1,1078,610,574,35,1,599,11,1200,590,393,206
1,ALBA,"ORAŞ CUGIR",1696,CUGIR,"ŞCOALA GIMNAZIALĂ ”IOSIF PERVAIN” CUGIR",147,"Alegeri Prezidentiale",1,1134,633,591,41,1,628,5,1200,567,434,194
1,ALBA,"ORAŞ CUGIR",1696,CUGIR,"ȘCOALA GIMNAZIALĂ IOSIF PERVAIN CUGIR",148,"Alegeri Prezidentiale",1,1135,517,484,32,1,510,7,1200,683,337,173
1,ALBA,"ORAŞ CUGIR",1696,BUCURU,"ŞCOALA PRIMARĂ - BUCURU",149,"Alegeri Prezidentiale",1,98,45,37,8,0,45,0,100,55,38,7
1,ALBA,"ORAŞ CUGIR",1696,CĂLENE,"ŞCOALA PRIMARĂ - CĂLENE",150,"Alegeri Prezidentiale",1,47,33,21,12,0,33,0,100,67,24,9
1,ALBA,"ORAŞ CUGIR",1696,MUGEŞTI,"ŞCOALA PRIMARĂ - MUGEŞTI",151,"Alegeri Prezidentiale",1,91,41,31,10,0,41,0,100,59,31,10
1,ALBA,"ORAŞ CUGIR",1696,VINEREA,"ȘCOALA GIMNAZIALĂ IOAN MIHU - VINEREA",152,"Alegeri Prezidentiale",1,1054,588,551,36,1,577,11,1108,520,424,153
1,ALBA,"ORAŞ CUGIR",1696,VINEREA,"ŞCOALA GIMNAZIALĂ ”IOAN MIHU” VINEREA",153,"Alegeri Prezidentiale",1,909,528,511,17,0,519,9,1000,472,358,161
1,ALBA,"ORAŞ OCNA MUREŞ",1794,"OCNA MUREŞ","GRĂDINIŢA CU PROGRAM NORMAL NR. 5",154,"Alegeri Prezidentiale",1,1387,615,599,16,0,608,7,1500,885,461,147
1,ALBA,"ORAŞ OCNA MUREŞ",1794,"OCNA MUREŞ","ȘCOALA GIMNAZIALĂ ”LUCIAN BLAGA”",155,"Alegeri Prezidentiale",1,1157,603,552,51,0,590,13,1200,597,435,155
1,ALBA,"ORAŞ OCNA MUREŞ",1794,"OCNA MUREŞ","CASA DE CULTURĂ ”ION SÂNGEREANU”",156,"Alegeri Prezidentiale",1,1238,589,539,50,0,574,15,1300,711,431,143
1,ALBA,"ORAŞ OCNA MUREŞ",1794,"OCNA MUREŞ","DIRECŢIA SANITAR-VETERINARĂ ŞI PENTRU SIGURANŢA ALIMENTELOR OCNA MUREŞ",157,"Alegeri Prezidentiale",1,1097,450,420,30,0,448,2,1200,750,334,114
1,ALBA,"ORAŞ OCNA MUREŞ",1794,"OCNA MUREŞ","LICEUL TEORETIC ”PETRU MAIOR”",158,"Alegeri Prezidentiale",1,1340,608,543,64,1,602,6,1400,792,450,152
1,ALBA,"ORAŞ OCNA MUREŞ",1794,"OCNA MUREŞ","GRĂDINIŢA CU PROGRAM NORMAL NR. 3",159,"Alegeri Prezidentiale",1,1446,677,633,44,0,668,9,1500,823,537,131
1,ALBA,"ORAŞ OCNA MUREŞ",1794,"UIOARA DE JOS","ŞCOALA PRIMARĂ UIOARA DE JOS",160,"Alegeri Prezidentiale",1,879,413,370,43,0,408,5,1002,589,289,119
1,ALBA,"ORAŞ OCNA MUREŞ",1794,"UIOARA DE SUS","ŞCOALA PRIMARĂ UIOARA DE SUS, SALA NR. 1",161,"Alegeri Prezidentiale",1,1399,590,553,37,0,585,5,1500,910,453,132
1,ALBA,"ORAŞ OCNA MUREŞ",1794,"CISTEIU DE MUREŞ","ŞCOALA GENERALĂ CISTEIU DE MUREŞ",162,"Alegeri Prezidentiale",1,545,199,183,16,0,197,2,600,401,169,28
1,ALBA,"ORAŞ OCNA MUREŞ",1794,MICOŞLACA,"GRĂDINIŢA CU PROGRAM NORMAL MICOŞLACA",163,"Alegeri Prezidentiale",1,257,127,100,27,0,126,1,300,173,74,52
1,ALBA,"ORAŞ OCNA MUREŞ",1794,RĂZBOIENI-CETATE,"CĂMINUL CULTURAL RĂZBOIENI-CETATE",164,"Alegeri Prezidentiale",1,1085,500,451,49,0,499,1,1200,700,360,139
1,ALBA,"ORAŞ TEIUŞ",8096,TEIUŞ,"CASA DE CULTURĂ TEIUŞ",165,"Alegeri Prezidentiale",1,1540,959,835,122,2,941,18,1600,641,621,320
1,ALBA,"ORAŞ TEIUŞ",8096,TEIUŞ,"ŞCOALA GIMNAZIALĂ TEIUŞ",166,"Alegeri Prezidentiale",1,1332,601,548,53,0,591,10,1400,799,401,190
1,ALBA,"ORAŞ TEIUŞ",8096,TEIUŞ,"LICEUL TEORETIC TEIUŞ",167,"Alegeri Prezidentiale",1,1492,901,791,101,9,887,14,1600,699,601,286
1,ALBA,"ORAŞ TEIUŞ",8096,TEIUŞ,"GARA CFR TEIUŞ",168,"Alegeri Prezidentiale",1,1036,573,473,99,1,566,7,1400,827,382,184
1,ALBA,"ORAŞ TEIUŞ",8096,BELDIU,"ŞCOALA PRIMARĂ BELDIU",169,"Alegeri Prezidentiale",1,194,117,92,25,0,117,0,200,83,59,58
1,ALBA,"ORAŞ TEIUŞ",8096,PEŢELCA,"ŞCOALA PRIMARĂ PEŢELCA",170,"Alegeri Prezidentiale",1,114,96,65,28,3,96,0,200,104,43,53
1,ALBA,"ORAŞ TEIUŞ",8096,CĂPUD,"CĂMIN CULTURAL CĂPUD",171,"Alegeri Prezidentiale",1,263,171,145,25,1,171,0,300,129,81,90
1,ALBA,"ORAŞ ZLATNA",1936,ZLATNA,"ŞCOALA GIMNAZIALĂ „ AVRAM IANCU” ZLATNA",172,"Alegeri Prezidentiale",1,1210,594,553,41,0,589,5,1300,706,363,226
1,ALBA,"ORAŞ ZLATNA",1936,ZLATNA,"ŞCOALA GIMNAZIALĂ „ AVRAM IANCU” ZLATNA",173,"Alegeri Prezidentiale",1,963,508,469,38,1,502,6,1000,492,318,184
1,ALBA,"ORAŞ ZLATNA",1936,ZLATNA,"LICEUL CORNELIU MEDREA ZLATNA",174,"Alegeri Prezidentiale",1,1346,603,569,34,0,591,12,1400,797,400,191
1,ALBA,"ORAŞ ZLATNA",1936,FENEŞ,"ŞCOALA GIMNAZIALĂ ” SAVA ALBESCU ” SAT FENEŞ",175,"Alegeri Prezidentiale",1,747,456,419,29,8,450,6,800,344,341,109
1,ALBA,"ORAŞ ZLATNA",1936,GALAŢI,"ŞCOALA PRIMARĂ , SAT GALAŢI",176,"Alegeri Prezidentiale",1,302,134,115,19,0,130,4,400,266,90,40
1,ALBA,"ORAŞ ZLATNA",1936,"IZVORU AMPOIULUI","CĂMIN CULTURAL, SAT IZVORUL AMPOIULUI",177,"Alegeri Prezidentiale",1,418,208,185,21,2,207,1,500,292,112,95
1,ALBA,"ORAŞ ZLATNA",1936,PĂTRÂNGENI,"ŞCOALA PRIMARĂ , SAT PĂTRÂNGENI",178,"Alegeri Prezidentiale",1,510,249,232,17,0,247,2,600,351,138,109
1,ALBA,"ORAŞ ZLATNA",1936,PIRITA,"ŞCOALA PRIMARĂ , SAT PIRITA",179,"Alegeri Prezidentiale",1,371,217,192,25,0,213,4,400,183,127,86
1,ALBA,"ORAŞ ZLATNA",1936,TRÂMPOIELE,"ŞCOALA PRIMARĂ , SAT TRÎMPOIELE",180,"Alegeri Prezidentiale",1,333,177,163,14,0,175,2,400,223,107,68
1,ALBA,"ORAŞ ZLATNA",1936,"VALEA MICĂ","ŞCOALA PRIMARĂ , SAT VALEA MICĂ",181,"Alegeri Prezidentiale",1,343,225,206,19,0,224,1,400,175,162,62
1,ALBA,"ORAŞ ZLATNA",1936,VÂLTORI,"CĂMIN CULTURAL, SAT VÎLTORI",182,"Alegeri Prezidentiale",1,171,104,86,17,1,103,1,200,96,71,32
1,ALBA,ALBAC,2130,ALBAC,"CĂMINUL CULTURAL ALBAC",183,"Alegeri Prezidentiale",1,744,474,394,60,20,464,10,800,326,314,150
1,ALBA,ALBAC,2130,CIONEŞTI,"ŞCOALA PRIMARĂ CIONEŞTI",184,"Alegeri Prezidentiale",1,534,283,249,18,16,282,1,600,317,234,48
1,ALBA,ALBAC,2130,COSTEŞTI,"ŞCOALA PRIMARĂ COSTEŞTI",185,"Alegeri Prezidentiale",1,82,50,39,11,0,50,0,100,50,41,9
1,ALBA,ALBAC,2130,POTIONCI,"ŞCOALA PRIMARĂ POTIONCI",186,"Alegeri Prezidentiale",1,64,38,30,8,0,38,0,100,62,28,10
1,ALBA,ALBAC,2130,ROGOZ,"ŞCOALA PRIMARĂ ROGOZ",187,"Alegeri Prezidentiale",1,242,120,109,7,4,119,1,300,180,85,34
1,ALBA,"ALMAŞU MARE",2309,"ALMAŞU MARE","PRIMARIA COMUNEI ALMSU MARE",188,"Alegeri Prezidentiale",1,321,169,154,15,0,167,2,400,231,106,61
1,ALBA,"ALMAŞU MARE",2309,"ALMAŞU MARE","SCOALA PRIMARA ALMASU MARE - SUSENI",189,"Alegeri Prezidentiale",1,207,110,96,14,0,108,2,300,190,68,40
1,ALBA,"ALMAŞU MARE",2309,"ALMAŞU DE MIJLOC","ŞCOALA PRIMARA ALMAŞU DE MIJLOC",190,"Alegeri Prezidentiale",1,126,65,54,11,0,65,0,200,135,50,15
1,ALBA,"ALMAŞU MARE",2309,CIB,"ŞCOALA PRIMARA CIB",191,"Alegeri Prezidentiale",1,236,182,144,36,2,178,4,300,118,137,41
1,ALBA,"ALMAŞU MARE",2309,GLOD,"ŞCOALA PRIMARA GLOD",192,"Alegeri Prezidentiale",1,152,85,68,17,0,83,2,200,115,60,23
1,ALBA,ARIEŞENI,2381,ARIEŞENI,"GRUP ȘCOLAR DE TURISM ARIEȘENI",193,"Alegeri Prezidentiale",1,571,433,358,62,13,424,9,600,167,267,157
1,ALBA,ARIEŞENI,2381,ARIEŞENI,"GRUP ȘCOLAR DE TURISM ARIEȘENI",194,"Alegeri Prezidentiale",1,537,418,332,75,11,411,7,600,182,256,155
1,ALBA,ARIEŞENI,2381,"CASA DE PIATRĂ","ȘCOALA PRIMARĂ CASA DE PIATRĂ",195,"Alegeri Prezidentiale",1,83,60,48,12,0,60,0,100,40,43,17
1,ALBA,ARIEŞENI,2381,COBLEŞ,"ȘCOALA PRIMARĂ COBLEȘ",196,"Alegeri Prezidentiale",1,197,138,110,20,8,136,2,300,162,68,68
1,ALBA,"AVRAM IANCU",2577,"AVRAM IANCU","CĂMINUL CULTURAL AVRAM IANCU",197,"Alegeri Prezidentiale",1,607,308,257,33,18,301,7,700,392,236,65
1,ALBA,"AVRAM IANCU",2577,TÂRSA,"ŞCOALA PRIMARĂ I-IV TÎRSA",198,"Alegeri Prezidentiale",1,617,365,336,21,8,361,4,700,335,242,119
1,ALBA,BERGHIN,2988,HENIG,"CLĂDIRE CĂMIN CULTURAL HENIG",199,"Alegeri Prezidentiale",1,234,148,109,39,0,146,2,300,152,122,24
1,ALBA,BERGHIN,2988,BERGHIN,"CLĂDIRE CĂMIN CULTURAL BERGHIN",200,"Alegeri Prezidentiale",1,698,279,244,35,0,274,5,800,521,231,43
1,ALBA,BERGHIN,2988,GHIRBOM,"CLĂDIRE CĂMIN CULTURAL GHIRBOM",201,"Alegeri Prezidentiale",1,412,238,216,22,0,237,1,500,262,211,26
1,ALBA,BERGHIN,2988,STRAJA,"CLĂDIRE CĂMIN CULTURAL STRAJA",202,"Alegeri Prezidentiale",1,285,169,146,23,0,168,1,400,231,135,33
1,ALBA,BISTRA,3039,BISTRA,"ŞCOALA GIMNAZIALĂ ” NICODIM GANEA” BISTRA",203,"Alegeri Prezidentiale",1,815,380,346,31,3,379,1,892,512,242,137
1,ALBA,BISTRA,3039,BISTRA,"ŞCOALA GIMNAZIALĂ ”NICODIM GANEA” BISTRA",204,"Alegeri Prezidentiale",1,1028,476,456,19,1,472,4,1100,624,302,170
1,ALBA,BISTRA,3039,BISTRA,"ŞCOALA GIMNAZIALĂ ”NICODIM GANEA” BISTRA",205,"Alegeri Prezidentiale",1,823,350,320,28,2,343,7,900,550,207,136
1,ALBA,BISTRA,3039,CIULDEŞTI,"ŞCOALA PRIMARĂ CIULDEŞTI - COMUNA BISTRA",206,"Alegeri Prezidentiale",1,612,286,276,10,0,285,1,700,414,190,95
1,ALBA,BISTRA,3039,GÂRDE,"ŞCOALA GIMNAZIALĂ GÎRDE I - COMUNA BISTRA",207,"Alegeri Prezidentiale",1,635,319,292,25,2,315,4,700,381,195,120
1,ALBA,BLANDIANA,3397,BLANDIANA,"PRIMARIA COMUNEI BLANDIANA",208,"Alegeri Prezidentiale",1,463,274,219,55,0,273,1,500,226,230,43
1,ALBA,BLANDIANA,3397,ACMARIU,"ŞCOALA PRIMARĂ ACMARIU",209,"Alegeri Prezidentiale",1,288,198,148,50,0,195,3,400,202,150,45
1,ALBA,BLANDIANA,3397,RĂCĂTĂU,"ŞCOALA CU CLASELE I-IV RĂCĂTĂU",210,"Alegeri Prezidentiale",1,28,23,13,10,0,23,0,100,77,18,5
1,ALBA,"BUCERDEA GRÂNOASĂ",9026,"BUCERDEA GRÂNOASĂ","CĂMINUL CULTURAL BUCERDEA GRÂNOASĂ",211,"Alegeri Prezidentiale",1,1057,626,598,19,9,612,14,1100,474,536,76
1,ALBA,"BUCERDEA GRÂNOASĂ",9026,"BUCERDEA GRÂNOASĂ","ŞCOALA GIMNAZIALĂ IOAN MAIORESCU BUCERDEA GRANOASĂ",212,"Alegeri Prezidentiale",1,767,393,363,21,9,385,8,800,407,335,50
1,ALBA,BUCIUM,3459,CIUCULEŞTI,"ŞCOALA PRIMARĂ CIUCULEŞTI",213,"Alegeri Prezidentiale",1,351,200,160,37,3,198,2,400,200,98,100
1,ALBA,BUCIUM,3459,BUCIUM-SAT,"ŞCOALA PRIMARĂ BUCIUM-SAT",214,"Alegeri Prezidentiale",1,402,223,187,27,9,223,0,500,277,81,142
1,ALBA,BUCIUM,3459,CERBU,"ŞCOALA PRIMARĂ CERBU",215,"Alegeri Prezidentiale",1,263,147,133,12,2,147,0,300,153,53,94
1,ALBA,BUCIUM,3459,POIENI,"ŞCOALA PRIMARĂ POIENI",216,"Alegeri Prezidentiale",1,271,184,156,20,8,181,3,300,116,84,97
1,ALBA,CÂLNIC,4106,CÂLNIC,"PRIMĂRIA COMUNEI CÎLNIC",217,"Alegeri Prezidentiale",1,1149,567,531,36,0,559,8,1200,633,382,177
1,ALBA,CÂLNIC,4106,DEAL,"ŞCOALA PRIMARĂ DEAL",218,"Alegeri Prezidentiale",1,310,229,184,45,0,221,8,400,171,197,24
1,ALBA,CENADE,3761,CENADE,"PRIMĂRIA CENADE",219,"Alegeri Prezidentiale",1,767,413,356,34,23,409,4,800,387,369,40
1,ALBA,CERGĂU,3805,"CERGĂU MARE","ŞCOALA GIMNAZIALĂ ”ARON COTRUŞ” CERGĂU MARE",220,"Alegeri Prezidentiale",1,813,527,474,31,22,521,6,900,373,432,89
1,ALBA,CERGĂU,3805,"CERGĂU MIC","GRĂDINIȚA CU PROGRAM NORMAL CERGĂU MIC",221,"Alegeri Prezidentiale",1,261,179,144,27,8,177,2,300,121,154,23
1,ALBA,CERGĂU,3805,LUPU,"CLĂDIRE CĂMIN CULTURAL LUPU",222,"Alegeri Prezidentiale",1,205,177,129,41,7,176,1,300,123,140,36
1,ALBA,CERU-BĂCĂINŢI,3841,CERU-BĂCĂINŢI,"CĂMINUL CULTURAL",223,"Alegeri Prezidentiale",1,206,122,83,39,0,122,0,300,178,100,22
1,ALBA,"CETATEA DE BALTĂ",3958,"CETATEA DE BALTĂ","CĂMIN CULTURAL",224,"Alegeri Prezidentiale",1,584,212,191,19,2,209,3,700,488,146,63
1,ALBA,"CETATEA DE BALTĂ",3958,"CETATEA DE BALTĂ","CĂMIN CULTURAL",225,"Alegeri Prezidentiale",1,875,403,365,36,2,399,4,900,497,325,74
1,ALBA,"CETATEA DE BALTĂ",3958,"CRĂCIUNELU DE SUS","SCOALA GENERALA CRĂCIUNELU DE SUS",226,"Alegeri Prezidentiale",1,75,59,42,17,0,59,0,100,41,51,8
1,ALBA,"CETATEA DE BALTĂ",3958,SÂNTĂMĂRIE,"SCOALA GENERALA SÎNTĂMĂRIE",227,"Alegeri Prezidentiale",1,241,131,113,18,0,129,2,300,169,118,11
1,ALBA,"CETATEA DE BALTĂ",3958,TĂTÂRLAUA,"ȘCOALA GIMNAZIALĂ TĂTÂRLAUA",228,"Alegeri Prezidentiale",1,623,221,199,22,0,219,2,700,479,165,54
1,ALBA,CIUGUD,1071,CIUGUD,"ŞCOALĂ GIMNAZIALĂ CIUGUD",229,"Alegeri Prezidentiale",1,497,325,260,62,3,318,7,600,275,242,76
1,ALBA,CIUGUD,1071,DRÂMBAR,"CĂMIN CULTURAL DRÎMBAR",230,"Alegeri Prezidentiale",1,330,251,200,51,0,247,4,400,149,180,67
1,ALBA,CIUGUD,1071,HĂPRIA,"CĂMIN CULTURAL HĂPRIA",231,"Alegeri Prezidentiale",1,494,339,296,43,0,330,9,600,261,266,64
1,ALBA,CIUGUD,1071,LIMBA,"CĂMIN CULTURAL LIMBA",232,"Alegeri Prezidentiale",1,320,208,179,24,5,204,4,400,192,132,72
1,ALBA,CIUGUD,1071,ŞEUŞA,"CĂMIN CULTURAL ȘEUȘA",233,"Alegeri Prezidentiale",1,645,432,363,48,21,427,5,700,268,335,92
1,ALBA,CIUGUD,1071,TELEAC,"CĂMIN CULTURAL TELEAC",234,"Alegeri Prezidentiale",1,339,234,200,34,0,230,4,400,166,174,56
1,ALBA,CIURULEASA,4008,BUNINGINEA,"ŞCOALA PRIMARĂ BUNINGINEA",235,"Alegeri Prezidentiale",1,365,245,211,27,7,242,3,401,156,102,140
1,ALBA,CIURULEASA,4008,CIURULEASA,"PRIMĂRIA COMUNEI CIURULEASA",236,"Alegeri Prezidentiale",1,589,374,324,43,7,365,9,700,326,154,211
1,ALBA,"CRĂCIUNELU DE JOS",4188,"CRĂCIUNELU DE JOS","PRIMĂRIA COMUNEI CRĂCIUNELU DE JOS",237,"Alegeri Prezidentiale",1,852,534,466,53,15,526,8,900,366,449,77
1,ALBA,"CRĂCIUNELU DE JOS",4188,"CRĂCIUNELU DE JOS","ŞCOALA GIMNAZIALĂ - CRĂCIUNELU DE JOS",238,"Alegeri Prezidentiale",1,854,497,460,31,6,483,14,900,403,383,100
1,ALBA,CRICĂU,4142,CRICĂU,"BIBLIOTECA COMUNALĂ",239,"Alegeri Prezidentiale",1,1092,623,550,62,11,616,7,1200,577,462,154
1,ALBA,CRICĂU,4142,CRAIVA,"ȘCOALA PRIMARĂ CRAIVA",240,"Alegeri Prezidentiale",1,293,196,168,25,3,194,2,399,203,156,38
1,ALBA,CRICĂU,4142,TIBRU,"SALA DE ÎNTRUNIRI",241,"Alegeri Prezidentiale",1,313,220,177,33,10,219,1,400,180,183,36
1,ALBA,CUT,9019,CUT,"ŞCOALA GIMNAZIALĂ ”SEPTIMIU ALBINI”",242,"Alegeri Prezidentiale",1,1065,629,571,56,2,613,16,1100,471,478,135
1,ALBA,"DAIA ROMÂNĂ",4240,"DAIA ROMÂNĂ","PRIMĂRIA DAIA ROMÂNĂ",243,"Alegeri Prezidentiale",1,1055,626,597,29,0,624,2,1100,474,546,78
1,ALBA,"DAIA ROMÂNĂ",4240,"DAIA ROMÂNĂ","PRIMĂRIA DAIA ROMÂNĂ",244,"Alegeri Prezidentiale",1,1508,837,808,29,0,827,10,1600,763,737,90
1,ALBA,DOŞTAT,4268,DOŞTAT,"ŞCOALA GIMNAZIALĂ DOŞTAT",245,"Alegeri Prezidentiale",1,397,236,188,40,8,235,1,500,264,196,39
1,ALBA,DOŞTAT,4268,BOZ,"ŞCOALA PRIMARĂ BOZ",246,"Alegeri Prezidentiale",1,366,219,189,30,0,218,1,400,181,193,25
1,ALBA,FĂRĂU,4302,FĂRĂU,"GRĂDINIŢA CU PROGRAM NORMAL FĂRĂU",247,"Alegeri Prezidentiale",1,472,265,231,33,1,257,8,500,235,204,53
1,ALBA,FĂRĂU,4302,HERIA,"GRĂDINIŢA CU PROGRAM NORMAL HERIA",248,"Alegeri Prezidentiale",1,221,112,83,29,0,110,2,300,188,96,14
1,ALBA,FĂRĂU,4302,SÂNBENEDIC,"ŞCOALA PRIMARĂ SÎNBENEDIC",249,"Alegeri Prezidentiale",1,193,113,93,20,0,112,1,200,87,94,18
1,ALBA,FĂRĂU,4302,MEDVEŞ,"ŞCOALA PRIMARĂ MEDVEŞ",250,"Alegeri Prezidentiale",1,140,101,82,19,0,100,1,200,99,84,16
1,ALBA,FĂRĂU,4302,ŞILEA,"CLĂDIRE ” PUNCT DE INFORMARE”",251,"Alegeri Prezidentiale",1,244,144,123,21,0,144,0,300,156,119,25
1,ALBA,"GALDA DE JOS",4366,"GALDA DE JOS","CĂMINUL CULTURAL GALDA DE JOS",252,"Alegeri Prezidentiale",1,1554,849,757,84,8,843,6,1600,751,645,198
1,ALBA,"GALDA DE JOS",4366,BENIC,"ŞCOALA GIMNAZIALĂ BENIC",253,"Alegeri Prezidentiale",1,427,268,220,43,5,266,2,500,232,208,58
1,ALBA,"GALDA DE JOS",4366,CETEA,"ŞCOALA PRIMARĂ CETEA",254,"Alegeri Prezidentiale",1,359,194,153,40,1,194,0,400,206,151,43
1,ALBA,"GALDA DE JOS",4366,"GALDA DE SUS","ŞCOALA PRIMARĂ GALDA DE SUS",255,"Alegeri Prezidentiale",1,340,195,159,32,4,194,1,400,205,147,47
1,ALBA,"GALDA DE JOS",4366,MESENTEA,"SALA DE FESTIVITĂŢI MESENTEA",256,"Alegeri Prezidentiale",1,199,141,105,36,0,140,1,300,159,104,36
1,ALBA,"GALDA DE JOS",4366,OIEJDEA,"CĂMINUL CULTURAL OIEJDEA",257,"Alegeri Prezidentiale",1,702,353,298,55,0,348,5,800,447,306,42
1,ALBA,"GALDA DE JOS",4366,"POAIANA GALDEI","CLĂDIRE ADMINISTRATIVĂ (FOSTĂ ŞCOALA GENERALĂ POIANA GALDEI)",258,"Alegeri Prezidentiale",1,121,80,49,31,0,78,2,200,120,59,19
1,ALBA,GÂRBOVA,4482,GÂRBOVA,"PRIMĂRIA COMUNEI GÂRBOVA",259,"Alegeri Prezidentiale",1,1165,567,519,48,0,561,6,1200,633,453,108
1,ALBA,GÂRBOVA,4482,CĂRPINIŞ,"ȘCOALA PRIMARĂ CĂRPINIȘ",260,"Alegeri Prezidentiale",1,212,122,92,30,0,120,2,300,178,94,26
1,ALBA,GÂRBOVA,4482,RECIU,"ȘCOALA PRIMARĂ RECIU",261,"Alegeri Prezidentiale",1,268,139,121,18,0,139,0,300,161,118,21
1,ALBA,"GÂRDA DE SUS",4525,"GÂRDA DE SUS","ŞCOALA GIMNAZIALĂ ”EMIL RACOVIŢĂ” GÎRDA DE SUS",262,"Alegeri Prezidentiale",1,803,450,386,64,0,443,7,900,450,278,165
1,ALBA,"GÂRDA DE SUS",4525,BIHARIA,"ŞCOALA PRIMARĂ BIHARIA",263,"Alegeri Prezidentiale",1,123,51,42,9,0,50,1,200,149,39,11
1,ALBA,"GÂRDA DE SUS",4525,GHEŢARI,"ŞCOALA GIMNAZIALĂ GHEŢARI",264,"Alegeri Prezidentiale",1,412,210,198,12,0,209,1,500,290,173,36
1,ALBA,HOPÂRTA,4703,HOPÂRTA,"CĂMIN CULTURAL HOPÎRTA",265,"Alegeri Prezidentiale",1,232,141,109,32,0,135,6,300,159,100,35
1,ALBA,HOPÂRTA,4703,SILIVAŞ,"CĂMIN CULTURAL SILIVAŞ",266,"Alegeri Prezidentiale",1,220,136,120,16,0,132,4,300,164,96,36
1,ALBA,HOPÂRTA,4703,ŞPĂLNACA,"CĂMIN CULTURAL ŞPĂLNACA",267,"Alegeri Prezidentiale",1,151,115,74,41,0,114,1,200,85,85,29
1,ALBA,HOPÂRTA,4703,TURDAŞ,"CĂMIN CULTURAL TURDAŞ",268,"Alegeri Prezidentiale",1,136,86,58,28,0,86,0,200,114,62,24
1,ALBA,HOPÂRTA,4703,"VAMA SEACĂ","CĂMIN CULTURAL VAMA SEACĂ",269,"Alegeri Prezidentiale",1,145,109,82,27,0,107,2,200,91,80,27
1,ALBA,HOREA,4767,HOREA,"ȘCOALA GIMNAZIALĂ HOREA",270,"Alegeri Prezidentiale",1,612,332,302,24,6,330,2,700,368,219,111
1,ALBA,HOREA,4767,DÂRLEŞTI,"ȘCOALA PRIMARĂ TRIFEȘTI",271,"Alegeri Prezidentiale",1,388,265,250,9,6,264,1,400,135,201,63
1,ALBA,HOREA,4767,GIURGIUŢ,"ȘCOALA PRIMARĂ GIURGIUȚ",272,"Alegeri Prezidentiale",1,120,88,73,12,3,88,0,200,112,67,21
1,ALBA,HOREA,4767,MĂTIŞEŞTI,"CĂMIN CULTURAL MĂTIȘEȘTI",273,"Alegeri Prezidentiale",1,352,217,197,14,6,214,3,400,183,162,52
1,ALBA,HOREA,4767,PĂTRUŞEŞTI,"ȘCOALA PRIMARĂ PĂTRUȘEȘTI",274,"Alegeri Prezidentiale",1,127,82,71,10,1,79,3,200,118,60,19
1,ALBA,HOREA,4767,PRELUCA,"ȘCOALA PRIMARĂ PRELUCA",275,"Alegeri Prezidentiale",1,59,48,35,13,0,48,0,100,52,40,8
1,ALBA,IGHIU,4927,IGHIU,"PRIMĂRIA COMUNEI IGHIU",276,"Alegeri Prezidentiale",1,1175,664,614,50,0,657,7,1200,536,531,126
1,ALBA,IGHIU,4927,"BUCERDEA VINOASĂ","ȘCOALA PRIMARĂ BUCERDEA VINOASĂ",277,"Alegeri Prezidentiale",1,750,458,406,52,0,452,6,800,342,373,79
1,ALBA,IGHIU,4927,IGHIEL,"ȘCOALA GIMNAZIALĂ IGHIEL",278,"Alegeri Prezidentiale",1,823,437,416,21,0,425,12,900,463,358,67
1,ALBA,IGHIU,4927,ŞARD,"ŞCOALA GIMNAZIALĂ ŞARD",279,"Alegeri Prezidentiale",1,925,488,438,50,0,484,4,1000,512,386,98
1,ALBA,IGHIU,4927,ŞARD,"ŞCOALA GIMNAZIALĂ ŞARD",280,"Alegeri Prezidentiale",1,1085,550,506,43,1,536,14,1200,650,442,94
1,ALBA,IGHIU,4927,ŢELNA,"ȘCOALĂ GIMNAZIALĂ ȚELNA",281,"Alegeri Prezidentiale",1,883,434,400,33,1,430,4,1000,566,352,78
1,ALBA,ÎNTREGALDE,4981,ÎNTREGALDE,"ȘCOALA GIMNAZIALĂ ÎNTREGALDE",282,"Alegeri Prezidentiale",1,225,92,74,18,0,92,0,300,208,74,18
1,ALBA,ÎNTREGALDE,4981,"DEALU GEOAGIULUI","ȘCOALA CU CLASELE I-IV DEALU GEOAGIULUI",283,"Alegeri Prezidentiale",1,85,42,29,13,0,41,1,100,58,37,4
1,ALBA,ÎNTREGALDE,4981,GHIONCANI,"ȘCOALA CU CLASELE I-IV GHIONCANI",284,"Alegeri Prezidentiale",1,53,26,15,11,0,26,0,100,74,19,7
1,ALBA,ÎNTREGALDE,4981,NECRILEŞTI,"CĂMINUL CULTURAL NECRILEȘTI",285,"Alegeri Prezidentiale",1,146,90,70,19,1,89,1,200,110,72,17
1,ALBA,JIDVEI,5103,JIDVEI,"CĂMINUL CULTURAL JIDVEI",286,"Alegeri Prezidentiale",1,1102,549,517,32,0,542,7,1200,651,448,94
1,ALBA,JIDVEI,5103,BĂLCACIU,"ŞCOALA GIMNAZIALĂ BĂLCACIU",287,"Alegeri Prezidentiale",1,1108,421,387,32,2,417,4,1200,779,357,60
1,ALBA,JIDVEI,5103,"CĂPÂLNA DE JOS","CĂMINUL CULTURAL CĂPÎLNA DE JOS",288,"Alegeri Prezidentiale",1,635,312,294,18,0,308,4,700,388,245,63
1,ALBA,JIDVEI,5103,FEISA,"CĂMINUL CULTURAL FEISA",289,"Alegeri Prezidentiale",1,642,361,339,22,0,355,6,700,339,304,51
1,ALBA,JIDVEI,5103,VESEUŞ,"CĂMINUL CULTURAL VESEUŞ",290,"Alegeri Prezidentiale",1,737,420,394,18,8,416,4,800,380,366,50
1,ALBA,LIVEZILE,5167,LIVEZILE,"ȘCOALA GIMNAZIALĂ LIVEZILE",291,"Alegeri Prezidentiale",1,581,406,334,45,27,402,4,701,295,308,94
1,ALBA,LIVEZILE,5167,"POIANA AIUDULUI","CĂMIN CULTURAL",292,"Alegeri Prezidentiale",1,273,197,140,44,13,196,1,300,103,123,73
1,ALBA,LIVEZILE,5167,IZVOARELE,"CĂMIN CULTURAL IZVOARELE",293,"Alegeri Prezidentiale",1,103,92,48,38,6,91,1,200,108,73,18
1,ALBA,LIVEZILE,5167,VĂLIŞOARA,"CĂMIN CULTURAL VĂLIȘOARA",294,"Alegeri Prezidentiale",1,116,93,58,34,1,92,1,200,107,72,20
1,ALBA,"LOPADEA NOUĂ",5210,"LOPADEA NOUĂ","PRIMĂRIA LOPADEA NOUĂ",295,"Alegeri Prezidentiale",1,821,357,329,20,8,352,5,900,543,336,16
1,ALBA,"LOPADEA NOUĂ",5210,ASINIP,"CĂMIN CULTURAL",296,"Alegeri Prezidentiale",1,82,62,34,28,0,61,1,100,38,46,15
1,ALBA,"LOPADEA NOUĂ",5210,BĂGĂU,"CLĂDIRE ANEXĂ PRIMĂRIA LOPADEA NOUĂ",297,"Alegeri Prezidentiale",1,429,257,226,31,0,251,6,500,243,204,47
1,ALBA,"LOPADEA NOUĂ",5210,BEŢA,"ȘCOALA PRIMARĂ BEȚA",298,"Alegeri Prezidentiale",1,310,170,155,15,0,165,5,400,230,155,10
1,ALBA,"LOPADEA NOUĂ",5210,CIUGUZEL,"CLĂDIRE ANEXĂ PRIMĂRIA LOPADEA NOUĂ",299,"Alegeri Prezidentiale",1,547,373,326,37,10,370,3,600,227,329,41
1,ALBA,"LOPADEA NOUĂ",5210,ODVEREM,"CLĂDIRE ANEXĂ PRIMĂRIA LOPADEA NOUĂ",300,"Alegeri Prezidentiale",1,46,40,19,21,0,40,0,100,60,34,6
1,ALBA,"LUNCA MUREŞULUI",5309,"LUNCA MUREŞULUI","ŞCOALA GIMNAZIALĂ ”SIMION LAZĂR” LUNCA MUREŞULUI, NR. 241A",301,"Alegeri Prezidentiale",1,799,338,309,29,0,337,1,900,562,273,64
1,ALBA,"LUNCA MUREŞULUI",5309,"LUNCA MUREŞULUI","ŞCOALA GIMNAZIALĂ ”SIMION LAZĂR” LUNCA MUREŞULUI, NR. 241A",302,"Alegeri Prezidentiale",1,876,386,366,20,0,378,8,900,514,323,55
1,ALBA,"LUNCA MUREŞULUI",5309,"GURA ARIEŞULUI","ŞCOALA PRIMARĂ GURA ARIEŞULUI, NR. 84",303,"Alegeri Prezidentiale",1,369,201,169,32,0,201,0,400,199,125,76
1,ALBA,LUPŞA,5336,LUPŞA,"CĂMINUL CULTURAL LUPȘA",304,"Alegeri Prezidentiale",1,680,376,346,29,1,372,4,700,324,195,177
1,ALBA,LUPŞA,5336,HĂDĂRĂU,"ŞCOALA PRIMARĂ HĂDĂRĂU",305,"Alegeri Prezidentiale",1,305,168,150,18,0,163,5,400,232,90,73
1,ALBA,LUPŞA,5336,"VALEA LUPŞII","ŞCOALA PRIMARĂ VALEA LUPȘII",306,"Alegeri Prezidentiale",1,720,372,342,30,0,370,2,800,428,223,147
1,ALBA,LUPŞA,5336,MUŞCA,"SEDIUL FOSTEI PRIMĂRII MUȘCA",307,"Alegeri Prezidentiale",1,943,501,466,34,1,493,8,1000,499,257,236
1,ALBA,METEŞ,5577,"LUNCA AMPOIŢEI","ŞCOALA CU CLASELE I-IV",308,"Alegeri Prezidentiale",1,210,136,105,31,0,134,2,300,164,112,22
1,ALBA,METEŞ,5577,"PRESACA AMPOIULUI","ŞCOALA PRIMARĂ PRESACA AMPOIULUI",309,"Alegeri Prezidentiale",1,286,216,182,33,1,212,4,300,84,124,88
1,ALBA,METEŞ,5577,METEŞ,"ŞCOALA GIMNAZIALĂ METEŞ",310,"Alegeri Prezidentiale",1,518,248,210,38,0,246,2,600,352,157,89
1,ALBA,METEŞ,5577,AMPOIŢA,"ŞCOALA GIMNAZIALĂ AMPOIŢA",311,"Alegeri Prezidentiale",1,579,396,324,72,0,392,4,600,204,305,87
1,ALBA,METEŞ,5577,TĂUŢI,"ŞCOALA PRIMARĂ ”DIONISIU POPOVICIU” TĂUŢI",312,"Alegeri Prezidentiale",1,537,295,266,23,6,292,3,600,305,221,71
1,ALBA,METEŞ,5577,"POIANA AMPOIULUI","CĂMINUL CULTURAL POIANA AMPOIULUI",313,"Alegeri Prezidentiale",1,217,112,96,16,0,112,0,300,188,64,48
1,ALBA,MIHALŢ,5700,MIHALŢ,"ŞCOALA GIMNAZIALĂ ”ION BREAZU” MIHALŢ",314,"Alegeri Prezidentiale",1,1027,588,552,34,2,586,2,1100,512,452,134
1,ALBA,MIHALŢ,5700,MIHALŢ,"ŞCOALA GIMNAZIALĂ ”ION BREAZU” MIHALŢ",315,"Alegeri Prezidentiale",1,816,456,407,49,0,451,5,908,452,336,115
1,ALBA,MIHALŢ,5700,CISTEI,"ŞCOALA PRIMARĂ CISTEI",316,"Alegeri Prezidentiale",1,466,300,268,31,1,298,2,500,200,242,56
1,ALBA,MIHALŢ,5700,OBREJA,"ŞCOALA PRIMARĂ OBREJA",317,"Alegeri Prezidentiale",1,465,270,229,39,2,268,2,500,230,192,76
1,ALBA,MIRĂSLĂU,5755,MIRĂSLĂU,"GRĂDINIŢA CU PROGRAM NORMAL - MIRĂSLĂU",318,"Alegeri Prezidentiale",1,715,333,307,26,0,329,4,800,467,249,80
1,ALBA,MIRĂSLĂU,5755,CICĂU,"ŞCOALA PRIMARĂ - CICĂU",319,"Alegeri Prezidentiale",1,99,49,35,14,0,48,1,200,151,36,12
1,ALBA,MIRĂSLĂU,5755,DECEA,"ŞCOALA PRIMARĂ - DECEA",320,"Alegeri Prezidentiale",1,628,267,240,27,0,263,4,700,433,201,62
1,ALBA,MIRĂSLĂU,5755,"LOPADEA VECHE","ŞCOALA PRIMARĂ - LOPADEA VECHE",321,"Alegeri Prezidentiale",1,224,159,130,29,0,158,1,300,141,118,40
1,ALBA,MIRĂSLĂU,5755,ORMENIŞ,"ŞCOALA PRIMARĂ - ORMENIŞ",322,"Alegeri Prezidentiale",1,64,52,33,19,0,51,1,100,48,36,15
1,ALBA,MOGOŞ,5826,MOGOŞ,"CONSILIUL LOCAL AL COMUNEI MOGOŞ",323,"Alegeri Prezidentiale",1,509,259,220,28,11,252,7,600,341,198,54
1,ALBA,MOGOŞ,5826,BUTEŞTI,"ŞCOALA CU CLASELE I-IV, SAT BUTEŞTI",324,"Alegeri Prezidentiale",1,57,34,21,13,0,34,0,100,66,28,6
1,ALBA,MOGOŞ,5826,"VALEA BARNII","REFUGIU TURISTIC VALEA BARNII",325,"Alegeri Prezidentiale",1,136,51,34,14,3,51,0,200,149,37,14
1,ALBA,NOŞLAC,6048,NOŞLAC,"PRIMĂRIA NOSLAC",326,"Alegeri Prezidentiale",1,968,434,379,53,2,430,4,1000,566,366,64
1,ALBA,NOŞLAC,6048,GĂBUD,"ŞCOALA GENERALĂ GĂBUD",327,"Alegeri Prezidentiale",1,210,128,91,37,0,125,3,300,172,85,40
1,ALBA,NOŞLAC,6048,"STÂNA DE MUREŞ","ŞCOALA GENERALĂ STÎNA DE MUREŞ",328,"Alegeri Prezidentiale",1,312,171,126,45,0,171,0,400,229,144,27
1,ALBA,OCOLIŞ,6119,OCOLIŞ,"INTERNAT ŞCOLAR - OCOLIŞ",329,"Alegeri Prezidentiale",1,259,143,110,31,2,142,1,300,157,112,30
1,ALBA,OCOLIŞ,6119,"LUNCA LARGĂ","TABĂRA DE CREAȚIE SI ODIHNĂ ”AVRAM IANCU”",330,"Alegeri Prezidentiale",1,50,51,29,19,3,51,0,100,49,42,9
1,ALBA,OCOLIŞ,6119,RUNC,"ȘCOALA PRIMARĂ - RUNC",331,"Alegeri Prezidentiale",1,116,71,58,13,0,70,1,200,129,56,14
1,ALBA,OCOLIŞ,6119,VIDOLM,"ȘCOALA PRIMARĂ - VIDOLM",332,"Alegeri Prezidentiale",1,53,57,29,28,0,57,0,100,43,36,21
1,ALBA,OHABA,6164,OHABA,"CONSILIUL LOCAL OHABA",333,"Alegeri Prezidentiale",1,356,266,192,44,30,262,4,400,134,165,97
1,ALBA,OHABA,6164,COLIBI,"CLĂDIRE ADMINISTRATIVĂ COLIBI (FOSTA ŞCOALĂ GENERALĂ)",334,"Alegeri Prezidentiale",1,28,36,14,22,0,36,0,100,64,29,7
1,ALBA,OHABA,6164,SECĂŞEL,"FOSTUL SEDIU C.A.P.",335,"Alegeri Prezidentiale",1,149,118,75,38,5,115,3,200,82,81,34
1,ALBA,PIANU,6217,"PIANU DE SUS","ŞCOALA GIMNAZIALĂ PIANU DE SUS",336,"Alegeri Prezidentiale",1,1387,787,713,62,12,774,13,1500,713,628,146
1,ALBA,PIANU,6217,"PIANU DE JOS","ŞCOALA GIMNAZIALĂ ”AUGUSTIN BENA” PIANU DE JOS",337,"Alegeri Prezidentiale",1,1096,569,491,75,3,566,3,1200,631,459,107
1,ALBA,PIANU,6217,PLAIURI,"CLĂDIRE ADMINISTRATIVĂ (FOSTA ŞCOALĂ GENERALĂ CU CLASELE I-IV) PLAIURI",338,"Alegeri Prezidentiale",1,36,24,13,11,0,23,1,100,76,20,3
1,ALBA,PIANU,6217,PURCĂREŢI,"ŞCOALA PRIMARĂ ”GHEORGHE PAVELESCU” PURCĂREŢI",339,"Alegeri Prezidentiale",1,216,101,84,17,0,100,1,300,199,77,23
1,ALBA,PIANU,6217,STRUNGARI,"ŞCOALA GIMNAZIALĂ STRUNGARI",340,"Alegeri Prezidentiale",1,203,150,117,33,0,148,2,300,150,85,63
1,ALBA,"POIANA VADULUI",6271,"POIANA VADULUI","CĂMINUL CULTURAL SAT POIANA VADULUI",341,"Alegeri Prezidentiale",1,865,420,377,43,0,413,7,900,480,212,201
1,ALBA,PONOR,6397,PONOR,"PRIMARIA COMUNEI PONOR",342,"Alegeri Prezidentiale",1,350,150,129,18,3,149,1,400,250,109,40
1,ALBA,PONOR,6397,GEOGEL,"CAMINUL CULTURAL GEOGEL",343,"Alegeri Prezidentiale",2,187,116,79,33,4,116,0,200,84,90,26
1,ALBA,POŞAGA,6468,"POŞAGA DE JOS","CĂMINUL CULTURAL",344,"Alegeri Prezidentiale",1,349,202,174,28,0,201,1,400,198,155,46
1,ALBA,POŞAGA,6468,LUNCA,"ȘCOALA CU CLASELE I-IV - LUNCA",345,"Alegeri Prezidentiale",1,119,86,50,33,3,86,0,200,114,67,19
1,ALBA,POŞAGA,6468,ORĂŞTI,"ȘCOALA CU CLASELE I-IV - ORĂȘTI",346,"Alegeri Prezidentiale",1,105,59,45,14,0,58,1,201,142,34,24
1,ALBA,POŞAGA,6468,"POŞAGA DE SUS","ŞCOALA PRIMARĂ - POȘAGA DE SUS",347,"Alegeri Prezidentiale",2,138,73,61,12,0,73,0,200,127,50,23
1,ALBA,POŞAGA,6468,SĂGAGEA,"ȘCOALA PRIMARĂ - SAGAGEA",348,"Alegeri Prezidentiale",1,165,86,68,18,0,85,1,200,114,75,10
1,ALBA,RĂDEŞTI,6547,RĂDEŞTI,"CĂMIN CULTURAL RĂDEŞTI",349,"Alegeri Prezidentiale",1,573,320,289,30,1,316,4,600,280,201,115
1,ALBA,RĂDEŞTI,6547,LEORINŢ,"ŞCOALA PRIMARĂ LEORINŢ",350,"Alegeri Prezidentiale",1,260,187,153,34,0,187,0,302,115,164,23
1,ALBA,RĂDEŞTI,6547,MEŞCREAC,"ŞCOALA PRIMARĂ MEŞCREAC",351,"Alegeri Prezidentiale",1,256,150,125,25,0,150,0,300,150,113,37
1,ALBA,RÂMEŢ,6627,RÂMEŢ,"PRIMĂRIA COMUNEI RÎMEŢ",352,"Alegeri Prezidentiale",1,175,64,41,23,0,64,0,200,136,44,20
1,ALBA,RÂMEŢ,6627,BRĂDEŞTI,"FOSTA ŞCOALĂ CU CLASELE I-IV BRĂDEȘTI",353,"Alegeri Prezidentiale",1,92,61,36,25,0,61,0,100,39,20,41
1,ALBA,RÂMEŢ,6627,"VALEA INZELULUI","FOSTA ŞCOALĂ CU CLASELE I-IV VALEA INZELULUI",354,"Alegeri Prezidentiale",1,72,51,32,19,0,51,0,100,49,26,25
1,ALBA,RÂMEŢ,6627,"VALEA MĂNĂSTIRII","FOSTA ŞCOALĂ CU CLASELE I-IV VALEA MĂNĂSTIRII",355,"Alegeri Prezidentiale",1,132,138,78,48,12,131,7,500,362,58,73
1,ALBA,RIMETEA,6592,RIMETEA,"CĂMINUL CULTURAL RIMETEA",356,"Alegeri Prezidentiale",1,456,262,167,95,0,257,5,500,238,202,55
1,ALBA,RIMETEA,6592,COLŢEŞTI,"ŞCOALA PRIMARA COLŢEŞTI",357,"Alegeri Prezidentiale",1,443,150,122,28,0,150,0,500,350,134,16
1,ALBA,"ROŞIA DE SECAŞ",6930,UNGUREI,"CĂMIN CULTURAL",358,"Alegeri Prezidentiale",1,269,132,119,13,0,132,0,300,168,80,52
1,ALBA,"ROŞIA DE SECAŞ",6930,"ROŞIA DE SECAŞ","PRIMĂRIA ROŞIA DE SECAŞ",359,"Alegeri Prezidentiale",1,586,326,283,43,0,321,5,599,273,234,87
1,ALBA,"ROŞIA DE SECAŞ",6930,TĂU,"FOSTUL SEDIU CAP",360,"Alegeri Prezidentiale",1,363,189,139,50,0,189,0,400,211,128,61
1,ALBA,"ROŞIA MONTANĂ",6761,CĂRPINIŞ,"ŞCOALA CU CLASELE I-IV - GURA ROȘIEI",361,"Alegeri Prezidentiale",1,637,300,282,18,0,294,6,700,400,114,180
1,ALBA,"ROŞIA MONTANĂ",6761,VÂRTOP,"ŞCOALA CU CLASELE I-IV - VÎRTOP",362,"Alegeri Prezidentiale",1,185,109,94,15,0,108,1,200,91,53,55
1,ALBA,"ROŞIA MONTANĂ",6761,"ROŞIA MONTANĂ","PRIMARIA COMUNEI ROȘIA MONTANĂ",363,"Alegeri Prezidentiale",1,681,330,299,31,0,322,8,700,370,171,151
1,ALBA,"ROŞIA MONTANĂ",6761,CĂRPINIŞ,"LOCUINȚE SOCIALE - CĂRPINIȘ",364,"Alegeri Prezidentiale",1,667,345,329,16,0,341,4,699,354,188,153
1,ALBA,"ROŞIA MONTANĂ",6761,CORNA,"ȘCOALA CU CLASELE I-IV - CORNA",365,"Alegeri Prezidentiale",1,129,101,78,23,0,101,0,200,99,55,46
1,ALBA,SĂLCIUA,6976,"SĂLCIUA DE JOS","ŞCOALA PRIMARĂ SĂLCIUA DE JOS",366,"Alegeri Prezidentiale",1,684,377,325,51,1,373,4,699,322,231,142
1,ALBA,SĂLCIUA,6976,"SĂLCIUA DE SUS","ŞCOALA GIMNAZIALĂ ”SIMION PANTEA” SĂLCIUA",367,"Alegeri Prezidentiale",1,569,289,265,19,5,288,1,600,311,214,74
1,ALBA,SĂLIŞTEA,7044,SĂLIŞTEA,"ȘCOALA GIMNAZIALĂ ”DAVID PRODAN” SĂLIȘTEA",368,"Alegeri Prezidentiale",1,1034,681,608,70,3,672,9,1100,419,578,94
1,ALBA,SĂLIŞTEA,7044,MĂRGINENI,"ŞCOALA PRIMARĂ MĂRGINENI",369,"Alegeri Prezidentiale",1,48,33,21,12,0,33,0,100,67,29,4
1,ALBA,SĂLIŞTEA,7044,SĂLIŞTEA-DEAL,"ŞCOALA PRIMARĂ SĂLIŞTEA-DEAL",370,"Alegeri Prezidentiale",1,234,144,130,14,0,139,5,300,156,112,27
1,ALBA,SĂLIŞTEA,7044,TĂRTĂRIA,"ŞCOALA PRIMARĂ TĂRTĂRIA",371,"Alegeri Prezidentiale",1,571,390,328,62,0,382,8,600,210,303,79
1,ALBA,SĂSCIORI,7099,CĂPÂLNA,"ȘCOALA PRIMARĂ CĂPÎLNA",372,"Alegeri Prezidentiale",1,698,360,327,33,0,357,3,800,440,318,39
1,ALBA,SĂSCIORI,7099,SĂSCIORI,"ȘCOALA GIMNAZIALĂ SĂSCIORI",373,"Alegeri Prezidentiale",1,1341,717,644,73,0,709,8,1400,683,606,103
1,ALBA,SĂSCIORI,7099,LAZ,"ȘCOALA PRIMARĂ LAZ",374,"Alegeri Prezidentiale",1,350,213,185,28,0,213,0,400,187,177,36
1,ALBA,SĂSCIORI,7099,SEBEŞEL,"ȘCOALA PRIMARĂ SEBEȘEL",375,"Alegeri Prezidentiale",1,1029,580,538,42,0,573,7,1100,520,498,75
1,ALBA,SĂSCIORI,7099,LOMAN,"ȘCOALA GIMNAZIALĂ LOMAN",376,"Alegeri Prezidentiale",1,662,346,333,13,0,343,3,700,354,320,23
1,ALBA,SĂSCIORI,7099,RĂCHITA,"ȘCOALA GIMNAZIALĂ RĂCHITA",377,"Alegeri Prezidentiale",1,738,350,335,15,0,345,5,800,450,286,59
1,ALBA,SÂNCEL,7348,ICLOD,"GRADINIŢA DE COPII CU PROGRAM NORMAL ICLOD",378,"Alegeri Prezidentiale",1,315,109,89,20,0,105,4,400,291,89,16
1,ALBA,SÂNCEL,7348,SÂNCEL,"CĂMINUL CULTURAL SÎNCEL",379,"Alegeri Prezidentiale",1,1315,671,622,47,2,658,13,1400,729,546,112
1,ALBA,SÂNCEL,7348,PĂNADE,"ŞCOALA PRIMARĂ PĂNADE",380,"Alegeri Prezidentiale",1,524,299,268,31,0,292,7,600,301,239,53
1,ALBA,SÂNTIMBRU,7384,COŞLARIU,"CLĂDIRE VESTIAR - BAZA SPORTIVĂ COȘLARIU",381,"Alegeri Prezidentiale",1,372,256,201,44,11,254,2,400,144,178,76
1,ALBA,SÂNTIMBRU,7384,TOTOI,"ŞCOALA PRIMARĂ TOTOI",382,"Alegeri Prezidentiale",1,441,300,219,81,0,299,1,500,200,237,62
1,ALBA,SÂNTIMBRU,7384,SÂNTIMBRU,"PRIMĂRIA COMUNEI SÎNTIMBRU",383,"Alegeri Prezidentiale",1,728,427,364,58,5,427,0,800,373,326,101
1,ALBA,SÂNTIMBRU,7384,DUMITRA,"CENTRU DE ZI PERSOANE VĂRSTNICE",384,"Alegeri Prezidentiale",1,69,70,39,31,0,70,0,100,30,55,15
1,ALBA,SÂNTIMBRU,7384,GALTIU,"CĂMINUL CULTURAL ”EUGEN CURTA” GALTIU",385,"Alegeri Prezidentiale",1,400,242,204,37,1,239,3,500,258,175,64
1,ALBA,SÂNTIMBRU,7384,SÂNTIMBRU,"CLĂRIREA CĂMINUL CULTURAL SÎNTIMBRU",386,"Alegeri Prezidentiale",1,442,216,194,22,0,212,4,500,284,159,53
1,ALBA,SCĂRIŞOARA,7197,SCĂRIŞOARA,"CĂMINUL CULTURAL SCĂRIȘOARA",387,"Alegeri Prezidentiale",1,584,315,274,22,19,309,6,700,385,217,92
1,ALBA,SCĂRIŞOARA,7197,NEGEŞTI,"ŞCOALA PRIMARĂ NEGEȘTI",388,"Alegeri Prezidentiale",1,153,72,61,8,3,70,2,200,128,41,29
1,ALBA,SCĂRIŞOARA,7197,RUNC,"ŞCOALA PRIMARĂ RUNC",389,"Alegeri Prezidentiale",1,139,84,72,10,2,82,2,200,116,55,27
1,ALBA,SCĂRIŞOARA,7197,SFOARTEA,"ŞCOALA PRIMARĂ SFOARTEA",390,"Alegeri Prezidentiale",1,67,32,23,9,0,32,0,100,68,20,12
1,ALBA,SCĂRIŞOARA,7197,ŞTIULEŢI,"ŞCOALA PRIMARĂ ȘTIULEȚI",391,"Alegeri Prezidentiale",1,111,87,66,18,3,86,1,200,113,66,20
1,ALBA,SCĂRIŞOARA,7197,LĂZEŞTI,"ŞCOALA GIMNAZIALĂ LĂZEȘTI",392,"Alegeri Prezidentiale",1,207,99,79,20,0,98,1,300,201,72,26
1,ALBA,SOHODOL,7446,PELEŞ,"ȘCOALA PRIMARĂ PELEŞ",393,"Alegeri Prezidentiale",1,342,145,132,13,0,144,1,400,255,86,58
1,ALBA,SOHODOL,7446,POIANA,"ŞCOALA PRIMARĂ POIANA",394,"Alegeri Prezidentiale",1,131,56,44,12,0,56,0,200,144,27,29
1,ALBA,SOHODOL,7446,SOHODOL,"CĂMINUL CULTURAL SOHODOL",395,"Alegeri Prezidentiale",1,798,430,372,58,0,423,7,900,470,261,162
1,ALBA,SOHODOL,7446,LAZURI,"SC HIDROCONSTRUCȚIA SA SEBEȘ PUNCT DE LUCRU SAT LAZURI",396,"Alegeri Prezidentiale",1,185,110,93,17,0,110,0,200,90,68,42
1,ALBA,STREMŢ,7767,STREMŢ,"ŞCOALA GIMNAZIALĂ STREMŢ",397,"Alegeri Prezidentiale",1,1157,753,639,95,19,743,10,1200,447,446,297
1,ALBA,STREMŢ,7767,"GEOAGIU DE SUS","ŞCOALA GIMNAZIALA ”VASILE BOLOGA” GEOAGIU DE SUS",398,"Alegeri Prezidentiale",1,634,453,370,75,8,441,12,700,247,275,166
1,ALBA,STREMŢ,7767,GEOMAL,"ŞCOALA PRIMARA GEOMAL",399,"Alegeri Prezidentiale",1,270,215,163,42,10,213,2,300,85,106,107
1,ALBA,ŞIBOT,7810,ŞIBOT,"CĂMIN CULTURAL ȘIBOT",400,"Alegeri Prezidentiale",1,1158,616,534,81,1,612,4,1200,584,426,186
1,ALBA,ŞIBOT,7810,"BALOMIRU DE CÂMP","CĂMINUL CULTURAL BALOMIR",401,"Alegeri Prezidentiale",1,522,294,244,50,0,291,3,600,306,203,88
1,ALBA,ŞIBOT,7810,BĂCĂINŢI,"ŞCOALA PRIMARĂ BĂCĂINŢI",402,"Alegeri Prezidentiale",1,225,151,105,42,4,151,0,300,149,126,25
1,ALBA,ŞIBOT,7810,SĂRĂCSĂU,"CLĂDIRE ADMINISTRATIVĂ SĂRĂCSĂU (FOSTA ŞCOALĂ GENERALĂ)",403,"Alegeri Prezidentiale",1,159,86,55,31,0,86,0,200,114,71,15
1,ALBA,ŞONA,7865,"LUNCA TÂRNAVEI","CĂMIN CULTURAL LUNCA TÂRNAVEI",404,"Alegeri Prezidentiale",1,338,190,166,24,0,190,0,400,210,160,30
1,ALBA,ŞONA,7865,ŞONA,"ŞCOALA GIMNAZIALĂ ŞONA",405,"Alegeri Prezidentiale",1,1056,482,454,23,5,477,5,1100,618,378,99
1,ALBA,ŞONA,7865,ALECUŞ,"CĂMINUL CULTURAL ALECUŞ",406,"Alegeri Prezidentiale",1,84,37,21,16,0,37,0,100,63,30,7
1,ALBA,ŞONA,7865,BIIA,"SALA MULTIFUNCȚIONALĂ BIIA",407,"Alegeri Prezidentiale",1,974,594,534,41,19,591,3,1000,406,530,61
1,ALBA,ŞONA,7865,SÂNMICLĂUŞ,"ȘCOALA GIMNAZIALĂ SÎNMICLĂUŞ",408,"Alegeri Prezidentiale",1,1141,527,503,24,0,523,4,1200,673,475,48
1,ALBA,ŞPRING,7945,ŞPRING,"PRIMĂRIA COMUNEI ŞPRING",409,"Alegeri Prezidentiale",1,578,408,342,55,11,403,5,700,292,222,181
1,ALBA,ŞPRING,7945,CUNŢA,"ŞCOALA GIMNAZIALĂ CUNŢA",410,"Alegeri Prezidentiale",1,471,294,252,40,2,292,2,600,306,240,52
1,ALBA,ŞPRING,7945,DRAŞOV,"ŞCOALA PRIMARĂ DRAŞOV",411,"Alegeri Prezidentiale",1,439,241,212,26,3,239,2,500,259,148,91
1,ALBA,ŞPRING,7945,VINGARD,"SEDIU ADMINISTRATIV VINGARD - COMUNA ŞPRING",412,"Alegeri Prezidentiale",1,568,268,234,32,2,262,6,700,432,190,72
1,ALBA,ŞUGAG,8014,DOBRA,"CLĂDIRE ADMINISTRATIVĂ (FOSTĂ ŞCOALA GENERALĂ DOBRA)",413,"Alegeri Prezidentiale",1,455,301,272,28,1,296,5,500,199,267,29
1,ALBA,ŞUGAG,8014,MĂRTINIE,"ŞCOALA PRIMARĂ MĂRTINIE",414,"Alegeri Prezidentiale",1,456,316,300,16,0,316,0,500,184,283,33
1,ALBA,ŞUGAG,8014,ŞUGAG,"PRIMĂRIA COMUNEI ŞUGAG",415,"Alegeri Prezidentiale",1,1414,1005,891,108,6,1001,4,1500,495,921,80
1,ALBA,UNIREA,8158,UNIREA,"ŞCOALA GIMNAZIALĂ ”AVRAM IANCU” UNIREA",416,"Alegeri Prezidentiale",1,953,336,300,36,0,332,4,1000,664,257,75
1,ALBA,UNIREA,8158,UNIREA,"ŞCOALA GIMNAZIALĂ ”AVRAM IANCU” UNIREA",417,"Alegeri Prezidentiale",2,809,354,316,37,1,349,5,900,546,283,66
1,ALBA,UNIREA,8158,UNIREA,"ŞCOALA GIMNAZIALĂ ”GHEORGHE MAIER” UNIREA",418,"Alegeri Prezidentiale",1,1149,529,472,56,1,522,7,1200,671,356,166
1,ALBA,UNIREA,8158,"CIUGUDU DE JOS","ŞCOALA PRIMARĂ CIUGUDU DE JOS",419,"Alegeri Prezidentiale",1,278,110,87,23,0,108,2,302,192,87,21
1,ALBA,UNIREA,8158,"CIUGUDU DE SUS","ŞCOALA PRIMARĂ CIUGUDU DE SUS",420,"Alegeri Prezidentiale",1,112,78,49,29,0,77,1,199,121,58,19
1,ALBA,UNIREA,8158,DUMBRAVA,"ŞCOALA PRIMARĂ DUMBRAVA",421,"Alegeri Prezidentiale",1,272,157,96,39,22,152,5,300,143,94,58
1,ALBA,UNIREA,8158,INOC,"ŞCOALA PRIMARĂ INOC",422,"Alegeri Prezidentiale",1,154,83,52,31,0,82,1,200,117,53,29
1,ALBA,UNIREA,8158,MĂHĂCENI,"ŞCOALA PRIMARĂ MĂHĂCENI",423,"Alegeri Prezidentiale",1,223,125,76,49,0,125,0,300,175,80,45
1,ALBA,"VADU MOŢILOR",8229,"VADU MOŢILOR","ȘCOALA GIMNAZIALĂ VADU MOȚILOR",424,"Alegeri Prezidentiale",1,1124,571,510,60,1,563,8,1200,629,312,251
1,ALBA,"VALEA LUNGĂ",8354,"VALEA LUNGĂ","PRIMĂRIA VALEA LUNGĂ",425,"Alegeri Prezidentiale",1,1540,738,686,52,0,730,8,1607,869,591,139
1,ALBA,"VALEA LUNGĂ",8354,GLOGOVEŢ,"ŞCOALA PRIMARĂ GLOGOVEŢ",426,"Alegeri Prezidentiale",1,139,92,70,22,0,92,0,200,108,78,14
1,ALBA,"VALEA LUNGĂ",8354,LODROMAN,"ŞCOALA PRIMARĂ LODROMAN",427,"Alegeri Prezidentiale",1,151,96,78,18,0,95,1,200,104,66,29
1,ALBA,"VALEA LUNGĂ",8354,LUNCA,"ȘCOALA PRIMARĂ LUNCA",428,"Alegeri Prezidentiale",1,386,209,176,32,1,207,2,500,291,168,39
1,ALBA,"VALEA LUNGĂ",8354,TĂUNI,"CĂMIN CULTURAL TĂUNI",429,"Alegeri Prezidentiale",1,254,161,119,42,0,159,2,300,139,136,23
1,ALBA,VIDRA,8425,VIDRA,"PRIMĂRIA COMUNEI VIDRA",430,"Alegeri Prezidentiale",1,314,154,121,33,0,151,3,400,246,115,36
1,ALBA,VIDRA,8425,GOIEŞTI,"ŞCOALA PRIMARĂ GOIEŞTI",431,"Alegeri Prezidentiale",1,290,157,139,18,0,157,0,400,243,109,48
1,ALBA,VIDRA,8425,PONOREL,"FOSTUL SEDIU AL PRIMĂRIEI PONOREL",432,"Alegeri Prezidentiale",1,717,326,301,25,0,323,3,800,474,156,167
1,ALBA,"VINŢU DE JOS",8826,VURPĂR,"CĂMINUL CULTURAL VURPĂR",433,"Alegeri Prezidentiale",1,853,432,408,24,0,432,0,900,468,342,90
1,ALBA,"VINŢU DE JOS",8826,"VINŢU DE JOS","CĂMINUL CULTURAL VINŢU DE JOS",434,"Alegeri Prezidentiale",1,1061,656,569,87,0,642,14,1200,544,519,123
1,ALBA,"VINŢU DE JOS",8826,"VINŢU DE JOS","ŞCOALA GIMNAZIALĂ ”IULIU MANIU” VINŢU DE JOS",435,"Alegeri Prezidentiale",1,1321,661,617,44,0,650,11,1400,739,495,155
1,ALBA,"VINŢU DE JOS",8826,"VINŢU DE JOS","SALA PAROHIALĂ SIBIŞENI",436,"Alegeri Prezidentiale",1,588,356,308,48,0,352,4,700,344,289,63
1,ALBA,"VINŢU DE JOS",8826,INURI,"CĂMINUL CULTURAL INURI",437,"Alegeri Prezidentiale",1,150,42,31,11,0,42,0,200,158,35,7
1,ALBA,"VINŢU DE JOS",8826,MERETEU,"CĂMINUL CULTURAL MERETEU",438,"Alegeri Prezidentiale",1,170,115,90,25,0,115,0,200,85,87,28
1,ALBA,"VINŢU DE JOS",8826,"VALEA VINŢULUI","ŞCOALA PRIMARĂ VALEA VINŢULUI",439,"Alegeri Prezidentiale",1,325,147,137,10,0,147,0,400,253,119,28
2,ARAD,"MUNICIPIUL ARAD",9262,ARAD,"COLEGIUL TEHNIC ”AUREL VLAICU” ARAD - (SALA DE SPORT)",1,"Alegeri Prezidentiale",1,844,389,329,60,0,378,11,950,561,270,108
2,ARAD,"MUNICIPIUL ARAD",9262,ARAD,"POLICLINICA MUNICIPALĂ",2,"Alegeri Prezidentiale",1,1071,658,486,172,0,645,13,1150,492,462,183
2,ARAD,"MUNICIPIUL ARAD",9262,ARAD,"SPITALUL CLINIC MUNICIPAL - SECŢIA ORL",3,"Alegeri Prezidentiale",1,1119,669,539,92,38,652,17,1250,581,420,232
2,ARAD,"MUNICIPIUL ARAD",9262,ARAD,"COLEGIUL NAŢIONAL „VASILE GOLDIŞ” (FOSTA ŞCOALĂ GENERALĂ NR. 4)",4,"Alegeri Prezidentiale",1,1247,685,591,80,14,664,21,1350,665,450,214
2,ARAD,"MUNICIPIUL ARAD",9262,ARAD,"COLEGIUL NAŢIONAL „VASILE GOLDIŞ” (FOSTA ŞCOALĂ GENERALĂ NR. 4)",5,"Alegeri Prezidentiale",2,1225,728,580,114,34,714,14,1350,622,479,235
2,ARAD,"MUNICIPIUL ARAD",9262,ARAD,"COLEGIUL NAŢIONAL „VASILE GOLDIŞ” (FOSTA ŞCOALĂ GENERALĂ NR. 4)",6,"Alegeri Prezidentiale",1,917,549,438,89,22,536,13,1000,451,362,174
2,ARAD,"MUNICIPIUL ARAD",9262,ARAD,"COLEGIUL NAŢIONAL „VASILE GOLDIŞ” (FOSTA ŞCOALĂ GENERALĂ NR. 4)",7,"Alegeri Prezidentiale",1,926,573,471,67,35,557,16,1000,427,365,192
2,ARAD,"MUNICIPIUL ARAD",9262,ARAD,"COLEGIUL NAŢIONAL „VASILE GOLDIŞ”",8,"Alegeri Prezidentiale",1,1793,1117,846,178,93,1093,24,1950,833,788,305
2,ARAD,"MUNICIPIUL ARAD",9262,ARAD,"LICEUL DE ARTE „SABIN DRĂGOI”",9,"Alegeri Prezidentiale",1,1028,628,523,104,1,618,10,1100,472,458,160
2,ARAD,"MUNICIPIUL ARAD",9262,ARAD,"LICEUL DE ARTE „SABIN DRĂGOI”",10,"Alegeri Prezidentiale",1,1194,729,591,138,0,715,14,1308,579,481,234
2,ARAD,"MUNICIPIUL ARAD",9262,ARAD,"LICEUL TEHNOLOGIC DE ELECTRONICĂ ŞI AUTOMATIZĂRI „CAIUS IACOB”",11,"Alegeri Prezidentiale",2,1365,719,658,61,0,700,19,1500,781,469,231
2,ARAD,"MUNICIPIUL ARAD",9262,ARAD,"LICEUL TEOLOGIC BAPTIST „ALEXA POPOVICI”",12,"Alegeri Prezidentiale",1,848,461,409,50,2,454,7,950,489,313,141
2,ARAD,"MUNICIPIUL ARAD",9262,ARAD,"LICEUL TEOLOGIC BAPTIST „ALEXA POPOVICI”",13,"Alegeri Prezidentiale",1,986,471,447,24,0,457,14,1100,629,282,175
2,ARAD,"MUNICIPIUL ARAD",9262,ARAD,"LICEUL NAȚIONAL DE INFORMATICĂ",14,"Alegeri Prezidentiale",1,1351,816,648,168,0,795,21,1500,684,565,230
2,ARAD,"MUNICIPIUL ARAD",9262,ARAD,"SALA POLIVALENTĂ",15,"Alegeri Prezidentiale",1,1010,564,504,60,0,551,13,1100,536,370,181
2,ARAD,"MUNICIPIUL ARAD",9262,ARAD,"SALA POLIVALENTĂ",16,"Alegeri Prezidentiale",1,929,576,531,45,0,563,13,1000,424,374,189
2,ARAD,"MUNICIPIUL ARAD",9262,ARAD,"UNIVERSITATEA „AUREL VLAICU”",17,"Alegeri Prezidentiale",1,1489,781,728,52,1,764,17,1650,869,562,202
2,ARAD,"MUNICIPIUL ARAD",9262,ARAD,"UNIVERSITATEA „AUREL VLAICU”",18,"Alegeri Prezidentiale",1,1365,769,734,35,0,745,24,1500,731,500,245
2,ARAD,"MUNICIPIUL ARAD",9262,ARAD,"UNIVERSITATEA „AUREL VLAICU”",19,"Alegeri Prezidentiale",1,1248,693,668,25,0,676,17,1350,657,444,232
2,ARAD,"MUNICIPIUL ARAD",9262,ARAD,"UNIVERSITATEA „AUREL VLAICU”",20,"Alegeri Prezidentiale",2,1340,834,650,184,0,819,15,1450,616,598,221
2,ARAD,"MUNICIPIUL ARAD",9262,ARAD,"GRĂDINIȚA CU PROGRAM PRELUNGIT „PRICHINDEL” ARAD",21,"Alegeri Prezidentiale",1,1609,950,865,85,0,932,18,1750,800,644,288
2,ARAD,"MUNICIPIUL ARAD",9262,ARAD,"ŞCOALA GIMNAZIALĂ „REGINA MARIA” (FOSTA ŞCOALĂ GENERALĂ NR. 12)",22,"Alegeri Prezidentiale",1,1469,838,739,99,0,817,21,1600,762,581,236
2,ARAD,"MUNICIPIUL ARAD",9262,ARAD,"ŞCOALA GIMNAZIALĂ „REGINA MARIA” (FOSTA ŞCOALĂ GENERALĂ NR. 12)",23,"Alegeri Prezidentiale",1,1312,675,597,78,0,663,12,1450,775,430,233
2,ARAD,"MUNICIPIUL ARAD",9262,ARAD,"ŞCOALA GIMNAZIALĂ „REGINA MARIA” (FOSTA ŞCOALĂ GENERALĂ NR. 12)",24,"Alegeri Prezidentiale",1,1392,750,704,46,0,726,24,1500,750,511,215
2,ARAD,"MUNICIPIUL ARAD",9262,ARAD,"ȘCOALA GIMNAZIALĂ „CAIUS IACOB” (FOSTA ŞCOALĂ GENERALĂ NR. 22)",25,"Alegeri Prezidentiale",1,1416,826,726,100,0,807,19,1550,724,579,228
2,ARAD,"MUNICIPIUL ARAD",9262,ARAD,"ȘCOALA GIMNAZIALĂ „CAIUS IACOB” (FOSTA ŞCOALĂ GENERALĂ NR. 22)",26,"Alegeri Prezidentiale",1,1241,645,542,102,1,636,9,1350,705,462,174
2,ARAD,"MUNICIPIUL ARAD",9262,ARAD,"ȘCOALA GIMNAZIALĂ „CAIUS IACOB” (FOSTA ŞCOALĂ GENERALĂ NR. 22)",27,"Alegeri Prezidentiale",1,1354,727,683,44,0,720,7,1500,773,504,216
2,ARAD,"MUNICIPIUL ARAD",9262,ARAD,"ȘCOALA GIMNAZIALĂ „CAIUS IACOB” (FOSTA ŞCOALĂ GENERALĂ NR. 22)",28,"Alegeri Prezidentiale",1,1475,779,715,64,0,763,16,1600,821,559,204
2,ARAD,"MUNICIPIUL ARAD",9262,ARAD,"ȘCOALA GIMNAZIALĂ „CAIUS IACOB” (FOSTA ŞCOALĂ GENERALĂ NR. 22)",29,"Alegeri Prezidentiale",1,1238,635,586,49,0,621,14,1350,715,451,170
2,ARAD,"MUNICIPIUL ARAD",9262,ARAD,"ȘCOALA GIMNAZIALĂ „CAIUS IACOB” (FOSTA ŞCOALĂ GENERALĂ NR. 22)",30,"Alegeri Prezidentiale",1,1403,765,732,33,0,748,17,1550,785,566,182
2,ARAD,"MUNICIPIUL ARAD",9262,ARAD,"DIRECŢIA DE DEZVOLTARE ŞI ASISTENŢĂ COMUNITARĂ ARAD",31,"Alegeri Prezidentiale",1,1543,956,836,120,0,933,23,1700,744,656,277
2,ARAD,"MUNICIPIUL ARAD",9262,ARAD,"GRĂDINIŢA PP NR. 7",32,"Alegeri Prezidentiale",1,1473,740,689,51,0,719,21,1600,860,512,207
2,ARAD,"MUNICIPIUL ARAD",9262,ARAD,"GRĂDINIȚA P.P. NR. 7",33,"Alegeri Prezidentiale",1,1478,685,643,42,0,671,14,1650,965,441,230
2,ARAD,"MUNICIPIUL ARAD",9262,ARAD,"GRĂDINIȚA CU PROGRAM PRELUNGIT „PRICHINDEL”ARAD",34,"Alegeri Prezidentiale",1,1459,750,716,34,0,732,18,1600,850,523,209
2,ARAD,"MUNICIPIUL ARAD",9262,ARAD,"ŞCOALA GIMNAZIALĂ „ARON COTRUŞ”ARAD (FOSTA ŞCOALĂ GENERALĂ NR. 13)",35,"Alegeri Prezidentiale",1,1156,650,602,47,1,636,14,1250,600,471,165
2,ARAD,"MUNICIPIUL ARAD",9262,ARAD,"ŞCOALA GIMNAZIALĂ „ARON COTRUŞ”ARAD (FOSTA ŞCOALĂ GENERALĂ NR. 13)",36,"Alegeri Prezidentiale",1,1620,873,818,54,1,840,33,1750,877,582,258
2,ARAD,"MUNICIPIUL ARAD",9262,ARAD,"ŞCOALA GIMNAZIALĂ „ARON COTRUŞ”ARAD (FOSTA ŞCOALĂ GENERALĂ NR. 13)",37,"Alegeri Prezidentiale",1,1210,677,644,32,1,664,13,1300,623,455,209
2,ARAD,"MUNICIPIUL ARAD",9262,ARAD,"ŞCOALA GIMNAZIALĂ „ARON COTRUŞ”ARAD (FOSTA ŞCOALĂ GENERALĂ NR. 13)",38,"Alegeri Prezidentiale",1,1501,838,776,62,0,821,17,1650,812,570,251
2,ARAD,"MUNICIPIUL ARAD",9262,ARAD,"ŞCOALA GIMNAZIALĂ „ARON COTRUŞ”ARAD (FOSTA ŞCOALĂ GENERALĂ NR. 13)",39,"Alegeri Prezidentiale",1,826,446,375,71,0,440,6,900,454,341,99
2,ARAD,"MUNICIPIUL ARAD",9262,ARAD,"ŞCOALA GIMNAZIALĂ „ARON COTRUŞ”ARAD (FOSTA ŞCOALĂ GENERALĂ NR. 13)",40,"Alegeri Prezidentiale",1,1209,751,661,49,41,740,11,1342,591,518,222
2,ARAD,"MUNICIPIUL ARAD",9262,ARAD,"ŞCOALA GIMNAZIALĂ „ARON COTRUŞ”ARAD (FOSTA ŞCOALĂ GENERALĂ NR. 13)",41,"Alegeri Prezidentiale",1,1404,795,739,56,0,769,26,1550,755,564,205
2,ARAD,"MUNICIPIUL ARAD",9262,ARAD,"GRĂDINIŢA P.P. NR. 11 ARAD",42,"Alegeri Prezidentiale",1,1328,685,649,36,0,680,5,1450,765,509,171
2,ARAD,"MUNICIPIUL ARAD",9262,ARAD,"GRĂDINIŢA CU PROGRAM NORMAL NR. 9",43,"Alegeri Prezidentiale",1,722,657,319,41,297,651,6,808,151,255,396
2,ARAD,"MUNICIPIUL ARAD",9262,ARAD,"GRĂDINIŢA CU PROGRAM SĂPTĂMÂNAL NR. 2 ARAD",44,"Alegeri Prezidentiale",1,1200,792,511,52,229,779,13,1300,508,428,351
2,ARAD,"MUNICIPIUL ARAD",9262,ARAD,"ŞCOALA GIMNAZIALĂ „AUREL VLAICU”ARAD (FOSTA ŞCOALĂ GENERALĂ NR. 21)",45,"Alegeri Prezidentiale",1,1302,772,662,110,0,751,21,1450,678,518,233
2,ARAD,"MUNICIPIUL ARAD",9262,ARAD,"ŞCOALA GIMNAZIALĂ „AUREL VLAICU”ARAD (FOSTA ŞCOALĂ GENERALĂ NR. 21)",46,"Alegeri Prezidentiale",1,1066,626,552,72,2,607,19,1200,574,422,185
2,ARAD,"MUNICIPIUL ARAD",9262,ARAD,"ŞCOALA GIMNAZIALĂ „AUREL VLAICU”ARAD (FOSTA ŞCOALĂ GENERALĂ NR. 21)",47,"Alegeri Prezidentiale",1,1227,709,634,75,0,692,17,1350,641,478,214
2,ARAD,"MUNICIPIUL ARAD",9262,ARAD,"ȘCOALA GIMNAZIALĂ „NICOLAE BĂLCESCU” (FOSTA ŞCOALĂ GENERALĂ NR.11)",48,"Alegeri Prezidentiale",1,1700,849,786,62,1,832,17,1850,1001,581,251
2,ARAD,"MUNICIPIUL ARAD",9262,ARAD,"ȘCOALA GIMNAZIALĂ „NICOLAE BĂLCESCU” (FOSTA ŞCOALĂ GENERALĂ NR.11)",49,"Alegeri Prezidentiale",1,1642,732,656,76,0,714,18,1808,1076,528,186
2,ARAD,"MUNICIPIUL ARAD",9262,ARAD,"ȘCOALA GIMNAZIALĂ „NICOLAE BĂLCESCU” (FOSTA ŞCOALĂ GENERALĂ NR.11)",50,"Alegeri Prezidentiale",1,1256,633,583,50,0,624,9,1392,759,446,178
2,ARAD,"MUNICIPIUL ARAD",9262,ARAD,"GRĂDINIȚA CU PROGRAM PRELUNGIT „PALATUL FERMECAT” ARAD",51,"Alegeri Prezidentiale",1,1651,857,777,80,0,832,25,1800,943,583,249
2,ARAD,"MUNICIPIUL ARAD",9262,ARAD,"GRĂDINIȚA CU PROGRAM PRELUNGIT „PALATUL FERMECAT” ARAD",52,"Alegeri Prezidentiale",1,1660,807,734,73,0,786,21,1801,994,547,239
2,ARAD,"MUNICIPIUL ARAD",9262,ARAD,"CENTRUL DE VÂRSTNICI",53,"Alegeri Prezidentiale",1,1550,704,633,71,0,692,12,1700,996,495,197
2,ARAD,"MUNICIPIUL ARAD",9262,ARAD,"GRĂDINIŢA P.N. NR. 8",54,"Alegeri Prezidentiale",1,1886,1035,962,72,1,1010,25,2042,1007,805,205
2,ARAD,"MUNICIPIUL ARAD",9262,ARAD,"GRĂDINIŢA P.P. NR. 8 ARAD",55,"Alegeri Prezidentiale",1,1706,822,790,32,0,802,20,1850,1028,650,152
2,ARAD,"MUNICIPIUL ARAD",9262,ARAD,"ŞCOALA GIMNAZIALĂ „FRAŢII NEUMANN” (FOSTA ŞCOALĂ GENERALĂ NR. 10)",56,"Alegeri Prezidentiale",1,890,489,440,48,1,480,9,950,461,378,102
2,ARAD,"MUNICIPIUL ARAD",9262,ARAD,"ŞCOALA GIMNAZIALĂ „FRAŢII NEUMANN” (FOSTA ŞCOALĂ GENERALĂ NR. 10)",57,"Alegeri Prezidentiale",1,1402,650,622,28,0,633,17,1550,900,444,189
2,ARAD,"MUNICIPIUL ARAD",9262,ARAD,"LICEUL CU PROGRAM SPORTIV (FOSTA ŞCOALĂ GENERALĂ NR. 9)",58,"Alegeri Prezidentiale",1,1564,721,698,23,0,705,16,1700,979,529,176
2,ARAD,"MUNICIPIUL ARAD",9262,ARAD,"LICEUL CU PROGRAM SPORTIV (FOSTA ŞCOALĂ GENERALĂ NR. 9)",59,"Alegeri Prezidentiale",1,1308,556,527,29,0,543,13,1450,894,435,108
2,ARAD,"MUNICIPIUL ARAD",9262,ARAD,"LICEUL CU PROGRAM SPORTIV (FOSTA ŞCOALĂ GENERALĂ NR. 9)",60,"Alegeri Prezidentiale",1,1569,714,684,30,0,690,24,1700,986,538,152
2,ARAD,"MUNICIPIUL ARAD",9262,ARAD,"LICEUL CU PROGRAM SPORTIV (FOSTA ŞCOALĂ GENERALĂ NR. 9)",61,"Alegeri Prezidentiale",1,1236,537,517,20,0,522,15,1350,813,397,125
2,ARAD,"MUNICIPIUL ARAD",9262,ARAD,"LICEUL CU PROGRAM SPORTIV (FOSTA ŞCOALĂ GENERALĂ NR. 9)",62,"Alegeri Prezidentiale",1,1414,619,590,29,0,597,22,1550,931,407,190
2,ARAD,"MUNICIPIUL ARAD",9262,ARAD,"GRĂDINIŢA CU PROGRAM PRELUNGIT „GRĂDINIŢA PRIETENIEI” ARAD",63,"Alegeri Prezidentiale",1,1681,833,758,75,0,824,9,1850,1017,625,199
2,ARAD,"MUNICIPIUL ARAD",9262,ARAD,"GRĂDINIŢA CU PROGRAM PRELUNGIT „GRĂDINIŢA PRIETENIEI” ARAD",64,"Alegeri Prezidentiale",2,1514,692,636,56,0,682,10,1642,950,494,188
2,ARAD,"MUNICIPIUL ARAD",9262,ARAD,"COLEGIUL TEHNIC DE CONSTRUCȚII ȘI PROTECȚIA MEDIULUI (FOSTA ŞCOALĂ GENERALĂ NR. 6)",65,"Alegeri Prezidentiale",1,1485,795,678,117,0,775,20,1650,855,566,209
2,ARAD,"MUNICIPIUL ARAD",9262,ARAD,"COLEGIUL TEHNIC DE CONSTRUCȚII ȘI PROTECȚIA MEDIULUI (FOSTA ŞCOALĂ GENERALĂ NR. 6)",66,"Alegeri Prezidentiale",1,1608,824,780,43,1,799,25,1750,926,545,254
2,ARAD,"MUNICIPIUL ARAD",9262,ARAD,"GRĂDINIŢA CU PROGRAM PRELUNGIT „FURNICUŢA” ARAD",67,"Alegeri Prezidentiale",1,1680,810,739,71,0,792,18,1850,1040,547,245
2,ARAD,"MUNICIPIUL ARAD",9262,ARAD,"GRĂDINIŢA CU PROGRAM PRELUNGIT „FURNICUŢA” ARAD",68,"Alegeri Prezidentiale",1,1387,783,732,51,0,764,19,1500,717,514,250
2,ARAD,"MUNICIPIUL ARAD",9262,ARAD,"ŞCOALA GIMNAZIALĂ „AVRAM IANCU” (FOSTA ŞCOALĂ GENERALĂ NR. 18)",69,"Alegeri Prezidentiale",2,1215,681,596,85,0,667,14,1317,636,442,225
2,ARAD,"MUNICIPIUL ARAD",9262,ARAD,"ŞCOALA GIMNAZIALĂ „AVRAM IANCU” (FOSTA ŞCOALĂ GENERALĂ NR. 18)",70,"Alegeri Prezidentiale",1,1448,746,689,56,1,727,19,1608,862,511,216
2,ARAD,"MUNICIPIUL ARAD",9262,ARAD,"COLEGIUL TEHNIC DE CONSTRUCȚII ȘI PROTECȚIA MEDIULUI",71,"Alegeri Prezidentiale",1,1389,666,590,76,0,660,6,1500,834,495,165
2,ARAD,"MUNICIPIUL ARAD",9262,ARAD,"COLEGIUL TEHNIC DE CONSTRUCȚII ȘI PROTECȚIA MEDIULUI",72,"Alegeri Prezidentiale",1,1480,630,577,53,0,619,11,1600,970,465,154
2,ARAD,"MUNICIPIUL ARAD",9262,ARAD,"ŞCOALA GIMNAZIALĂ „ILARION FELEA” (FOSTA ŞCOALĂ GENERALĂ NR. 8)",73,"Alegeri Prezidentiale",1,1528,425,385,40,0,418,7,1700,1275,317,101
2,ARAD,"MUNICIPIUL ARAD",9262,ARAD,"AGENȚIA NAȚIONALĂ DE ADMINISTRARE FISCALĂ, FOSTA DIRECȚIE VAMALĂ",74,"Alegeri Prezidentiale",1,1027,559,450,109,0,548,11,1150,591,389,159
2,ARAD,"MUNICIPIUL ARAD",9262,ARAD,"AGENȚIA NAȚIONALĂ DE ADMINISTRARE FISCALĂ, FOSTA DIRECȚIE VAMALĂ",75,"Alegeri Prezidentiale",1,1285,700,591,109,0,683,17,1400,700,530,153
2,ARAD,"MUNICIPIUL ARAD",9262,ARAD,"GRĂDINIŢA P.N. NR. 12 ARAD",76,"Alegeri Prezidentiale",2,1650,734,667,67,0,722,12,1792,1058,502,220
2,ARAD,"MUNICIPIUL ARAD",9262,ARAD,"GRĂDINIŢA P.N. NR. 12 ARAD",77,"Alegeri Prezidentiale",1,1172,523,489,34,0,514,9,1300,777,364,150
2,ARAD,"MUNICIPIUL ARAD",9262,ARAD,"CENTRU PENTRU ACORDAREA AJUTOARELOR BĂNEŞTI PENTRU ÎNCĂLZIREA LOCUINŢELOR",78,"Alegeri Prezidentiale",1,1533,848,652,155,41,825,23,1700,852,600,225
2,ARAD,"MUNICIPIUL ARAD",9262,ARAD,"ŞCOALA GIMNAZIALĂ „IOSIF MOLDOVAN” (FOSTA ŞCOALĂ GENERALĂ NR. 3)",79,"Alegeri Prezidentiale",1,1570,757,716,41,0,739,18,1725,968,561,178
2,ARAD,"MUNICIPIUL ARAD",9262,ARAD,"ŞCOALA GIMNAZIALĂ „IOSIF MOLDOVAN” (FOSTA ŞCOALĂ GENERALĂ NR. 3)",80,"Alegeri Prezidentiale",1,1245,698,598,100,0,680,18,1350,652,491,189
2,ARAD,"MUNICIPIUL ARAD",9262,ARAD,"ŞCOALA GIMNAZIALĂ „IOSIF MOLDOVAN” (FOSTA ŞCOALĂ GENERALĂ NR. 3)",81,"Alegeri Prezidentiale",1,1193,603,573,29,1,588,15,1300,697,438,150
2,ARAD,"MUNICIPIUL ARAD",9262,ARAD,"ŞCOALA GIMNAZIALĂ „IOSIF MOLDOVAN” (FOSTA ŞCOALĂ GENERALĂ NR. 3)",82,"Alegeri Prezidentiale",1,1358,641,610,31,0,633,8,1500,859,478,155
2,ARAD,"MUNICIPIUL ARAD",9262,ARAD,"ŞCOALA GIMNAZIALĂ „IOSIF MOLDOVAN” (FOSTA ŞCOALĂ GENERALĂ NR. 3)",83,"Alegeri Prezidentiale",1,1478,642,571,30,41,625,17,1625,983,441,184
2,ARAD,"MUNICIPIUL ARAD",9262,ARAD,"ŞCOALA GIMNAZIALĂ ”IOSIF MOLDOVAN” (FOSTA ŞCOALA GENERALĂ NR. 3)",84,"Alegeri Prezidentiale",1,1860,872,809,62,1,844,28,2050,1178,647,197
2,ARAD,"MUNICIPIUL ARAD",9262,ARAD,"ŞCOALA GIMNAZIALĂ ”IOSIF MOLDOVAN” ARAD",85,"Alegeri Prezidentiale",1,1551,753,675,45,33,742,11,1700,947,543,199
2,ARAD,"MUNICIPIUL ARAD",9262,ARAD,"GRĂDINIȚA CU PROGRAM PRELUNGIT „ELEFĂNŢELUL ALFA” ARAD",86,"Alegeri Prezidentiale",2,1225,524,474,50,0,514,10,1350,826,395,119
2,ARAD,"MUNICIPIUL ARAD",9262,ARAD,"GRĂDINIȚA CU PROGRAM PRELUNGIT „ELEFĂNŢELUL ALFA” ARAD",87,"Alegeri Prezidentiale",1,1371,623,580,42,1,612,11,1500,877,478,134
2,ARAD,"MUNICIPIUL ARAD",9262,ARAD,"STAȚIUNEA DE CERCETARE - DEZVOLTARE PENTRU CREȘTEREA BOVINELOR ARAD",88,"Alegeri Prezidentiale",1,305,164,138,26,0,161,3,350,186,119,42
2,ARAD,"MUNICIPIUL ARAD",9262,ARAD,"LICEUL TEHNOLOGIC DE TRANSPORTURI AUTO „HENRI COANDĂ”",89,"Alegeri Prezidentiale",1,972,521,441,44,36,507,14,1050,529,357,150
2,ARAD,"MUNICIPIUL ARAD",9262,ARAD,"ŞCOALA GIMNAZIALĂ „MIHAI EMINESCU” (FOSTA ŞCOALĂ GENERALĂ NR. 1)",90,"Alegeri Prezidentiale",1,1438,770,662,69,39,752,18,1600,830,560,192
2,ARAD,"MUNICIPIUL ARAD",9262,ARAD,"COLEGIUL TEHNOLOGIC DE INDUSTRIE ALIMENTARĂ ARAD",91,"Alegeri Prezidentiale",1,1532,761,680,44,37,735,26,1700,939,556,179
2,ARAD,"MUNICIPIUL ARAD",9262,ARAD,"COLEGIUL TEHNOLOGIC DE INDUSTRIE ALIMENTARĂ ARAD",92,"Alegeri Prezidentiale",1,949,472,390,57,25,459,13,1050,578,303,156
2,ARAD,"MUNICIPIUL ARAD",9262,ARAD,"COLEGIUL „CSIKY GERGELY”",93,"Alegeri Prezidentiale",1,1174,515,438,60,17,505,10,1300,785,364,141
2,ARAD,"MUNICIPIUL ARAD",9262,ARAD,"LICEUL TEHNOLOGIC „FRANCISC NEUMANN”",94,"Alegeri Prezidentiale",1,1243,374,310,64,0,365,9,1350,976,270,95
2,ARAD,"MUNICIPIUL ARAD",9262,ARAD,"LICEUL TEHNOLOGIC „FRANCISC NEUMANN”",95,"Alegeri Prezidentiale",1,1441,539,508,31,0,528,11,1600,1061,385,143
2,ARAD,"MUNICIPIUL ARAD",9262,ARAD,"LICEUL TEHNOLOGIC „FRANCISC NEUMANN”",96,"Alegeri Prezidentiale",1,1247,457,440,16,1,453,4,1350,893,323,130
2,ARAD,"MUNICIPIUL ARAD",9262,ARAD,"PRIMĂRIA MUNICIPIULUI ARAD, DIRECȚIA VENITURI",97,"Alegeri Prezidentiale",1,1493,649,561,87,1,629,20,1650,1001,482,147
2,ARAD,"MUNICIPIUL ARAD",9262,ARAD,"COLEGIUL TEHNIC „AUREL VLAICU”",98,"Alegeri Prezidentiale",1,1038,564,498,66,0,545,19,1150,586,394,151
2,ARAD,"MUNICIPIUL ARAD",9262,ARAD,"LICEUL TEHNOLOGIC „FRANCISC NEUMANN” (INTERNAT)",99,"Alegeri Prezidentiale",1,1025,543,500,42,1,533,10,1150,607,353,180
2,ARAD,"MUNICIPIUL ARAD",9262,ARAD,"GRĂDINIŢA P.P. NR. 14 ARAD",100,"Alegeri Prezidentiale",1,1296,671,583,88,0,665,6,1450,779,477,188
2,ARAD,"MUNICIPIUL ARAD",9262,ARAD,"GRĂDINIŢA P.N. NR. 13 ARAD",101,"Alegeri Prezidentiale",1,479,237,212,25,0,230,7,550,313,185,45
2,ARAD,"MUNICIPIUL ARAD",9262,ARAD,"PATINOARUL MUNICIPAL ARAD",102,"Alegeri Prezidentiale",1,782,459,420,39,0,444,15,850,391,348,96
2,ARAD,"MUNICIPIUL ARAD",9262,ARAD,"LICEUL TEORETIC „ADAM M. GUTTENBRUNN” (FOSTA ȘCOALĂ GENERALĂ NR. 20)",103,"Alegeri Prezidentiale",1,1718,952,907,45,0,933,19,1850,898,683,250
2,ARAD,"MUNICIPIUL ARAD",9262,ARAD,"IMOBIL FOSTA GRĂDINIŢĂ P.N. NR. 25",104,"Alegeri Prezidentiale",1,716,410,392,18,0,404,6,800,390,313,91
2,ARAD,"MUNICIPIUL ARAD",9262,ARAD,"LICEUL TEORETIC „ADAM M. GUTTENBRUNN”, CLASELE I-VIII",105,"Alegeri Prezidentiale",1,1036,498,446,51,1,482,16,1150,652,350,132
2,ARAD,"MUNICIPIUL ARAD",9262,ARAD,"GRĂDINIŢA P.P. NR. 3 ARAD",106,"Alegeri Prezidentiale",1,1640,821,770,50,1,808,13,1800,979,580,228
2,ARAD,"MUNICIPIUL ARAD",9262,ARAD,"LICEUL TEORETIC „ADAM M. GUTTENBRUNN”",107,"Alegeri Prezidentiale",1,1082,486,462,24,0,476,10,1200,714,370,106
2,ARAD,"MUNICIPIUL ARAD",9262,ARAD,"LICEUL TEHNOLOGIC „IULIU MOLDOVAN” (FOST GRUP ŞCOLAR FORESTIER)",108,"Alegeri Prezidentiale",1,1595,742,663,79,0,724,18,1750,1008,570,154
2,ARAD,"MUNICIPIUL ARAD",9262,ARAD,"LICEUL TEORETIC ”ADAM MULLER GUTTENBRUNN” ARAD (CORP P+1E - CLASA PREGĂTITOARE C)",109,"Alegeri Prezidentiale",1,1021,481,450,31,0,474,7,1125,644,343,131
2,ARAD,"MUNICIPIUL ARAD",9262,ARAD,"LICEUL TEORETIC ”ADAM MULLER GUTTENBRUNN” ARAD (CORP P+1E - SALA DE RELIGIE)",110,"Alegeri Prezidentiale",1,886,408,368,40,0,402,6,1000,592,289,113
2,ARAD,"MUNICIPIUL ARAD",9262,ARAD,"ŞCOALA GIMNAZIALĂ „ADAM NICOLAE” (FOSTA ŞCOALĂ GENERALĂ NR. 7)",111,"Alegeri Prezidentiale",1,1627,645,608,36,1,628,17,1800,1155,455,173
2,ARAD,"MUNICIPIUL ARAD",9262,ARAD,"ŞCOALA GIMNAZIALĂ „ADAM NICOLAE” (FOSTA ŞCOALĂ GENERALĂ NR. 7)",112,"Alegeri Prezidentiale",1,1262,588,570,18,0,582,6,1400,812,448,134
2,ARAD,"MUNICIPIUL ARAD",9262,ARAD,"ŞCOALA GIMNAZIALĂ „ADAM NICOLAE” (FOSTA ŞCOALĂ GENERALĂ NR. 7)",113,"Alegeri Prezidentiale",1,1472,691,655,36,0,675,16,1600,909,514,161
2,ARAD,"MUNICIPIUL ARAD",9262,ARAD,"CÂMPUL DUMBRAVA ROŞIE",114,"Alegeri Prezidentiale",1,118,74,44,30,0,73,1,150,76,58,15
2,ARAD,"MUNICIPIUL ARAD",9262,ARAD,"CÂMPUL ALBINELOR",115,"Alegeri Prezidentiale",1,154,103,86,17,0,102,1,200,97,86,16
2,ARAD,"ORAŞ CHIŞINEU-CRIŞ",9459,CHIŞINEU-CRIŞ,"LICEUL TEORETIC „MIHAI VELICIU”",116,"Alegeri Prezidentiale",1,1324,705,655,48,2,692,13,1450,745,483,209
2,ARAD,"ORAŞ CHIŞINEU-CRIŞ",9459,CHIŞINEU-CRIŞ,"LICEUL TEORETIC „MIHAI VELICIU”",117,"Alegeri Prezidentiale",1,871,422,389,33,0,410,12,950,528,269,141
2,ARAD,"ORAŞ CHIŞINEU-CRIŞ",9459,CHIŞINEU-CRIŞ,"ȘCOALA GENERALĂ CHIȘINEU-CRIȘ",118,"Alegeri Prezidentiale",1,1499,815,728,87,0,788,27,1650,835,508,280
2,ARAD,"ORAŞ CHIŞINEU-CRIŞ",9459,CHIŞINEU-CRIŞ,"GRĂDINIŢA „PĂDURENI”",119,"Alegeri Prezidentiale",1,1588,770,689,81,0,752,18,1700,930,532,220
2,ARAD,"ORAŞ CHIŞINEU-CRIŞ",9459,NĂDAB,"ŞCOALA GIMNAZIALĂ NĂDAB",120,"Alegeri Prezidentiale",1,1478,723,683,36,4,706,17,1600,877,362,344
2,ARAD,"ORAŞ CURTICI",9495,CURTICI,"LICEUL TEHNOLOGIC „ION CREANGĂ”",121,"Alegeri Prezidentiale",1,1342,615,575,40,0,608,7,1450,835,441,167
2,ARAD,"ORAŞ CURTICI",9495,CURTICI,"LICEUL TEHNOLOGIC „ION CREANGĂ”",122,"Alegeri Prezidentiale",1,1402,574,530,44,0,567,7,1550,976,418,149
2,ARAD,"ORAŞ CURTICI",9495,CURTICI,"LICEUL TEHNOLOGIC „ION CREANGĂ”",123,"Alegeri Prezidentiale",1,1494,534,443,91,0,525,9,1600,1066,389,136
2,ARAD,"ORAŞ CURTICI",9495,CURTICI,"LICEUL TEHNOLOGIC „ION CREANGĂ”",124,"Alegeri Prezidentiale",1,1382,605,540,64,1,598,7,1500,895,458,140
2,ARAD,"ORAŞ CURTICI",9495,CURTICI,"GRĂDINIŢA CU PROGRAM PRELUNGIT „GRĂDINIŢA VESELIEI”",125,"Alegeri Prezidentiale",1,1381,619,583,36,0,614,5,1500,881,460,154
2,ARAD,"ORAŞ INEU",9538,INEU,"ȘCOALA GIMNAZIALĂ INEU",126,"Alegeri Prezidentiale",1,1480,850,751,81,18,833,17,1650,800,534,299
2,ARAD,"ORAŞ INEU",9538,INEU,"GRĂDINIȚA PN INEU",127,"Alegeri Prezidentiale",1,1529,777,735,41,1,766,11,1700,923,548,218
2,ARAD,"ORAŞ INEU",9538,INEU,"LICEUL ”MIHAI VITEAZUL” INEU",128,"Alegeri Prezidentiale",1,1579,849,780,57,12,838,11,1750,901,545,293
2,ARAD,"ORAŞ INEU",9538,INEU,"CĂMINUL CULTURAL DIN CARTIERUL TRAIAN",129,"Alegeri Prezidentiale",1,1405,779,734,45,0,759,20,1550,771,558,201
2,ARAD,"ORAŞ INEU",9538,INEU,"SALA DE SPORT",130,"Alegeri Prezidentiale",1,1320,708,649,59,0,695,13,1450,742,448,247
2,ARAD,"ORAŞ INEU",9538,MOCREA,"ŞCOALA GIMNAZIALĂ MOCREA",131,"Alegeri Prezidentiale",1,602,271,244,27,0,270,1,650,379,183,87
2,ARAD,"ORAŞ LIPOVA",9574,LIPOVA,"LICEUL ATANASIE MARIENESCU",132,"Alegeri Prezidentiale",1,927,401,367,34,0,391,10,1000,599,241,150
2,ARAD,"ORAŞ LIPOVA",9574,LIPOVA,"SEDIUL ASOCIAŢIA CARITAS BANAT SANCTUS GERHARDUS LIPOVA",133,"Alegeri Prezidentiale",1,1150,512,472,40,0,502,10,1250,738,353,149
2,ARAD,"ORAŞ LIPOVA",9574,LIPOVA,"CLĂDIRE PAROHIA ROMANO-CATOLICĂ LIPOVA",134,"Alegeri Prezidentiale",1,1031,563,454,75,34,544,19,1150,587,318,226
2,ARAD,"ORAŞ LIPOVA",9574,LIPOVA,"CLĂDIRE PAROHIA ORTODOXĂ LIPOVA",135,"Alegeri Prezidentiale",1,1039,535,492,43,0,527,8,1150,615,316,211
2,ARAD,"ORAŞ LIPOVA",9574,LIPOVA,"CENTRU NAȚIONAL DE INFORMARE ȘI PROMOVARE TURISTICĂ LIPOVA",136,"Alegeri Prezidentiale",1,905,471,423,48,0,456,15,1000,529,288,168
2,ARAD,"ORAŞ LIPOVA",9574,LIPOVA,"LICEUL SEVER BOCU (GRĂDINIŢA P.P. LIPOVA)",137,"Alegeri Prezidentiale",1,1666,764,708,55,1,756,8,1850,1086,501,255
2,ARAD,"ORAŞ LIPOVA",9574,ŞOIMOŞ,"CLĂDIRE PAROHIA ORTODOXĂ ȘOIMOȘ",138,"Alegeri Prezidentiale",1,598,277,244,33,0,275,2,650,373,184,91
2,ARAD,"ORAŞ LIPOVA",9574,RADNA,"SEDIU AGENȚIA DE PLĂȚI ȘI INTERVENȚIE PENTRU AGRICULTURĂ RADNA",139,"Alegeri Prezidentiale",1,1145,505,454,51,0,501,4,1250,745,360,141
2,ARAD,"ORAŞ LIPOVA",9574,RADNA,"LICEUL ATANASIE MARIENESCU",140,"Alegeri Prezidentiale",1,952,487,399,73,15,470,17,1050,563,302,168
2,ARAD,"ORAŞ NĂDLAC",9627,NĂDLAC,"LICEUL TEORETIC „JOZEF GREGOR TAJOVSKY” NĂDLAC, PIAŢA UNIRII",141,"Alegeri Prezidentiale",1,1628,816,706,109,1,809,7,1800,984,666,143
2,ARAD,"ORAŞ NĂDLAC",9627,NĂDLAC,"CASA DE CULTURĂ NĂDLAC, STRADA 1 DECEMBRIE (STRADA 23 AUGUST),",142,"Alegeri Prezidentiale",1,1561,729,635,93,1,720,9,1700,971,594,126
2,ARAD,"ORAŞ NĂDLAC",9627,NĂDLAC,"LICEUL TEORETIC „JOZEF GREGOR TAJOVSKY” NĂDLAC, STRADA 1 DECEMBRIE (STRADA 23 AUGUST)",143,"Alegeri Prezidentiale",1,1722,719,658,61,0,706,13,1850,1131,523,183
2,ARAD,"ORAŞ NĂDLAC",9627,NĂDLAC,"PICHET GRĂNICERI (DIRECȚIA POLIȚIEI DE FRONTIERĂ ORADEA), STRADA GRĂNICERILOR,",144,"Alegeri Prezidentiale",1,1648,769,727,42,0,762,7,1800,1031,643,119
2,ARAD,"ORAŞ PÂNCOTA",9654,PÂNCOTA,"CLĂDIRE „BUCURIA COPIILOR”",145,"Alegeri Prezidentiale",1,1081,480,439,36,5,474,6,1200,720,296,178
2,ARAD,"ORAŞ PÂNCOTA",9654,PÂNCOTA,"LICEUL TEORETIC PÎNCOTA",146,"Alegeri Prezidentiale",1,1365,617,566,50,1,606,11,1500,883,464,142
2,ARAD,"ORAŞ PÂNCOTA",9654,PÂNCOTA,"LICEUL TEORETIC PÎNCOTA",147,"Alegeri Prezidentiale",1,1451,594,570,20,4,582,12,1600,1006,426,156
2,ARAD,"ORAŞ PÂNCOTA",9654,PÂNCOTA,"GRĂDINIŢA PN PÎNCOTA",148,"Alegeri Prezidentiale",1,1309,484,445,34,5,476,8,1450,966,297,179
2,ARAD,"ORAŞ PÂNCOTA",9654,MĂDERAT,"ŞCOALA GIMNAZIALĂ MĂDERAT",149,"Alegeri Prezidentiale",1,1260,526,456,68,2,520,6,1400,874,372,148
2,ARAD,"ORAŞ PECICA",11584,PECICA,"CASA DE CULTURĂ „DORU IOAN PETESCU”",150,"Alegeri Prezidentiale",1,1077,594,539,55,0,588,6,1200,606,443,145
2,ARAD,"ORAŞ PECICA",11584,PECICA,"LICEUL TEORETIC „GHEORGHE LAZĂR”",151,"Alegeri Prezidentiale",1,1728,867,773,93,1,842,25,1850,983,652,190
2,ARAD,"ORAŞ PECICA",11584,PECICA,"CLĂDIRE PRIVATĂ (CANTINA I.A.S)",152,"Alegeri Prezidentiale",1,1350,522,485,37,0,515,7,1450,928,416,99
2,ARAD,"ORAŞ PECICA",11584,PECICA,"PRIMĂRIA ORAȘULUI PECICA",153,"Alegeri Prezidentiale",1,1322,582,501,54,27,565,17,1450,868,471,94
2,ARAD,"ORAŞ PECICA",11584,PECICA,"ŞCOALA PRIMARĂ 2 PECICA",154,"Alegeri Prezidentiale",1,1430,622,588,33,1,601,21,1600,978,483,118
2,ARAD,"ORAŞ PECICA",11584,PECICA,"ŞCOALA PRIMARĂ 3 PECICA",155,"Alegeri Prezidentiale",1,1607,548,480,68,0,537,11,1750,1202,421,116
2,ARAD,"ORAŞ PECICA",11584,PECICA,"ŞCOALA PRIMARĂ 1 PECICA",156,"Alegeri Prezidentiale",1,1633,805,754,50,1,794,11,1750,945,602,192
2,ARAD,"ORAŞ PECICA",11584,TURNU,"CLĂDIREA PRIMĂRIEI ORAȘULUI PECICA (FOSTA PRIMĂRIE TURNU)",157,"Alegeri Prezidentiale",1,1021,582,431,151,0,576,6,1100,518,473,103
2,ARAD,"ORAŞ PECICA",11584,SEDERHAT,"ŞCOALA PRIMARĂ SEDERHAT",158,"Alegeri Prezidentiale",1,274,154,123,30,1,153,1,300,146,130,23
2,ARAD,"ORAŞ SÂNTANA",12091,SÂNTANA,"GRĂDINIȚA CU PROGRAM PRELUNGIT NR. 1 SÂNTANA (CU 8 SĂLI DE GRUPĂ) - SALĂ MULTIFUNCȚIONALĂ",159,"Alegeri Prezidentiale",2,1309,425,387,38,0,409,16,1450,1025,323,86
2,ARAD,"ORAŞ SÂNTANA",12091,SÂNTANA,"LICEUL TEHNOLOGIC STEFAN HELL SÂNTANA",160,"Alegeri Prezidentiale",1,1743,636,593,43,0,628,8,1950,1314,455,173
2,ARAD,"ORAŞ SÂNTANA",12091,SÂNTANA,"GRĂDINIȚA CU PROGRAM PRELUNGIT NR. 1 SÂNTANA ( CU 8 SĂLI DE GRUPĂ ) - SALĂ GRUPĂ 2",161,"Alegeri Prezidentiale",1,1054,395,355,40,0,388,7,1150,755,294,94
2,ARAD,"ORAŞ SÂNTANA",12091,SÂNTANA,"ȘCOALA GIMNAZIALĂ SÂNTANA",162,"Alegeri Prezidentiale",1,1448,530,495,35,0,526,4,1600,1070,327,199
2,ARAD,"ORAŞ SÂNTANA",12091,SÂNTANA,"GRĂDINIȚA PP NR. 2 SÂNTANA",163,"Alegeri Prezidentiale",1,1287,476,434,42,0,460,16,1400,924,312,148
2,ARAD,"ORAŞ SÂNTANA",12091,SÂNTANA,"GRĂDINIȚA PP NR. 2 SÂNTANA",164,"Alegeri Prezidentiale",1,1660,344,313,31,0,338,6,1850,1506,226,112
2,ARAD,"ORAŞ SÂNTANA",12091,SÂNTANA,"BIBLIOTECA ORAȘULUI SÂNTANA",165,"Alegeri Prezidentiale",1,1025,266,238,28,0,262,4,1100,834,157,105
2,ARAD,"ORAŞ SÂNTANA",12091,SÂNTANA,"CĂMIN CULTURAL SATU NOU",166,"Alegeri Prezidentiale",1,1068,533,493,40,0,524,9,1200,667,353,171
2,ARAD,"ORAŞ SÂNTANA",12091,SÂNTANA,"GRĂDINIȚA PP NR. 1 SÂNTANA",167,"Alegeri Prezidentiale",1,922,413,398,15,0,405,8,1000,587,263,142
2,ARAD,"ORAŞ SÂNTANA",12091,"CAPORAL ALEXA","CĂMINUL CULTURAL CAPORAL ALEXA",168,"Alegeri Prezidentiale",1,1154,500,449,51,0,499,1,1250,750,353,146
2,ARAD,"ORAŞ SEBIŞ",9690,SEBIŞ,"CASA DE CULTURĂ SEBIȘ",169,"Alegeri Prezidentiale",1,1550,658,612,46,0,633,25,1700,1042,422,211
2,ARAD,"ORAŞ SEBIŞ",9690,SEBIŞ,"LICEUL ORAŞULUI SEBIŞ",170,"Alegeri Prezidentiale",1,1528,741,667,74,0,719,22,1700,959,462,257
2,ARAD,"ORAŞ SEBIŞ",9690,SEBIŞ,"ŞCOALA GIMNAZIALĂ SEBIŞ",171,"Alegeri Prezidentiale",1,1284,547,509,38,0,541,6,1400,853,346,195
2,ARAD,"ORAŞ SEBIŞ",9690,SEBIŞ,"ŞCOALA PRIMARĂ PRĂJEŞTI",172,"Alegeri Prezidentiale",1,198,144,107,37,0,139,5,250,106,77,62
2,ARAD,"ORAŞ SEBIŞ",9690,PRUNIŞOR,"ŞCOALA PRIMARĂ PRUNIŞOR",173,"Alegeri Prezidentiale",1,478,227,201,26,0,223,4,550,323,153,70
2,ARAD,"ORAŞ SEBIŞ",9690,DONCENI,"ŞCOALA PRIMARĂ DONCENI",174,"Alegeri Prezidentiale",1,126,73,57,16,0,70,3,150,77,58,12
2,ARAD,"ORAŞ SEBIŞ",9690,SĂLĂJENI,"CĂMINUL CULTURAL SĂLĂJENI",175,"Alegeri Prezidentiale",1,136,88,71,17,0,87,1,150,62,79,8
2,ARAD,ALMAŞ,9743,ALMAŞ,"CĂMINUL CULTURAL ALMAŞ",176,"Alegeri Prezidentiale",1,1117,532,498,34,0,522,10,1200,668,314,208
2,ARAD,ALMAŞ,9743,CIL,"CĂMINUL CULTURAL CIL",177,"Alegeri Prezidentiale",1,469,251,224,25,2,244,7,500,249,149,95
2,ARAD,ALMAŞ,9743,RĂDEŞTI,"CĂMINUL CULTURAL RĂDEŞTI",178,"Alegeri Prezidentiale",1,349,222,197,25,0,210,12,400,178,131,79
2,ARAD,ALMAŞ,9743,"JOIA MARE","CĂMINUL CULTURAL JOIA MARE",179,"Alegeri Prezidentiale",1,160,100,80,20,0,99,1,200,100,70,29
2,ARAD,APATEU,9798,APATEU,"ȘCOALA GIMNAZIALĂ ”GHEORGHE POPOVICI” APATEU,",180,"Alegeri Prezidentiale",1,946,443,418,23,2,438,5,1050,607,313,125
2,ARAD,APATEU,9798,APATEU,"ȘCOALA GIMNAZIALĂ ”GHEORGHE POPOVICI” APATEU,",181,"Alegeri Prezidentiale",1,944,378,353,25,0,377,1,1050,672,235,142
2,ARAD,APATEU,9798,BERECHIU,"ŞCOALA PRIMARĂ BERECHIU",182,"Alegeri Prezidentiale",1,656,315,287,28,0,309,6,700,385,188,121
2,ARAD,APATEU,9798,MOŢIORI,"ŞCOALA GENERALĂ MOŢIORI",183,"Alegeri Prezidentiale",1,234,156,137,19,0,152,4,250,94,78,74
2,ARAD,ARCHIŞ,9832,ARCHIŞ,"PRIMĂRIA COMUNEI ARCHIŞ",184,"Alegeri Prezidentiale",1,304,207,173,26,8,207,0,350,143,105,102
2,ARAD,ARCHIŞ,9832,NERMIŞ,"GRĂDINIŢA CU PROGRAM NORMAL NERMIȘ",185,"Alegeri Prezidentiale",1,157,121,100,21,0,121,0,200,79,61,60
2,ARAD,ARCHIŞ,9832,BÂRZEŞTI,"GRĂDINIŢA CU PROGRAM NORMAL BÎRZEŞTI",186,"Alegeri Prezidentiale",1,132,90,78,12,0,90,0,150,60,45,45
2,ARAD,ARCHIŞ,9832,GROŞENI,"ŞCOALA GIMNAZIALĂ GROŞENI",187,"Alegeri Prezidentiale",1,634,377,340,37,0,373,4,700,323,188,185
2,ARAD,BATA,9887,BATA,"PRIMĂRIA COMUNEI BATA",188,"Alegeri Prezidentiale",1,344,182,147,35,0,180,2,400,218,122,58
2,ARAD,BATA,9887,ŢELA,"CAMIN CULTURAL ȚELA",189,"Alegeri Prezidentiale",1,260,134,101,33,0,133,1,300,166,76,57
2,ARAD,BATA,9887,"BACĂU DE MIJLOC","CĂMINUL CULTURAL BACĂUL DE MIJLOC",190,"Alegeri Prezidentiale",1,158,77,59,18,0,77,0,175,98,53,24
2,ARAD,BATA,9887,BULCI,"CĂMINUL CULTURAL BULCI",191,"Alegeri Prezidentiale",2,86,62,33,29,0,61,1,100,38,39,22
2,ARAD,BÂRSA,10051,BÂRSA,"GRĂDINIŢA PN BÎRSA",192,"Alegeri Prezidentiale",1,780,427,381,46,0,422,5,850,423,297,125
2,ARAD,BÂRSA,10051,ALDEŞTI,"CĂMIN CULTURAL ALDEŞTI",193,"Alegeri Prezidentiale",1,428,224,186,37,1,220,4,475,251,126,94
2,ARAD,BÂRSA,10051,HODIŞ,"CLĂDIREA COMUNEI BÎRSA (FOSTA ŞCOALĂ CU CLASELE I-IV HODIŞ)",194,"Alegeri Prezidentiale",1,144,88,68,19,1,86,2,175,87,59,27
2,ARAD,BÂRSA,10051,VOIVODENI,"CLĂDIREA COMUNEI BÎRSA (FOSTA ŞCOALĂ CU CLASELE I-IV VOIVODENI)",195,"Alegeri Prezidentiale",1,153,88,68,17,3,86,2,175,87,56,30
2,ARAD,BÂRZAVA,10104,BÂRZAVA,"CĂMINUL CULTURAL BÂRZAVA",196,"Alegeri Prezidentiale",1,758,455,361,92,2,447,8,825,370,248,199
2,ARAD,BÂRZAVA,10104,MONOROŞTIA,"ŞCOALA GENERALĂ MONOROŞTIA",197,"Alegeri Prezidentiale",1,249,152,133,19,0,149,3,275,123,81,68
2,ARAD,BÂRZAVA,10104,CĂPRUŢA,"CENTRU LOCAL DE INFORMARE ȘI PROMOVARE TURISTICĂ CĂPRUȚA",198,"Alegeri Prezidentiale",1,210,148,100,40,8,147,1,250,102,92,55
2,ARAD,BÂRZAVA,10104,DUMBRĂVIŢA,"CĂMINUL CULTURAL DUMBRĂVIŢA",199,"Alegeri Prezidentiale",1,232,168,126,39,3,165,3,250,82,90,75
2,ARAD,BÂRZAVA,10104,"GROŞII NOI","ŞCOALA GIMNAZIALĂ GROŞII NOI",200,"Alegeri Prezidentiale",1,167,120,83,37,0,120,0,200,80,65,55
2,ARAD,BÂRZAVA,10104,"SLATINA DE MUREŞ","CĂMIN CULTURAL SLATINA DE MUREŞ",201,"Alegeri Prezidentiale",1,136,76,68,8,0,73,3,150,74,36,37
2,ARAD,BÂRZAVA,10104,BĂTUŢA,"ŞCOALA GENERALĂ BĂTUŢA",202,"Alegeri Prezidentiale",1,54,44,18,26,0,44,0,75,31,18,26
2,ARAD,BÂRZAVA,10104,LALAŞINŢ,"ŞCOALA GENERALĂ LALAŞINŢ",203,"Alegeri Prezidentiale",1,273,154,93,61,0,154,0,300,146,72,82
2,ARAD,BELIU,9930,BELIU,"PRIMĂRIA COMUNEI BELIU",204,"Alegeri Prezidentiale",1,1413,802,708,85,9,794,8,1550,748,466,328
2,ARAD,BELIU,9930,TĂGĂDĂU,"CĂMINUL CULTURAL TĂGĂDĂU",205,"Alegeri Prezidentiale",1,405,205,178,27,0,203,2,450,245,93,110
2,ARAD,BELIU,9930,BENEŞTI,"CĂMINUL CULTURAL BENEŞTI",206,"Alegeri Prezidentiale",1,94,75,56,19,0,75,0,100,25,51,24
2,ARAD,BELIU,9930,BOCHIA,"CĂMINUL CULTURAL BOCHIA",207,"Alegeri Prezidentiale",1,47,41,29,11,1,41,0,50,9,28,13
2,ARAD,BELIU,9930,SECACI,"CĂMINUL CULTURAL SECACI",208,"Alegeri Prezidentiale",1,123,63,58,5,0,63,0,150,87,36,27
2,ARAD,BELIU,9930,"VASILE GOLDIŞ","ȘCOALA PRIMARĂ VASILE GOLDIŞ",209,"Alegeri Prezidentiale",1,399,248,193,36,19,247,1,450,202,116,131
2,ARAD,BIRCHIŞ,10006,BIRCHIŞ,"CĂMINUL CULTURAL BIRCHIŞ",210,"Alegeri Prezidentiale",1,536,226,187,39,0,225,1,600,374,153,72
2,ARAD,BIRCHIŞ,10006,CĂPĂLNAŞ,"ŞCOALA GIMNAZIALĂ CĂPĂLNAŞ",211,"Alegeri Prezidentiale",3,741,325,261,64,0,324,1,800,475,169,155
2,ARAD,BIRCHIŞ,10006,OSTROV,"CĂMINUL CULTURAL OSTROV",212,"Alegeri Prezidentiale",1,211,113,84,29,0,112,1,250,137,75,37
2,ARAD,BOCSIG,10195,BOCSIG,"CĂMINUL CULTURAL BOCSIG",213,"Alegeri Prezidentiale",1,1510,670,618,52,0,659,11,1650,980,329,330
2,ARAD,BOCSIG,10195,BOCSIG,"ȘCOALA PRIMARĂ BOCSIG CARTIER",214,"Alegeri Prezidentiale",1,328,189,157,32,0,187,2,350,161,121,66
2,ARAD,BOCSIG,10195,MÂNERĂU,"CĂMINUL CULTURAL MÎNERĂU",215,"Alegeri Prezidentiale",1,289,181,140,41,0,178,3,350,169,93,85
2,ARAD,BOCSIG,10195,RĂPSIG,"ŞCOALA PRIMARĂ RĂPSIG",216,"Alegeri Prezidentiale",1,604,346,314,32,0,344,2,643,297,168,176
2,ARAD,BRAZII,10239,BRAZII,"PRIMĂRIA COMUNEI BRAZII",217,"Alegeri Prezidentiale",1,74,64,40,24,0,64,0,100,36,28,36
2,ARAD,BRAZII,10239,IACOBINI,"CĂMINUL CULTURAL IACOBINI",218,"Alegeri Prezidentiale",1,167,115,97,18,0,115,0,200,85,75,40
2,ARAD,BRAZII,10239,SECAŞ,"CĂMINUL CULTURAL SECAŞ",219,"Alegeri Prezidentiale",1,379,220,200,20,0,208,12,400,180,144,64
2,ARAD,BRAZII,10239,BUCEAVA-ŞOIMUŞ,"CĂMINUL CULTURAL BUCEAVA",220,"Alegeri Prezidentiale",1,74,47,41,6,0,47,0,100,53,31,16
2,ARAD,BRAZII,10239,BUCEAVA-ŞOIMUŞ,"CĂMINUL CULTURAL ŞOIMUŞ",221,"Alegeri Prezidentiale",1,73,53,40,13,0,53,0,100,47,41,12
2,ARAD,BRAZII,10239,MĂDRIGEŞTI,"CĂMINUL CULTURAL MĂDRIGEŞTI",222,"Alegeri Prezidentiale",1,225,119,103,16,0,117,2,250,131,55,62
2,ARAD,BUTENI,10293,BUTENI,"PRIMĂRIA COMUNEI BUTENI",223,"Alegeri Prezidentiale",1,778,422,389,28,5,416,6,850,428,274,142
2,ARAD,BUTENI,10293,BUTENI,"CĂMINUL CULTURAL BUTENI",224,"Alegeri Prezidentiale",1,998,505,459,35,11,493,12,1100,595,310,183
2,ARAD,BUTENI,10293,CUIED,"CLĂDIREA PRIMĂRIEI BUTENI (FOSTA PRIMĂRIE CUIED)",225,"Alegeri Prezidentiale",1,538,292,262,30,0,288,4,600,308,174,114
2,ARAD,BUTENI,10293,PĂULIAN,"CĂMINUL CULTURAL PĂULIAN",226,"Alegeri Prezidentiale",1,266,138,121,17,0,138,0,300,162,90,48
2,ARAD,BUTENI,10293,BERINDIA,"CĂMINUL CULTURAL BERINDIA",227,"Alegeri Prezidentiale",1,178,104,91,13,0,101,3,200,96,58,43
2,ARAD,CĂRAND,10346,CĂRAND,"CĂMINUL CULTURAL CĂRAND",228,"Alegeri Prezidentiale",1,491,300,259,39,2,289,11,550,250,182,107
2,ARAD,CĂRAND,10346,SELIŞTEA,"CĂMINUL CULTURAL SELIŞTEA",229,"Alegeri Prezidentiale",1,419,222,190,30,2,219,3,450,228,132,87
2,ARAD,CERMEI,10373,CERMEI,"PRIMĂRIA COMUNEI CERMEI, NR. 304",230,"Alegeri Prezidentiale",1,1534,664,611,53,0,659,5,1700,1036,391,268
2,ARAD,CERMEI,10373,ŞOMOŞCHEŞ,"PUNCT DE LUCRU AL PRIMĂRIEI,NR.339",231,"Alegeri Prezidentiale",1,695,299,263,36,0,293,6,750,451,161,132
2,ARAD,CHISINDIA,10417,CHISINDIA,"PRIMĂRIA COMUNEI CHISINDIA",232,"Alegeri Prezidentiale",1,711,389,344,44,1,386,3,808,419,239,147
2,ARAD,CHISINDIA,10417,PĂIUŞENI,"CĂMIN CULTURAL PĂIUŞENI",233,"Alegeri Prezidentiale",1,312,168,149,19,0,164,4,350,182,95,69
2,ARAD,CHISINDIA,10417,VĂSOAIA,"CĂMIN CULTURAL VĂSOAIA",234,"Alegeri Prezidentiale",1,39,31,15,16,0,31,0,50,19,25,6
2,ARAD,CONOP,10453,CONOP,"ŞCOALA GIMNAZIALĂ CONOP",235,"Alegeri Prezidentiale",1,479,267,212,52,3,264,3,550,283,159,105
2,ARAD,CONOP,10453,BELOTINŢ,"ŞCOALA PRIMARĂ BELOTINŢ",236,"Alegeri Prezidentiale",1,241,102,87,15,0,101,1,275,173,65,36
2,ARAD,CONOP,10453,CHELMAC,"ȘCOALA PRIMARĂ CHELMAC",237,"Alegeri Prezidentiale",1,225,153,112,41,0,151,2,250,97,82,69
2,ARAD,CONOP,10453,MILOVA,"ŞCOALA PRIMARĂ MILOVA",238,"Alegeri Prezidentiale",1,433,178,155,23,0,173,5,475,297,108,65
2,ARAD,CONOP,10453,ODVOŞ,"ŞCOALA PRIMARĂ ODVOŞ",239,"Alegeri Prezidentiale",1,370,183,151,32,0,181,2,400,217,119,62
2,ARAD,COVĂSINŢ,10514,COVĂSINŢ,"CĂMIN CULTURAL COVĂSÎNŢ",240,"Alegeri Prezidentiale",1,1063,454,397,40,17,448,6,1150,696,356,92
2,ARAD,COVĂSINŢ,10514,COVĂSINŢ,"PRIMĂRIA COMUNEI COVĂSÎNŢ",241,"Alegeri Prezidentiale",1,1050,413,353,41,19,404,9,1150,737,295,109
2,ARAD,CRAIVA,10532,CRAIVA,"PRIMĂRIA COMUNEI CRAIVA",242,"Alegeri Prezidentiale",1,493,230,195,32,3,228,2,550,320,143,85
2,ARAD,CRAIVA,10532,CHIŞLACA,"ŞCOALA PRIMARĂ CHIŞLACA",243,"Alegeri Prezidentiale",1,563,304,272,29,3,299,5,600,296,138,161
2,ARAD,CRAIVA,10532,MĂRĂUŞ,"ŞCOALA PRIMARĂ MĂRĂUŞ",244,"Alegeri Prezidentiale",1,241,149,136,13,0,144,5,250,101,89,55
2,ARAD,CRAIVA,10532,STOINEŞTI,"ŞCOALA PRIMARĂ STOINEŞTI",245,"Alegeri Prezidentiale",1,139,75,67,8,0,74,1,150,75,47,27
2,ARAD,CRAIVA,10532,SUSAG,"ŞCOALA PRIMARĂ SUSAG",246,"Alegeri Prezidentiale",1,290,184,161,21,2,181,3,300,116,86,95
2,ARAD,CRAIVA,10532,COROI,"CĂMINUL CULTURAL COROI",247,"Alegeri Prezidentiale",1,132,90,72,18,0,89,1,150,60,64,25
2,ARAD,CRAIVA,10532,ŞIAD,"ŞCOALA PRIMARĂ ŞIAD",248,"Alegeri Prezidentiale",1,194,124,111,13,0,123,1,225,101,70,53
2,ARAD,CRAIVA,10532,"ROGOZ DE BELIU","ŞCOALA PRIMARĂ ROGOZ DE BELIU",249,"Alegeri Prezidentiale",2,109,63,50,13,0,62,1,125,62,34,28
2,ARAD,CRAIVA,10532,CIUNTEŞTI,"ŞCOALA PRIMARĂ CIUNTEŞTI",250,"Alegeri Prezidentiale",1,125,65,58,7,0,64,1,150,85,29,35
2,ARAD,DEZNA,10649,DEZNA,"CĂMINUL CULTURAL DEZNA",251,"Alegeri Prezidentiale",1,659,444,360,68,16,438,6,725,281,230,208
2,ARAD,DEZNA,10649,BUHANI,"CĂMINUL CULTURAL BUHANI",252,"Alegeri Prezidentiale",1,148,96,70,26,0,94,2,175,79,51,43
2,ARAD,DEZNA,10649,NEAGRA,"CĂMINUL CULTURAL NEAGRA",253,"Alegeri Prezidentiale",1,79,71,39,31,1,71,0,100,29,30,41
2,ARAD,DEZNA,10649,"SLATINA DE CRIŞ","CĂMINUL CULTURAL SLATINA DE CRIȘ",254,"Alegeri Prezidentiale",1,104,88,53,34,1,88,0,125,37,52,36
2,ARAD,DEZNA,10649,LAZ,"CĂMINUL CULTURAL LAZ",255,"Alegeri Prezidentiale",1,34,22,7,14,1,22,0,50,28,10,12
2,ARAD,DIECI,10701,DIECI,"CĂMINUL CULTURAL DIECI",256,"Alegeri Prezidentiale",1,614,423,365,35,23,416,7,675,252,237,179
2,ARAD,DIECI,10701,CROCNA,"CĂMINUL CULTURAL CROCNA",257,"Alegeri Prezidentiale",1,313,209,150,29,30,204,5,350,141,114,90
2,ARAD,DIECI,10701,REVETIŞ,"CĂMINUL CULTURAL REVETIŞ",258,"Alegeri Prezidentiale",1,271,156,124,25,7,154,2,300,144,78,76
2,ARAD,DIECI,10701,ROŞIA,"CĂMINUL CULTURAL ROŞIA",259,"Alegeri Prezidentiale",1,40,32,15,17,0,32,0,50,18,18,14
2,ARAD,DOROBANŢI,12912,DOROBANŢI,"CĂMIN CULTURAL DOROBANŢI",260,"Alegeri Prezidentiale",1,1386,479,419,55,5,457,22,1500,1021,388,69
2,ARAD,FÂNTÂNELE,9280,FÂNTÂNELE,"PRIMĂRIA COMUNEI FÎNTÎNELE",261,"Alegeri Prezidentiale",1,1165,592,531,61,0,585,7,1300,708,438,147
2,ARAD,FÂNTÂNELE,9280,FÂNTÂNELE,"ŞCOALA GIMNAZIALĂ FÎNTÎNELE",262,"Alegeri Prezidentiale",1,1014,518,458,60,0,507,11,1100,582,358,149
2,ARAD,FÂNTÂNELE,9280,"TISA NOUĂ","CĂMINUL CULTURAL TISA NOUĂ",263,"Alegeri Prezidentiale",1,837,416,379,37,0,409,7,900,484,271,138
2,ARAD,FELNAC,10827,FELNAC,"ȘCOALA GIMNAZIALĂ „AUREL SEBEȘAN” FELNAC",264,"Alegeri Prezidentiale",1,1132,667,568,82,17,657,10,1250,583,403,254
2,ARAD,FELNAC,10827,FELNAC,"ȘCOALA GIMNAZIALĂ „AUREL SEBEȘAN” FELNAC",265,"Alegeri Prezidentiale",1,1173,640,579,48,13,628,12,1250,610,258,370
2,ARAD,FELNAC,10827,CĂLUGĂRENI,"ŞCOALA PRIMARĂ CĂLUGĂRENI",266,"Alegeri Prezidentiale",1,223,171,123,43,5,171,0,250,79,96,75
2,ARAD,FRUMUŞENI,12920,FRUMUŞENI,"ŞCOALA GIMNAZIALĂ FRUMUŞENI",267,"Alegeri Prezidentiale",1,1466,676,611,65,0,662,14,1600,924,517,145
2,ARAD,FRUMUŞENI,12920,ALUNIŞ,"GRĂDINIŢA CU PROGRAM NORMAL ALUNIŞ",268,"Alegeri Prezidentiale",1,845,443,395,44,4,440,3,925,482,373,67
2,ARAD,GHIOROC,10872,GHIOROC,"PRIMĂRIA COMUNEI GHIOROC",269,"Alegeri Prezidentiale",1,1547,810,686,122,2,803,7,1700,890,657,146
2,ARAD,GHIOROC,10872,CUVIN,"CĂMINUL CULTURAL CUVIN",270,"Alegeri Prezidentiale",1,1339,641,583,58,0,632,9,1450,809,482,150
2,ARAD,GHIOROC,10872,MINIŞ,"CĂMINUL CULTURAL MINIŞ",271,"Alegeri Prezidentiale",1,570,331,263,68,0,329,2,625,294,258,71
2,ARAD,GRĂNICERI,10916,GRĂNICERI,"PRIMĂRIA COMUNEI GRĂNICERI",272,"Alegeri Prezidentiale",1,1056,453,421,32,0,449,4,1150,697,353,96
2,ARAD,GRĂNICERI,10916,ŞICLĂU,"ŞCOALA GIMNAZIALĂ ŞICLĂU",273,"Alegeri Prezidentiale",1,967,330,285,45,0,326,4,1050,720,212,114
2,ARAD,GURAHONŢ,10943,GURAHONŢ,"PRIMĂRIA COMUNEI GURAHONŢ",274,"Alegeri Prezidentiale",1,765,414,366,45,3,409,5,850,436,261,148
2,ARAD,GURAHONŢ,10943,GURAHONŢ,"PRIMĂRIA COMUNEI GURAHONŢ",275,"Alegeri Prezidentiale",1,715,400,355,43,2,391,9,775,375,213,178
2,ARAD,GURAHONŢ,10943,BONŢEŞTI,"CĂMINUL CULTURAL BONŢEŞTI",276,"Alegeri Prezidentiale",1,546,282,247,30,5,277,5,599,317,137,140
2,ARAD,GURAHONŢ,10943,FENIŞ,"CĂMINUL CULTURAL FENIŞ",277,"Alegeri Prezidentiale",1,88,59,46,11,2,59,0,100,41,37,22
2,ARAD,GURAHONŢ,10943,HONŢIŞOR,"CĂMINUL CULTURAL HONŢIŞOR",278,"Alegeri Prezidentiale",2,277,174,158,16,0,171,3,302,128,64,107
2,ARAD,GURAHONŢ,10943,IOSAŞ,"CĂMINUL CULTURAL IOSAŞ",279,"Alegeri Prezidentiale",1,198,109,100,9,0,107,2,226,117,68,39
2,ARAD,GURAHONŢ,10943,PESCARI,"CĂMINUL CULTURAL PESCARI",280,"Alegeri Prezidentiale",1,221,140,108,24,8,138,2,250,110,92,46
2,ARAD,GURAHONŢ,10943,ZIMBRU,"CĂMINUL CULTURAL ZIMBRU",281,"Alegeri Prezidentiale",2,383,246,213,14,19,241,5,425,179,161,80
2,ARAD,HĂLMAGIU,11058,HĂLMAGIU,"PRIMĂRIA COMUNEI HĂLMAGIU",282,"Alegeri Prezidentiale",1,980,468,421,46,1,464,4,1050,582,205,259
2,ARAD,HĂLMAGIU,11058,BĂNEŞTI,"CĂMINUL CULTURAL BĂNEȘTI",283,"Alegeri Prezidentiale",1,250,154,134,20,0,154,0,275,121,85,69
2,ARAD,HĂLMAGIU,11058,BRUSTURI,"ŞCOALA GENERALĂ",284,"Alegeri Prezidentiale",1,293,146,136,10,0,146,0,325,179,66,80
2,ARAD,HĂLMAGIU,11058,TISA,"ŞCOALA GENERALĂ",285,"Alegeri Prezidentiale",1,146,108,91,17,0,108,0,175,67,52,56
2,ARAD,HĂLMAGIU,11058,ŢĂRMURE,"CĂMIN CULTURAL ŢĂRMURE",286,"Alegeri Prezidentiale",1,279,164,138,26,0,164,0,300,136,77,87
2,ARAD,HĂLMAGIU,11058,LEASA,"CĂMINUL CULTURAL LEASA",287,"Alegeri Prezidentiale",1,167,115,83,32,0,115,0,200,85,30,85
2,ARAD,HĂLMAGIU,11058,POIENARI,"CĂMINUL CULTURAL POIENARI",288,"Alegeri Prezidentiale",1,152,98,81,17,0,98,0,175,77,50,48
2,ARAD,HĂLMĂGEL,11174,HĂLMĂGEL,"PRIMĂRIA COMUNEI HĂLMĂGEL",289,"Alegeri Prezidentiale",1,489,267,237,30,0,263,4,549,282,153,110
2,ARAD,HĂLMĂGEL,11174,LUNCŞOARA,"ŞCOALA PRIMARĂ LUNCŞOARA",290,"Alegeri Prezidentiale",1,294,159,133,26,0,158,1,325,166,89,69
2,ARAD,HĂLMĂGEL,11174,SÂRBI,"CĂMINUL CULTURAL SÎRBI",291,"Alegeri Prezidentiale",1,78,60,47,13,0,56,4,101,41,38,18
2,ARAD,HĂLMĂGEL,11174,TÂRNĂVIŢA,"ŞCOALA PRIMARĂ TÎRNĂVIŢA",292,"Alegeri Prezidentiale",1,116,93,76,17,0,93,0,150,57,51,42
2,ARAD,HĂŞMAŞ,11236,HĂŞMAŞ,"CĂMINUL CULTURAL HĂŞMAŞ",293,"Alegeri Prezidentiale",1,346,249,202,41,6,243,6,400,151,148,95
2,ARAD,HĂŞMAŞ,11236,COMĂNEŞTI,"CĂMINUL CULTURAL COMĂNEŞTI",294,"Alegeri Prezidentiale",1,85,69,49,15,5,67,2,100,31,54,13
2,ARAD,HĂŞMAŞ,11236,"AGRIŞU MIC","CĂMINUL CULTURAL AGRIŞU MIC",295,"Alegeri Prezidentiale",1,138,126,99,25,2,121,5,150,24,58,63
2,ARAD,HĂŞMAŞ,11236,BOTFEI,"CĂMINUL CULTURAL BOTFEI",296,"Alegeri Prezidentiale",1,193,152,113,35,4,147,5,200,48,82,65
2,ARAD,HĂŞMAŞ,11236,"URVIŞU DE BELIU","CĂMINUL CULTURAL URVIŞU DE BELIU",297,"Alegeri Prezidentiale",1,180,129,114,14,1,128,1,200,71,65,63
2,ARAD,HĂŞMAŞ,11236,CLIT,"CĂMINUL CULTURAL CLIT",298,"Alegeri Prezidentiale",1,61,45,37,8,0,45,0,75,30,34,11
2,ARAD,IGNEŞTI,11307,IGNEŞTI,"CĂMINUL CULTURAL IGNEŞTI",299,"Alegeri Prezidentiale",1,225,138,114,24,0,137,1,250,112,81,56
2,ARAD,IGNEŞTI,11307,MINEAD,"CLĂDIREA FOSTEI ȘCOLI PRIMARE MINEAD",300,"Alegeri Prezidentiale",1,80,62,44,18,0,61,1,100,38,46,15
2,ARAD,IGNEŞTI,11307,NĂDĂLBEŞTI,"CĂMINUL CULTURAL NĂDĂLBEȘTI",301,"Alegeri Prezidentiale",1,98,61,43,18,0,59,2,125,64,40,19
2,ARAD,IGNEŞTI,11307,SUSANI,"ȘCOALA PRIMARĂ SUSANI",302,"Alegeri Prezidentiale",1,173,86,73,13,0,86,0,200,114,61,25
2,ARAD,IRATOŞU,11352,IRATOŞU,"CONSILIUL LOCAL IRATOŞU",303,"Alegeri Prezidentiale",1,1610,637,567,70,0,626,11,1750,1113,519,107
2,ARAD,IRATOŞU,11352,"VARIAŞU MARE","ŞCOALA GIMNAZIALĂ VARIAŞU MARE",304,"Alegeri Prezidentiale",1,419,218,165,53,0,214,4,450,232,181,33
2,ARAD,IRATOŞU,11352,"VARIAŞU MIC","ŞCOALA GIMNAZIALĂ VARIAŞU MIC",305,"Alegeri Prezidentiale",1,105,56,39,17,0,56,0,125,69,48,8
2,ARAD,LIVADA,9333,LIVADA,"ŞCOALA GIMNAZIALĂ LIVADA",306,"Alegeri Prezidentiale",1,1669,980,816,163,1,961,19,1800,820,709,252
2,ARAD,LIVADA,9333,SÂNLEANI,"ŞCOALA GIMNAZIALĂ SÎNLEANI",307,"Alegeri Prezidentiale",1,1435,747,667,80,0,737,10,1600,853,531,206
2,ARAD,MACEA,11398,MACEA,"ŞCOALA GIMNAZIALĂ PAVEL COVACI MACEA",308,"Alegeri Prezidentiale",1,1819,826,757,69,0,816,10,1950,1124,597,219
2,ARAD,MACEA,11398,MACEA,"ŞCOALA GIMNAZIALĂ PAVEL COVACI MACEA",309,"Alegeri Prezidentiale",1,1934,789,738,48,3,777,12,2100,1311,530,247
2,ARAD,MACEA,11398,SÂNMARTIN,"ŞCOALA GIMNAZIALĂ PAVEL COVACI MACEA",310,"Alegeri Prezidentiale",1,1161,366,343,23,0,364,2,1250,884,285,79
2,ARAD,MACEA,11398,SÂNMARTIN,"ŞCOALA GIMNAZIALĂ PAVEL COVACI MACEA",311,"Alegeri Prezidentiale",1,996,326,296,30,0,323,3,1100,774,254,69
2,ARAD,MIŞCA,11423,MIŞCA,"CĂMINUL CULTURAL MIȘCA",312,"Alegeri Prezidentiale",1,1012,407,365,42,0,404,3,1100,693,212,192
2,ARAD,MIŞCA,11423,"SATU NOU","CLĂDIREA PRIMĂRIEI DIN SATUL SATU NOU",313,"Alegeri Prezidentiale",1,669,224,207,17,0,218,6,725,501,180,38
2,ARAD,MIŞCA,11423,VÂNĂTORI,"CLĂDIREA PRIMĂRIEI DIN SATUL VÎNĂTORI",314,"Alegeri Prezidentiale",1,934,375,348,27,0,371,4,1000,625,201,170
2,ARAD,MIŞCA,11423,"ZERINDU MIC","ŞCOALA PRIMARĂ DIN SATUL ZERINDU MIC",315,"Alegeri Prezidentiale",1,149,68,57,11,0,68,0,175,107,59,9
2,ARAD,MONEASA,11478,MONEASA,"ȘCOALA GENERALĂ „GHEORGHE GROZA”",316,"Alegeri Prezidentiale",1,574,724,323,379,22,712,12,850,126,381,331
2,ARAD,MONEASA,11478,RĂNUŞA,"ŞCOALA PRIMARĂ RĂNUŞA",317,"Alegeri Prezidentiale",1,197,151,111,40,0,149,2,226,75,65,84
2,ARAD,OLARI,11502,OLARI,"PRIMĂRIA COMUNEI OLARI",318,"Alegeri Prezidentiale",1,1285,494,454,40,0,491,3,1400,906,387,104
2,ARAD,OLARI,11502,"SINTEA MICĂ","ŞCOALA PRIMARĂ SINTEA MICĂ",319,"Alegeri Prezidentiale",1,324,169,139,30,0,167,2,350,181,136,31
2,ARAD,PĂULIŞ,11539,PĂULIŞ,"PRIMĂRIA COMUNEI PĂULIŞ",320,"Alegeri Prezidentiale",1,1524,835,694,125,16,815,20,1650,815,557,258
2,ARAD,PĂULIŞ,11539,SÂMBĂTENI,"CĂMINUL CULTURAL SÎMBĂTENI",321,"Alegeri Prezidentiale",1,1628,818,730,87,1,795,23,1800,982,539,256
2,ARAD,PĂULIŞ,11539,CLADOVA,"CĂMINUL CULTURAL CLADOVA",322,"Alegeri Prezidentiale",1,251,166,127,39,0,165,1,275,109,107,58
2,ARAD,PĂULIŞ,11539,BARAŢCA,"CENTRUL LOCAL DE INFORMARE TURISTICĂ BARAŢCA",323,"Alegeri Prezidentiale",1,201,115,93,22,0,112,3,225,110,86,26
2,ARAD,"PEREGU MARE",11637,"PEREGU MARE","PRIMĂRIA COMUNEI PEREGU MARE",324,"Alegeri Prezidentiale",1,767,302,270,25,7,299,3,858,556,239,60
2,ARAD,"PEREGU MARE",11637,"PEREGU MIC","CLĂDIREA PRIMĂRIEI DIN SATUL PEREGU MIC",325,"Alegeri Prezidentiale",1,798,260,238,22,0,253,7,842,582,208,45
2,ARAD,PETRIŞ,11664,PETRIŞ,"PRIMĂRIA PETRIŞ",326,"Alegeri Prezidentiale",1,373,227,184,43,0,218,9,425,198,127,91
2,ARAD,PETRIŞ,11664,ILTEU,"CĂMINUL CULTURAL ILTEU",327,"Alegeri Prezidentiale",1,196,123,80,43,0,122,1,225,102,78,44
2,ARAD,PETRIŞ,11664,SELIŞTE,"CĂMINUL CULTURAL SELIŞTE",328,"Alegeri Prezidentiale",1,92,56,41,15,0,55,1,100,44,30,25
2,ARAD,PETRIŞ,11664,CORBEŞTI,"CĂMINUL CULTURAL CORBEŞTI",329,"Alegeri Prezidentiale",1,152,82,62,20,0,79,3,175,93,47,32
2,ARAD,PETRIŞ,11664,"ROŞIA NOUĂ","CĂMINUL CULTURAL ROŞIA NOUĂ",330,"Alegeri Prezidentiale",1,225,113,98,15,0,109,4,250,137,52,57
2,ARAD,PETRIŞ,11664,OBÂRŞIA,"CĂMINUL CULTURAL OBÎRŞIA",331,"Alegeri Prezidentiale",1,88,68,48,20,0,67,1,100,32,43,24
2,ARAD,PILU,11735,PILU,"PRIMĂRIA COMUNEI PILU",332,"Alegeri Prezidentiale",1,878,353,314,39,0,346,7,950,597,217,129
2,ARAD,PILU,11735,VĂRŞAND,"ŞCOALA GIMNAZIALĂ VĂRȘAND",333,"Alegeri Prezidentiale",1,775,325,272,53,0,322,3,850,525,234,88
2,ARAD,PLEŞCUŢA,11762,PLEŞCUŢA,"PRIMĂRIA COMUNEI PLEŞCUŢA",334,"Alegeri Prezidentiale",1,235,160,117,43,0,159,1,250,90,97,62
2,ARAD,PLEŞCUŢA,11762,TĂLAGIU,"CĂMINUL CULTURAL TĂLAGIU",335,"Alegeri Prezidentiale",1,316,190,159,31,0,189,1,350,160,88,101
2,ARAD,PLEŞCUŢA,11762,ACIUŢA,"CĂMINUL CULTURAL ACIUŢA",336,"Alegeri Prezidentiale",1,181,101,86,15,0,100,1,200,99,53,47
2,ARAD,PLEŞCUŢA,11762,"GURA VĂII","CĂMINUL CULTURAL GURA VĂII",337,"Alegeri Prezidentiale",1,221,134,113,21,0,133,1,250,116,88,45
2,ARAD,SĂVÂRŞIN,11842,SĂVÂRŞIN,"PRIMĂRIA COMUNEI SĂVÂRŞIN",338,"Alegeri Prezidentiale",1,1290,688,553,124,11,669,19,1400,712,395,274
2,ARAD,SĂVÂRŞIN,11842,PÂRNEŞTI,"ŞCOALA PRIMARĂ PÎRNEŞTI",339,"Alegeri Prezidentiale",1,140,82,72,10,0,81,1,150,68,46,35
2,ARAD,SĂVÂRŞIN,11842,TROAŞ,"ŞCOALA PRIMARĂ TROAŞ",340,"Alegeri Prezidentiale",1,135,75,54,21,0,73,2,150,75,33,40
2,ARAD,SĂVÂRŞIN,11842,TEMEŞEŞTI,"CĂMINUL CULTURAL TEMEŞEŞTI",341,"Alegeri Prezidentiale",1,110,68,54,14,0,68,0,125,57,33,35
2,ARAD,SĂVÂRŞIN,11842,TOC,"ŞCOALA PRIMARĂ TOC",342,"Alegeri Prezidentiale",1,347,163,136,27,0,160,3,400,237,97,63
2,ARAD,SĂVÂRŞIN,11842,CĂPRIOARA,"ŞCOALA PRIMARĂ CĂPRIOARA",343,"Alegeri Prezidentiale",1,206,137,92,45,0,136,1,225,88,69,67
2,ARAD,SĂVÂRŞIN,11842,"VALEA MARE","CĂMIN CULTURAL VALEA MARE",344,"Alegeri Prezidentiale",1,170,100,66,34,0,98,2,200,100,60,38
2,ARAD,SECUSIGIU,11940,SECUSIGIU,"PRIMĂRIA COMUNEI SECUSIGIU",345,"Alegeri Prezidentiale",1,881,361,320,41,0,360,1,950,589,230,130
2,ARAD,SECUSIGIU,11940,SECUSIGIU,"ȘCOALA GIMNAZIALĂ SECUSIGIU",346,"Alegeri Prezidentiale",1,954,345,309,36,0,341,4,1050,705,218,123
2,ARAD,SECUSIGIU,11940,"SATU MARE","CLĂDIREA PRIMĂRIEI DIN SATU MARE",347,"Alegeri Prezidentiale",1,804,307,275,32,0,305,2,867,560,243,62
2,ARAD,SECUSIGIU,11940,MUNAR,"CĂMINUL CULTURAL MUNAR",348,"Alegeri Prezidentiale",1,411,236,214,22,0,234,2,450,214,179,55
2,ARAD,SECUSIGIU,11940,"SÂNPETRU GERMAN","REMIZA P.S.I SÎNPETRU GERMAN",349,"Alegeri Prezidentiale",1,856,307,280,27,0,295,12,950,643,209,86
2,ARAD,SECUSIGIU,11940,"SÂNPETRU GERMAN","ȘCOALA GIMNAZIALĂ SÎNPETRU GERMAN",350,"Alegeri Prezidentiale",1,878,333,318,15,0,325,8,950,617,225,100
2,ARAD,SELEUŞ,11995,SELEUŞ,"PRIMĂRIA COMUNEI SELEUŞ",351,"Alegeri Prezidentiale",1,1535,739,699,40,0,727,12,1700,961,482,245
2,ARAD,SELEUŞ,11995,IERMATA,"ŞCOALA PRIMARĂ IERMATA",352,"Alegeri Prezidentiale",1,327,190,166,24,0,180,10,350,160,109,71
2,ARAD,SELEUŞ,11995,MORODA,"CĂMINUL CULTURAL MORODA",353,"Alegeri Prezidentiale",2,567,256,230,26,0,250,6,650,394,177,73
2,ARAD,SEMLAC,12037,SEMLAC,"ȘCOALA GIMNAZIALĂ „DR. IOAN DANICICO”",354,"Alegeri Prezidentiale",1,1729,711,640,69,2,703,8,1900,1189,563,140
2,ARAD,SEMLAC,12037,SEMLAC,"ȘCOALA GIMNAZIALĂ SEMLAC",355,"Alegeri Prezidentiale",1,1633,597,555,40,2,589,8,1750,1153,446,143
2,ARAD,"SINTEA MARE",12055,"SINTEA MARE","CĂMINUL CULTURAL SINTEA MARE",356,"Alegeri Prezidentiale",1,1036,481,425,56,0,478,3,1150,669,346,132
2,ARAD,"SINTEA MARE",12055,ADEA,"CĂMINUL CULTURAL ADEA",357,"Alegeri Prezidentiale",1,845,238,216,21,1,236,2,950,712,152,84
2,ARAD,"SINTEA MARE",12055,ŢIPAR,"CLĂDIREA ADMINISTRATIVĂ A PRIMĂRIEI SINTEA MARE",358,"Alegeri Prezidentiale",1,1146,441,411,30,0,435,6,1249,808,356,79
2,ARAD,SOCODOR,12126,SOCODOR,"PRIMĂRIA COMUNEI SOCODOR",359,"Alegeri Prezidentiale",1,901,560,474,59,27,555,5,1000,440,397,158
2,ARAD,SOCODOR,12126,SOCODOR,"CĂMINUL CULTURAL SOCODOR",360,"Alegeri Prezidentiale",1,920,558,488,37,33,554,4,1000,442,392,162
2,ARAD,ŞAGU,12144,ŞAGU,"PRIMĂRIA COMUNEI ȘAGU",361,"Alegeri Prezidentiale",1,1207,592,551,41,0,586,6,1325,733,476,110
2,ARAD,ŞAGU,12144,ŞAGU,"PRIMĂRIA COMUNEI ȘAGU",362,"Alegeri Prezidentiale",1,612,333,290,43,0,325,8,650,317,275,50
2,ARAD,ŞAGU,12144,CRUCENI,"ŞCOALA GENERALĂ",363,"Alegeri Prezidentiale",1,605,277,250,27,0,271,6,650,373,213,58
2,ARAD,ŞAGU,12144,FIRITEAZ,"ŞCOALA GENERALĂ",364,"Alegeri Prezidentiale",1,378,185,152,33,0,184,1,425,240,135,49
2,ARAD,ŞAGU,12144,FISCUT,"ŞCOALA GIMNAZIALĂ",365,"Alegeri Prezidentiale",1,467,199,176,23,0,197,2,500,301,157,40
2,ARAD,ŞAGU,12144,"HUNEDOARA TIMIŞANĂ","CĂMINUL CULTURAL HUNEDOARA TIMIȘANĂ",366,"Alegeri Prezidentiale",1,167,108,78,30,0,108,0,200,92,75,33
2,ARAD,ŞEITIN,12206,ŞEITIN,"PRIMĂRIA COMUNEI ȘEITIN",367,"Alegeri Prezidentiale",1,1236,525,480,44,1,515,10,1325,800,333,182
2,ARAD,ŞEITIN,12206,ŞEITIN,"ȘCOALA GIMNAZIALĂ „ȘTEFAN BOZIAN” ȘEITIN",368,"Alegeri Prezidentiale",1,1233,506,470,36,0,497,9,1325,819,352,145
2,ARAD,ŞEPREUŞ,12224,ŞEPREUŞ,"ŞCOALA GIMNAZIALĂ ”MIHAI VELICIU”",369,"Alegeri Prezidentiale",1,1003,451,393,38,20,446,5,1100,649,260,186
2,ARAD,ŞEPREUŞ,12224,ŞEPREUŞ,"ŞCOALA GIMNAZIALĂ ”MIHAI VELICIU”",370,"Alegeri Prezidentiale",1,1169,427,375,36,16,424,3,1300,873,287,137
2,ARAD,ŞICULA,12242,GURBA,"ŞCOALA GIMNAZIALĂ GURBA",371,"Alegeri Prezidentiale",1,921,413,378,35,0,409,4,1000,587,257,152
2,ARAD,ŞICULA,12242,CHERELUŞ,"ŞCOALA GIMNAZIALĂ CHERELUȘ",372,"Alegeri Prezidentiale",1,765,358,326,32,0,355,3,850,492,228,127
2,ARAD,ŞICULA,12242,ŞICULA,"CĂMINUL CULTURAL ȘICULA",373,"Alegeri Prezidentiale",1,913,443,403,40,0,440,3,1000,557,247,193
2,ARAD,ŞICULA,12242,ŞICULA,"ȘCOALA GIMNAZIALĂ ȘICULA",374,"Alegeri Prezidentiale",1,908,355,335,20,0,351,4,1000,645,227,124
2,ARAD,ŞILINDIA,12288,ŞILINDIA,"CĂMINUL CULTURAL ȘILINDIA",375,"Alegeri Prezidentiale",1,703,378,296,48,34,371,7,792,414,279,92
2,ARAD,ŞIMAND,12340,ŞIMAND,"ȘCOALA GIMNAZIALĂ ŞIMAND",376,"Alegeri Prezidentiale",1,1390,585,512,73,0,577,8,1500,915,383,194
2,ARAD,ŞIMAND,12340,ŞIMAND,"ȘCOALA PRIMARĂ ŞIMAND",377,"Alegeri Prezidentiale",1,1238,587,546,41,0,576,11,1350,763,391,185
2,ARAD,ŞIMAND,12340,ŞIMAND,"ȘCOALA GIMNAZIALĂ ȘIMAND - GRĂDINIȚA CU PROGRAM NORMAL NR.2",378,"Alegeri Prezidentiale",1,782,305,280,25,0,298,7,850,545,206,92
2,ARAD,ŞIRIA,12368,ŞIRIA,"CĂMINUL CULTURAL ȘIRIA",379,"Alegeri Prezidentiale",1,1370,543,469,73,1,532,11,1500,957,383,149
2,ARAD,ŞIRIA,12368,ŞIRIA,"CĂMINUL CULTURAL ȘIRIA",380,"Alegeri Prezidentiale",1,1349,461,420,41,0,455,6,1500,1039,316,139
2,ARAD,ŞIRIA,12368,GALŞA,"CĂMINUL CULTURAL GALȘA",381,"Alegeri Prezidentiale",1,1869,788,719,69,0,781,7,2050,1262,610,171
2,ARAD,ŞIRIA,12368,MÂSCA,"CĂMINUL CULTURAL MÎSCA",382,"Alegeri Prezidentiale",1,754,437,379,58,0,431,6,850,413,257,174
2,ARAD,ŞIRIA,12368,ŞIRIA,"CLĂDIRE ADMINISTRATIVĂ(FOSTA ȘCOALA GIMNAZIALĂ)",383,"Alegeri Prezidentiale",1,1754,496,454,42,0,479,17,1950,1454,353,126
2,ARAD,ŞIŞTAROVĂŢ,12402,ŞIŞTAROVĂŢ,"PRIMĂRIA COMUNEI ȘIȘTAROVĂȚ",384,"Alegeri Prezidentiale",1,288,207,162,43,2,205,2,325,118,128,77
2,ARAD,ŞOFRONEA,9360,ŞOFRONEA,"CĂMINUL CULTURAL ŞOFRONEA",385,"Alegeri Prezidentiale",1,1822,939,821,111,7,919,20,1950,1011,668,251
2,ARAD,ŞOFRONEA,9360,SÂNPAUL,"CĂMINUL CULTURAL SÎNPAUL",386,"Alegeri Prezidentiale",1,615,336,283,53,0,329,7,698,362,249,80
2,ARAD,TAUŢ,12457,MINIŞEL,"ŞCOALA PRIMARĂ MINIŞEL",387,"Alegeri Prezidentiale",1,121,94,75,19,0,90,4,150,56,51,39
2,ARAD,TAUŢ,12457,TAUŢ,"CĂMINUL CULTURAL TAUŢ",388,"Alegeri Prezidentiale",1,552,335,250,69,16,332,3,600,265,202,130
2,ARAD,TAUŢ,12457,NADĂŞ,"CĂMINUL CULTURAL NADĂŞ",389,"Alegeri Prezidentiale",1,622,303,278,25,0,298,5,700,397,194,104
2,ARAD,TAUŢ,12457,"MINIŞU DE SUS","CĂMINUL CULTURAL MINIŞU DE SUS",390,"Alegeri Prezidentiale",1,48,38,21,17,0,38,0,75,37,11,27
2,ARAD,TÂRNOVA,12509,TÂRNOVA,"ȘCOALA GIMNAZIALĂ TÂRNOVA",391,"Alegeri Prezidentiale",1,1484,732,661,64,7,713,19,1650,918,459,254
2,ARAD,TÂRNOVA,12509,CHIER,"CĂMINUL CULTURAL CHIER",392,"Alegeri Prezidentiale",1,968,435,376,54,5,430,5,1050,615,300,130
2,ARAD,TÂRNOVA,12509,"AGRIŞU MARE","ȘCOALA GIMNAZIALĂ AGRIŞU MARE",393,"Alegeri Prezidentiale",1,902,516,471,36,9,503,13,1000,484,436,67
2,ARAD,TÂRNOVA,12509,ARĂNEAG,"CĂMINUL CULTURAL ARĂNEAG",394,"Alegeri Prezidentiale",1,337,196,148,38,10,195,1,375,179,129,66
2,ARAD,TÂRNOVA,12509,DRAUŢ,"CĂMINUL CULTURAL DRAUŢ",395,"Alegeri Prezidentiale",1,668,418,350,56,12,411,7,750,332,277,134
2,ARAD,TÂRNOVA,12509,DUD,"CĂMINUL CULTURAL DUD",396,"Alegeri Prezidentiale",1,548,365,288,59,18,359,6,600,235,275,84
2,ARAD,USUSĂU,10765,USUSĂU,"ŞCOALA GIMNAZIALĂ ”TEODOR PĂCĂŢIAN” USUSĂU",397,"Alegeri Prezidentiale",1,484,227,206,21,0,226,1,550,323,142,84
2,ARAD,USUSĂU,10765,DORGOŞ,"GRĂDINIŢA CU PROGRAM NORMAL DORGOŞ",398,"Alegeri Prezidentiale",2,235,142,106,36,0,141,1,250,108,70,71
2,ARAD,USUSĂU,10765,ZĂBALŢ,"ŞCOALA PRIMARĂ ZĂBALŢ",399,"Alegeri Prezidentiale",1,236,156,122,34,0,154,2,250,94,87,67
2,ARAD,USUSĂU,10765,BRUZNIC,"GRĂDINIŢA CU PROGRAM NORMAL BRUZNIC",400,"Alegeri Prezidentiale",1,89,42,28,14,0,42,0,100,58,29,13
2,ARAD,"VĂRĂDIA DE MUREŞ",12572,"VĂRĂDIA DE MUREŞ","CĂMINUL CULTURAL VĂRĂDIA DE MUREȘ",401,"Alegeri Prezidentiale",1,472,219,175,41,3,215,4,525,306,127,88
2,ARAD,"VĂRĂDIA DE MUREŞ",12572,LUPEŞTI,"CĂMINUL CULTURAL LUPEȘTI",402,"Alegeri Prezidentiale",1,211,152,133,19,0,151,1,250,98,82,69
2,ARAD,"VĂRĂDIA DE MUREŞ",12572,BAIA,"CĂMINUL CULTURAL BAIA",403,"Alegeri Prezidentiale",1,101,77,61,16,0,75,2,125,48,35,40
2,ARAD,"VĂRĂDIA DE MUREŞ",12572,JULIŢA,"ŞCOALA PRIMARĂ JULIȚA",404,"Alegeri Prezidentiale",1,298,212,153,59,0,207,5,350,138,120,87
2,ARAD,"VĂRĂDIA DE MUREŞ",12572,"NICOLAE BĂLCESCU","CĂMINUL CULTURAL NICOLAE BĂLCESCU",405,"Alegeri Prezidentiale",1,194,133,85,48,0,131,2,200,67,88,43
2,ARAD,"VĂRĂDIA DE MUREŞ",12572,STEJAR,"CĂMINUL CULTURAL STEJAR",406,"Alegeri Prezidentiale",1,117,75,59,16,0,75,0,150,75,43,32
2,ARAD,VÂRFURILE,12689,VÂRFURILE,"CĂMINUL CULTURAL VÎRFURILE",407,"Alegeri Prezidentiale",1,996,440,398,42,0,429,11,1100,660,238,191
2,ARAD,VÂRFURILE,12689,"AVRAM IANCU","ŞCOALA GENERALĂ AVRAM IANCU",408,"Alegeri Prezidentiale",1,629,296,276,20,0,293,3,700,404,185,108
2,ARAD,VÂRFURILE,12689,LAZURI,"CĂMIN CULTURAL LAZURI",409,"Alegeri Prezidentiale",1,643,291,263,28,0,283,8,700,409,137,146
2,ARAD,VINGA,12643,VINGA,"PRIMĂRIA COMUNEI VINGA",410,"Alegeri Prezidentiale",1,915,454,373,81,0,447,7,1000,546,336,111
2,ARAD,VINGA,12643,VINGA,"ŞCOALA GIMNAZIALĂ NR. 2 VINGA",411,"Alegeri Prezidentiale",1,1296,504,452,52,0,499,5,1400,896,360,139
2,ARAD,VINGA,12643,VINGA,"GRĂDINIŢA PN VINGA",412,"Alegeri Prezidentiale",1,1599,611,566,45,0,602,9,1750,1139,501,101
2,ARAD,VINGA,12643,MAILAT,"ŞCOALA GENERALĂ MAILAT",413,"Alegeri Prezidentiale",1,818,314,239,75,0,306,8,900,586,250,56
2,ARAD,VINGA,12643,MĂNĂŞTUR,"ŞCOALA GENERALĂ MĂNĂŞTUR",414,"Alegeri Prezidentiale",1,993,487,452,35,0,480,7,1100,613,411,69
2,ARAD,VLADIMIRESCU,9397,MÂNDRULOC,"ŞCOALA GIMNAZIALĂ MÎNDRULOC",415,"Alegeri Prezidentiale",1,1151,628,526,102,0,620,8,1250,622,466,154
2,ARAD,VLADIMIRESCU,9397,CICIR,"ŞCOALA GIMNAZIALĂ CICIR",416,"Alegeri Prezidentiale",1,853,459,411,48,0,449,10,950,491,315,134
2,ARAD,VLADIMIRESCU,9397,VLADIMIRESCU,"CĂMINUL CULTURAL VLADIMIRESCU",417,"Alegeri Prezidentiale",1,1958,917,831,86,0,903,14,2150,1233,732,171
2,ARAD,VLADIMIRESCU,9397,VLADIMIRESCU,"PRIMĂRIA COMUNEI VLADIMIRESCU",418,"Alegeri Prezidentiale",1,1610,725,629,96,0,713,12,1750,1025,568,145
2,ARAD,VLADIMIRESCU,9397,VLADIMIRESCU,"CENTRU DE ZI VÂRSTNICI VLADIMIRESCU",419,"Alegeri Prezidentiale",1,1881,956,883,73,0,944,12,2050,1094,751,193
2,ARAD,VLADIMIRESCU,9397,VLADIMIRESCU,"ȘCOALA GIMNAZIALĂ VLADIMIRESCU",420,"Alegeri Prezidentiale",1,1871,895,770,125,0,888,7,2050,1155,688,200
2,ARAD,VLADIMIRESCU,9397,HORIA,"ȘCOALA GIMNAZIALĂ HORIA",421,"Alegeri Prezidentiale",1,1044,541,483,58,0,527,14,1150,609,358,169
2,ARAD,VLADIMIRESCU,9397,HORIA,"CLĂDIRE TAXE ŞI IMPOZITE HORIA",422,"Alegeri Prezidentiale",1,1109,493,455,38,0,481,12,1200,707,335,146
2,ARAD,ZĂBRANI,12778,NEUDORF,"ȘCOALA PRIMARĂ NEUDORF",423,"Alegeri Prezidentiale",1,834,369,334,35,0,366,3,900,531,272,94
2,ARAD,ZĂBRANI,12778,ZĂBRANI,"CĂMIN CULTURAL ZĂBRANI",424,"Alegeri Prezidentiale",1,1008,443,408,35,0,432,11,1100,657,313,119
2,ARAD,ZĂBRANI,12778,ZĂBRANI,"GRĂDINIŢA CU PROGRAM NORMAL ZĂBRANI",425,"Alegeri Prezidentiale",1,906,371,333,38,0,366,5,1000,629,268,98
2,ARAD,ZĂBRANI,12778,CHESINŢ,"GRĂDINIŢA PROGRAM NORMAL CHESINŢ",426,"Alegeri Prezidentiale",1,950,414,369,45,0,406,8,1050,636,323,83
2,ARAD,ZĂDĂRENI,12938,"BODROGU NOU","CĂMINUL CULTURAL BODROGU NOU, NR. 68",427,"Alegeri Prezidentiale",1,229,169,108,61,0,162,7,250,81,100,62
2,ARAD,ZĂDĂRENI,12938,ZĂDĂRENI,"SALA DE ŞEDINŢE A CONSILIULUI LOCAL ZĂDĂRENI",428,"Alegeri Prezidentiale",1,994,427,390,35,2,416,11,1100,673,301,115
2,ARAD,ZĂDĂRENI,12938,ZĂDĂRENI,"SEDIU S.V.S.U. ZĂDĂRENI",429,"Alegeri Prezidentiale",1,1091,524,457,51,16,516,8,1200,676,410,106
2,ARAD,ZĂRAND,12812,CINTEI,"ŞCOALA GIMNAZIALĂ CINTEI",430,"Alegeri Prezidentiale",1,975,505,473,32,0,501,4,1100,595,360,141
2,ARAD,ZĂRAND,12812,ZĂRAND,"PRIMĂRIA COMUNEI ZĂRAND",431,"Alegeri Prezidentiale",1,1154,441,373,68,0,435,6,1250,809,242,193
2,ARAD,ZERIND,12849,ZERIND,"PRIMĂRIA COMUNEI ZERIND",432,"Alegeri Prezidentiale",1,725,157,140,17,0,152,5,800,643,114,38
2,ARAD,ZERIND,12849,"IERMATA NEAGRĂ","ŞCOALA PRIMARA IERMATA NEAGRA",433,"Alegeri Prezidentiale",1,470,105,91,14,0,101,4,500,395,89,12
2,ARAD,"ZIMANDU NOU",12876,"ZIMANDU NOU","CĂMINUL CULTURAL ZIMANDU NOU",434,"Alegeri Prezidentiale",1,1419,647,596,51,0,634,13,1550,903,548,86
2,ARAD,"ZIMANDU NOU",12876,"ANDREI ŞAGUNA","CĂMINUL CULTURAL ANDREI ȘAGUNA",435,"Alegeri Prezidentiale",1,1252,700,640,60,0,691,9,1400,700,540,151
2,ARAD,"ZIMANDU NOU",12876,ZIMANDCUZ,"ŞCOALA PRIMARĂ ZIMANDCUZ",436,"Alegeri Prezidentiale",1,1318,560,495,63,2,554,6,1450,890,423,131
2,ARAD,"ZIMANDU NOU",12876,"ZIMANDU NOU","CĂMINUL CULTURAL UTVINIȘ",437,"Alegeri Prezidentiale",1,188,132,96,36,0,130,2,205,73,113,17
3,ARGEŞ,"MUNICIPIUL PITEŞTI",13169,PITEŞTI,"BIBLIOTECA JUDEŢEANĂ ARGEŞ ”DINICU GOLESCU”",1,"Alegeri Prezidentiale",1,1212,840,616,223,1,823,17,1300,460,483,340
3,ARGEŞ,"MUNICIPIUL PITEŞTI",13169,PITEŞTI,"COLEGIUL ECONOMIC ”MARIA TEIULEANU”",2,"Alegeri Prezidentiale",1,1132,771,622,149,0,754,17,1200,429,457,297
3,ARGEŞ,"MUNICIPIUL PITEŞTI",13169,PITEŞTI,"ŞCOALA GIMNAZIALĂ ”ION PILLAT” ( FOSTĂ ŞCOALĂ NR.3)",3,"Alegeri Prezidentiale",1,1050,583,524,59,0,573,10,1100,517,348,225
3,ARGEŞ,"MUNICIPIUL PITEŞTI",13169,PITEŞTI,"COLEGIUL ECONOMIC ”MARIA TEIULEANU” (FOST LICEUL TEHNOLOGIC „ION MINCU”)",4,"Alegeri Prezidentiale",1,1463,878,785,55,38,849,29,1600,722,513,336
3,ARGEŞ,"MUNICIPIUL PITEŞTI",13169,PITEŞTI,"ŞCOALA GIMNAZIALĂ ” NEGRU VODĂ” ( FOSTĂ ŞCOALA NR. 12)",5,"Alegeri Prezidentiale",1,1742,936,836,100,0,916,20,1900,964,557,359
3,ARGEŞ,"MUNICIPIUL PITEŞTI",13169,PITEŞTI,"ŞCOALA GIMNAZIALĂ ” NEGRU VODĂ” ( FOSTĂ ŞCOALA NR. 12)",6,"Alegeri Prezidentiale",1,1874,927,861,66,0,900,27,2000,1073,553,347
3,ARGEŞ,"MUNICIPIUL PITEŞTI",13169,PITEŞTI,"ŞCOALA GIMNAZIALĂ ” NEGRU VODĂ” ( FOSTĂ ŞCOALA NR. 12)",7,"Alegeri Prezidentiale",1,1758,824,784,40,0,801,23,1900,1076,454,347
3,ARGEŞ,"MUNICIPIUL PITEŞTI",13169,PITEŞTI,"ŞCOALA GIMNAZIALĂ ” NEGRU VODĂ” ( FOSTĂ ŞCOALA NR. 12)",8,"Alegeri Prezidentiale",1,1861,868,818,50,0,847,21,2000,1132,478,369
3,ARGEŞ,"MUNICIPIUL PITEŞTI",13169,PITEŞTI,"GRĂDINIŢA CU PROGRAM PRELUNGIT ” MICUL PRINŢ” (FOSTA GRĂDINIŢA CU PROGRAM PRELUNGIT NR. 13",9,"Alegeri Prezidentiale",1,1881,1053,963,90,0,1038,15,2000,947,626,412
3,ARGEŞ,"MUNICIPIUL PITEŞTI",13169,PITEŞTI,"ŞCOALA GIMNAZIALĂ ”MIRCEA CEL BĂTRAN” (FOSTĂ ŞCOALA NR. 13)",10,"Alegeri Prezidentiale",1,1858,1000,938,62,0,979,21,2000,1000,552,427
3,ARGEŞ,"MUNICIPIUL PITEŞTI",13169,PITEŞTI,"ŞCOALA GIMNAZIALĂ ”MIRCEA CEL BĂTRAN” (FOSTĂ ŞCOALA NR. 13)",11,"Alegeri Prezidentiale",1,1823,952,897,55,0,920,32,2000,1048,497,423
3,ARGEŞ,"MUNICIPIUL PITEŞTI",13169,PITEŞTI,"ŞCOALA GIMNAZIALĂ ”MIRCEA CEL BĂTRAN” (FOSTĂ ŞCOALA NR. 13)",12,"Alegeri Prezidentiale",1,1906,1055,991,64,0,1031,24,2000,945,521,510
3,ARGEŞ,"MUNICIPIUL PITEŞTI",13169,PITEŞTI,"ŞCOALA GIMNAZIALĂ ”MIRCEA CEL BĂTRAN” (FOSTĂ ŞCOALA NR. 13)",13,"Alegeri Prezidentiale",1,1790,1106,941,165,0,1082,24,1900,794,578,504
3,ARGEŞ,"MUNICIPIUL PITEŞTI",13169,PITEŞTI,"GRĂDINIŢA CU PROGRAM PRELUNGIT ”LUMINIŞUL PĂDURII” (FOSTĂ GRĂDINIŢĂ NR. 6)",14,"Alegeri Prezidentiale",1,1403,804,759,45,0,776,28,1500,696,431,345
3,ARGEŞ,"MUNICIPIUL PITEŞTI",13169,PITEŞTI,"GRĂDINIŢA CU PROGRAM PRELUNGIT ”LUMINIŞUL PĂDURII” (FOSTĂ GRĂDINIŢĂ NR. 6)",15,"Alegeri Prezidentiale",1,1708,927,876,51,0,905,22,1800,873,528,377
3,ARGEŞ,"MUNICIPIUL PITEŞTI",13169,PITEŞTI,"LICEUL TEHNOLOGIC ”DACIA” (FOST GRUP ŞCOLAR INDUSTRIAL CONSTRUCŢII MAŞINI)",16,"Alegeri Prezidentiale",1,1532,937,816,121,0,903,34,1692,755,579,324
3,ARGEŞ,"MUNICIPIUL PITEŞTI",13169,PITEŞTI,"COLEGIUL NAŢIONAL ”ION C. BRĂTIANU”",17,"Alegeri Prezidentiale",1,915,582,454,127,1,569,13,1000,418,378,191
3,ARGEŞ,"MUNICIPIUL PITEŞTI",13169,PITEŞTI,"ŞCOALA NR.1 - STRUCTURĂ A ŞCOLII GIMNAZIALE „NICOLAE BĂLCESCU” (FOSTA ŞCOALA GIMNAZIALĂ NR.9)",18,"Alegeri Prezidentiale",1,1676,962,896,66,0,938,24,1800,838,516,422
3,ARGEŞ,"MUNICIPIUL PITEŞTI",13169,PITEŞTI,"ŞCOALA NR.1 - STRUCTURĂ A ŞCOLII GIMNAZIALE „NICOLAE BĂLCESCU” (FOSTA ŞCOALA GIMNAZIALĂ NR.9)",19,"Alegeri Prezidentiale",1,1635,991,863,46,82,974,17,1800,809,572,402
3,ARGEŞ,"MUNICIPIUL PITEŞTI",13169,PITEŞTI,"UNIVERSITATEA „CONSTANTIN BRÂNCOVEANU” (INTRAREA C)",20,"Alegeri Prezidentiale",1,1540,811,731,80,0,803,8,1700,889,461,342
3,ARGEŞ,"MUNICIPIUL PITEŞTI",13169,PITEŞTI,"ŞCOALA GIMNAZIALĂ „ALEXANDRU DAVILA” (INTRAREA B) (FOSTA ŞCOALĂ NR.14)",21,"Alegeri Prezidentiale",1,1145,580,510,70,0,559,21,1300,720,303,256
3,ARGEŞ,"MUNICIPIUL PITEŞTI",13169,PITEŞTI,"ŞCOALA GIMNAZIALĂ ”NICOLAE BĂLCESCU” ( FOSTA ŞCOALĂ NR.6)",22,"Alegeri Prezidentiale",1,1762,972,892,80,0,945,27,1900,928,491,454
3,ARGEŞ,"MUNICIPIUL PITEŞTI",13169,PITEŞTI,"ŞCOALA GIMNAZIALĂ ”NICOLAE BĂLCESCU” ( FOSTA ŞCOALĂ NR.6)",23,"Alegeri Prezidentiale",1,1711,836,769,67,0,819,17,1900,1064,433,386
3,ARGEŞ,"MUNICIPIUL PITEŞTI",13169,PITEŞTI,"ŞCOALA GIMNAZIALĂ ”NICOLAE BĂLCESCU” ( FOSTA ŞCOALĂ NR.6)",24,"Alegeri Prezidentiale",1,1742,914,867,46,1,895,19,1900,986,498,397
3,ARGEŞ,"MUNICIPIUL PITEŞTI",13169,PITEŞTI,"ŞCOALA GIMNAZIALĂ ”NICOLAE BĂLCESCU” ( FOSTA ŞCOALĂ NR.6)",25,"Alegeri Prezidentiale",1,1735,931,892,39,0,915,16,1900,969,536,379
3,ARGEŞ,"MUNICIPIUL PITEŞTI",13169,PITEŞTI,"GRĂDINIŢA CU PROGRAM PRELUNGIT ”ALBĂ CA ZĂPADA” ( FOSTA GRĂDINIŢĂ NR. 10)",26,"Alegeri Prezidentiale",1,1846,912,865,47,0,885,27,2000,1088,472,413
3,ARGEŞ,"MUNICIPIUL PITEŞTI",13169,PITEŞTI,"ŞCOALA GIMNAZIALĂ ”ADRIAN PĂUNESCU” (FOSTĂ ŞCOALA NR. 15 )",27,"Alegeri Prezidentiale",1,1750,982,886,96,0,961,21,1900,918,512,449
3,ARGEŞ,"MUNICIPIUL PITEŞTI",13169,PITEŞTI,"ŞCOALA GIMNAZIALĂ ”ADRIAN PĂUNESCU” (FOSTĂ ŞCOALA NR. 15 )",28,"Alegeri Prezidentiale",1,1812,987,877,110,0,953,34,1900,913,491,462
3,ARGEŞ,"MUNICIPIUL PITEŞTI",13169,PITEŞTI,"GRĂDINIŢA CU PROGRAM NORMAL NR. 11- STRUCTURĂ A GRĂDINIŢEI CU PROGRAM PRELUNGIT „ALBĂ CA ZĂPADA”",29,"Alegeri Prezidentiale",1,1866,980,911,69,0,945,35,2000,1020,570,375
3,ARGEŞ,"MUNICIPIUL PITEŞTI",13169,PITEŞTI,"S.C. LISA DRAXLMAIER S.A.",30,"Alegeri Prezidentiale",1,1846,994,926,68,0,964,30,2000,1006,525,439
3,ARGEŞ,"MUNICIPIUL PITEŞTI",13169,PITEŞTI,"S.C. LISA DRAXLMAIER S.A.",31,"Alegeri Prezidentiale",1,2002,1060,991,69,0,1040,20,2100,1040,570,470
3,ARGEŞ,"MUNICIPIUL PITEŞTI",13169,PITEŞTI,"LICEUL TEORETIC ”ION CANTACUZINIO”",32,"Alegeri Prezidentiale",1,1843,1045,914,115,16,1021,24,2000,955,607,414
3,ARGEŞ,"MUNICIPIUL PITEŞTI",13169,PITEŞTI,"LICEUL TEORETIC ”ION CANTACUZINIO”",33,"Alegeri Prezidentiale",1,1928,1130,1043,87,0,1091,39,2100,970,617,474
3,ARGEŞ,"MUNICIPIUL PITEŞTI",13169,PITEŞTI,"LICEUL TEORETIC ” ION CANTACUZINO”",34,"Alegeri Prezidentiale",1,1761,866,822,44,0,849,17,1899,1033,446,403
3,ARGEŞ,"MUNICIPIUL PITEŞTI",13169,PITEŞTI,"LICEUL TEORETIC ”ION CANTACUZINO” (INTRAREA D)",35,"Alegeri Prezidentiale",1,1627,1129,877,66,186,1106,23,1800,671,556,550
3,ARGEŞ,"MUNICIPIUL PITEŞTI",13169,PITEŞTI,"ŞCOALA GIMNAZIALĂ ”MATEI BASARAB” ( FOSTA ŞCOALA NR. 19)",36,"Alegeri Prezidentiale",1,1905,1138,1028,110,0,1110,28,2100,962,697,413
3,ARGEŞ,"MUNICIPIUL PITEŞTI",13169,PITEŞTI,"ŞCOALA GIMNAZIALĂ ”MATEI BASARAB” ( FOSTA ŞCOALA NR. 19)",37,"Alegeri Prezidentiale",1,1926,1160,1080,80,0,1135,25,2100,940,717,418
3,ARGEŞ,"MUNICIPIUL PITEŞTI",13169,PITEŞTI,"ŞCOALA GIMNAZIALĂ „MATEI BASARAB” (FOSTA ŞCOALĂ NR.19)",38,"Alegeri Prezidentiale",1,1835,1009,966,43,0,985,24,2100,1091,577,408
3,ARGEŞ,"MUNICIPIUL PITEŞTI",13169,PITEŞTI,"UNIVERSITATEA ”CONSTANTIN BRÂNCOVEANU”",39,"Alegeri Prezidentiale",1,1474,839,753,86,0,817,22,1600,761,470,347
3,ARGEŞ,"MUNICIPIUL PITEŞTI",13169,PITEŞTI,"UNIVERSITATEA ”CONSTANTIN BRÂNCOVEANU”",40,"Alegeri Prezidentiale",1,1614,828,785,43,0,794,34,1800,972,445,349
3,ARGEŞ,"MUNICIPIUL PITEŞTI",13169,PITEŞTI,"ŞCOALA GIMNAZIALĂ ”ALEXANDRU DAVILA” (FOSTĂ ŞCOALĂ NR.14)",41,"Alegeri Prezidentiale",1,1860,1043,986,57,0,1012,31,2000,957,603,409
3,ARGEŞ,"MUNICIPIUL PITEŞTI",13169,PITEŞTI,"ŞCOALA GIMNAZIALĂ ”MARIN PREDA” (FOSTA ŞCOALĂ NR.10)",42,"Alegeri Prezidentiale",1,1762,987,884,103,0,969,18,1900,913,556,413
3,ARGEŞ,"MUNICIPIUL PITEŞTI",13169,PITEŞTI,"ŞCOALA GIMNAZIALĂ ”MARIN PREDA” (FOSTA ŞCOALĂ NR.10)",43,"Alegeri Prezidentiale",1,1454,888,810,76,2,870,18,1600,712,430,440
3,ARGEŞ,"MUNICIPIUL PITEŞTI",13169,PITEŞTI,"ŞCOALA GIMNAZIALĂ ”MARIN PREDA” (FOSTA ŞCOALĂ NR.10)",44,"Alegeri Prezidentiale",1,1622,1006,900,106,0,982,24,1800,794,572,410
3,ARGEŞ,"MUNICIPIUL PITEŞTI",13169,PITEŞTI,"COLEGIUL TEHNIC ” ARMAND CĂLINESCU”",45,"Alegeri Prezidentiale",1,712,438,348,63,27,424,14,800,362,280,144
3,ARGEŞ,"MUNICIPIUL PITEŞTI",13169,PITEŞTI,"COLEGIUL TEHNIC ” ARMAND CĂLINESCU”",46,"Alegeri Prezidentiale",1,1363,744,706,36,2,729,15,1500,756,404,325
3,ARGEŞ,"MUNICIPIUL PITEŞTI",13169,PITEŞTI,"ŞCOALA GIMNAZIALĂ ”NICOLAE SIMONIDE” (FOSTĂ ŞCOALĂ NR.1)",47,"Alegeri Prezidentiale",1,1102,639,583,56,0,621,18,1299,660,341,280
3,ARGEŞ,"MUNICIPIUL PITEŞTI",13169,PITEŞTI,"ŞCOALA GIMNAZIALĂ ”NICOLAE SIMONIDE” (FOSTĂ ŞCOALĂ NR.1)",48,"Alegeri Prezidentiale",1,1567,805,764,39,2,795,10,1800,995,485,310
3,ARGEŞ,"MUNICIPIUL PITEŞTI",13169,PITEŞTI,"ŞCOALA GIMNAZIALĂ ”NICOLAE SIMONIDE” (FOSTĂ ŞCOALĂ NR.1)",49,"Alegeri Prezidentiale",1,899,537,494,43,0,528,9,1000,463,301,227
3,ARGEŞ,"MUNICIPIUL PITEŞTI",13169,PITEŞTI,"DIRECŢIA APELOR ARGEŞ-VEDEA",50,"Alegeri Prezidentiale",1,1074,538,498,40,0,525,13,1200,662,325,200
3,ARGEŞ,"MUNICIPIUL PITEŞTI",13169,PITEŞTI,"DISPENSARUL NR. 16 (ÎN CLĂDIREA CREŞEI NR. 9)",51,"Alegeri Prezidentiale",1,1739,982,933,49,0,957,25,1900,918,540,417
3,ARGEŞ,"MUNICIPIUL PITEŞTI",13169,PITEŞTI,"ŞCOALA GIMNAZIALĂ ”NICOLAE IORGA”(FOSTĂ ŞCOALĂ NR.5)",52,"Alegeri Prezidentiale",1,1403,828,749,79,0,813,15,1600,772,523,290
3,ARGEŞ,"MUNICIPIUL PITEŞTI",13169,PITEŞTI,"ŞCOALA GIMNAZIALĂ ”NICOLAE IORGA”(FOSTĂ ŞCOALĂ NR.5)",53,"Alegeri Prezidentiale",1,1084,603,547,56,0,593,10,1200,597,374,219
3,ARGEŞ,"MUNICIPIUL PITEŞTI",13169,PITEŞTI,"ŞCOALA GIMNAZIALĂ ”TUDOR VLADIMIRESCU” ( FOSTĂ ŞCOALĂ NR.20)",54,"Alegeri Prezidentiale",1,1727,991,877,113,1,950,41,1900,909,573,377
3,ARGEŞ,"MUNICIPIUL PITEŞTI",13169,PITEŞTI,"ŞCOALA GIMNAZIALĂ ”TUDOR VLADIMIRESCU” ( FOSTĂ ŞCOALĂ NR.20)",55,"Alegeri Prezidentiale",1,1624,864,787,77,0,836,28,1800,936,471,365
3,ARGEŞ,"MUNICIPIUL PITEŞTI",13169,PITEŞTI,"ŞCOALA GIMNAZIALĂ ” TUDOR VLADIMIRESCU” ( FOSTĂ ŞCOALĂ NR.20)",56,"Alegeri Prezidentiale",1,1769,1010,952,58,0,977,33,2000,990,554,423
3,ARGEŞ,"MUNICIPIUL PITEŞTI",13169,PITEŞTI,"ŞCOALA GIMNAZIALĂ ” MIRCEA ELIADE” ( FOSTĂ ŞCOALĂ NR.18)",57,"Alegeri Prezidentiale",1,1691,869,825,44,0,847,22,1900,1031,463,384
3,ARGEŞ,"MUNICIPIUL PITEŞTI",13169,PITEŞTI,"ŞCOALA GIMNAZIALĂ ” MIRCEA ELIADE” ( FOSTĂ ŞCOALĂ NR.18)",58,"Alegeri Prezidentiale",1,1672,816,773,43,0,789,27,1800,984,399,390
3,ARGEŞ,"MUNICIPIUL PITEŞTI",13169,PITEŞTI,"ŞCOALA GIMNAZIALĂ ” TUDOR ARGHEZI” ( FOSTĂ ŞCOALĂ NR.7)",59,"Alegeri Prezidentiale",1,1785,866,774,92,0,837,29,2000,1134,488,349
3,ARGEŞ,"MUNICIPIUL PITEŞTI",13169,PITEŞTI,"ŞCOALA GIMNAZIALĂ ” TUDOR ARGHEZI” ( FOSTĂ ŞCOALĂ NR.7)",60,"Alegeri Prezidentiale",1,1895,1100,971,129,0,1072,28,2100,1000,619,453
3,ARGEŞ,"MUNICIPIUL PITEŞTI",13169,PITEŞTI,"ŞCOALA GIMNAZIALĂ ” TUDOR ARGHEZI” ( FOSTĂ ŞCOALĂ NR.7)",61,"Alegeri Prezidentiale",1,1957,1115,1068,47,0,1089,26,2200,1085,628,461
3,ARGEŞ,"MUNICIPIUL PITEŞTI",13169,PITEŞTI,"ŞCOALA GIMNAZIALĂ ” TUDOR ARGHEZI” ( FOSTĂ ŞCOALĂ NR.7)",62,"Alegeri Prezidentiale",1,1790,920,883,37,0,901,19,1900,980,458,443
3,ARGEŞ,"MUNICIPIUL PITEŞTI",13169,PITEŞTI,"COLEGIUL TEHNIC ”COSTIN D. NENIŢESCU”",63,"Alegeri Prezidentiale",1,1588,779,664,115,0,758,21,1800,1021,444,314
3,ARGEŞ,"MUNICIPIUL PITEŞTI",13169,PITEŞTI,"COLEGIUL TEHNIC ”COSTIN D. NENIŢESCU”",64,"Alegeri Prezidentiale",1,1737,898,857,41,0,881,17,2000,1102,517,364
3,ARGEŞ,"MUNICIPIUL PITEŞTI",13169,PITEŞTI,"COLEGIUL TEHNIC ”COSTIN D. NENIŢESCU”",65,"Alegeri Prezidentiale",1,1630,837,802,35,0,813,24,1900,1063,435,378
3,ARGEŞ,"MUNICIPIUL PITEŞTI",13169,PITEŞTI,"ŞCOALA NR.2 - STRUCTURĂ A ŞCOLII GIMNAZIALE „TUDOR VLADIMIRESCU” (FOSTA ȘCOALĂ NR.8)",66,"Alegeri Prezidentiale",1,1768,1158,1017,141,0,1134,24,2000,842,678,456
3,ARGEŞ,"MUNICIPIUL PITEŞTI",13169,PITEŞTI,"CLUBUL PENSIONARILOR",67,"Alegeri Prezidentiale",1,1841,965,908,57,0,949,16,2000,1035,507,442
3,ARGEŞ,"MUNICIPIUL PITEŞTI",13169,PITEŞTI,"ŞCOALA GIMNAZIALĂ ”MIHAI EMINESCU” (FOSTA ŞCOALA NR.11)",68,"Alegeri Prezidentiale",1,1524,928,778,150,0,911,17,1700,772,533,378
3,ARGEŞ,"MUNICIPIUL PITEŞTI",13169,PITEŞTI,"ŞCOALA GIMNAZIALĂ ”MIHAI EMINESCU” (FOSTA ŞCOALA NR.11)",69,"Alegeri Prezidentiale",1,1430,896,788,108,0,869,27,1600,704,474,395
3,ARGEŞ,"MUNICIPIUL PITEŞTI",13169,PITEŞTI,"GRĂDINIŢA CU PROGRAM PRELUNGIT ” FLOARE DE COLŢ” ( FOSTA GRĂDINIŢĂ NR.5)",70,"Alegeri Prezidentiale",1,1215,754,703,51,0,729,25,1400,646,415,314
3,ARGEŞ,"MUNICIPIUL PITEŞTI",13169,PITEŞTI,"UNIVERSITATEA PITEŞTI",71,"Alegeri Prezidentiale",1,1742,1003,881,122,0,972,31,1900,897,573,399
3,ARGEŞ,"MUNICIPIUL PITEŞTI",13169,PITEŞTI,"COLEGIUL NAŢIONAL ”ALEXANDRU ODOBESCU”",72,"Alegeri Prezidentiale",2,1950,1080,1010,70,0,1054,26,2100,1020,585,469
3,ARGEŞ,"MUNICIPIUL PITEŞTI",13169,PITEŞTI,"COLEGIUL NAŢIONAL ”ALEXANDRU ODOBESCU”",73,"Alegeri Prezidentiale",1,1744,905,837,68,0,880,25,1900,995,508,372
3,ARGEŞ,"MUNICIPIUL PITEŞTI",13169,PITEŞTI,"GRĂDINIŢA CU PROGRAM PRELUNGIT ” ARMONIA” ( FOSTA GRĂDINIŢĂ NR.8)",74,"Alegeri Prezidentiale",1,1841,851,777,74,0,825,26,2100,1249,490,335
3,ARGEŞ,"MUNICIPIUL PITEŞTI",13169,PITEŞTI,"ŞCOALA GIMNAZIALĂ ”ION MINULESCU” (FOSTA ŞCOALĂ NR.2)",75,"Alegeri Prezidentiale",1,1465,814,653,160,1,796,18,1600,786,480,316
3,ARGEŞ,"MUNICIPIUL PITEŞTI",13169,PITEŞTI,"ŞCOALA GIMNAZIALĂ ”ION MINULESCU” (FOSTA ŞCOALĂ NR.2)",76,"Alegeri Prezidentiale",1,1671,980,880,100,0,950,30,1900,920,521,429
3,ARGEŞ,"MUNICIPIUL PITEŞTI",13169,PITEŞTI,"COLEGIUL TEHNIC ”DIMITRIE DIMA”",77,"Alegeri Prezidentiale",1,1591,919,822,97,0,889,30,1800,881,484,405
3,ARGEŞ,"MUNICIPIUL PITEŞTI",13169,PITEŞTI,"COLEGIUL TEHNIC ”DIMITRIE DIMA”",78,"Alegeri Prezidentiale",1,1867,844,796,47,1,824,20,2100,1256,435,389
3,ARGEŞ,"MUNICIPIUL PITEŞTI",13169,PITEŞTI,"ŞCOALA GIMNAZIALĂ ” TUDOR MUŞATESCU” (FOSTA ŞCOALA NR. 17) (INTRAREA A)",79,"Alegeri Prezidentiale",1,1342,648,586,62,0,628,20,1500,852,395,233
3,ARGEŞ,"MUNICIPIUL PITEŞTI",13169,PITEŞTI,"ŞCOALA GIMNAZIALĂ „TUDOR MUŞATESCU” (FOSTĂ ŞCOALĂ NR.17) (INTRAREA B)",80,"Alegeri Prezidentiale",1,1333,623,582,41,0,604,19,1500,877,352,252
3,ARGEŞ,"MUNICIPIUL PITEŞTI",13169,PITEŞTI,"LICEUL TEHNOLOGIC ” CONSTANTIN BRÂNCUŞI” ( FOST LICEU TEHNOLOGIC DE INDUSTRIALIZAREA LEMNULUI)",81,"Alegeri Prezidentiale",1,1689,989,945,44,0,963,26,1900,911,515,448
3,ARGEŞ,"MUNICIPIUL PITEŞTI",13169,PITEŞTI,"LICEUL TEHNOLOGIC ” CONSTANTIN BRÂNCUŞI” ( FOST LICEU TEHNOLOGIC DE INDUSTRIALIZAREA LEMNULUI)",82,"Alegeri Prezidentiale",1,1661,908,841,66,1,876,32,1800,892,501,375
3,ARGEŞ,"MUNICIPIUL PITEŞTI",13169,PITEŞTI,"GRĂDINIŢA CU PROGRAM NORMAL ”ISTEŢEL” ( FOSTA GRĂDINIŢĂ NR.4)",83,"Alegeri Prezidentiale",1,1752,916,852,63,1,894,22,1900,984,469,425
3,ARGEŞ,"MUNICIPIUL PITEŞTI",13169,PITEŞTI,"GRĂDINIŢA CU PROGRAM PRELUNGIT ” ARIPI DESCHISE” ( FOSTA GRĂDINIŢĂ NR.14)",84,"Alegeri Prezidentiale",1,1794,1008,941,67,0,971,37,2000,992,542,429
3,ARGEŞ,"MUNICIPIUL PITEŞTI",13169,PITEŞTI,"ŞCOALA GIMNAZIALĂ ”I. L. CARAGIALE” (FOSTĂ ŞCOALĂ NR.16)",85,"Alegeri Prezidentiale",2,1625,897,816,81,0,867,30,1800,903,487,380
3,ARGEŞ,"MUNICIPIUL PITEŞTI",13169,PITEŞTI,"ŞCOALA GIMNAZIALĂ ”I. L. CARAGIALE” (FOSTĂ ŞCOALĂ NR.16)",86,"Alegeri Prezidentiale",1,1752,882,843,39,0,859,23,1900,1018,472,387
3,ARGEŞ,"MUNICIPIUL PITEŞTI",13169,PITEŞTI,"ŞCOALA GIMNAZIALĂ ”I. L. CARAGIALE” (FOSTĂ ŞCOALĂ NR.16)",87,"Alegeri Prezidentiale",1,1671,923,895,28,0,900,23,1900,977,543,357
3,ARGEŞ,"MUNICIPIUL PITEŞTI",13169,PITEŞTI,"ŞCOALA GIMNAZIALĂ ” TRAIAN” ( FOSTĂ ŞCOALĂ NR.4)",88,"Alegeri Prezidentiale",1,1399,849,773,76,0,821,28,1600,751,440,381
3,ARGEŞ,"MUNICIPIUL PITEŞTI",13169,PITEŞTI,"ŞCOALA GIMNAZIALĂ ” TRAIAN” ( FOSTĂ ŞCOALĂ NR.4)",89,"Alegeri Prezidentiale",1,1664,951,851,100,0,924,27,1900,949,514,410
3,ARGEŞ,"MUNICIPIUL CÂMPULUNG",13490,CÂMPULUNG,"ŞCOALA GIMNAZIALĂ ”OPREA IORGULESCU” - I",90,"Alegeri Prezidentiale",1,758,488,394,93,1,479,9,850,362,277,202
3,ARGEŞ,"MUNICIPIUL CÂMPULUNG",13490,CÂMPULUNG,"ŞCOALA GIMNAZIALĂ ”OPREA IORGULESCU” - II",91,"Alegeri Prezidentiale",2,883,502,455,47,0,494,8,950,448,261,233
3,ARGEŞ,"MUNICIPIUL CÂMPULUNG",13490,CÂMPULUNG,"ŞCOALA GIMNAZIALĂ NANU MUSCEL",92,"Alegeri Prezidentiale",1,1165,694,578,94,22,679,15,1300,606,385,294
3,ARGEŞ,"MUNICIPIUL CÂMPULUNG",13490,CÂMPULUNG,"BIBLIOTECA GRUI",93,"Alegeri Prezidentiale",1,1679,816,746,70,0,795,21,1850,1034,480,315
3,ARGEŞ,"MUNICIPIUL CÂMPULUNG",13490,CÂMPULUNG,"GRĂDINIŢA CU PROGRAM NORMAL NR. 9 - I",94,"Alegeri Prezidentiale",1,1597,731,694,37,0,712,19,1800,1069,413,299
3,ARGEŞ,"MUNICIPIUL CÂMPULUNG",13490,CÂMPULUNG,"GRĂDINIŢA CU PROGRAM NORMAL NR. 9 - II",95,"Alegeri Prezidentiale",1,1451,665,644,21,0,648,17,1600,935,339,309
3,ARGEŞ,"MUNICIPIUL CÂMPULUNG",13490,CÂMPULUNG,"GRĂDINIŢA CU PROGRAM NORMAL NR 9 - III",96,"Alegeri Prezidentiale",1,1482,729,707,22,0,714,15,1650,921,362,352
3,ARGEŞ,"MUNICIPIUL CÂMPULUNG",13490,CÂMPULUNG,"ŞCOALA GENERALĂ NR. 5",97,"Alegeri Prezidentiale",1,1139,556,513,43,0,543,13,1200,644,335,208
3,ARGEŞ,"MUNICIPIUL CÂMPULUNG",13490,CÂMPULUNG,"S.C. HIDROELECTRICA S.A.",98,"Alegeri Prezidentiale",1,922,518,470,48,0,505,13,1000,482,263,242
3,ARGEŞ,"MUNICIPIUL CÂMPULUNG",13490,CÂMPULUNG,"ŞCOALA GIMNAZIALĂ ”THEODOR AMAN” - I",99,"Alegeri Prezidentiale",1,1441,688,621,67,0,671,17,1600,912,387,284
3,ARGEŞ,"MUNICIPIUL CÂMPULUNG",13490,CÂMPULUNG,"ŞCOALA GIMNAZIALĂ ”THEODOR AMAN” - II",100,"Alegeri Prezidentiale",1,1107,496,454,42,0,486,10,1200,704,247,239
3,ARGEŞ,"MUNICIPIUL CÂMPULUNG",13490,CÂMPULUNG,"ŞCOALA GIMNAZIALĂ ”THEODOR AMAN” - III",101,"Alegeri Prezidentiale",1,1332,554,521,33,0,545,9,1450,896,284,261
3,ARGEŞ,"MUNICIPIUL CÂMPULUNG",13490,CÂMPULUNG,"GRĂDINIŢA CU PROGRAM PRELUNGIT ”SFÂNTA MARINA” - I",102,"Alegeri Prezidentiale",1,1378,601,584,17,0,587,14,1500,899,300,287
3,ARGEŞ,"MUNICIPIUL CÂMPULUNG",13490,CÂMPULUNG,"GRĂDINIŢA CU PROGRAM PRELUNGIT ”SFÂNTA MARINA” - II",103,"Alegeri Prezidentiale",1,1314,537,514,23,0,523,14,1450,913,276,247
3,ARGEŞ,"MUNICIPIUL CÂMPULUNG",13490,CÂMPULUNG,"GRĂDINIŢA CU PROGRAM PRELUNGIT ”SFÂNTA MARINA” - III",104,"Alegeri Prezidentiale",1,1622,609,580,28,1,594,15,1800,1191,317,277
3,ARGEŞ,"MUNICIPIUL CÂMPULUNG",13490,CÂMPULUNG,"GRĂDINIŢA CU PROGRAM NORMAL NR. 8 - I",105,"Alegeri Prezidentiale",1,1630,612,583,29,0,601,11,1800,1188,296,305
3,ARGEŞ,"MUNICIPIUL CÂMPULUNG",13490,CÂMPULUNG,"GRĂDINIŢA CU PROGRAM NORMAL NR. 8 - II",106,"Alegeri Prezidentiale",1,1443,726,680,46,0,708,18,1600,874,381,327
3,ARGEŞ,"MUNICIPIUL CÂMPULUNG",13490,CÂMPULUNG,"GRĂDINIŢA VALEA ROMÂNEŞTILOR",107,"Alegeri Prezidentiale",1,392,179,164,15,0,173,6,450,271,67,106
3,ARGEŞ,"MUNICIPIUL CÂMPULUNG",13490,CÂMPULUNG,"LICEUL TEORETIC ”DAN BARBILIAN”",108,"Alegeri Prezidentiale",1,1030,587,530,57,0,579,8,1150,563,294,285
3,ARGEŞ,"MUNICIPIUL CÂMPULUNG",13490,CÂMPULUNG,"COLEGIUL NAŢIONAL PEDAGOGIC ”CAROL I”",109,"Alegeri Prezidentiale",1,763,392,348,44,0,382,10,800,408,206,176
3,ARGEŞ,"MUNICIPIUL CÂMPULUNG",13490,CÂMPULUNG,"SERVICIUL ÎNTREŢINERE DRUMURI ŞI STRĂZI",110,"Alegeri Prezidentiale",1,973,448,414,34,0,440,8,1050,602,230,210
3,ARGEŞ,"MUNICIPIUL CÂMPULUNG",13490,CÂMPULUNG,"LICEUL TEHNOLOGIC AUTO",111,"Alegeri Prezidentiale",1,1218,496,458,38,0,486,10,1350,854,230,256
3,ARGEŞ,"MUNICIPIUL CÂMPULUNG",13490,CÂMPULUNG,"ŞCOALA GENERALĂ NR.4 ”APA SĂRATĂ”",112,"Alegeri Prezidentiale",1,747,302,269,33,0,296,6,850,548,158,138
3,ARGEŞ,"MUNICIPIUL CÂMPULUNG",13490,CÂMPULUNG,"GRĂDINIŢA NR. 1",113,"Alegeri Prezidentiale",1,525,261,239,22,0,257,4,550,289,165,92
3,ARGEŞ,"MUNICIPIUL CÂMPULUNG",13490,CÂMPULUNG,"COLEGIUL NAŢIONAL ”DINICU GOLESCU”",114,"Alegeri Prezidentiale",1,1276,761,624,135,2,746,15,1450,689,437,309
3,ARGEŞ,"MUNICIPIUL CÂMPULUNG",13490,CÂMPULUNG,"ŞCOALA GIMNAZIALĂ ”C.D. ARICESCU”",115,"Alegeri Prezidentiale",1,887,649,414,103,132,628,21,950,301,335,293
3,ARGEŞ,"MUNICIPIUL CURTEA DE ARGEŞ",13622,"CURTEA DE ARGEŞ","ȘCOALA GIMNAZIALĂ NR.2 ”REGINA MARIA” ( I )",116,"Alegeri Prezidentiale",1,1499,753,697,56,0,727,26,1600,847,411,316
3,ARGEŞ,"MUNICIPIUL CURTEA DE ARGEŞ",13622,"CURTEA DE ARGEŞ","ȘCOALA GIMNAZIALĂ NR.2 ”REGINA MARIA” ( II )",117,"Alegeri Prezidentiale",1,1192,616,559,56,1,599,17,1300,684,378,221
3,ARGEŞ,"MUNICIPIUL CURTEA DE ARGEŞ",13622,"CURTEA DE ARGEŞ","ȘCOALA GIMNAZIALĂ NR.2 ”REGINA MARIA” ( III )",118,"Alegeri Prezidentiale",1,1631,883,805,46,32,859,24,1800,917,495,364
3,ARGEŞ,"MUNICIPIUL CURTEA DE ARGEŞ",13622,"CURTEA DE ARGEŞ","GRUP ȘCOLAR ”FERDINAND I”",119,"Alegeri Prezidentiale",1,1630,759,703,56,0,742,17,1800,1041,421,321
3,ARGEŞ,"MUNICIPIUL CURTEA DE ARGEŞ",13622,"CURTEA DE ARGEŞ","GRUP ȘCOLAR AGRICOL ”CONSTANTIN DOBRESCU ARGEȘ” ( I )",120,"Alegeri Prezidentiale",1,1389,675,605,70,0,661,14,1500,825,318,343
3,ARGEŞ,"MUNICIPIUL CURTEA DE ARGEŞ",13622,"CURTEA DE ARGEŞ","GRUP ȘCOLAR AGRICOL ”CONSTANTIN DOBRESCU ARGEȘ” ( II )",121,"Alegeri Prezidentiale",1,1683,749,670,79,0,728,21,1900,1151,424,304
3,ARGEŞ,"MUNICIPIUL CURTEA DE ARGEŞ",13622,"CURTEA DE ARGEŞ","ȘCOALA GIMNAZIALĂ NR.6 ”BASARAB I”",122,"Alegeri Prezidentiale",1,1407,707,643,64,0,693,14,1600,893,388,305
3,ARGEŞ,"MUNICIPIUL CURTEA DE ARGEŞ",13622,"CURTEA DE ARGEŞ","GRUP ȘCOLAR FORESTIER CURTEA DE ARGEȘ ( I )",123,"Alegeri Prezidentiale",1,1449,712,657,54,1,693,19,1600,888,393,300
3,ARGEŞ,"MUNICIPIUL CURTEA DE ARGEŞ",13622,"CURTEA DE ARGEŞ","GRUP ȘCOLAR FORESTIER CURTEA DE ARGEȘ ( II )",124,"Alegeri Prezidentiale",1,1503,636,616,20,0,620,16,1600,964,300,320
3,ARGEŞ,"MUNICIPIUL CURTEA DE ARGEŞ",13622,"CURTEA DE ARGEŞ","CENTRUL DE CULTURĂ ȘI ARTE ” GEORGE TOPÎRCEANU” ( I )",125,"Alegeri Prezidentiale",1,1439,746,687,57,2,724,22,1600,854,343,381
3,ARGEŞ,"MUNICIPIUL CURTEA DE ARGEŞ",13622,"CURTEA DE ARGEŞ","ȘCOALA GIMNAZIALĂ NR.4 ” MIRCEA CEL BATRÂN”",126,"Alegeri Prezidentiale",1,1367,808,718,90,0,785,23,1500,692,414,371
3,ARGEŞ,"MUNICIPIUL CURTEA DE ARGEŞ",13622,"CURTEA DE ARGEŞ","ȘCOALA GIMNAZIALĂ NR.1 ”CAROL I”",127,"Alegeri Prezidentiale",1,1215,604,561,43,0,588,16,1300,696,360,228
3,ARGEŞ,"MUNICIPIUL CURTEA DE ARGEŞ",13622,"CURTEA DE ARGEŞ","ȘCOALA GIMNAZIALĂ NR.1 ”CAROL I”",128,"Alegeri Prezidentiale",1,1559,753,690,63,0,737,16,1700,947,419,318
3,ARGEŞ,"MUNICIPIUL CURTEA DE ARGEŞ",13622,"CURTEA DE ARGEŞ","ȘCOALA GENERALĂ NR.5 ”ARMAND CĂLINESCU” (I)",129,"Alegeri Prezidentiale",1,1384,664,610,54,0,643,21,1600,936,369,274
3,ARGEŞ,"MUNICIPIUL CURTEA DE ARGEŞ",13622,"CURTEA DE ARGEŞ","ȘCOALA GENERALĂ NR 5 ”ARMAND CĂLINESCU” (II)",130,"Alegeri Prezidentiale",1,1047,471,433,38,0,462,9,1200,729,260,202
3,ARGEŞ,"MUNICIPIUL CURTEA DE ARGEŞ",13622,"CURTEA DE ARGEŞ","ȘCOALA GENERALĂ VALEA SASULUI",131,"Alegeri Prezidentiale",1,859,533,495,37,1,521,12,1000,467,272,249
3,ARGEŞ,"MUNICIPIUL CURTEA DE ARGEŞ",13622,"CURTEA DE ARGEŞ","GRUP ȘCOLAR AUTO CURTEA DE ARGEȘ",132,"Alegeri Prezidentiale",1,1894,884,846,38,0,874,10,2000,1116,497,377
3,ARGEŞ,"MUNICIPIUL CURTEA DE ARGEŞ",13622,"CURTEA DE ARGEŞ","CENTRUL DE CULTURĂ ȘI ARTE ”GEORGE TOPÎRCEANU” (II)",133,"Alegeri Prezidentiale",1,1449,809,708,100,1,785,24,1500,691,443,342
3,ARGEŞ,"MUNICIPIUL CURTEA DE ARGEŞ",13622,"CURTEA DE ARGEŞ","ȘCOALA GENERALĂ NR.3 ”SFÂNTUL APOSTOL ANDREI”",134,"Alegeri Prezidentiale",1,1363,647,618,29,0,631,16,1500,853,348,283
3,ARGEŞ,"MUNICIPIUL CURTEA DE ARGEŞ",13622,NOAPTEŞ,"ȘCOALA GENERALĂ NOAPTEȘ",135,"Alegeri Prezidentiale",1,735,392,377,15,0,380,12,900,508,213,167
3,ARGEŞ,"ORAŞ COSTEŞTI",13668,COSTEŞTI,"PRIMĂRIA ORAŞULUI COSTEŞTI",136,"Alegeri Prezidentiale",1,1814,915,855,60,0,898,17,1990,1075,474,424
3,ARGEŞ,"ORAŞ COSTEŞTI",13668,COSTEŞTI,"CASA DE CULTURĂ COSTEŞTI",137,"Alegeri Prezidentiale",1,1728,873,797,76,0,854,19,1910,1037,435,419
3,ARGEŞ,"ORAŞ COSTEŞTI",13668,COSTEŞTI,"LICEUL TEORETIC COSTEŞTI",138,"Alegeri Prezidentiale",1,1616,854,750,61,43,835,19,1790,936,414,421
3,ARGEŞ,"ORAŞ COSTEŞTI",13668,COSTEŞTI,"ŞCOALA TELEŞTI",139,"Alegeri Prezidentiale",1,787,375,349,26,0,371,4,870,495,173,198
3,ARGEŞ,"ORAŞ COSTEŞTI",13668,COSTEŞTI,"ŞCOALA GENERALĂ ZORILE",140,"Alegeri Prezidentiale",1,846,423,386,37,0,416,7,940,517,204,212
3,ARGEŞ,"ORAŞ COSTEŞTI",13668,BROŞTENI,"ŞCOALA GENERALĂ BROŞTENI",141,"Alegeri Prezidentiale",1,678,350,308,42,0,346,4,750,400,155,191
3,ARGEŞ,"ORAŞ COSTEŞTI",13668,"PODU BROŞTENI","ŞCOALA GENERALĂ PODU BROŞTENI",142,"Alegeri Prezidentiale",1,521,285,231,54,0,282,3,580,295,151,131
3,ARGEŞ,"ORAŞ COSTEŞTI",13668,"PÂRVU ROŞU","ŞCOALA GENERALĂ PÎRVU ROŞU",143,"Alegeri Prezidentiale",1,512,257,213,44,0,248,9,560,303,121,127
3,ARGEŞ,"ORAŞ COSTEŞTI",13668,STÂRCI,"ŞCOALA GENERALĂ STÎRCI",144,"Alegeri Prezidentiale",1,195,80,69,11,0,79,1,210,130,42,37
3,ARGEŞ,"ORAŞ MIOVENI",13301,MIOVENI,"GRĂDINIŢA ”FLORILE SOARELUI”-INTRARE 1",145,"Alegeri Prezidentiale",1,1521,827,757,70,0,810,17,1650,823,542,268
3,ARGEŞ,"ORAŞ MIOVENI",13301,MIOVENI,"LICEUL TEORETIC ”IULIA ZAMFIRESCU” - INTRARE C",146,"Alegeri Prezidentiale",1,1409,773,723,49,1,752,21,1520,747,457,295
3,ARGEŞ,"ORAŞ MIOVENI",13301,MIOVENI,"FOSTUL SEDIU AL GRĂDINIȚEI DIN BLOCUL M6",147,"Alegeri Prezidentiale",1,1764,930,887,43,0,914,16,1910,980,511,403
3,ARGEŞ,"ORAŞ MIOVENI",13301,MIOVENI,"GRĂDINIŢA ”FLORILE SOARELUI” - INTRARE 2",148,"Alegeri Prezidentiale",1,1395,792,765,27,0,772,20,1500,708,509,263
3,ARGEŞ,"ORAŞ MIOVENI",13301,MIOVENI,"DISPENSAR UMAN",149,"Alegeri Prezidentiale",1,1465,840,783,57,0,815,25,1570,730,474,341
3,ARGEŞ,"ORAŞ MIOVENI",13301,MIOVENI,"ŞCOALA GIMNAZIALĂ ”LIVIU REBREANU” (CĂMIN ȘCOALĂ) - CORP B",150,"Alegeri Prezidentiale",1,1873,994,934,58,2,972,22,2010,1016,582,390
3,ARGEŞ,"ORAŞ MIOVENI",13301,MIOVENI,"LICEUL TEORETIC ”IULIA ZAMFIRESCU” - INTRARE B",151,"Alegeri Prezidentiale",1,1464,795,732,63,0,779,16,1580,785,466,313
3,ARGEŞ,"ORAŞ MIOVENI",13301,MIOVENI,"ȘCOALA GIMNAZIALĂ LIVIU REBREANU” - INTRARE ELEVI",152,"Alegeri Prezidentiale",1,1001,597,553,44,0,586,11,1080,483,375,211
3,ARGEŞ,"ORAŞ MIOVENI",13301,MIOVENI,"ȘCOALA GIMNAZIALĂ ”LIVIU REBREANU” - INTRARE PROFESORI",153,"Alegeri Prezidentiale",1,1131,621,589,32,0,599,22,1220,599,376,223
3,ARGEŞ,"ORAŞ MIOVENI",13301,MIOVENI,"GRĂDINIŢA CU PROGRAM PRELUNGIT ”TIC-PITIC”",154,"Alegeri Prezidentiale",1,1169,678,629,49,0,659,19,1260,582,418,241
3,ARGEŞ,"ORAŞ MIOVENI",13301,MIOVENI,"FOSTUL SEDIU AL GRĂDINIȚEI DIN BLOCUL F9",155,"Alegeri Prezidentiale",1,1145,676,609,67,0,664,12,1240,564,399,265
3,ARGEŞ,"ORAŞ MIOVENI",13301,MIOVENI,"ŞCOALA VECHE",156,"Alegeri Prezidentiale",1,1240,761,686,75,0,743,18,1330,569,437,306
3,ARGEŞ,"ORAŞ MIOVENI",13301,MIOVENI,"CASA DE CULTURĂ A SINDICATELOR DACIA",157,"Alegeri Prezidentiale",1,1427,883,787,96,0,856,27,1540,657,480,376
3,ARGEŞ,"ORAŞ MIOVENI",13301,MIOVENI,"FOSTUL SEDIU AL GRĂDINIȚEI DIN BLOCUL T6",158,"Alegeri Prezidentiale",1,1750,972,917,55,0,946,26,1900,928,613,333
3,ARGEŞ,"ORAŞ MIOVENI",13301,MIOVENI,"FOSTUL SEDIU AL GRĂDINIȚEI ”CAMPIONII” DIN BLOCUL T2A",159,"Alegeri Prezidentiale",1,1223,718,630,88,0,703,15,1320,602,415,288
3,ARGEŞ,"ORAŞ MIOVENI",13301,MIOVENI,"GRĂDINIȚA ”CAMPIONII”",160,"Alegeri Prezidentiale",1,1711,931,861,70,0,904,27,1861,930,580,324
3,ARGEŞ,"ORAŞ MIOVENI",13301,MIOVENI,"ȘCOALA GIMNAZIALĂ ”GEORGE TOPÂRCEANU”",161,"Alegeri Prezidentiale",1,983,1012,544,109,359,996,16,1470,458,436,560
3,ARGEŞ,"ORAŞ MIOVENI",13301,RACOVIŢA,"ȘCOALA GIMNAZIALĂ ”MARIN SORESCU” RACOVIȚA",162,"Alegeri Prezidentiale",1,941,660,540,77,43,652,8,1070,410,311,341
3,ARGEŞ,"ORAŞ MIOVENI",13301,RACOVIŢA,"FOSTUL SEDIU AL ȘCOLII RACOVIȚA DE SUS",163,"Alegeri Prezidentiale",1,697,417,392,25,0,406,11,750,333,198,208
3,ARGEŞ,"ORAŞ MIOVENI",13301,COLIBAŞI,"ȘCOALA GIMNAZIALĂ NR.1 MIOVENI (COLIBAȘI)",164,"Alegeri Prezidentiale",1,1282,827,723,39,65,810,17,1460,633,432,378
3,ARGEŞ,"ORAŞ MIOVENI",13301,COLIBAŞI,"CĂMINUL CULTURAL COLIBAȘI",165,"Alegeri Prezidentiale",1,655,415,379,29,7,408,7,700,285,227,181
3,ARGEŞ,"ORAŞ MIOVENI",13301,CLUCEREASA,"FOSTUL SEDIU AL ȘCOLII CLUCEREASA",166,"Alegeri Prezidentiale",1,306,178,155,23,0,176,2,330,152,89,87
3,ARGEŞ,"ORAŞ MIOVENI",13301,FĂGETU,"ȘCOALA PRIMARĂ FĂGETU",167,"Alegeri Prezidentiale",1,729,444,424,20,0,437,7,800,356,141,296
3,ARGEŞ,"ORAŞ MIOVENI",13301,FĂGETU,"CĂMINUL CULTURAL FĂGETU",168,"Alegeri Prezidentiale",1,206,167,150,17,0,164,3,220,53,80,84
3,ARGEŞ,"ORAŞ ŞTEFĂNEŞTI",13392,ENCULEŞTI,"ŞCOALA PRIMARĂ ENCULEŞTI",169,"Alegeri Prezidentiale",1,474,256,209,47,0,251,5,500,244,133,118
3,ARGEŞ,"ORAŞ ŞTEFĂNEŞTI",13392,"VALEA MARE-PODGORIA","ȘCOALA GENERALĂ ”CONSTANTIN BRÂNCOVEANU”",170,"Alegeri Prezidentiale",1,1226,556,505,51,0,544,12,1400,844,272,272
3,ARGEŞ,"ORAŞ ŞTEFĂNEŞTI",13392,"VALEA MARE-PODGORIA","ŞCOALA GENERALĂ ”CONSTANTIN BRÂNCOVEANU” VALEA MARE",171,"Alegeri Prezidentiale",1,1717,975,886,89,0,945,30,1900,925,555,390
3,ARGEŞ,"ORAŞ ŞTEFĂNEŞTI",13392,"VALEA MARE-PODGORIA","NIDEC MOTOR CORPORATION ROMANIA S.A.",172,"Alegeri Prezidentiale",1,1876,1122,985,137,0,1080,42,2000,878,704,376
3,ARGEŞ,"ORAŞ ŞTEFĂNEŞTI",13392,"ŞTEFĂNEŞTII NOI","LICEUL TEHNOLOGIC ”DINU BRĂTIANU”",173,"Alegeri Prezidentiale",1,1734,1028,890,109,29,1006,22,1892,864,629,377
3,ARGEŞ,"ORAŞ ŞTEFĂNEŞTI",13392,"ŞTEFĂNEŞTII NOI","LICEUL TEHNOLOGIC ”DINU BRĂTIANU”",174,"Alegeri Prezidentiale",1,1330,612,513,99,0,602,10,1498,886,359,243
3,ARGEŞ,"ORAŞ ŞTEFĂNEŞTI",13392,IZVORANI,"ŞCOALA GENERALĂ NR.1 ŞTEFĂNEŞTI, CORP C (GRĂDINIŢĂ)",175,"Alegeri Prezidentiale",1,956,521,460,61,0,514,7,1100,579,309,205
3,ARGEŞ,"ORAŞ ŞTEFĂNEŞTI",13392,ŞTEFĂNEŞTI,"CASA DE CULTURĂ ŞTEFĂNEŞTI",176,"Alegeri Prezidentiale",1,1078,611,541,70,0,597,14,1199,588,330,267
3,ARGEŞ,"ORAŞ ŞTEFĂNEŞTI",13392,ŞTEFĂNEŞTI,"ŞCOALA PRIMARĂ ŞTEFĂNEŞTI",177,"Alegeri Prezidentiale",1,1391,722,672,50,0,702,20,1500,778,388,314
3,ARGEŞ,"ORAŞ ŞTEFĂNEŞTI",13392,GOLEŞTI,"ŞCOALA ”RADU GOLESCU” GOLEȘTI",178,"Alegeri Prezidentiale",2,1035,505,449,56,0,498,7,1101,596,262,236
3,ARGEŞ,"ORAŞ TOPOLOVENI",13757,TOPOLOVENI,"ŞCOALA PRIMARĂ GOLEŞTII-BADII",179,"Alegeri Prezidentiale",1,834,450,412,38,0,442,8,920,470,224,218
3,ARGEŞ,"ORAŞ TOPOLOVENI",13757,TOPOLOVENI,"LICEUL TEORETIC ”ION MIHALACHE’’ TOPOLOVENI",180,"Alegeri Prezidentiale",1,1002,567,496,71,0,555,12,1100,533,329,226
3,ARGEŞ,"ORAŞ TOPOLOVENI",13757,TOPOLOVENI,"LICEUL TEORETIC ”ION MIHALACHE’’ TOPOLOVENI",181,"Alegeri Prezidentiale",1,871,535,486,49,0,528,7,900,365,291,237
3,ARGEŞ,"ORAŞ TOPOLOVENI",13757,TOPOLOVENI,"CENTRUL DE ZI TOPOLOVENI",182,"Alegeri Prezidentiale",1,643,352,327,25,0,343,9,700,348,171,172
3,ARGEŞ,"ORAŞ TOPOLOVENI",13757,TOPOLOVENI,"ŞCOALA GIMNAZIALĂ ”NICOLAE CRISTESCU” TOPOLOVENI",183,"Alegeri Prezidentiale",1,852,525,456,69,0,515,10,900,375,299,216
3,ARGEŞ,"ORAŞ TOPOLOVENI",13757,TOPOLOVENI,"ŞCOALA GIMNAZIALĂ ”NICOLAE CRISTESCU” TOPOLOVENI",184,"Alegeri Prezidentiale",1,954,521,479,42,0,512,9,1030,509,323,189
3,ARGEŞ,"ORAŞ TOPOLOVENI",13757,TOPOLOVENI,"ŞCOALA GIMNAZIALĂ ” NICOLAE CRISTESCU” SALA DE SPORT",185,"Alegeri Prezidentiale",1,1071,627,567,60,0,613,14,1200,573,396,217
3,ARGEŞ,"ORAŞ TOPOLOVENI",13757,TOPOLOVENI,"ŞCOALA PRIMARĂ INURI",186,"Alegeri Prezidentiale",1,244,169,153,16,0,169,0,300,131,75,94
3,ARGEŞ,"ORAŞ TOPOLOVENI",13757,TOPOLOVENI,"ŞCOALA PRIMARĂ ŢIGĂNEŞTI- LINIE",187,"Alegeri Prezidentiale",1,621,367,344,23,0,363,4,700,333,178,185
3,ARGEŞ,"ORAŞ TOPOLOVENI",13757,ŢIGĂNEŞTI,"ŞCOALA GENERALĂ ŢIGĂNEŞTI - CENTRU",188,"Alegeri Prezidentiale",1,676,406,367,39,0,399,7,750,344,177,222
3,ARGEŞ,"ALBEŞTII DE ARGEŞ",13819,"ALBEŞTII PĂMÂNTENI","CASA DE CULTURĂ ALBEŞTII DE ARGEŞ",189,"Alegeri Prezidentiale",1,1556,795,745,50,0,780,15,1600,805,458,322
3,ARGEŞ,"ALBEŞTII DE ARGEŞ",13819,"ALBEŞTII UNGURENI","ŞCOALA PRIMARĂ ALBEŞTII -UNGURENI",190,"Alegeri Prezidentiale",1,1277,612,575,37,0,596,16,1500,888,381,215
3,ARGEŞ,"ALBEŞTII DE ARGEŞ",13819,"ALBEŞTII UNGURENI","ŞCOALA PRIMARĂ ALBEŞTII-UNGURENI",191,"Alegeri Prezidentiale",1,744,381,355,26,0,378,3,800,419,235,143
3,ARGEŞ,"ALBEŞTII DE ARGEŞ",13819,BRĂTEŞTI,"ŞCOALA PRIMARĂ BRĂTEŞTI",192,"Alegeri Prezidentiale",1,593,344,324,20,0,338,6,800,456,156,182
3,ARGEŞ,"ALBEŞTII DE ARGEŞ",13819,DOBROTU,"SCOALA PRIMARĂ DOBROŢU",193,"Alegeri Prezidentiale",1,819,420,381,38,1,417,3,800,380,259,158
3,ARGEŞ,"ALBEŞTII DE MUSCEL",13891,ALBEŞTI,"ŞCOALA GIMNAZIALĂ NR.1 ALBEȘTII DE MUSCEL, STRADA MAGISTRAT SORIN MOISESCU NR.360",194,"Alegeri Prezidentiale",1,922,444,396,38,10,441,3,1000,556,251,190
3,ARGEŞ,"ALBEŞTII DE MUSCEL",13891,CÂNDEŞTI,"ŞCOALA GENERALĂ I-IV CÂNDEȘTI, STRADA MAGISTRAT SORIN MOISESCU, NR.182",195,"Alegeri Prezidentiale",1,351,221,183,38,0,221,0,400,179,111,110
3,ARGEŞ,ALBOTA,13935,ALBOTA,"CĂMIN CULTURAL ALBOTA",196,"Alegeri Prezidentiale",1,1891,1078,926,152,0,1059,19,2000,922,592,467
3,ARGEŞ,ALBOTA,13935,MAREŞ,"ŞCOALA GIMNAZIALĂ MAREŞ",197,"Alegeri Prezidentiale",1,868,572,498,74,0,566,6,900,328,248,318
3,ARGEŞ,ALBOTA,13935,CERBU,"ŞCOALA PRIMARĂ CERBU",198,"Alegeri Prezidentiale",1,625,385,341,44,0,375,10,800,415,162,213
3,ARGEŞ,ANINOASA,13999,ANINOASA,"ŞCOALA GIMNAZIALĂ BROŞTENI - ANINOASA, CORP B",199,"Alegeri Prezidentiale",1,1229,722,639,83,0,702,20,1340,618,304,398
3,ARGEŞ,ANINOASA,13999,"VALEA SILIŞTII","CĂMIN CULTURAL VALEA SILIŞTII",200,"Alegeri Prezidentiale",1,508,327,287,40,0,326,1,560,233,111,215
3,ARGEŞ,ANINOASA,13999,SLĂNIC,"ŞCOALA GIMNAZIALĂ SLĂNIC",201,"Alegeri Prezidentiale",1,908,561,512,43,6,554,7,1000,439,206,348
3,ARGEŞ,AREFU,14049,AREFU,"CĂMINUL CULTURAL AREFU",202,"Alegeri Prezidentiale",1,1053,479,414,65,0,476,3,1200,721,277,199
3,ARGEŞ,AREFU,14049,"CĂPĂŢÂNENII PĂMÂNTENI","ŞCOALA GIMNAZIALĂ GEORGE STEPHĂNESCU",203,"Alegeri Prezidentiale",1,926,498,402,96,0,485,13,1000,502,335,150
3,ARGEŞ,BASCOV,13187,BASCOV,"GRĂDINIȚA NR. 1 BASCOV",204,"Alegeri Prezidentiale",1,1384,874,728,146,0,864,10,1440,566,530,334
3,ARGEŞ,BASCOV,13187,BASCOV,"ŞCOALA GENERALĂ BASCOV, CLĂDIREA VECHE",205,"Alegeri Prezidentiale",1,1942,1160,1040,120,0,1129,31,2130,970,676,453
3,ARGEŞ,BASCOV,13187,BASCOV,"ŞCOALA GENERALĂ BASCOV, CLĂDIREA NOUĂ",206,"Alegeri Prezidentiale",1,1271,809,691,118,0,780,29,1399,590,450,330
3,ARGEŞ,BASCOV,13187,SCHIAU,"ŞCOALA GENERALĂ SCHIAU",207,"Alegeri Prezidentiale",1,1483,799,713,86,0,787,12,1610,811,460,327
3,ARGEŞ,BASCOV,13187,GLÂMBOCU,"ŞCOALA GENERALĂ GLÎMBOCU",208,"Alegeri Prezidentiale",1,789,471,433,38,0,468,3,860,389,246,222
3,ARGEŞ,BASCOV,13187,"VALEA URSULUI","ŞCOALA GENERALĂ VALEA URSULUI",209,"Alegeri Prezidentiale",1,1568,958,785,173,0,943,15,1730,772,522,421
3,ARGEŞ,BASCOV,13187,MICA,"ŞCOALA GENERALĂ MICA",210,"Alegeri Prezidentiale",1,508,317,291,26,0,306,11,630,313,138,168
3,ARGEŞ,BĂBANA,14085,BĂBANA,"ŞCOALA BĂBANA",211,"Alegeri Prezidentiale",1,776,440,388,52,0,430,10,800,360,216,214
3,ARGEŞ,BĂBANA,14085,SLĂTIOARELE,"ŞCOALA SLĂTIOARELE",212,"Alegeri Prezidentiale",1,668,393,311,82,0,392,1,700,307,187,205
3,ARGEŞ,BĂBANA,14085,BĂBANA,"BIBLIOTECA COMUNALĂ",213,"Alegeri Prezidentiale",1,585,421,318,102,1,416,5,700,279,143,273
3,ARGEŞ,BĂBANA,14085,GROŞI,"ŞCOALA GROŞI",214,"Alegeri Prezidentiale",1,378,262,207,51,4,255,7,400,138,95,160
3,ARGEŞ,BĂICULEŞTI,14165,BĂICULEŞTI,"PRIMĂRIA BĂICULEŞTI",215,"Alegeri Prezidentiale",1,1400,668,596,72,0,654,14,1600,932,332,322
3,ARGEŞ,BĂICULEŞTI,14165,MĂNICEŞTI,"ŞCOALA MĂNICEŞTI",216,"Alegeri Prezidentiale",1,614,288,246,42,0,285,3,700,412,125,160
3,ARGEŞ,BĂICULEŞTI,14165,ZIGONENI,"CĂMINUL CULTURAL",217,"Alegeri Prezidentiale",1,826,483,417,66,0,476,7,900,417,274,202
3,ARGEŞ,BĂICULEŞTI,14165,"VALEA LUI ENACHE","CĂMINUL CULTURAL",218,"Alegeri Prezidentiale",1,676,419,381,38,0,415,4,700,281,185,230
3,ARGEŞ,BĂICULEŞTI,14165,TUTANA,"SEDIUL ADMINISTRATIV TUTANA",219,"Alegeri Prezidentiale",2,1504,707,643,64,0,700,7,1600,893,364,336
3,ARGEŞ,BĂLILEŞTI,14272,BĂLILEŞTI,"CĂMIN CULTURAL BĂLILEŞTI",220,"Alegeri Prezidentiale",1,903,556,475,81,0,547,9,1000,444,252,295
3,ARGEŞ,BĂLILEŞTI,14272,BĂJEŞTI,"CĂMIN CULTURAL BĂJEŞTI",221,"Alegeri Prezidentiale",1,831,530,454,76,0,525,5,900,370,285,240
3,ARGEŞ,BĂLILEŞTI,14272,POIENIŢA,"CĂMIN CULTURAL POIENIŢA",222,"Alegeri Prezidentiale",1,982,588,541,47,0,579,9,1000,412,270,309
3,ARGEŞ,BĂLILEŞTI,14272,PRIBOAIA,"ŞCOALA CU CLASELE I-IV GOLEŞTI-PRIBOAIA",223,"Alegeri Prezidentiale",1,569,299,256,43,0,298,1,700,401,150,148
3,ARGEŞ,BÂRLA,14450,URLUENI,"ŞCOALA URLUIENI",224,"Alegeri Prezidentiale",1,1004,422,323,99,0,421,1,1100,678,238,183
3,ARGEŞ,BÂRLA,14450,MÂNDRA,"ŞCOALA MÎNDRA",225,"Alegeri Prezidentiale",1,662,286,220,66,0,285,1,700,414,147,138
3,ARGEŞ,BÂRLA,14450,BÂRLA,"ŞCOALA BÎRLA",226,"Alegeri Prezidentiale",1,770,377,295,82,0,374,3,800,423,149,225
3,ARGEŞ,BÂRLA,14450,MOZĂCENII-VALE,"CENTRUL AFTER SCHOOL MOZĂCENII VALE",227,"Alegeri Prezidentiale",1,936,436,363,73,0,432,4,1100,664,278,154
3,ARGEŞ,BÂRLA,14450,BĂDEŞTI,"ŞCOALA BĂDEŞTI",228,"Alegeri Prezidentiale",1,264,153,128,25,0,151,2,300,147,108,43
3,ARGEŞ,BELEŢI-NEGREŞTI,14352,BELEŢI,"CĂMIN CULTURAL BELEŢI",229,"Alegeri Prezidentiale",1,535,291,263,28,0,283,8,600,309,148,135
3,ARGEŞ,BELEŢI-NEGREŞTI,14352,NEGREŞTI,"CĂMIN CULTURAL NEGREŞTI",230,"Alegeri Prezidentiale",1,961,600,548,52,0,593,7,1000,400,312,281
3,ARGEŞ,BEREVOEŞTI,14405,BEREVOEŞTI,"CĂMIN CULTURAL BEREVOEŞTI-PĂMÎNTENI",231,"Alegeri Prezidentiale",1,1693,826,744,82,0,816,10,1700,874,325,491
3,ARGEŞ,BEREVOEŞTI,14405,GĂMĂCEŞTI,"ŞCOALA GĂMĂCEŞTI",232,"Alegeri Prezidentiale",1,842,416,397,19,0,402,14,900,484,73,329
3,ARGEŞ,BEREVOEŞTI,14405,BRATIA,"ŞCOALA BRATIA",233,"Alegeri Prezidentiale",1,145,104,88,16,0,103,1,300,196,22,81
3,ARGEŞ,BOGAŢI,14584,BOGAŢI,"ŞCOALA BOGAŢI",234,"Alegeri Prezidentiale",1,1366,634,568,66,0,628,6,1475,841,265,363
3,ARGEŞ,BOGAŢI,14584,GLÂMBOCELU,"ŞCOALA GLÎMBOCELU",235,"Alegeri Prezidentiale",1,599,332,286,45,1,325,7,660,328,137,188
3,ARGEŞ,BOGAŢI,14584,CHIŢEŞTI,"ŞCOALA CHIŢEŞTI",236,"Alegeri Prezidentiale",1,212,151,107,44,0,151,0,240,89,70,81
3,ARGEŞ,BOGAŢI,14584,BUJOI,"GRĂDINIŢA BUJOI",237,"Alegeri Prezidentiale",1,515,265,239,26,0,262,3,570,305,124,138
3,ARGEŞ,BOGAŢI,14584,SUSENI,"ŞCOALA SUSENI",238,"Alegeri Prezidentiale",1,789,398,370,28,0,392,6,870,472,141,251
3,ARGEŞ,BOGAŢI,14584,GLÂMBOCEL,"ŞCOALA GLÎMBOCEL",239,"Alegeri Prezidentiale",1,160,101,80,21,0,99,2,180,79,46,53
3,ARGEŞ,BOTENI,14673,BOTENI,"CĂMIN CULTURAL BOTENI",240,"Alegeri Prezidentiale",1,1480,906,800,88,18,894,12,1600,694,449,445
3,ARGEŞ,BOTENI,14673,LUNCA,"ŞCOALA PRIMARĂ LUNCA",241,"Alegeri Prezidentiale",1,500,281,257,21,3,279,2,600,319,130,149
3,ARGEŞ,BOŢEŞTI,14726,BOŢEŞTI,"CĂMINUL CULTURAL BOȚEȘTI",242,"Alegeri Prezidentiale",1,669,420,357,63,0,417,3,700,280,242,175
3,ARGEŞ,BOŢEŞTI,14726,BOŢEŞTI,"ŞCOALA PRIMARĂ MOŞTENI-GRECI",243,"Alegeri Prezidentiale",1,240,178,124,54,0,176,2,300,122,97,79
3,ARGEŞ,BRADU,13276,BRADU,"CĂMINUL CULTURAL BRADU",244,"Alegeri Prezidentiale",1,950,601,485,116,0,587,14,1150,549,303,284
3,ARGEŞ,BRADU,13276,BRADU,"ȘCOALA PRIMARĂ ” MIHAI EMINESCU”",245,"Alegeri Prezidentiale",1,813,472,397,75,0,462,10,900,428,176,286
3,ARGEŞ,BRADU,13276,BRADU,"GRĂDINIȚA ” SCUFIȚA ROȘIE ”",246,"Alegeri Prezidentiale",1,1903,1050,945,105,0,1038,12,2201,1151,439,599
3,ARGEŞ,BRADU,13276,GEAMĂNA,"CLĂDIREA ADMINISTRATIVĂ C25 (FOSTA UNITATE MILITARĂ)",247,"Alegeri Prezidentiale",1,1076,605,555,50,0,600,5,1200,595,380,220
3,ARGEŞ,BRADU,13276,GEAMĂNA,"GRĂDINIȚA DE LA ȘCOALA PRIMARĂ GEAMĂNA",248,"Alegeri Prezidentiale",1,2141,1212,1067,145,0,1183,29,2150,938,638,545
3,ARGEŞ,BRĂDULEŢ,14753,BRĂDULEŢ,"CĂMIN CULTURAL BRĂDULEŢ",249,"Alegeri Prezidentiale",1,453,272,213,59,0,266,6,460,188,115,151
3,ARGEŞ,BRĂDULEŢ,14753,GALEŞU,"CĂMINUL CULTURAL GALEŞU",250,"Alegeri Prezidentiale",1,740,412,365,47,0,402,10,750,338,179,223
3,ARGEŞ,BRĂDULEŢ,14753,BRĂDETU,"ŞCOALA PRIMARĂ BRĂDETU",251,"Alegeri Prezidentiale",1,284,246,151,95,0,239,7,390,144,108,131
3,ARGEŞ,BUDEASA,14851,"BUDEASA MARE","ŞCOALA GENERALĂ BUDEASA MARE",252,"Alegeri Prezidentiale",1,1084,663,534,129,0,648,15,1200,537,388,260
3,ARGEŞ,BUDEASA,14851,"BUDEASA MICĂ","ŞCOALA GENERALĂ BUDEASA MICĂ",253,"Alegeri Prezidentiale",1,734,473,419,54,0,464,9,800,327,225,239
3,ARGEŞ,BUDEASA,14851,GĂLĂŞEŞTI,"ŞCOALA GENERALĂ GĂLĂŞEŞTI",254,"Alegeri Prezidentiale",1,799,466,424,42,0,459,7,900,434,226,233
3,ARGEŞ,BUDEASA,14851,CALOTEŞTI,"ŞCOALA GENERALĂ CALOTEŞTI",255,"Alegeri Prezidentiale",1,829,474,408,66,0,469,5,900,426,222,247
3,ARGEŞ,"BUGHEA DE JOS",14922,"BUGHEA DE JOS","SCOALA GIMNAZIALA BUGHEA DE JOS",256,"Alegeri Prezidentiale",1,1373,721,663,56,2,709,12,1500,779,427,282
3,ARGEŞ,"BUGHEA DE JOS",14922,"BUGHEA DE JOS","SCOALA PRIMARA MLACI",257,"Alegeri Prezidentiale",1,561,224,195,29,0,220,4,600,376,91,129
3,ARGEŞ,"BUGHEA DE JOS",14922,"BUGHEA DE JOS","SCOALA PRIMARA HULUBESTI",258,"Alegeri Prezidentiale",1,458,239,219,20,0,233,6,492,253,105,128
3,ARGEŞ,"BUGHEA DE SUS",20063,"BUGHEA DE SUS","ŞCOALA GIMNAZIALĂ NR. 1 BUGHEA DE SUS",259,"Alegeri Prezidentiale",1,1687,855,769,75,11,834,21,1800,945,473,361
3,ARGEŞ,"BUGHEA DE SUS",20063,"BUGHEA DE SUS","GRĂDINIŢA GRUI",260,"Alegeri Prezidentiale",1,691,447,401,41,5,442,5,800,353,301,141
3,ARGEŞ,BUZOEŞTI,14940,ŞERBOENI,"ȘCOALA GIMNAZIALĂ ŞERBOENI",261,"Alegeri Prezidentiale",1,1215,599,529,70,0,587,12,1300,701,256,331
3,ARGEŞ,BUZOEŞTI,14940,IONEŞTI,"GRĂDINIŢA CU PROGRAM NORMAL IONEŞTI",262,"Alegeri Prezidentiale",1,595,288,250,37,1,282,6,700,412,125,157
3,ARGEŞ,BUZOEŞTI,14940,TOMŞANCA,"ŞCOALA GIMNAZIALĂ TOMŞANCA",263,"Alegeri Prezidentiale",1,301,144,115,29,0,142,2,400,256,38,104
3,ARGEŞ,BUZOEŞTI,14940,VULPEŞTI,"ŞCOALA GIMNAZIALĂ VULPEŞTI",264,"Alegeri Prezidentiale",1,858,316,269,47,0,311,5,900,584,152,159
3,ARGEŞ,BUZOEŞTI,14940,CORNĂŢEL,"ŞCOALA GIMNAZIALĂ CORNĂŢEL",265,"Alegeri Prezidentiale",1,767,320,264,56,0,315,5,900,580,126,189
3,ARGEŞ,BUZOEŞTI,14940,BUZOEŞTI,"ȘCOALA GIMNAZIALĂ BUZOEŞTI",266,"Alegeri Prezidentiale",1,886,383,280,103,0,382,1,900,517,160,222
3,ARGEŞ,CĂLDĂRARU,15064,CĂLDĂRARU,"ŞCOALA GIM.”PROF.UNIV.DR.ION STOIA” CĂLDĂRARU",267,"Alegeri Prezidentiale",1,719,338,271,67,0,331,7,800,462,139,192
3,ARGEŞ,CĂLDĂRARU,15064,STRÂMBENI,"ŞCOALAGEN CU CLS. I-VIII STRÎMBENI",268,"Alegeri Prezidentiale",1,689,330,260,70,0,326,4,800,470,96,230
3,ARGEŞ,CĂLDĂRARU,15064,BURDEA,"ŞCOALA PRIMARĂ ”ÎNV.CONSTANTIN MIHALCEA” BURDEA",269,"Alegeri Prezidentiale",1,467,207,158,49,0,206,1,500,293,67,139
3,ARGEŞ,CĂLINEŞTI,15108,VRĂNEŞTI,"SCOALA GENERALA VRANESTI",270,"Alegeri Prezidentiale",1,1622,811,751,60,0,801,10,1750,939,439,362
3,ARGEŞ,CĂLINEŞTI,15108,CĂLINEŞTI,"SCOALA CALINESTI",271,"Alegeri Prezidentiale",1,1647,796,689,83,24,782,14,1750,954,402,380
3,ARGEŞ,CĂLINEŞTI,15108,CÂRSTIENI,"SCOALA CIRSTIENI",272,"Alegeri Prezidentiale",1,1505,597,566,31,0,588,9,1650,1053,260,328
3,ARGEŞ,CĂLINEŞTI,15108,CIOCĂNEŞTI,"SCOALA CIOCANESTI",273,"Alegeri Prezidentiale",1,781,436,375,61,0,433,3,850,414,256,177
3,ARGEŞ,CĂLINEŞTI,15108,GLODU,"SCOALA GLODU",274,"Alegeri Prezidentiale",1,603,323,289,34,0,322,1,700,377,172,150
3,ARGEŞ,CĂLINEŞTI,15108,GORGANU,"GRĂDINIŢA DRĂGHICEŞTI",275,"Alegeri Prezidentiale",1,850,460,411,47,2,454,6,950,490,254,200
3,ARGEŞ,CĂLINEŞTI,15108,"RADU NEGRU","SCOALA RADU NEGRU",276,"Alegeri Prezidentiale",1,520,242,216,26,0,241,1,600,358,166,75
3,ARGEŞ,CĂLINEŞTI,15108,URLUCEA,"SCOALA RINCACIOV",277,"Alegeri Prezidentiale",1,553,248,218,30,0,244,4,650,402,124,120
3,ARGEŞ,CĂLINEŞTI,15108,VĂLENI-PODGORIA,"SCOALA VALENI",278,"Alegeri Prezidentiale",1,916,449,409,40,0,438,11,1000,551,261,177
3,ARGEŞ,CĂTEASCA,15233,CĂTEASCA,"CĂMINUL CULTURAL CĂTEASCA",279,"Alegeri Prezidentiale",1,709,381,299,82,0,374,7,770,389,208,166
3,ARGEŞ,CĂTEASCA,15233,SILIŞTEA,"CĂMINUL CULTURAL SILIŞTEA",280,"Alegeri Prezidentiale",1,405,216,184,32,0,213,3,450,234,104,109
3,ARGEŞ,CĂTEASCA,15233,GRUIU,"CĂMINUL CULTURAL GRUIU",281,"Alegeri Prezidentiale",1,539,284,234,50,0,282,2,580,296,142,140
3,ARGEŞ,CĂTEASCA,15233,CIREŞU,"CĂMIN CULTURAL CIREŞU",282,"Alegeri Prezidentiale",1,569,282,234,48,0,278,4,620,338,120,158
3,ARGEŞ,CĂTEASCA,15233,CATANELE,"CĂMINUL CULTURAL CĂTANELE",283,"Alegeri Prezidentiale",1,805,471,392,79,0,458,13,880,409,273,185
3,ARGEŞ,CEPARI,15313,"CEPARII PĂMÂNTENI","CĂMINUL CULTURAL CEPARI",284,"Alegeri Prezidentiale",1,695,338,292,44,2,331,7,750,412,186,145
3,ARGEŞ,CEPARI,15313,CĂRPENIŞ,"ŞCOALA CĂRPENIŞ",285,"Alegeri Prezidentiale",1,580,363,301,55,7,359,4,650,287,174,185
3,ARGEŞ,CEPARI,15313,URLUIEŞTI,"ŞCOALA URLUIEŞTI",286,"Alegeri Prezidentiale",1,227,138,109,29,0,138,0,275,137,82,56
3,ARGEŞ,CEPARI,15313,"CEPARII UNGURENI","ŞCOALA CEPARI - UNGURENI",287,"Alegeri Prezidentiale",1,277,153,129,22,2,153,0,325,172,86,67
3,ARGEŞ,CETĂŢENI,15402,CETĂŢENI,"CĂMIN CULTURAL CETĂŢENI",288,"Alegeri Prezidentiale",1,900,456,397,59,0,449,7,900,444,194,255
3,ARGEŞ,CETĂŢENI,15402,LĂICĂI,"GRĂDINIŢA LĂICĂI",289,"Alegeri Prezidentiale",1,660,344,299,45,0,336,8,800,456,132,204
3,ARGEŞ,CETĂŢENI,15402,"VALEA CETĂŢUIA","ŞCOALA I-IV VALEA CETĂŢUIA",290,"Alegeri Prezidentiale",1,702,383,359,24,0,381,2,800,417,142,239
3,ARGEŞ,CICĂNEŞTI,15448,CICĂNEŞTI,"ŞCOALA GIMNAZIALĂ CICĂNEŞTI",291,"Alegeri Prezidentiale",1,1693,1164,1059,105,0,1148,16,1900,736,446,702
3,ARGEŞ,CIOFRÂNGENI,15493,CIOFRÂNGENI,"CĂMIN CULTURAL CIOFRÎNGENI",292,"Alegeri Prezidentiale",1,1046,589,507,82,0,581,8,1100,511,314,267
3,ARGEŞ,CIOFRÂNGENI,15493,LACURILE,"SCOALA CU CLASELE I-IV LACURILE",293,"Alegeri Prezidentiale",1,520,294,244,48,2,291,3,600,306,143,148
3,ARGEŞ,CIOFRÂNGENI,15493,BURLUŞI,"CĂMIN CULTURAL BURLUŞI",294,"Alegeri Prezidentiale",1,382,255,189,66,0,253,2,400,145,116,137
3,ARGEŞ,CIOMĂGEŞTI,15554,BRATIA,"ȘCOALA GIMNAZIALĂ BRĂTIA",295,"Alegeri Prezidentiale",1,342,258,180,78,0,255,3,400,142,130,125
3,ARGEŞ,CIOMĂGEŞTI,15554,CIOMĂGEŞTI,"ŞCOALA CU CLS. I-IV CIOMĂGEŞTI-SAT",296,"Alegeri Prezidentiale",1,340,223,166,57,0,219,4,350,127,124,95
3,ARGEŞ,CIOMĂGEŞTI,15554,DOGARI,"GRĂDINIȚA DOGARI",297,"Alegeri Prezidentiale",1,213,121,90,31,0,120,1,250,129,49,71
3,ARGEŞ,COCU,15652,COCU,"ŞCOALĂ GIMNAZIALĂ NR.1 COCU",298,"Alegeri Prezidentiale",1,500,259,171,88,0,259,0,550,291,101,158
3,ARGEŞ,COCU,15652,CRUCIŞOARA,"ŞCOALĂ PRIMARĂ CRUCIŞOARA",299,"Alegeri Prezidentiale",1,246,155,102,53,0,154,1,250,95,62,92
3,ARGEŞ,COCU,15652,"RĂCHIŢELE DE JOS","PRIMARIA COMUNEI COCU",300,"Alegeri Prezidentiale",1,302,156,100,56,0,154,2,350,194,57,97
3,ARGEŞ,COCU,15652,"RĂCHIŢELE DE SUS","ŞCOALĂ PRIMARĂ RICHIŢELE DE SUS",301,"Alegeri Prezidentiale",1,307,86,65,21,0,86,0,350,264,48,38
3,ARGEŞ,COCU,15652,BĂRBĂTEŞTI,"ŞCOALĂ PRIMARĂ BĂRBĂTEŞTI",302,"Alegeri Prezidentiale",1,470,182,141,41,0,180,2,500,318,73,107
3,ARGEŞ,CORBENI,15741,"OEŞTII UNGURENI","ŞCOALA GIMNAZIALĂ PROF. DR. VASILE VASILESCU",303,"Alegeri Prezidentiale",1,833,449,406,43,0,437,12,900,451,252,185
3,ARGEŞ,CORBENI,15741,"OEŞTII UNGURENI","ŞCOALA GIMNAZIALĂ PROF. DR. VASILE VASILESCU",304,"Alegeri Prezidentiale",1,1227,574,532,42,0,562,12,1250,676,281,281
3,ARGEŞ,CORBENI,15741,CORBENI,"GRĂDINIŢA NR. 1 CORBENI",305,"Alegeri Prezidentiale",1,634,266,236,30,0,261,5,700,434,142,119
3,ARGEŞ,CORBENI,15741,CORBENI,"ŞCOALA GIMNAZIALĂ NR. 1 CORBENI",306,"Alegeri Prezidentiale",1,1294,670,590,80,0,659,11,1350,680,403,256
3,ARGEŞ,CORBENI,15741,BERINDEŞTI,"ŞCOALA PRIMARĂ BERINDEŞTI",307,"Alegeri Prezidentiale",1,597,301,263,38,0,297,4,800,499,190,107
3,ARGEŞ,CORBI,15830,CORBI,"CĂMIN CULTURAL CORBI",308,"Alegeri Prezidentiale",1,1660,781,701,79,1,771,10,1800,1019,398,373
3,ARGEŞ,CORBI,15830,CORBŞORI,"CĂMIN CULTURAL CORBŞORI",309,"Alegeri Prezidentiale",1,763,450,373,75,2,445,5,900,450,259,186
3,ARGEŞ,CORBI,15830,STĂNEŞTI,"CĂMIN CULTURAL STĂNEŞTI",310,"Alegeri Prezidentiale",1,930,480,413,67,0,463,17,1000,520,259,204
3,ARGEŞ,COŞEŞTI,15901,PETREŞTI,"ŞCOALA PETREŞTI",311,"Alegeri Prezidentiale",1,716,435,344,91,0,430,5,900,465,162,268
3,ARGEŞ,COŞEŞTI,15901,COŞEŞTI,"CĂMIN CULTURAL COŞEŞTI",312,"Alegeri Prezidentiale",1,859,426,388,38,0,415,11,1000,574,193,222
3,ARGEŞ,COŞEŞTI,15901,LEICEŞTI,"CĂMIN CULTURAL LEICEŞTI",313,"Alegeri Prezidentiale",1,1586,752,687,65,0,744,8,1600,848,341,403
3,ARGEŞ,COŞEŞTI,15901,JUPÂNEŞTI,"CĂMIN CULTURAL JUPÎNEŞTI",314,"Alegeri Prezidentiale",2,889,366,327,39,0,363,3,900,534,182,181
3,ARGEŞ,COŞEŞTI,15901,LĂPUŞANI,"CĂMINUL CULTURAL LĂPUŞANI",315,"Alegeri Prezidentiale",1,311,183,167,16,0,179,4,400,217,92,87
3,ARGEŞ,COTMEANA,15983,COTMEANA,"CENTRU DE INFORMARE TURISTICĂ COTMEANA",316,"Alegeri Prezidentiale",1,786,366,294,72,0,361,5,808,442,147,214
3,ARGEŞ,COTMEANA,15983,LINTEŞTI,"ŞCOALA LINTEŞTI",317,"Alegeri Prezidentiale",1,339,193,136,57,0,191,2,400,207,53,138
3,ARGEŞ,COTMEANA,15983,URSOAIA,"CENTRUL INGRIJIRE COPII",318,"Alegeri Prezidentiale",1,438,228,181,47,0,227,1,500,272,121,106
3,ARGEŞ,CUCA,16132,CUCA,"ŞCOALA GIMNAZIALĂ ”MIRCEA GHIŢULESCU” CUCA",319,"Alegeri Prezidentiale",2,397,224,169,55,0,221,3,431,207,111,110
3,ARGEŞ,CUCA,16132,TEODOREŞTI,"ŞCOALA PRIMARĂ LĂUNELE",320,"Alegeri Prezidentiale",1,509,252,199,53,0,249,3,543,291,87,162
3,ARGEŞ,CUCA,16132,MĂCĂI,"ŞCOALA PRIMARĂ MĂCĂI",321,"Alegeri Prezidentiale",1,511,286,219,67,0,285,1,545,259,122,163
3,ARGEŞ,CUCA,16132,CÂRCEŞTI,"ŞCOALA PRIMARĂ CÎRCEŞTI",322,"Alegeri Prezidentiale",1,247,150,121,29,0,147,3,281,131,47,100
3,ARGEŞ,DAVIDEŞTI,16285,DAVIDEŞTI,"ŞCOALA DAVIDEŞTI",323,"Alegeri Prezidentiale",1,485,323,271,52,0,321,2,500,177,174,147
3,ARGEŞ,DAVIDEŞTI,16285,VOROVENI,"ŞCOALA VOROVENI",324,"Alegeri Prezidentiale",1,480,264,232,32,0,259,5,500,236,103,156
3,ARGEŞ,DAVIDEŞTI,16285,CONŢEŞTI,"ŞCOALA CONŢEŞTI NR.1",325,"Alegeri Prezidentiale",1,671,301,269,32,0,294,7,800,499,165,129
3,ARGEŞ,DAVIDEŞTI,16285,CONŢEŞTI,"ŞCOALA OLTEANCA",326,"Alegeri Prezidentiale",2,755,345,314,31,0,339,6,800,455,80,259
3,ARGEŞ,DÂMBOVICIOARA,16329,"PODU DÂMBOVIŢEI","CĂMINUL CULTURAL PODU DÎMBOVIŢEI",327,"Alegeri Prezidentiale",1,459,408,317,91,0,399,9,500,92,190,209
3,ARGEŞ,DÂMBOVICIOARA,16329,DÂMBOVICIOARA,"CLĂDIRE MULTIFUNCȚIONALĂ DÎMBOVICIOARA",328,"Alegeri Prezidentiale",1,236,190,143,47,0,185,5,300,110,87,98
3,ARGEŞ,DÂMBOVICIOARA,16329,CIOCANU,"ŞCOALA CIOCANU",329,"Alegeri Prezidentiale",1,60,67,26,41,0,64,3,100,33,32,32
3,ARGEŞ,DÂRMĂNEŞTI,16365,PISCANI,"ŞCOALA PISCANI",330,"Alegeri Prezidentiale",1,749,400,369,31,0,397,3,800,400,200,197
3,ARGEŞ,DÂRMĂNEŞTI,16365,DÂRMĂNEŞTI,"ŞCOALA DÎRMĂNEŞTI",331,"Alegeri Prezidentiale",1,1053,466,433,33,0,459,7,1200,734,231,228
3,ARGEŞ,DÂRMĂNEŞTI,16365,"VALEA NANDRII","ŞCOALA VALEA NANDRII",332,"Alegeri Prezidentiale",1,573,328,277,51,0,324,4,600,272,165,159
3,ARGEŞ,DÂRMĂNEŞTI,16365,NEGRENI,"CAMINUL CULTURAL NEGRENI",333,"Alegeri Prezidentiale",1,554,364,319,45,0,363,1,600,236,145,218
3,ARGEŞ,DOBREŞTI,16427,DOBREŞTI,"CĂMIN CULTURAL DOBREŞTI",334,"Alegeri Prezidentiale",1,741,465,370,86,9,459,6,800,335,221,238
3,ARGEŞ,DOBREŞTI,16427,FUREŞTI,"ŞCOALA GEN. I-IV FUREŞTI",335,"Alegeri Prezidentiale",1,713,351,320,31,0,347,4,800,449,160,187
3,ARGEŞ,DOMNEŞTI,16454,DOMNEŞTI,"CAMINUL CULTURAL ”PETRE IONESCU MUSCEL”",336,"Alegeri Prezidentiale",1,1281,862,730,110,22,835,27,1400,538,398,437
3,ARGEŞ,DOMNEŞTI,16454,DOMNEŞTI,"CAMINUL CULTURAL ”PETRE IONESCU MUSCEL” -",337,"Alegeri Prezidentiale",1,1343,849,737,79,33,839,10,1500,651,401,438
3,ARGEŞ,DRAGOSLAVELE,16472,DRAGOSLAVELE,"ŞCOALA GIMNAZIALĂ IOSIF CATRINESCU CLS. V-VIII",338,"Alegeri Prezidentiale",1,654,376,338,38,0,363,13,730,354,231,132
3,ARGEŞ,DRAGOSLAVELE,16472,DRAGOSLAVELE,"ŞCOALAPRIMARĂ DRAGOSLAVELE",339,"Alegeri Prezidentiale",1,907,524,471,53,0,518,6,1000,476,323,195
3,ARGEŞ,DRAGOSLAVELE,16472,"VALEA HOTARULUI","ŞCOALA VALEA HOTARULUI",340,"Alegeri Prezidentiale",1,518,318,295,23,0,311,7,570,252,158,153
3,ARGEŞ,DRĂGANU,16506,DRĂGANU-OLTENI,"CĂMIN CULTURAL DRĂGANU",341,"Alegeri Prezidentiale",1,1689,896,712,184,0,882,14,1900,1004,480,402
3,ARGEŞ,GODENI,16551,GODENI,"ȘCOALA GODENI, NR.26",342,"Alegeri Prezidentiale",1,1021,572,524,46,2,562,10,1100,528,222,340
3,ARGEŞ,GODENI,16551,COTEŞTI,"ŞCOALA GIMNAZIALĂ COTEȘTI-GODENI, NR.198",343,"Alegeri Prezidentiale",1,1439,709,646,62,1,694,15,1600,891,354,340
3,ARGEŞ,HÂRSEȘTI,16613,HÂRSEŞTI,"CĂMINUL CULTURAL HÂRSEŞTI",344,"Alegeri Prezidentiale",1,1260,653,494,158,1,640,13,1200,547,225,415
3,ARGEŞ,HÂRSEȘTI,16613,MARTALOGI,"ŞCOALA MARTALOGI",345,"Alegeri Prezidentiale",1,585,339,267,70,2,337,2,800,461,110,227
3,ARGEŞ,HÂRTIEŞTI,16659,HÂRTIEŞTI,"CĂMIN CULTURAL HÎRTIEŞTI",346,"Alegeri Prezidentiale",1,777,441,421,20,0,431,10,900,459,188,243
3,ARGEŞ,HÂRTIEŞTI,16659,DEALU,"PRIMĂRIA VECHE HÎRTIEŞTI",347,"Alegeri Prezidentiale",1,297,191,157,34,0,187,4,300,109,68,119
3,ARGEŞ,HÂRTIEŞTI,16659,LUCIENI,"ŞCOALA LUCIENI",348,"Alegeri Prezidentiale",1,276,183,152,31,0,180,3,300,117,72,108
3,ARGEŞ,HÂRTIEŞTI,16659,LESPEZI,"CENTRUL DE ZI LESPEZI",349,"Alegeri Prezidentiale",1,385,258,246,12,0,255,3,400,142,34,221
3,ARGEŞ,IZVORU,16739,IZVORU,"ŞCOALA GIMNAZIALĂ ELENA DAVILA PERTICARI",350,"Alegeri Prezidentiale",1,905,476,406,70,0,473,3,1000,524,222,251
3,ARGEŞ,IZVORU,16739,IZVORU,"ŞCOALA GIMNAZIALĂ ELENA DAVILA PERTICARI",351,"Alegeri Prezidentiale",1,899,441,393,48,0,434,7,1000,559,255,179
3,ARGEŞ,LEORDENI,16757,LEORDENI,PRIMĂRIE,352,"Alegeri Prezidentiale",1,1420,803,666,103,34,794,9,1600,797,373,421
3,ARGEŞ,LEORDENI,16757,BUDIŞTENI,"CENTRUL CULTURAL MULTIFUNCȚIONAL BUDIŞTENI",353,"Alegeri Prezidentiale",1,1044,490,435,55,0,486,4,1100,610,238,248
3,ARGEŞ,LEORDENI,16757,GLÂMBOCATA-DEAL,"CLĂDIREA MULTIFUNCŢIONALĂ GLÂMBOCATA-DEAL",354,"Alegeri Prezidentiale",1,899,426,367,59,0,416,10,1000,574,229,187
3,ARGEŞ,LEORDENI,16757,CIULNIŢA,"ŞCOALA CIULNIŢA",355,"Alegeri Prezidentiale",1,911,508,428,80,0,494,14,1000,492,227,267
3,ARGEŞ,LEORDENI,16757,"COTU MALULUI","ŞCOALA COTU MALULUI",356,"Alegeri Prezidentiale",1,342,147,129,18,0,145,2,400,253,26,119
3,ARGEŞ,LEREŞTI,16908,LEREŞTI,"ȘCOALA GIMNAZIALĂ NR.1 LEREȘTI, SAT LEREȘTI",357,"Alegeri Prezidentiale",1,1355,809,725,82,2,794,15,1500,691,353,441
3,ARGEŞ,LEREŞTI,16908,VOINEŞTI,"ȘCOALA GIMNAZIALĂ NR.1 LEREȘTI, SAT VOINEȘTI",358,"Alegeri Prezidentiale",1,1337,893,750,126,17,883,10,1500,607,406,477
3,ARGEŞ,LEREŞTI,16908,LEREŞTI,"CĂMIN CULTURAL LEREȘTI",359,"Alegeri Prezidentiale",1,1106,667,554,113,0,659,8,1200,533,260,399
3,ARGEŞ,"LUNCA CORBULUI",16944,"LUNCA CORBULUI","ŞCOALA GIMNAZIALĂ ”GENERAL CONSTANTIN CRISTESCU” LUNCA CORBULUI",360,"Alegeri Prezidentiale",1,814,458,352,106,0,451,7,900,442,214,237
3,ARGEŞ,"LUNCA CORBULUI",16944,"LUNCA CORBULUI","ŞCOALA SILIŞTENI",361,"Alegeri Prezidentiale",1,208,140,94,45,1,138,2,240,100,60,78
3,ARGEŞ,"LUNCA CORBULUI",16944,"LUNCA CORBULUI","ŞCOALA PĂDUREŢI",362,"Alegeri Prezidentiale",1,831,341,258,83,0,337,4,900,559,152,185
3,ARGEŞ,"LUNCA CORBULUI",16944,"LUNCA CORBULUI","ŞCOALA MÎRGHIA DE SUS",363,"Alegeri Prezidentiale",1,334,220,132,88,0,216,4,360,140,75,141
3,ARGEŞ,MĂLURENI,17049,MĂLURENI,"ŞCOALA MĂLURENI",364,"Alegeri Prezidentiale",1,517,262,200,62,0,258,4,564,302,104,154
3,ARGEŞ,MĂLURENI,17049,MĂLURENI,"CĂMIN CULTURAL BĂDICENI",365,"Alegeri Prezidentiale",1,428,264,204,60,0,262,2,480,216,149,113
3,ARGEŞ,MĂLURENI,17049,TOPLIŢA,"ŞCOALA BOHARI",366,"Alegeri Prezidentiale",1,319,173,136,37,0,172,1,368,195,102,70
3,ARGEŞ,MĂLURENI,17049,TOPLIŢA,"ŞCOALA TOPLIŢA",367,"Alegeri Prezidentiale",1,288,153,119,34,0,153,0,340,187,51,102
3,ARGEŞ,MĂLURENI,17049,ZĂRNEŞTI,"ŞCOALA ZĂRNEŞTI",368,"Alegeri Prezidentiale",1,768,380,320,60,0,378,2,820,440,172,206
3,ARGEŞ,MĂLURENI,17049,BUNEŞTI,"ŞCOALA BUNEŞTI",369,"Alegeri Prezidentiale",1,557,252,179,73,0,247,5,612,360,101,146
3,ARGEŞ,MĂLURENI,17049,PĂULEASCA,"TABĂRA PĂULEASCA",370,"Alegeri Prezidentiale",1,667,226,215,11,0,219,7,716,490,84,135
3,ARGEŞ,MĂRĂCINENI,13365,MĂRĂCINENI,"ŞCOALA GENERALĂ NR.1",371,"Alegeri Prezidentiale",1,1198,655,583,72,0,642,13,1600,945,316,326
3,ARGEŞ,MĂRĂCINENI,13365,MĂRĂCINENI,"ŞCOALA GENERALĂ NR.1",372,"Alegeri Prezidentiale",1,1523,899,801,98,0,867,32,1600,701,506,361
3,ARGEŞ,MĂRĂCINENI,13365,ARGEŞELU,"ŞCOALA GENERALĂ ARGEŞELU",373,"Alegeri Prezidentiale",1,1724,998,880,117,1,988,10,1700,702,493,495
3,ARGEŞ,MERIŞANI,17101,DOBROGOSTEA,"ŞCOALA PRIMARĂ DOBROGOSTEA",374,"Alegeri Prezidentiale",1,1031,475,425,50,0,466,9,1100,625,221,245
3,ARGEŞ,MERIŞANI,17101,BORLEŞTI,"ȘCOALA GENERALĂ BORLEȘTI",375,"Alegeri Prezidentiale",1,482,290,256,34,0,287,3,500,210,137,150
3,ARGEŞ,MERIŞANI,17101,MERIŞANI,"CĂMINUL CULTURAL MERIŞANI",376,"Alegeri Prezidentiale",1,677,345,294,51,0,341,4,800,455,181,160
3,ARGEŞ,MERIŞANI,17101,"MALU VÂNĂT","ŞCOALA PRIMARĂ MALU VÂNĂT",377,"Alegeri Prezidentiale",1,657,295,269,26,0,288,7,800,505,127,161
3,ARGEŞ,MERIŞANI,17101,VÂLCELELE,"CĂMINUL CULTURAL VÎLCELELE",378,"Alegeri Prezidentiale",1,748,457,353,102,2,452,5,800,343,206,246
3,ARGEŞ,MICEŞTI,17209,MICEŞTI,"ŞCOALA GIMNAZIALA NR.1 MICEŞTI",379,"Alegeri Prezidentiale",1,1457,819,753,66,0,793,26,1600,781,480,313
3,ARGEŞ,MICEŞTI,17209,PURCĂRENI,"CĂMIN CULTURAL PURCĂRENI",380,"Alegeri Prezidentiale",1,1394,737,695,42,0,726,11,1600,863,390,336
3,ARGEŞ,MICEŞTI,17209,PĂULEASCA,"ŞCOALA PRIMARA NR.2 PĂULEASCA",381,"Alegeri Prezidentiale",1,812,434,390,44,0,425,9,800,366,206,219
3,ARGEŞ,MIHĂEŞTI,17254,MIHĂEŞTI,"CĂMINUL CULTURAL MIHĂEȘTI",382,"Alegeri Prezidentiale",1,2029,898,827,71,0,880,18,2100,1202,357,523
3,ARGEŞ,MIHĂEŞTI,17254,"VALEA POPII","ȘCOALA GENERALĂ VALEA POPII",383,"Alegeri Prezidentiale",1,781,504,462,42,0,493,11,901,397,222,271
3,ARGEŞ,MIHĂEŞTI,17254,DRĂGHICI,"CĂMIN CULTURAL DRĂGHICI",384,"Alegeri Prezidentiale",1,887,497,441,56,0,493,4,1000,503,203,290
3,ARGEŞ,MIHĂEŞTI,17254,VĂCAREA,"ȘCOALA GENERALĂ VĂCAREA",385,"Alegeri Prezidentiale",1,461,321,281,40,0,319,2,500,179,154,165
3,ARGEŞ,MIHĂEŞTI,17254,FURNICOŞI,"CAMINUL CULTURAL FURNICOSI",386,"Alegeri Prezidentiale",1,736,428,382,46,0,421,7,900,472,220,201
3,ARGEŞ,MIOARELE,17334,MĂŢĂU,"CĂMIN CULTURAL MĂŢĂU",387,"Alegeri Prezidentiale",1,984,478,437,37,4,474,4,1000,522,248,226
3,ARGEŞ,MIOARELE,17334,SUSLĂNEŞTI,"ŞCOALA PRIMARĂ I-IV SUSLĂNEŞTI",388,"Alegeri Prezidentiale",1,332,206,172,34,0,205,1,400,194,112,93
3,ARGEŞ,MIROŞI,17398,MIROŞI,"CĂMIN CULTURAL MIROŞI",389,"Alegeri Prezidentiale",1,1194,475,422,53,0,473,2,1300,825,146,327
3,ARGEŞ,MIROŞI,17398,SURDULEŞTI,"ŞCOALA SURDULEŞTI",390,"Alegeri Prezidentiale",1,732,339,279,57,3,333,6,800,461,102,231
3,ARGEŞ,MORĂREŞTI,17423,MORĂREŞTI,"ŞCOALA GENERALĂ CU CLASELE I-VIII MORĂREŞTI",391,"Alegeri Prezidentiale",1,879,494,381,113,0,484,10,900,406,233,251
3,ARGEŞ,MORĂREŞTI,17423,DEDULEŞTI,"ŞCOALA CU CLASELE I-IV DEDULEŞTI",392,"Alegeri Prezidentiale",1,600,311,224,87,0,306,5,700,389,165,141
3,ARGEŞ,MOŞOAIA,17496,MOŞOAIA,"CĂMIN CULTURAL MOŞOAIA",393,"Alegeri Prezidentiale",1,1413,733,648,85,0,721,12,1600,867,372,349
3,ARGEŞ,MOŞOAIA,17496,HINŢEŞTI,"ŞCOALA CU CLASELE I-VIII HINŢEŞTI",394,"Alegeri Prezidentiale",1,1000,545,474,71,0,533,12,1100,555,268,265
3,ARGEŞ,MOŞOAIA,17496,SMEURA,"ŞCOALA CU CLASELE I-IV SMEURA",395,"Alegeri Prezidentiale",1,1315,748,661,87,0,728,20,1400,652,441,287
3,ARGEŞ,MOŞOAIA,17496,CIOCĂNĂI,"ŞCOALA CU CLASELE I-IV CIOCĂNĂI",396,"Alegeri Prezidentiale",1,540,309,268,41,0,302,7,600,291,156,146
3,ARGEŞ,MOŞOAIA,17496,SMEURA,"SOCIETATEA COMERCIALĂ BUILDING ASTROM SOCIETATE CU RĂSPUNDERE LIMITATĂ",397,"Alegeri Prezidentiale",1,964,627,551,76,0,617,10,1100,473,399,218
3,ARGEŞ,MOZĂCENI,17575,MOZĂCENI,"LICEUL TEHNOLOGIC LIVIU REBREANU MOZĂCENI",398,"Alegeri Prezidentiale",1,1209,668,558,110,0,665,3,1302,634,342,323
3,ARGEŞ,MOZĂCENI,17575,MOZĂCENI,"ŞCOALA GENERALĂ MIŞEI",399,"Alegeri Prezidentiale",1,505,275,221,54,0,271,4,598,323,167,104
3,ARGEŞ,MUŞĂTEŞTI,17619,MUŞĂTEŞTI,"CĂMIN CULTURAL CONSTANTIN DOBRESCU ARGEȘ - ROBAIA",400,"Alegeri Prezidentiale",1,1179,667,583,80,4,659,8,1250,583,298,361
3,ARGEŞ,MUŞĂTEŞTI,17619,VÂLSĂNEŞTI,"SEDIUL PRIMĂRIEI VECHI - VILSĂNEȘTI",401,"Alegeri Prezidentiale",1,452,226,174,52,0,224,2,492,266,103,121
3,ARGEŞ,MUŞĂTEŞTI,17619,COSTEŞTI-VÂSLAN,"ŞCOALA GENERALĂ COSTEŞTI - VÎLSAN",402,"Alegeri Prezidentiale",1,545,325,276,47,2,323,2,600,275,146,177
3,ARGEŞ,MUŞĂTEŞTI,17619,STROEŞTI,"ŞCOALA GENERALĂ STROEŞTI",403,"Alegeri Prezidentiale",1,861,460,413,45,2,458,2,950,490,210,248
3,ARGEŞ,NEGRAŞI,17726,NEGRAŞI,"ŞCOALA NEGRAŞI",404,"Alegeri Prezidentiale",1,605,342,277,65,0,335,7,654,312,149,186
3,ARGEŞ,NEGRAŞI,17726,BÂRLOGU,"GRĂDINIŢA BÎRLOGU",405,"Alegeri Prezidentiale",1,641,337,232,105,0,334,3,701,364,112,222
3,ARGEŞ,NEGRAŞI,17726,MOZACU,"ŞCOALA MOZACU",406,"Alegeri Prezidentiale",1,249,162,122,40,0,159,3,270,108,45,114
3,ARGEŞ,NEGRAŞI,17726,BUTA,"ŞCOALA BUTA",407,"Alegeri Prezidentiale",1,155,97,68,29,0,94,3,175,78,42,52
3,ARGEŞ,NUCŞOARA,17771,NUCŞOARA,"ŞCOALA CU CLASELE I-VIII ”TOMA ARNĂUŢOIU”",408,"Alegeri Prezidentiale",1,367,246,201,45,0,242,4,400,154,104,138
3,ARGEŞ,NUCŞOARA,17771,SBOGHIŢEŞTI,"CĂMIN CULTURAL SBOGHIŢEŞTI",409,"Alegeri Prezidentiale",1,344,227,193,34,0,226,1,370,143,88,138
3,ARGEŞ,NUCŞOARA,17771,SLATINA,"CĂMIN CULTURAL SLATINA",410,"Alegeri Prezidentiale",1,422,242,216,26,0,236,6,430,188,80,156
3,ARGEŞ,OARJA,17824,OARJA,"ȘCOALA GIMNAZIALĂ ”D. RĂDULESCU” OARJA",411,"Alegeri Prezidentiale",2,1434,874,756,118,0,863,11,1600,726,436,427
3,ARGEŞ,OARJA,17824,OARJA,"ŞCOALA PRIMARĂ OARJA SAT",412,"Alegeri Prezidentiale",1,788,473,412,57,4,462,11,808,335,236,226
3,ARGEŞ,PIETROŞANI,17851,PIETROŞANI,"SALA DE SPORT PIETROŞANI",413,"Alegeri Prezidentiale",1,1438,775,711,64,0,760,15,1600,825,377,383
3,ARGEŞ,PIETROŞANI,17851,BĂDEŞTI,"CĂMIN CULTURAL BĂDEŞTI",414,"Alegeri Prezidentiale",2,1264,673,627,46,0,663,10,1400,727,312,351
3,ARGEŞ,PIETROŞANI,17851,RETEVOIEŞTI,"ŞCOALA GENERALĂ CU CLASELE I-IV RETEVOIEŞTI",415,"Alegeri Prezidentiale",1,1380,631,580,51,0,625,6,1500,869,281,344
3,ARGEŞ,PIETROŞANI,17851,GĂNEŞTI,"ŞCOALAGENERALĂ CU CLASELE I-IV GĂNEŞTI",416,"Alegeri Prezidentiale",1,522,273,245,28,0,272,1,600,327,121,151
3,ARGEŞ,"POIANA LACULUI",18028,"POIANA LACULUI","ŞCOALA CU CLASELE I-VIII POIANA LACULUI",417,"Alegeri Prezidentiale",1,1494,747,649,98,0,745,2,1645,898,399,346
3,ARGEŞ,"POIANA LACULUI",18028,DINCULEŞTI,"ŞCOALA CU CLASELE I-IV DINCULEŞTI",418,"Alegeri Prezidentiale",1,287,168,145,23,0,165,3,320,152,85,80
3,ARGEŞ,"POIANA LACULUI",18028,CĂTUNAŞI,"ŞCOALA CU CLASELE I-IV CĂTUNAŞI",419,"Alegeri Prezidentiale",1,400,281,208,73,0,276,5,440,159,161,115
3,ARGEŞ,"POIANA LACULUI",18028,SĂMARA,"ŞCOALA CU CLASELE I-VIII SĂMARA",420,"Alegeri Prezidentiale",1,762,324,292,32,0,323,1,830,506,194,129
3,ARGEŞ,"POIANA LACULUI",18028,METOFU,"ŞCOALA CU CLASELE I-IV METOFU",421,"Alegeri Prezidentiale",1,286,180,163,17,0,179,1,312,132,55,124
3,ARGEŞ,"POIANA LACULUI",18028,"DEALU VIILOR","ŞCOALA CU CLASELE I-IV DEALUL VIILOR",422,"Alegeri Prezidentiale",1,302,152,137,15,0,152,0,333,181,89,63
3,ARGEŞ,"POIANA LACULUI",18028,"PĂDUROIU DIN DEAL","GRĂDINIŢA PĂDUROIU DIN DEAL",423,"Alegeri Prezidentiale",2,728,356,317,39,0,352,4,800,444,173,179
3,ARGEŞ,"POIANA LACULUI",18028,"PĂDUROIU DIN VALE","GRĂDINIŢA PĂDUROIU DIN VALE",424,"Alegeri Prezidentiale",1,644,291,254,37,0,289,2,705,414,145,144
3,ARGEŞ,"POIANA LACULUI",18028,GĂRDINEŞTI,"ŞCOALA CU CLASELE I-IV GĂRDINEŞTI",425,"Alegeri Prezidentiale",1,377,228,177,51,0,228,0,407,179,95,133
3,ARGEŞ,"POIENARII DE ARGEŞ",17913,POIENARI,"CĂMIN CULTURAL POIENARI",426,"Alegeri Prezidentiale",1,655,487,370,116,1,485,2,700,213,346,139
3,ARGEŞ,"POIENARII DE ARGEŞ",17913,IOANICEŞTI,"ŞCOALA GENERALĂ I-IV IOANICEŞTI",427,"Alegeri Prezidentiale",1,189,120,89,30,1,119,1,200,80,87,32
3,ARGEŞ,"POIENARII DE MUSCEL",17968,POIENARI,"ŞCOALA GIMNAZIALA NR.1 POIENARII DE MUSCEL",428,"Alegeri Prezidentiale",1,1207,524,481,43,0,520,4,1200,676,231,289
3,ARGEŞ,"POIENARII DE MUSCEL",17968,JUGUR,"ŞCOALA PRIMARĂ NR.1 JUGUR",429,"Alegeri Prezidentiale",1,909,410,381,29,0,408,2,1000,590,177,231
3,ARGEŞ,"POIENARII DE MUSCEL",17968,GROŞANI,"GRĂDINIŢA CU PROGRAM NORMAL NR.2 GROŞANI",430,"Alegeri Prezidentiale",1,614,293,270,23,0,288,5,800,507,151,137
3,ARGEŞ,POPEŞTI,18162,POPEŞTI,"ŞCOALA POPEŞTI",431,"Alegeri Prezidentiale",1,488,274,191,83,0,270,4,600,326,74,196
3,ARGEŞ,POPEŞTI,18162,SLOBOZIA,"ŞCOALA SLOBOZIA",432,"Alegeri Prezidentiale",1,548,285,226,59,0,284,1,600,315,58,226
3,ARGEŞ,POPEŞTI,18162,PURCĂRENI,"ŞCOALA PURCĂRENI",433,"Alegeri Prezidentiale",1,558,299,247,52,0,298,1,600,301,48,250
3,ARGEŞ,PRIBOIENI,18242,PRIBOIENI,"ȘCOALA GIMNAZIALĂ ”C. RĂDULESCU CODIN”",434,"Alegeri Prezidentiale",1,1418,884,829,55,0,869,15,1600,716,346,523
3,ARGEŞ,PRIBOIENI,18242,PRIBOIENI,"CLUBUL TINERETULUI PRIBOIENI",435,"Alegeri Prezidentiale",1,1548,963,908,55,0,946,17,1700,737,391,555
3,ARGEŞ,RĂTEŞTI,18331,TIGVENI,"CĂMINUL CULTURAL TIGVENI",436,"Alegeri Prezidentiale",1,666,336,289,47,0,332,4,700,364,133,199
3,ARGEŞ,RĂTEŞTI,18331,FURDUEŞTI,"ŞCOALA CU CLASELE I-IV FURDUEŞTI",437,"Alegeri Prezidentiale",1,429,207,181,26,0,203,4,500,293,101,102
3,ARGEŞ,RĂTEŞTI,18331,NEJLOVELU,"ŞCOALA CU CLASELE I-IV NEJLOVELU",438,"Alegeri Prezidentiale",1,399,198,139,59,0,197,1,450,252,81,116
3,ARGEŞ,RĂTEŞTI,18331,PĂTULENI,"ŞCOALA CU CLASELE I-IV PĂTULENI",439,"Alegeri Prezidentiale",1,758,390,349,41,0,384,6,800,410,147,237
3,ARGEŞ,RĂTEŞTI,18331,MAVRODOLU,"ŞCOALA CU CLASELE I-IV MAVRODOLU",440,"Alegeri Prezidentiale",1,131,75,49,26,0,73,2,150,75,34,39
3,ARGEŞ,RÂCA,20048,RÂCA,"CAMINUL CULTURAL RÂCA",441,"Alegeri Prezidentiale",1,833,590,454,136,0,590,0,900,310,50,540
3,ARGEŞ,RECEA,18411,RECEA,"ŞCOALA GENERALA NR. 1 RECEA",442,"Alegeri Prezidentiale",1,1426,773,601,158,14,767,6,1600,827,297,470
3,ARGEŞ,RECEA,18411,"DEAGU DE JOS","ŞCOALA CU CLASELE I-VIII DEAGURILE",443,"Alegeri Prezidentiale",1,760,392,311,70,11,391,1,800,408,117,274
3,ARGEŞ,ROCIU,18475,ROCIU,"GRĂDINIŢA CU PROGRAM NORMAL ”MARIN ANGELESCU”, ROCIU",444,"Alegeri Prezidentiale",1,374,281,163,70,48,274,7,350,69,79,195
3,ARGEŞ,ROCIU,18475,"GLIGANU DE JOS","GRĂDINIŢA CU PROGRAM NORMAL ”THEODOR ANGHEL”, GLIGANU DE JOS",445,"Alegeri Prezidentiale",1,341,281,167,89,25,277,4,350,69,81,196
3,ARGEŞ,ROCIU,18475,"GLIGANU DE SUS","ŞCOALA PRIMARĂ ”ION BĂLTEANU”, GLIGANU DE SUS",446,"Alegeri Prezidentiale",1,545,430,268,102,60,427,3,800,370,122,305
3,ARGEŞ,ROCIU,18475,ŞERBĂNEŞTI,"ŞCOALA GIMNAZIALĂ ”GHEORGHE MOCANU” PRIMAR, GIMNAZIAL, ŞERBĂNEŞTI",447,"Alegeri Prezidentiale",1,797,568,447,81,40,565,3,800,232,204,361
3,ARGEŞ,RUCĂR,18527,RUCĂR,"LICEUL TEHNOLOGIC ” VICTOR SLĂVESCU” - SALA DE SPORT",448,"Alegeri Prezidentiale",1,1271,693,639,52,2,687,6,1400,707,419,268
3,ARGEŞ,RUCĂR,18527,RUCĂR,"ŞCOALA GENERALĂ NR.2 - CLASA NR. 1",449,"Alegeri Prezidentiale",1,1043,638,503,135,0,625,13,1100,462,370,255
3,ARGEŞ,RUCĂR,18527,RUCĂR,"ŞCOALA GIMNAZIALĂ ”NAE A GHICA” - SALA DE SPORT",450,"Alegeri Prezidentiale",1,1000,582,533,49,0,578,4,1100,518,354,224
3,ARGEŞ,RUCĂR,18527,SĂTIC,"ŞCOALA SĂTIC",451,"Alegeri Prezidentiale",1,101,112,41,71,0,110,2,200,88,77,33
3,ARGEŞ,RUCĂR,18527,RUCĂR,"ȘCOALA GIMNAZIALĂ ”NAE A. GHICA” - SALA CLASĂ PREGĂTITOARE",452,"Alegeri Prezidentiale",1,1447,819,753,66,0,805,14,1500,681,500,305
3,ARGEŞ,SĂLĂTRUCU,18554,SĂLĂTRUCU,"CĂMINUL CULTURAL SĂLĂTRUCU CENTRU",453,"Alegeri Prezidentiale",1,1220,601,551,49,1,596,5,1300,699,293,303
3,ARGEŞ,SĂLĂTRUCU,18554,VĂLENI,"ŞCOALA CU CLASELE I-IV VĂLENI",454,"Alegeri Prezidentiale",1,543,298,260,38,0,288,10,600,302,138,150
3,ARGEŞ,SĂPATA,18581,"DEALU BRADULUI","ŞCOALA GENERALĂ DEALU BRADULUI",455,"Alegeri Prezidentiale",1,155,121,85,36,0,119,2,200,79,53,66
3,ARGEŞ,SĂPATA,18581,POPEŞTI,"CĂMIN CULTURAL POPEŞTI",456,"Alegeri Prezidentiale",1,669,444,342,102,0,434,10,700,256,145,289
3,ARGEŞ,SĂPATA,18581,BĂNĂREŞTI,"ŞCOALA GIMNAZIALĂ DUMITRU UDRESCU SĂPATA",457,"Alegeri Prezidentiale",1,332,235,177,58,0,231,4,360,125,78,153
3,ARGEŞ,SĂPATA,18581,MÂRŢEŞTI,"IMOBIL PROPRIETATE MIU COSMIN",458,"Alegeri Prezidentiale",1,212,155,109,46,0,154,1,240,85,51,103
3,ARGEŞ,"SCHITU GOLEŞTI",18670,"SCHITU GOLEŞTI","ŞCOALA GIMNAZIALĂ NR.1 SCHITU GOLEȘTI",459,"Alegeri Prezidentiale",1,1544,752,689,61,2,738,14,1700,948,352,386
3,ARGEŞ,"SCHITU GOLEŞTI",18670,"VALEA PECHII","GRĂDINIȚA VALEA PECHII",460,"Alegeri Prezidentiale",1,764,382,358,24,0,380,2,800,418,215,165
3,ARGEŞ,"SCHITU GOLEŞTI",18670,LĂZĂREŞTI,"CĂMIN CULTURAL LĂZĂREŞTI",461,"Alegeri Prezidentiale",1,1782,837,767,70,0,827,10,2000,1163,455,372
3,ARGEŞ,SLOBOZIA,18741,SLOBOZIA,"ŞCOALA GEN.NR.2 CLASELE I-IV",462,"Alegeri Prezidentiale",1,1894,719,656,61,2,712,7,2000,1281,239,473
3,ARGEŞ,SLOBOZIA,18741,NIGRIŞOARA,"ŞCOALA NIGRIŞOARA",463,"Alegeri Prezidentiale",1,253,130,109,21,0,130,0,400,270,63,67
3,ARGEŞ,SLOBOZIA,18741,SLOBOZIA,"ȘOALA GENERALĂ DIN CENTRUL COMUNEI",464,"Alegeri Prezidentiale",1,1668,756,665,91,0,748,8,1800,1044,226,522
3,ARGEŞ,STÂLPENI,18778,STÂLPENI,"GRĂDINIŢA CU PROGRAM PRELUNGIT STÎLPENI",465,"Alegeri Prezidentiale",1,1559,904,822,82,0,889,15,1600,696,359,530
3,ARGEŞ,STÂLPENI,18778,LIVEZENI,"ŞCOALA GENERALĂ LIVEZENI",466,"Alegeri Prezidentiale",1,1189,644,600,44,0,623,21,1300,656,278,345
3,ARGEŞ,STÂLPENI,18778,RĂDEŞTI,"CAMINUL CULTURAL RĂDEŞTI",467,"Alegeri Prezidentiale",1,1388,874,780,94,0,859,15,1600,726,381,478
3,ARGEŞ,STOENEŞTI,18858,STOENEŞTI,"CĂMIN CULTURAL STOENEŞTI",468,"Alegeri Prezidentiale",1,1065,580,487,93,0,574,6,1199,619,350,224
3,ARGEŞ,STOENEŞTI,18858,BĂDENI,"CĂMIN CULTURAL BĂDENI",469,"Alegeri Prezidentiale",1,1441,672,605,67,0,665,7,1500,828,350,315
3,ARGEŞ,STOENEŞTI,18858,PIATRA,"CĂMIN CULTURAL PIATRA",470,"Alegeri Prezidentiale",1,414,210,189,21,0,207,3,500,290,101,106
3,ARGEŞ,STOENEŞTI,18858,"VALEA BĂDENILOR","ŞCOALA GEN. VALEA BĂDENILOR",471,"Alegeri Prezidentiale",1,616,340,324,16,0,335,5,699,359,110,225
3,ARGEŞ,STOLNICI,18938,STOLNICI,"GRĂDINIȚA CU PROGRAM NORMAL STOLNICI",472,"Alegeri Prezidentiale",1,1475,583,484,99,0,579,4,1600,1017,148,431
3,ARGEŞ,STOLNICI,18938,FÂLFANI,"CĂMINUL CULTURAL FÎLFANI",473,"Alegeri Prezidentiale",1,1006,446,312,134,0,442,4,1100,654,176,266
3,ARGEŞ,SUSENI,19007,CERŞANI,"ŞCOALA PRIMARĂ IOAN RIZESCU",474,"Alegeri Prezidentiale",1,615,352,281,71,0,347,5,700,348,171,176
3,ARGEŞ,SUSENI,19007,SUSENI,"PRIMĂRIA COMUNEI SUSENI",475,"Alegeri Prezidentiale",1,883,487,394,93,0,478,9,1000,513,271,207
3,ARGEŞ,SUSENI,19007,ŢUŢULEŞTI,"ŞCOALA PRIMARĂ GHEOGHE TOMA",476,"Alegeri Prezidentiale",1,1033,577,471,106,0,566,11,1100,523,293,273
3,ARGEŞ,"ŞTEFAN CEL MARE",19114,"ŞTEFAN CEL MARE","ŞCOALA CU CLASELE I-VIII ŞTEFAN CEL MARE",477,"Alegeri Prezidentiale",1,699,301,262,39,0,299,2,800,499,98,201
3,ARGEŞ,"ŞTEFAN CEL MARE",19114,"ŞTEFAN CEL MARE","ŞCOALA CU CLASELE I-VIII ŞTEFAN CEL MARE",478,"Alegeri Prezidentiale",1,830,400,368,32,0,399,1,800,400,154,245
3,ARGEŞ,"ŞTEFAN CEL MARE",19114,GLAVACIOC,"ŞCOALA GLAVACIOC",479,"Alegeri Prezidentiale",1,353,166,132,34,0,163,3,500,334,53,110
3,ARGEŞ,ŞUICI,19141,ŞUICI,"CĂMIN CULTURAL ŞUICI",480,"Alegeri Prezidentiale",1,990,550,470,61,19,541,9,1000,450,278,263
3,ARGEŞ,ŞUICI,19141,RUDENI,"ŞCOALA PRIMARĂ RUDENI",481,"Alegeri Prezidentiale",1,681,374,347,27,0,373,1,800,426,209,164
3,ARGEŞ,ŞUICI,19141,IANCULEŞTI,"ŞCOALA IANCULEŞTI",482,"Alegeri Prezidentiale",1,226,125,108,17,0,124,1,300,175,65,59
3,ARGEŞ,ŞUICI,19141,"VALEA CALULUI","ŞCOALA PRIMARĂ VALEA CALULUI",483,"Alegeri Prezidentiale",1,80,58,44,14,0,57,1,100,42,21,36
3,ARGEŞ,TEIU,19212,TEIU,"CĂMIN CULTURAL TEIU",484,"Alegeri Prezidentiale",1,938,595,437,157,1,591,4,1000,405,157,434
3,ARGEŞ,TEIU,19212,LEŞILE,"ŞCOALA GENERALĂ LEŞILE",485,"Alegeri Prezidentiale",1,151,111,72,39,0,106,5,200,89,38,68
3,ARGEŞ,TIGVENI,19249,TIGVENI,"PRIMĂRIA TIGVENI",486,"Alegeri Prezidentiale",1,1506,720,648,72,0,708,12,1600,880,300,408
3,ARGEŞ,TIGVENI,19249,"BÂRSEŞTII DE JOS","ȘCOALA CU CLASELE I-IV BÎRSEȘTII DE JOS",487,"Alegeri Prezidentiale",1,1004,460,400,60,0,453,7,1100,640,223,230
3,ARGEŞ,TIGVENI,19249,VLĂDEŞTI,"ŞCOALA CU CLASELE I-IV VLĂDEŞTI",488,"Alegeri Prezidentiale",1,198,112,87,25,0,112,0,300,188,34,78
3,ARGEŞ,ŢIŢEŞTI,19338,BUCŞENEŞTI-LOTAŞI,"PRIMĂRIA COMUNEI ȚIȚEȘTI",489,"Alegeri Prezidentiale",1,1262,667,595,69,3,657,10,1400,733,412,245
3,ARGEŞ,ŢIŢEŞTI,19338,"VALEA STÂNII","ȘCOALA CU CLASELE I-IV VALEA STÂNII",490,"Alegeri Prezidentiale",1,861,529,467,58,4,527,2,900,371,286,241
3,ARGEŞ,ŢIŢEŞTI,19338,ŢIŢEŞTI,"ȘCOALA CU CLASELE I-IV ȚIȚEȘTI",491,"Alegeri Prezidentiale",1,1009,479,450,28,1,472,7,1100,621,294,178
3,ARGEŞ,ŢIŢEŞTI,19338,"VALEA MĂNĂSTIRII","ȘCOALA CU CLASELE I-IV VALEA MĂNĂSTIRII",492,"Alegeri Prezidentiale",1,795,310,281,29,0,302,8,900,590,221,81
3,ARGEŞ,UDA,19392,UDA,"ŞCOALA I-VIII UDA",493,"Alegeri Prezidentiale",1,529,274,213,61,0,272,2,560,286,138,134
3,ARGEŞ,UDA,19392,COTU,"ŞCOALA COTU",494,"Alegeri Prezidentiale",1,198,186,114,72,0,183,3,230,44,111,72
3,ARGEŞ,UDA,19392,SĂLIŞTEA,"ŞCOALA I - IV SĂLIŞTEA",495,"Alegeri Prezidentiale",1,452,255,179,76,0,253,2,485,230,150,103
3,ARGEŞ,UDA,19392,RÂJLEŢU-GOVORA,"CĂMIN CULTURAL GOVORA",496,"Alegeri Prezidentiale",1,393,208,152,56,0,207,1,425,217,103,104
3,ARGEŞ,UNGHENI,19560,UNGHENI,"ŞCOALA CU CLASELE I-VIII UNGHENI",497,"Alegeri Prezidentiale",1,589,340,261,79,0,334,6,650,310,126,208
3,ARGEŞ,UNGHENI,19560,COLŢU,"ŞCOALA COLŢU",498,"Alegeri Prezidentiale",1,579,371,286,85,0,367,4,650,279,55,312
3,ARGEŞ,UNGHENI,19560,HUMELE,"SOCIETATEA AGRICOLA ALBINA",499,"Alegeri Prezidentiale",1,1081,530,413,117,0,526,4,1200,670,145,381
3,ARGEŞ,"VALEA DANULUI",19631,"VALEA DANULUI","CĂMINUL CULTURAL VALEA DANULUI",500,"Alegeri Prezidentiale",1,1643,925,845,80,0,917,8,1800,875,563,354
3,ARGEŞ,"VALEA DANULUI",19631,VERNEŞTI,"CĂMINUL CULTURAL VERNEŞTI",501,"Alegeri Prezidentiale",1,891,525,472,53,0,522,3,1000,475,291,231
3,ARGEŞ,"VALEA IAŞULUI",19695,"VALEA IAŞULUI","ŞCOALA GIMNAZIALĂ VALEA IAŞULUI",502,"Alegeri Prezidentiale",1,832,471,376,34,61,461,10,1000,529,248,213
3,ARGEŞ,"VALEA IAŞULUI",19695,BOROVINEŞTI,"PENSIUNEA ”VALEA BĂDILII”",503,"Alegeri Prezidentiale",1,188,102,81,21,0,102,0,200,98,62,40
3,ARGEŞ,"VALEA IAŞULUI",19695,MUSTĂŢEŞTI,"ŞCOALA PRIMARĂ MUSTĂTEŞTI",504,"Alegeri Prezidentiale",1,1052,541,509,32,0,528,13,1100,559,300,228
3,ARGEŞ,"VALEA IAŞULUI",19695,CERBURENI,"GRĂDINIŢA CERBURENI",505,"Alegeri Prezidentiale",1,304,150,136,14,0,148,2,300,150,85,63
3,ARGEŞ,"VALEA MARE-PRAVĂŢ",13524,"VALEA MARE-PRAVĂŢ","CĂMIN CULTURAL VALEA MARE PRAVĂŢ",506,"Alegeri Prezidentiale",1,1240,683,623,58,2,675,8,1400,717,374,301
3,ARGEŞ,"VALEA MARE-PRAVĂŢ",13524,NĂMĂEŞTI,"CĂMIN CULTURAL NĂMĂEŞTI",507,"Alegeri Prezidentiale",1,486,339,272,67,0,333,6,700,361,175,158
3,ARGEŞ,"VALEA MARE-PRAVĂŢ",13524,BILCEŞTI,"ŞCOALA BILCEŞTI",508,"Alegeri Prezidentiale",1,688,317,300,17,0,313,4,700,383,194,119
3,ARGEŞ,"VALEA MARE-PRAVĂŢ",13524,"GURA PRAVĂŢ","ŞCOALA GURA PRAVĂŢ",509,"Alegeri Prezidentiale",1,909,523,505,18,0,511,12,900,377,123,388
3,ARGEŞ,VEDEA,19793,VEDEA,"LICEUL TEHNOLOGIC VEDEA",510,"Alegeri Prezidentiale",1,748,515,298,169,48,510,5,800,285,210,300
3,ARGEŞ,VEDEA,19793,VAŢA,"ŞCOALA VAŢA",511,"Alegeri Prezidentiale",1,509,337,237,100,0,335,2,600,263,169,166
3,ARGEŞ,VEDEA,19793,PRODANI,"ŞCOALA PRODANI",512,"Alegeri Prezidentiale",1,595,314,262,50,2,311,3,599,285,116,195
3,ARGEŞ,VEDEA,19793,FATA,"ŞCOALA FATA",513,"Alegeri Prezidentiale",1,451,257,196,61,0,255,2,501,244,80,175
3,ARGEŞ,VEDEA,19793,"IZVORU DE SUS","ŞCOALA IZVORU DE SUS",514,"Alegeri Prezidentiale",1,279,153,112,39,2,151,2,300,147,45,106
3,ARGEŞ,VEDEA,19793,FRĂTICI,"ŞCOALA FRĂTICI",515,"Alegeri Prezidentiale",1,351,205,168,36,1,201,4,400,195,86,115
3,ARGEŞ,VLĂDEŞTI,19999,VLĂDEŞTI,"GRĂDINIŢA NR. 3",516,"Alegeri Prezidentiale",1,1682,874,812,62,0,862,12,1800,926,432,430
3,ARGEŞ,VLĂDEŞTI,19999,VLĂDEŞTI,"ŞCOALA PRIMARĂ NR. 2",517,"Alegeri Prezidentiale",1,872,419,392,27,0,414,5,1000,581,176,238
3,ARGEŞ,VULTUREŞTI,20055,VULTUREŞTI,"PRIMĂRIA VULTUREȘTI",518,"Alegeri Prezidentiale",1,1560,676,619,57,0,664,12,1650,974,339,325
3,ARGEŞ,VULTUREŞTI,20055,BÂRZEŞTI,"CĂMINUL CULTURAL BÂRZEȘTI",519,"Alegeri Prezidentiale",1,465,274,240,34,0,266,8,550,276,139,127
3,ARGEŞ,VULTUREŞTI,20055,HULUBA,"ȘCOALA PRIMARĂ HULUBA",520,"Alegeri Prezidentiale",1,176,143,113,30,0,142,1,200,57,100,42
4,BACĂU,"MUNICIPIUL BACĂU",20297,BACĂU,"ŞCOALA GIMNAZIALĂ NR. 9",1,"Alegeri Prezidentiale",1,1250,610,568,42,0,596,14,1400,790,439,157
4,BACĂU,"MUNICIPIUL BACĂU",20297,BACĂU,"ŞCOALA GIMNAZIALĂ NR. 9",2,"Alegeri Prezidentiale",1,1129,629,543,86,0,616,13,1200,571,456,160
4,BACĂU,"MUNICIPIUL BACĂU",20297,BACĂU,"ȘCOALA GIMNAZIALĂ ”GEORGETA MIRCEA CANCICOV”",3,"Alegeri Prezidentiale",1,1556,682,629,53,0,662,20,1700,1018,509,153
4,BACĂU,"MUNICIPIUL BACĂU",20297,BACĂU,"ȘCOALA GIMNAZIALĂ ”GEORGETA MIRCEA CANCICOV”",4,"Alegeri Prezidentiale",1,1550,684,622,62,0,669,15,1700,1016,484,185
4,BACĂU,"MUNICIPIUL BACĂU",20297,BACĂU,"ȘCOALA GIMNAZIALĂ ”GEORGETA MIRCEA CANCICOV”",5,"Alegeri Prezidentiale",2,1486,687,647,40,0,670,17,1600,913,440,230
4,BACĂU,"MUNICIPIUL BACĂU",20297,BACĂU,"ȘCOALA GIMNAZIALĂ ”GEORGETA MIRCEA CANCICOV”",6,"Alegeri Prezidentiale",1,1454,727,672,55,0,703,24,1600,873,483,220
4,BACĂU,"MUNICIPIUL BACĂU",20297,BACĂU,"DIRECȚIA DE ASISTENTĂ SOCIALĂ",7,"Alegeri Prezidentiale",1,1369,716,609,107,0,696,20,1500,784,504,192
4,BACĂU,"MUNICIPIUL BACĂU",20297,BACĂU,"GRĂDINIȚA CU PROGRAM PRELUNGIT ”CRAI NOU”",8,"Alegeri Prezidentiale",1,1097,484,420,64,0,476,8,1200,716,368,108
4,BACĂU,"MUNICIPIUL BACĂU",20297,BACĂU,"GRĂDINIȚA CU PROGRAM PRELUNGIT ”CRAI NOU”",9,"Alegeri Prezidentiale",1,1088,500,438,62,0,490,10,1200,700,383,107
4,BACĂU,"MUNICIPIUL BACĂU",20297,BACĂU,"ȘCOALA GIMNAZIALĂ ”MIHAIL SADOVEANU”",10,"Alegeri Prezidentiale",1,1402,599,558,40,1,591,8,1500,901,443,148
4,BACĂU,"MUNICIPIUL BACĂU",20297,BACĂU,"ȘCOALA GIMNAZIALĂ ”MIHAIL SADOVEANU”",11,"Alegeri Prezidentiale",2,1388,575,531,44,0,568,7,1500,925,426,142
4,BACĂU,"MUNICIPIUL BACĂU",20297,BACĂU,"ȘCOALA GIMNAZIALĂ ”MIHAIL SADOVEANU”",12,"Alegeri Prezidentiale",1,1377,612,573,38,1,603,9,1500,888,423,180
4,BACĂU,"MUNICIPIUL BACĂU",20297,BACĂU,"ȘCOALA GIMNAZIALĂ ”MIHAIL SADOVEANU”",13,"Alegeri Prezidentiale",1,1529,732,648,84,0,725,7,1600,868,595,130
4,BACĂU,"MUNICIPIUL BACĂU",20297,BACĂU,"GRĂDINIŢA CU PROGRAM NORMAL NR. 4",14,"Alegeri Prezidentiale",1,1224,527,497,30,0,515,12,1300,773,373,142
4,BACĂU,"MUNICIPIUL BACĂU",20297,BACĂU,"GRĂDINIŢA CU PROGRAM NORMAL NR. 4",15,"Alegeri Prezidentiale",1,1216,539,520,18,1,521,18,1300,761,363,158
4,BACĂU,"MUNICIPIUL BACĂU",20297,BACĂU,"ȘCOALA GIMNAZIALĂ ”MIHAI DRĂGAN”",16,"Alegeri Prezidentiale",1,1251,640,576,64,0,618,22,1400,760,435,183
4,BACĂU,"MUNICIPIUL BACĂU",20297,BACĂU,"ȘCOALA GIMNAZIALĂ ”MIHAI DRĂGAN”",17,"Alegeri Prezidentiale",1,1236,584,559,25,0,568,16,1400,816,368,200
4,BACĂU,"MUNICIPIUL BACĂU",20297,BACĂU,"ȘCOALA GIMNAZIALĂ ”MIHAI DRĂGAN”",18,"Alegeri Prezidentiale",1,1739,158,109,49,0,151,7,1900,1742,110,41
4,BACĂU,"MUNICIPIUL BACĂU",20297,BACĂU,"ȘCOALA GIMNAZIALĂ ”MIHAI DRĂGAN” BACĂU",19,"Alegeri Prezidentiale",1,1454,682,637,45,0,661,21,1600,918,442,219
4,BACĂU,"MUNICIPIUL BACĂU",20297,BACĂU,"ȘCOALA GIMNAZIALĂ ”MIHAI DRĂGAN” BACĂU",20,"Alegeri Prezidentiale",1,1441,683,650,33,0,669,14,1600,917,450,219
4,BACĂU,"MUNICIPIUL BACĂU",20297,BACĂU,"ADMINISTRAȚIA FINANȚELOR PUBLICE BACĂU",21,"Alegeri Prezidentiale",1,992,464,429,35,0,452,12,1100,636,265,187
4,BACĂU,"MUNICIPIUL BACĂU",20297,BACĂU,"COLEGIUL NAŢIONAL ”GHEORGHE VRÂNCEANU”",22,"Alegeri Prezidentiale",1,1416,813,732,81,0,792,21,1503,690,576,216
4,BACĂU,"MUNICIPIUL BACĂU",20297,BACĂU,"COLEGIUL NAŢIONAL ”GHEORGHE VRÂNCEANU”",23,"Alegeri Prezidentiale",1,1276,619,566,52,1,605,14,1400,781,440,165
4,BACĂU,"MUNICIPIUL BACĂU",20297,BACĂU,"ŞCOALA GIMNAZIALĂ ”ALEXANDRU IOAN CUZA”",24,"Alegeri Prezidentiale",1,1214,713,614,99,0,694,19,1300,587,408,286
4,BACĂU,"MUNICIPIUL BACĂU",20297,BACĂU,"COLEGIUL NAŢIONAL ”FERDINAND I”",25,"Alegeri Prezidentiale",1,1206,630,533,75,22,613,17,1300,670,413,200
4,BACĂU,"MUNICIPIUL BACĂU",20297,BACĂU,"COLEGIUL NAŢIONAL ”FERDINAND I”",26,"Alegeri Prezidentiale",1,976,485,433,29,23,482,3,1100,615,311,171
4,BACĂU,"MUNICIPIUL BACĂU",20297,BACĂU,"COLEGIUL NAŢIONAL ”FERDINAND I”",27,"Alegeri Prezidentiale",1,1515,697,666,31,0,680,17,1700,1003,433,247
4,BACĂU,"MUNICIPIUL BACĂU",20297,BACĂU,"COLEGIUL NAȚIONAL ”FERDINAND I”",28,"Alegeri Prezidentiale",1,1575,811,761,50,0,788,23,1700,889,512,276
4,BACĂU,"MUNICIPIUL BACĂU",20297,BACĂU,"DIRECŢIA PENTRU AGRICULTURĂ BACĂU",29,"Alegeri Prezidentiale",1,1492,731,692,39,0,719,12,1600,869,545,174
4,BACĂU,"MUNICIPIUL BACĂU",20297,BACĂU,"GRADINITA CU PROGRAM PRELUNGIT NR.29",30,"Alegeri Prezidentiale",1,1246,599,552,47,0,585,14,1400,801,409,176
4,BACĂU,"MUNICIPIUL BACĂU",20297,BACĂU,"GRADINITA CU PROGRAM PRELUNGIT NR.29",31,"Alegeri Prezidentiale",1,1054,525,494,30,1,514,11,1100,575,377,137
4,BACĂU,"MUNICIPIUL BACĂU",20297,BACĂU,"GRADINITA CU PROGRAM PRELUNGIT NR.29",32,"Alegeri Prezidentiale",1,1121,528,490,38,0,515,13,1200,672,325,190
4,BACĂU,"MUNICIPIUL BACĂU",20297,BACĂU,"GRĂDINIŢA CU PROGRAM NORMAL NR.26",33,"Alegeri Prezidentiale",2,1211,565,526,38,1,550,15,1300,735,365,185
4,BACĂU,"MUNICIPIUL BACĂU",20297,BACĂU,"ȘCOALA GIMNAZIALĂ ”ION CREANGĂ”",34,"Alegeri Prezidentiale",1,1385,613,582,31,0,603,10,1499,886,408,195
4,BACĂU,"MUNICIPIUL BACĂU",20297,BACĂU,"ȘCOALA GIMNAZIALĂ ”ION CREANGĂ”",35,"Alegeri Prezidentiale",1,1422,681,629,52,0,675,6,1600,919,512,163
4,BACĂU,"MUNICIPIUL BACĂU",20297,BACĂU,"ȘCOALA GIMNAZIALĂ ”ION CREANGĂ”",36,"Alegeri Prezidentiale",1,1260,695,639,56,0,673,22,1400,705,484,189
4,BACĂU,"MUNICIPIUL BACĂU",20297,BACĂU,"COLEGIUL TEHNIC DE COMUNICAȚII ”NICOLAE VASILESCU-KARPEN”",37,"Alegeri Prezidentiale",2,1600,832,728,104,0,815,17,1800,968,564,251
4,BACĂU,"MUNICIPIUL BACĂU",20297,BACĂU,"COLEGIUL TEHNIC DE COMUNICAȚII ”NICOLAE VASILESCU-KARPEN”",38,"Alegeri Prezidentiale",1,1750,787,730,57,0,774,13,1900,1113,515,259
4,BACĂU,"MUNICIPIUL BACĂU",20297,BACĂU,"COLEGIUL TEHNIC DE COMUNICAȚII ”NICOLAE VASILESCU-KARPEN”",39,"Alegeri Prezidentiale",1,1644,230,186,44,0,221,9,1800,1570,153,68
4,BACĂU,"MUNICIPIUL BACĂU",20297,BACĂU,"COLEGIUL TEHNIC DE COMUNICAȚII ”NICOLAE VASILESCU-KARPEN”",40,"Alegeri Prezidentiale",1,1648,784,738,46,0,763,21,1800,1016,544,219
4,BACĂU,"MUNICIPIUL BACĂU",20297,BACĂU,"COLEGIUL TEHNIC ”ANGHEL SALIGNY” - CORPUL F",41,"Alegeri Prezidentiale",1,1440,790,621,67,102,779,11,1600,810,477,302
4,BACĂU,"MUNICIPIUL BACĂU",20297,BACĂU,"COLEGIUL TEHNIC ”ANGHEL SALIGNY” - CORPUL F",42,"Alegeri Prezidentiale",1,1319,666,546,22,98,651,15,1400,734,369,282
4,BACĂU,"MUNICIPIUL BACĂU",20297,BACĂU,"COLEGIUL ”MIHAI EMINESCU”",43,"Alegeri Prezidentiale",1,1095,736,529,109,98,718,18,1200,464,410,308
4,BACĂU,"MUNICIPIUL BACĂU",20297,BACĂU,"COLEGIUL ”MIHAI EMINESCU”",44,"Alegeri Prezidentiale",1,1419,652,509,43,100,634,18,1500,848,323,311
4,BACĂU,"MUNICIPIUL BACĂU",20297,BACĂU,"SCOALA GIMNAZIALĂ ”ALEXANDRU CEL BUN”",45,"Alegeri Prezidentiale",2,1268,649,615,34,0,631,18,1400,751,405,226
4,BACĂU,"MUNICIPIUL BACĂU",20297,BACĂU,"GRĂDINIŢA CU PROGRAM PRELUNGIT NR.12",46,"Alegeri Prezidentiale",1,1019,464,425,39,0,451,13,1100,636,254,197
4,BACĂU,"MUNICIPIUL BACĂU",20297,BACĂU,"COLEGIUL NATIONAL ”VASILE ALECSANDRI”",47,"Alegeri Prezidentiale",1,891,464,407,56,1,454,10,1000,536,303,151
4,BACĂU,"MUNICIPIUL BACĂU",20297,BACĂU,"COLEGIUL NATIONAL ”VASILE ALECSANDRI”",48,"Alegeri Prezidentiale",1,868,466,409,56,1,456,10,900,434,298,158
4,BACĂU,"MUNICIPIUL BACĂU",20297,BACĂU,"COLEGIUL NAȚIONAL DE ARTĂ ”GEORGE APOSTU”",49,"Alegeri Prezidentiale",1,753,451,386,64,1,438,13,800,349,271,167
4,BACĂU,"MUNICIPIUL BACĂU",20297,BACĂU,"COLEGIUL NAȚIONAL PEDAGOGIC ”ŞTEFAN CEL MARE”",50,"Alegeri Prezidentiale",1,1335,829,598,147,84,810,19,1486,657,555,255
4,BACĂU,"MUNICIPIUL BACĂU",20297,BACĂU,"COLEGIUL NAȚIONAL PEDAGOGIC ”ŞTEFAN CEL MARE”",51,"Alegeri Prezidentiale",2,1474,942,615,94,233,918,24,1600,658,574,344
4,BACĂU,"MUNICIPIUL BACĂU",20297,BACĂU,"ŞCOALA GIMNAZIALĂ ”GEORGE BACOVIA”",52,"Alegeri Prezidentiale",2,1254,619,581,38,0,608,11,1400,781,416,192
4,BACĂU,"MUNICIPIUL BACĂU",20297,BACĂU,"ŞCOALA GIMNAZIALĂ ”GEORGE BACOVIA”",53,"Alegeri Prezidentiale",1,1289,569,534,35,0,555,14,1399,830,349,206
4,BACĂU,"MUNICIPIUL BACĂU",20297,BACĂU,"ȘCOALA GIMNAZIALĂ ”GEORGE BACOVIA”",54,"Alegeri Prezidentiale",1,1247,515,470,45,0,507,8,1400,885,324,183
4,BACĂU,"MUNICIPIUL BACĂU",20297,BACĂU,"GRĂDINIŢA CU PROGRAM PRELUNGIT NR.28",55,"Alegeri Prezidentiale",2,1048,587,516,70,1,569,18,1100,513,348,221
4,BACĂU,"MUNICIPIUL BACĂU",20297,BACĂU,"GRĂDINIŢA CU PROGRAM PRELUNGIT NR.28",56,"Alegeri Prezidentiale",1,1213,522,480,42,0,516,6,1300,778,354,162
4,BACĂU,"MUNICIPIUL BACĂU",20297,BACĂU,"ŞCOALA GIMNAZIALĂ ”DOMNIȚA MARIA”",57,"Alegeri Prezidentiale",1,1512,742,660,82,0,716,26,1700,958,439,277
4,BACĂU,"MUNICIPIUL BACĂU",20297,BACĂU,"ŞCOALA GIMNAZIALĂ ”DOMNIȚA MARIA”",58,"Alegeri Prezidentiale",1,1242,595,542,53,0,572,23,1398,803,400,172
4,BACĂU,"MUNICIPIUL BACĂU",20297,BACĂU,"ŞCOALA GIMNAZIALĂ ”DOMNIȚA MARIA”",59,"Alegeri Prezidentiale",1,1416,660,641,19,0,647,13,1500,840,425,222
4,BACĂU,"MUNICIPIUL BACĂU",20297,BACĂU,"ŞCOALA GIMNAZIALĂ ”DOMNIȚA MARIA”",60,"Alegeri Prezidentiale",1,1350,638,566,72,0,625,13,1500,862,426,199
4,BACĂU,"MUNICIPIUL BACĂU",20297,BACĂU,"ŞCOALA GIMNAZIALĂ ”DOMNIȚA MARIA”",61,"Alegeri Prezidentiale",2,1577,842,807,35,0,812,30,1700,858,571,241
4,BACĂU,"MUNICIPIUL BACĂU",20297,BACĂU,"ȘCOALA GIMNAZIALĂ ”DR.ALEXANDRU ŞAFRAN”",62,"Alegeri Prezidentiale",1,1833,629,547,82,0,620,9,1900,1271,436,184
4,BACĂU,"MUNICIPIUL BACĂU",20297,BACĂU,"ȘCOALA GIMNAZIALĂ ”DR.ALEXANDRU ŞAFRAN”",63,"Alegeri Prezidentiale",1,1749,660,626,34,0,650,10,1900,1240,414,236
4,BACĂU,"MUNICIPIUL BACĂU",20297,BACĂU,"GRADINITA CU PROGRAM PRELUNGIT NR.24",64,"Alegeri Prezidentiale",1,1374,680,618,61,1,664,16,1500,820,424,240
4,BACĂU,"MUNICIPIUL BACĂU",20297,BACĂU,"COLEGIUL „GRIGORE ANTIPA”",65,"Alegeri Prezidentiale",1,1402,621,559,62,0,609,12,1500,879,409,200
4,BACĂU,"MUNICIPIUL BACĂU",20297,BACĂU,"COLEGIUL „GRIGORE ANTIPA”",66,"Alegeri Prezidentiale",1,1430,664,612,52,0,653,11,1600,936,434,219
4,BACĂU,"MUNICIPIUL BACĂU",20297,BACĂU,"CLĂDIRE CĂMIN (CARE A APARȚINUT FOSTULUI COLEGIU TEHNIC ”LETEA”",67,"Alegeri Prezidentiale",1,1719,730,686,44,0,707,23,1900,1170,483,224
4,BACĂU,"MUNICIPIUL BACĂU",20297,BACĂU,"CLĂDIRE CĂMIN (CARE A APARȚINUT FOSTULUI COLEGIU TEHNIC ”LETEA”",68,"Alegeri Prezidentiale",1,1566,652,625,26,1,639,13,1700,1048,418,221
4,BACĂU,"MUNICIPIUL BACĂU",20297,BACĂU,"CLĂDIRE CĂMIN (CARE A APARȚINUT FOSTULUI COLEGIU TEHNIC ”LETEA”",69,"Alegeri Prezidentiale",1,1663,684,657,27,0,673,11,1800,1116,439,234
4,BACĂU,"MUNICIPIUL BACĂU",20297,BACĂU,"ŞCOALA GIMNAZIALĂ NR.10",70,"Alegeri Prezidentiale",1,1331,687,659,28,0,678,9,1400,713,393,285
4,BACĂU,"MUNICIPIUL BACĂU",20297,BACĂU,"ȘCOALA GIMNAZIALĂ NR.10",71,"Alegeri Prezidentiale",1,1233,652,590,61,1,634,18,1300,648,389,245
4,BACĂU,"MUNICIPIUL BACĂU",20297,BACĂU,"ȘCOALA GIMNAZIALĂ NR.10",72,"Alegeri Prezidentiale",1,792,484,399,85,0,474,10,900,416,341,133
4,BACĂU,"MUNICIPIUL BACĂU",20297,BACĂU,"COLEGIUL TEHNIC ”DUMITRU MANGERON”",73,"Alegeri Prezidentiale",1,1625,625,509,116,0,618,7,1800,1175,444,174
4,BACĂU,"MUNICIPIUL BACĂU",20297,BACĂU,"COLEGIUL TEHNIC ”DUMITRU MANGERON”",74,"Alegeri Prezidentiale",1,1775,603,575,28,0,592,11,1900,1297,420,172
4,BACĂU,"MUNICIPIUL BACĂU",20297,BACĂU,"ŞCOALA PRIMARĂ NR.1",75,"Alegeri Prezidentiale",1,1871,421,393,28,0,412,9,2100,1679,267,145
4,BACĂU,"MUNICIPIUL BACĂU",20297,BACĂU,"ŞCOALA PRIMARĂ NR.1",76,"Alegeri Prezidentiale",1,1693,403,380,23,0,390,13,1900,1497,277,113
4,BACĂU,"MUNICIPIUL BACĂU",20297,BACĂU,"SCOALA GIMNAZIALĂ ”OCTAVIAN VOICU”",77,"Alegeri Prezidentiale",1,1127,498,436,62,0,495,3,1200,702,341,154
4,BACĂU,"MUNICIPIUL BACĂU",20297,BACĂU,"SCOALA GIMNAZIALĂ ”OCTAVIAN VOICU”",78,"Alegeri Prezidentiale",1,1043,463,431,32,0,448,15,1100,637,315,133
4,BACĂU,"MUNICIPIUL BACĂU",20297,BACĂU,"SCOALA GIMNAZIALĂ ”OCTAVIAN VOICU”",79,"Alegeri Prezidentiale",1,1201,527,488,39,0,515,12,1300,773,352,163
4,BACĂU,"MUNICIPIUL BACĂU",20297,BACĂU,"SCOALA GIMNAZIALĂ ”OCTAVIAN VOICU”",80,"Alegeri Prezidentiale",1,1221,498,484,14,0,493,5,1300,802,315,178
4,BACĂU,"MUNICIPIUL BACĂU",20297,BACĂU,"GRĂDINIŢA CU PROGRAM PRELUNGIT ”DUMBRAVA MINUNATĂ”",81,"Alegeri Prezidentiale",1,1237,489,464,25,0,479,10,1400,911,308,171
4,BACĂU,"MUNICIPIUL BACĂU",20297,BACĂU,"GRĂDINIŢA CU PROGRAM PRELUNGIT ”DUMBRAVA MINUNATĂ”",82,"Alegeri Prezidentiale",1,1124,475,433,42,0,464,11,1200,725,349,115
4,BACĂU,"MUNICIPIUL BACĂU",20297,BACĂU,"GRĂDINIŢA CU PROGRAM PRELUNGIT NR.31",83,"Alegeri Prezidentiale",2,1090,497,456,41,0,480,17,1200,703,303,177
4,BACĂU,"MUNICIPIUL BACĂU",20297,BACĂU,"ŞCOALA GIMNAZIALĂ ”NICOLAE IORGA”",84,"Alegeri Prezidentiale",1,1306,614,549,65,0,605,9,1400,786,403,202
4,BACĂU,"MUNICIPIUL BACĂU",20297,BACĂU,"ŞCOALA GIMNAZIALĂ ”NICOLAE IORGA”",85,"Alegeri Prezidentiale",1,1135,464,439,25,0,454,10,1300,836,298,156
4,BACĂU,"MUNICIPIUL BACĂU",20297,BACĂU,"ŞCOALA GIMNAZIALĂ ”NICOLAE IORGA”",86,"Alegeri Prezidentiale",1,1379,637,614,22,1,625,12,1500,863,420,205
4,BACĂU,"MUNICIPIUL BACĂU",20297,BACĂU,"ŞCOALA GIMNAZIALĂ ”NICOLAE IORGA”",87,"Alegeri Prezidentiale",1,1441,602,587,14,1,587,15,1600,998,375,212
4,BACĂU,"MUNICIPIUL BACĂU",20297,BACĂU,"GRĂDINIŢA CU PROGRAM PRELUNGIT NR.21 (CORPUL I)",88,"Alegeri Prezidentiale",1,824,469,426,43,0,458,11,900,431,293,165
4,BACĂU,"MUNICIPIUL BACĂU",20297,BACĂU,"UNIVERSITATEA ”VASILE ALECSANDRI” - CORPUL A",89,"Alegeri Prezidentiale",1,977,538,428,110,0,523,15,1100,562,362,161
4,BACĂU,"MUNICIPIUL BACĂU",20297,BACĂU,"UNIVERSITATEA ”VASILE ALECSANDRI” - CORPUL A",90,"Alegeri Prezidentiale",1,863,471,368,102,1,469,2,900,429,333,136
4,BACĂU,"MUNICIPIUL BACĂU",20297,BACĂU,"GRĂDNIŢA CU PROGRAM PRELUNGIT NR.30",91,"Alegeri Prezidentiale",1,1092,492,448,43,1,482,10,1200,708,298,184
4,BACĂU,"MUNICIPIUL BACĂU",20297,BACĂU,"GRĂDNIŢA CU PROGRAM PRELUNGIT NR.30",92,"Alegeri Prezidentiale",1,984,498,452,46,0,484,14,1100,602,292,192
4,BACĂU,"MUNICIPIUL BACĂU",20297,BACĂU,"ŞCOALA GIMNAZIALĂ ”ION LUCA”",93,"Alegeri Prezidentiale",2,948,461,411,50,0,449,12,1000,539,297,152
4,BACĂU,"MUNICIPIUL BACĂU",20297,BACĂU,"ŞCOALA GIMNAZIALĂ ”ION LUCA”",94,"Alegeri Prezidentiale",2,1377,621,578,43,0,611,10,1500,879,405,206
4,BACĂU,"MUNICIPIUL BACĂU",20297,BACĂU,"ŞCOALA GIMNAZIALĂ ”ION LUCA”",95,"Alegeri Prezidentiale",1,1293,550,526,24,0,542,8,1400,850,354,188
4,BACĂU,"MUNICIPIUL BACĂU",20297,BACĂU,"ŞCOALA GIMNAZIALĂ ”ION LUCA”",96,"Alegeri Prezidentiale",1,1128,471,449,22,0,462,9,1200,729,291,171
4,BACĂU,"MUNICIPIUL BACĂU",20297,BACĂU,"GRĂDINIŢA CU PROGRAM PRELUNGIT NR.27",97,"Alegeri Prezidentiale",1,1246,564,515,49,0,556,8,1400,836,379,177
4,BACĂU,"MUNICIPIUL BACĂU",20297,BACĂU,"GRĂDINIŢA CU PROGRAM PRELUNGIT NR.27",98,"Alegeri Prezidentiale",1,1341,574,533,41,0,556,18,1500,926,382,174
4,BACĂU,"MUNICIPIUL BACĂU",20297,BACĂU,"ŞCOALA GIMNAZIALĂ ”ALECU RUSSO”",99,"Alegeri Prezidentiale",1,1738,605,540,65,0,595,10,1900,1295,372,223
4,BACĂU,"MUNICIPIUL BACĂU",20297,BACĂU,"ȘCOALA GIMNAZIALĂ ”ALECU RUSSO”",100,"Alegeri Prezidentiale",1,1652,621,585,36,0,605,16,1800,1179,387,218
4,BACĂU,"MUNICIPIUL BACĂU",20297,BACĂU,"ŞCOALA GIMNAZIALĂ ”ALECU RUSSO”",101,"Alegeri Prezidentiale",1,1319,550,520,28,2,536,14,1400,850,381,155
4,BACĂU,"MUNICIPIUL BACĂU",20297,BACĂU,"BAZINUL OLIMPIC BACĂU",102,"Alegeri Prezidentiale",2,1732,728,668,60,0,712,16,1900,1172,465,247
4,BACĂU,"MUNICIPIUL BACĂU",20297,BACĂU,"BAZINUL OLIMPIC BACĂU",103,"Alegeri Prezidentiale",1,1769,242,212,30,0,240,2,1900,1658,158,82
4,BACĂU,"MUNICIPIUL BACĂU",20297,BACĂU,"UNIVERSITATEA ”GEORGE BACOVIA”",104,"Alegeri Prezidentiale",1,881,393,371,22,0,382,11,1000,607,226,156
4,BACĂU,"MUNICIPIUL BACĂU",20297,BACĂU,"UNIVERSITATEA ”GEORGE BACOVIA”",105,"Alegeri Prezidentiale",1,1453,344,323,21,0,342,2,1600,1256,216,126
4,BACĂU,"MUNICIPIUL BACĂU",20297,BACĂU,"CĂMINUL PENTRU PERSOANE VÂRSTNICE BACĂU",106,"Alegeri Prezidentiale",1,1336,744,621,42,81,725,19,1500,756,423,302
4,BACĂU,"MUNICIPIUL BACĂU",20297,BACĂU,"ŞCOALA GIMNAZIALĂ ”MIRON COSTIN”",107,"Alegeri Prezidentiale",2,1242,513,443,70,0,502,11,1400,887,334,168
4,BACĂU,"MUNICIPIUL BACĂU",20297,BACĂU,"ŞCOALA GIMNAZIALĂ ”MIRON COSTIN”",108,"Alegeri Prezidentiale",1,1381,650,605,45,0,635,15,1500,850,428,207
4,BACĂU,"MUNICIPIUL BACĂU",20297,BACĂU,"ŞCOALA GIMNAZIALĂ ”MIRON COSTIN”",109,"Alegeri Prezidentiale",1,1324,630,603,27,0,609,21,1399,769,359,250
4,BACĂU,"MUNICIPIUL BACĂU",20297,BACĂU,"GRĂDINIŢA CU PROGRAM PRELUNGIT NR.23",110,"Alegeri Prezidentiale",1,1098,460,435,25,0,453,7,1200,740,285,168
4,BACĂU,"MUNICIPIUL BACĂU",20297,BACĂU,"GRĂDINIŢA CU PROGRAM PRELUNGIT NR.23",111,"Alegeri Prezidentiale",1,1257,571,536,35,0,559,12,1400,829,340,219
4,BACĂU,"MUNICIPIUL BACĂU",20297,BACĂU,"GRĂDINIŢA CU PROGRAM PRELUNGIT NR.33",112,"Alegeri Prezidentiale",1,1315,647,596,51,0,630,17,1400,753,403,227
4,BACĂU,"MUNICIPIUL BACĂU",20297,BACĂU,"LICEUL CU PROGRAM SPORTIV",113,"Alegeri Prezidentiale",1,1065,627,515,112,0,616,11,1200,573,416,200
4,BACĂU,"MUNICIPIUL BACĂU",20297,BACĂU,"LICEUL CU PROGRAM SPORTIV",114,"Alegeri Prezidentiale",1,1269,679,578,101,0,668,11,1400,721,464,204
4,BACĂU,"MUNICIPIUL BACĂU",20297,BACĂU,"LICEUL CU PROGRAM SPORTIV",115,"Alegeri Prezidentiale",1,1128,688,593,95,0,671,17,1200,512,452,219
4,BACĂU,"MUNICIPIUL BACĂU",20297,BACĂU,"ŞCOALA GIMNAZIALĂ ”COSTANTIN PLATON”",116,"Alegeri Prezidentiale",1,1424,800,712,88,0,781,19,1600,800,548,233
4,BACĂU,"MUNICIPIUL BACĂU",20297,BACĂU,"ŞCOALA GIMNAZIALĂ ”COSTANTIN PLATON”",117,"Alegeri Prezidentiale",1,1371,727,677,50,0,711,16,1500,773,437,274
4,BACĂU,"MUNICIPIUL BACĂU",20297,BACĂU,"ŞCOALA GIMNAZIALĂ ”COSTANTIN PLATON”",118,"Alegeri Prezidentiale",1,1498,826,764,62,0,802,24,1600,774,575,227
4,BACĂU,"MUNICIPIUL BACĂU",20297,BACĂU,"COLEGIUL ECONOMIC ”ION GHICA”",119,"Alegeri Prezidentiale",1,1102,657,539,118,0,644,13,1200,543,413,231
4,BACĂU,"MUNICIPIUL BACĂU",20297,BACĂU,"COLEGIUL ECONOMIC ”ION GHICA”",120,"Alegeri Prezidentiale",1,1102,487,390,97,0,476,11,1200,713,335,141
4,BACĂU,"MUNICIPIUL BACĂU",20297,BACĂU,"LICEUL TEHNOLOGIC ”PETRU RAREȘ”",121,"Alegeri Prezidentiale",1,1549,732,693,39,0,718,14,1700,968,474,244
4,BACĂU,"MUNICIPIUL BACĂU",20297,BACĂU,"LICEUL TEHNOLOGIC ”PETRU RAREȘ”",122,"Alegeri Prezidentiale",2,1281,627,567,60,0,616,11,1400,773,422,194
4,BACĂU,"MUNICIPIUL BACĂU",20297,BACĂU,"ŞCOALA GIMNAZIALĂ ”NICU ENEA”",123,"Alegeri Prezidentiale",1,1302,619,592,27,0,603,16,1400,781,430,173
4,BACĂU,"MUNICIPIUL BACĂU",20297,BACĂU,"ȘCOALA GIMNAZIALĂ ”NICU ENEA”",124,"Alegeri Prezidentiale",1,1302,626,583,42,1,619,7,1400,774,413,206
4,BACĂU,"MUNICIPIUL BACĂU",20297,BACĂU,"ȘCOALA GIMNAZIALĂ ”NICU ENEA”",125,"Alegeri Prezidentiale",1,1375,646,565,81,0,631,15,1500,854,446,185
4,BACĂU,"MUNICIPIUL MOINEŞTI",20876,MOINEŞTI,"LICEUL SPIRU HARET",126,"Alegeri Prezidentiale",1,920,425,397,28,0,416,9,1000,575,227,189
4,BACĂU,"MUNICIPIUL MOINEŞTI",20876,MOINEŞTI,"LICEUL SPIRU HARET",127,"Alegeri Prezidentiale",1,1040,614,432,41,141,605,9,1100,486,348,257
4,BACĂU,"MUNICIPIUL MOINEŞTI",20876,MOINEŞTI,"SALA DE SPORT A LICEULUI SPIRU HARET",128,"Alegeri Prezidentiale",1,1243,587,553,33,1,573,14,1400,813,364,209
4,BACĂU,"MUNICIPIUL MOINEŞTI",20876,MOINEŞTI,"ŞCOALA ŞTEFAN LUCHIAN",129,"Alegeri Prezidentiale",1,1193,562,505,57,0,547,15,1300,738,343,204
4,BACĂU,"MUNICIPIUL MOINEŞTI",20876,MOINEŞTI,"ŞCOALA ŞTEFAN LUCHIAN",130,"Alegeri Prezidentiale",1,1141,512,488,23,1,496,16,1300,788,278,218
4,BACĂU,"MUNICIPIUL MOINEŞTI",20876,MOINEŞTI,"BIBLIOTECA MUNICIPALA",131,"Alegeri Prezidentiale",1,1256,571,536,35,0,562,9,1400,829,374,188
4,BACĂU,"MUNICIPIUL MOINEŞTI",20876,MOINEŞTI,"ŞCOALA GEORGE ENESCU",132,"Alegeri Prezidentiale",1,1589,560,527,33,0,541,19,1700,1140,313,228
4,BACĂU,"MUNICIPIUL MOINEŞTI",20876,MOINEŞTI,"ŞCOALA GEORGE ENESCU",133,"Alegeri Prezidentiale",2,1293,421,392,29,0,410,11,1400,979,234,176
4,BACĂU,"MUNICIPIUL MOINEŞTI",20876,MOINEŞTI,"ŞCOALA GEORGE ENESCU",134,"Alegeri Prezidentiale",1,1214,534,506,28,0,523,11,1300,766,319,204
4,BACĂU,"MUNICIPIUL MOINEŞTI",20876,MOINEŞTI,"CLUBUL ELEVILOR",135,"Alegeri Prezidentiale",1,1341,545,513,28,4,535,10,1500,955,324,211
4,BACĂU,"MUNICIPIUL MOINEŞTI",20876,MOINEŞTI,"ŞCOALA TRISTAN TZARA",136,"Alegeri Prezidentiale",1,1262,537,505,21,11,528,9,1400,863,304,224
4,BACĂU,"MUNICIPIUL MOINEŞTI",20876,MOINEŞTI,"ŞCOALA TRISTAN TZARA",137,"Alegeri Prezidentiale",1,1331,563,536,26,1,551,12,1500,937,325,226
4,BACĂU,"MUNICIPIUL MOINEŞTI",20876,MOINEŞTI,"CLĂDIRE ŞCOALA LUNCA",138,"Alegeri Prezidentiale",1,1146,458,438,20,0,453,5,1300,842,312,141
4,BACĂU,"MUNICIPIUL MOINEŞTI",20876,MOINEŞTI,"ŞCOALA ALEXANDRU SEVER",139,"Alegeri Prezidentiale",1,646,306,294,12,0,301,5,700,394,201,100
4,BACĂU,"MUNICIPIUL MOINEŞTI",20876,MOINEŞTI,"ŞCOALA ALEXANDRU SEVER",140,"Alegeri Prezidentiale",1,1090,465,444,21,0,460,5,1200,735,270,190
4,BACĂU,"MUNICIPIUL MOINEŞTI",20876,MOINEŞTI,"ŞCOALA ALEXANDRU SEVER HANGANI",141,"Alegeri Prezidentiale",2,1158,476,454,22,0,455,21,1300,824,265,190
4,BACĂU,"MUNICIPIUL MOINEŞTI",20876,MOINEŞTI,"CLĂDIRE ŞCOALA GĂZĂRIE",142,"Alegeri Prezidentiale",1,1026,418,391,27,0,407,11,1100,682,252,155
4,BACĂU,"MUNICIPIUL ONEŞTI",20563,ONEŞTI,"COLEGIUL NAŢIONAL ”GRIGORE C.MOISIL”",143,"Alegeri Prezidentiale",1,1375,582,555,27,0,569,13,1500,918,322,247
4,BACĂU,"MUNICIPIUL ONEŞTI",20563,ONEŞTI,"COLEGIUL NAŢIONAL ”GRIGORE C.MOISIL”",144,"Alegeri Prezidentiale",2,1104,499,439,60,0,494,5,1200,701,296,198
4,BACĂU,"MUNICIPIUL ONEŞTI",20563,ONEŞTI,"COLEGIUL NAŢIONAL ”GRIGORE C.MOISIL”",145,"Alegeri Prezidentiale",1,957,437,388,48,1,428,9,1100,663,208,220
4,BACĂU,"MUNICIPIUL ONEŞTI",20563,ONEŞTI,"ȘCOALA GIMNAZIALĂ ”SFÂNTUL VOIEVOD ȘTEFAN CEL MARE” (FOSTA NR.9)",146,"Alegeri Prezidentiale",1,1240,524,489,34,1,515,9,1400,876,268,247
4,BACĂU,"MUNICIPIUL ONEŞTI",20563,ONEŞTI,"ȘCOALA GIMNAZIALĂ ”SFÂNTUL VOIEVOD ȘTEFAN CEL MARE”(FOSTA NR.9)",147,"Alegeri Prezidentiale",1,1346,597,552,44,1,583,14,1500,903,323,260
4,BACĂU,"MUNICIPIUL ONEŞTI",20563,ONEŞTI,"ȘCOALA GIMNAZIALĂ ”EMIL RACOVIȚĂ” (FOSTA NR.10)",148,"Alegeri Prezidentiale",1,1145,457,418,38,1,446,11,1300,843,284,162
4,BACĂU,"MUNICIPIUL ONEŞTI",20563,ONEŞTI,"ȘCOALA GIMNAZIALĂ ”EMIL RACOVIȚĂ” (FOSTA NR.10)",149,"Alegeri Prezidentiale",1,1284,525,494,31,0,507,18,1400,875,317,190
4,BACĂU,"MUNICIPIUL ONEŞTI",20563,ONEŞTI,"ȘCOALA GIMNAZIALĂ ”EMIL RACOVIȚĂ” (FOSTA NR.10)",150,"Alegeri Prezidentiale",1,1006,407,383,24,0,401,6,1100,693,223,178
4,BACĂU,"MUNICIPIUL ONEŞTI",20563,ONEŞTI,"LICEUL TEHNOLOGIC (FOSTA NR.7)",151,"Alegeri Prezidentiale",1,1224,456,406,50,0,447,9,1300,844,304,143
4,BACĂU,"MUNICIPIUL ONEŞTI",20563,ONEŞTI,"LICEUL TEHNOLOGIC (FOSTA NR.7)",152,"Alegeri Prezidentiale",1,1160,462,421,41,0,444,18,1299,837,296,148
4,BACĂU,"MUNICIPIUL ONEŞTI",20563,ONEŞTI,"LICEUL TEHNOLOGIC (FOSTA NR.7)",153,"Alegeri Prezidentiale",1,1192,468,443,25,0,455,13,1300,832,262,193
4,BACĂU,"MUNICIPIUL ONEŞTI",20563,ONEŞTI,"LICEUL TEHNOLOGIC (FOSTA NR.7)",154,"Alegeri Prezidentiale",1,1166,499,479,19,1,489,10,1300,801,263,226
4,BACĂU,"MUNICIPIUL ONEŞTI",20563,ONEŞTI,"ŞCOALA GIMNAZIALĂ ”GHIŢĂ MOCANU” (FOSTĂ NR.5)",155,"Alegeri Prezidentiale",2,1172,506,482,24,0,492,14,1300,794,271,221
4,BACĂU,"MUNICIPIUL ONEŞTI",20563,ONEŞTI,"ŞCOALA GIMNAZIALĂ ”GHIŢĂ MOCANU” (FOSTĂ NR.5)",156,"Alegeri Prezidentiale",1,812,404,340,64,0,396,8,900,496,250,146
4,BACĂU,"MUNICIPIUL ONEŞTI",20563,ONEŞTI,"ȘCOALA GIMNAZIALĂ ”GHIȚĂ MOCANU” (FOSTĂ NR.5)",157,"Alegeri Prezidentiale",1,1452,668,627,41,0,638,30,1600,932,355,283
4,BACĂU,"MUNICIPIUL ONEŞTI",20563,ONEŞTI,"ȘCOALA GIMNAZIALĂ ”GHIȚĂ MOCANU” (FOSTĂ NR.5)",158,"Alegeri Prezidentiale",1,1551,633,613,20,0,612,21,1700,1067,346,266
4,BACĂU,"MUNICIPIUL ONEŞTI",20563,ONEŞTI,"ȘCOALA GIMNAZIALĂ NR.1",159,"Alegeri Prezidentiale",1,988,423,387,36,0,409,14,1100,677,233,176
4,BACĂU,"MUNICIPIUL ONEŞTI",20563,ONEŞTI,"ȘCOALA GIMNAZIALĂ NR.1",160,"Alegeri Prezidentiale",1,1326,630,573,57,0,618,12,1500,870,377,241
4,BACĂU,"MUNICIPIUL ONEŞTI",20563,ONEŞTI,"ȘCOALA GIMNAZIALĂ NR.1",161,"Alegeri Prezidentiale",1,1298,601,568,33,0,590,11,1400,799,339,251
4,BACĂU,"MUNICIPIUL ONEŞTI",20563,ONEŞTI,"LICEUL CU PROGRAM SPORTIV ”NADIA COMĂNECI”",162,"Alegeri Prezidentiale",1,1058,682,474,30,178,670,12,1200,518,367,303
4,BACĂU,"MUNICIPIUL ONEŞTI",20563,ONEŞTI,"LICEUL CU PROGRAM SPORTIV ”NADIA COMĂNECI”",163,"Alegeri Prezidentiale",1,1140,505,464,40,1,492,13,1300,795,284,208
4,BACĂU,"MUNICIPIUL ONEŞTI",20563,ONEŞTI,"LICEUL CU PROGRAM SPORTIV ”NADIA COMĂNECI”",164,"Alegeri Prezidentiale",1,1437,596,564,32,0,579,17,1600,1004,337,242
4,BACĂU,"MUNICIPIUL ONEŞTI",20563,ONEŞTI,"COLEGIU NAŢIONAL ”DIMITRIE CANTEMIR”",165,"Alegeri Prezidentiale",1,1187,515,467,48,0,508,7,1300,785,317,191
4,BACĂU,"MUNICIPIUL ONEŞTI",20563,ONEŞTI,"COLEGIU NAŢIONAL ”DIMITRIE CANTEMIR”",166,"Alegeri Prezidentiale",1,1398,545,521,24,0,533,12,1500,955,324,209
4,BACĂU,"MUNICIPIUL ONEŞTI",20563,ONEŞTI,"COLEGIU NAŢIONAL ”DIMITRIE CANTEMIR”",167,"Alegeri Prezidentiale",1,1212,451,428,23,0,442,9,1300,849,292,150
4,BACĂU,"MUNICIPIUL ONEŞTI",20563,ONEŞTI,"LICEUL TEHNOLOGIC ”PETRU PONI”",168,"Alegeri Prezidentiale",1,935,390,368,22,0,372,18,1000,610,234,138
4,BACĂU,"MUNICIPIUL ONEŞTI",20563,ONEŞTI,"LICEUL TEHNOLOGIC ”PETRU PONI”",169,"Alegeri Prezidentiale",1,928,368,333,35,0,361,7,1000,632,234,127
4,BACĂU,"MUNICIPIUL ONEŞTI",20563,ONEŞTI,"ȘCOALA GIMNAZIALĂ ”GEORGE CĂLINESCU” (FOSTĂ NR.8)",170,"Alegeri Prezidentiale",1,1470,584,549,35,0,571,13,1600,1016,328,243
4,BACĂU,"MUNICIPIUL ONEŞTI",20563,ONEŞTI,"ȘCOALA GIMNAZIALĂ ”GEORGE CĂLINESCU” (FOSTĂ NR.8)",171,"Alegeri Prezidentiale",1,1327,578,553,25,0,564,14,1400,822,353,211
4,BACĂU,"MUNICIPIUL ONEŞTI",20563,ONEŞTI,"COLEGIUL TEHNIC ”GHEORGHE ASACHI”",172,"Alegeri Prezidentiale",1,1362,576,521,55,0,561,15,1500,924,334,227
4,BACĂU,"MUNICIPIUL ONEŞTI",20563,ONEŞTI,"COLEGIUL TEHNIC ”GHEORGHE ASACHI”",173,"Alegeri Prezidentiale",1,1221,510,473,37,0,490,20,1300,790,279,211
4,BACĂU,"MUNICIPIUL ONEŞTI",20563,ONEŞTI,"LICEUL TEHNOLOGIC (TCR)",174,"Alegeri Prezidentiale",1,910,385,361,24,0,368,17,1000,615,220,148
4,BACĂU,"MUNICIPIUL ONEŞTI",20563,ONEŞTI,"SERA BORZEŞTI",175,"Alegeri Prezidentiale",1,810,275,255,20,0,271,4,900,625,180,91
4,BACĂU,"MUNICIPIUL ONEŞTI",20563,SLOBOZIA,"CENTRUL SOCIAL SLOBOZIA",176,"Alegeri Prezidentiale",1,1058,444,427,17,0,432,12,1200,756,240,192
4,BACĂU,"MUNICIPIUL ONEŞTI",20563,ONEŞTI,"GRĂDINIŢA ”SFÂNTUL PAUL”",177,"Alegeri Prezidentiale",1,1343,561,533,11,17,544,17,1500,939,334,210
4,BACĂU,"MUNICIPIUL ONEŞTI",20563,ONEŞTI,"GRĂDINIŢA ”SFÂNTUL PAUL”",178,"Alegeri Prezidentiale",2,1321,586,563,23,0,575,11,1400,814,379,196
4,BACĂU,"ORAŞ BUHUŞI",20778,BUHUŞI,"PRIMĂRIA ORAŞ BUHUŞI",179,"Alegeri Prezidentiale",1,1744,538,509,28,1,524,14,1900,1362,266,258
4,BACĂU,"ORAŞ BUHUŞI",20778,BUHUŞI,"LICEUL TEORETIC ”ION BORCEA”",180,"Alegeri Prezidentiale",1,1431,506,481,25,0,496,10,1600,1094,274,222
4,BACĂU,"ORAŞ BUHUŞI",20778,BUHUŞI,"LICEUL TEORETIC ”ION BORCEA”",181,"Alegeri Prezidentiale",1,1304,454,387,23,44,446,8,1400,946,246,200
4,BACĂU,"ORAŞ BUHUŞI",20778,BUHUŞI,"CASA DE CULTURĂ ”ELISABETA BOSTAN”",182,"Alegeri Prezidentiale",1,1572,598,547,51,0,593,5,1700,1102,295,298
4,BACĂU,"ORAŞ BUHUŞI",20778,BUHUŞI,"ŞCOALA GIMNAZIALĂ ”MIHAI EMINESCU”",183,"Alegeri Prezidentiale",1,1557,539,514,24,1,523,16,1700,1161,290,233
4,BACĂU,"ORAŞ BUHUŞI",20778,BUHUŞI,"BIBLIOTECA ORĂŞENEASCĂ ”GEORGE BACOVIA”",184,"Alegeri Prezidentiale",1,1389,575,537,27,11,557,18,1500,925,305,252
4,BACĂU,"ORAŞ BUHUŞI",20778,BUHUŞI,"ŞCOALA GIMNAZIALĂ NR. 2 BUHUȘI",185,"Alegeri Prezidentiale",1,1634,498,478,20,0,486,12,1800,1302,290,196
4,BACĂU,"ORAŞ BUHUŞI",20778,BUHUŞI,"COMPLEXUL DE SERVICII COMUNITARE ȘI CENTRUL DE CONSILIERE, INFORMARE ȘI SPRIJIN",186,"Alegeri Prezidentiale",1,1733,472,455,17,0,468,4,1900,1428,278,190
4,BACĂU,"ORAŞ BUHUŞI",20778,BUHUŞI,"ŞCOALA GIMNAZIALĂ ŞTEFAN CEL MARE",187,"Alegeri Prezidentiale",1,1900,437,412,25,0,423,14,2100,1663,223,200
4,BACĂU,"ORAŞ BUHUŞI",20778,BUHUŞI,"ŞCOALA GIMNAZIALĂ ”MIHAIL ANDREI”",188,"Alegeri Prezidentiale",1,1694,463,436,27,0,455,8,1900,1437,248,207
4,BACĂU,"ORAŞ BUHUŞI",20778,BUHUŞI,"SALA SPORT POLIVALENTĂ",189,"Alegeri Prezidentiale",1,1791,541,516,19,6,528,13,2000,1459,355,173
4,BACĂU,"ORAŞ BUHUŞI",20778,BUHUŞI,"ŞCOALA GIMNAZIALĂ BUHUȘI",190,"Alegeri Prezidentiale",1,1341,348,335,13,0,341,7,1500,1152,188,153
4,BACĂU,"ORAŞ COMĂNEŞTI",20821,COMĂNEŞTI,"CENTRUL 5",191,"Alegeri Prezidentiale",1,1096,553,511,41,1,539,14,1200,647,290,249
4,BACĂU,"ORAŞ COMĂNEŞTI",20821,COMĂNEŞTI,"ŞCOALA CIPRIAN PORUMBESCU",192,"Alegeri Prezidentiale",1,1278,571,543,28,0,549,22,1400,829,287,262
4,BACĂU,"ORAŞ COMĂNEŞTI",20821,COMĂNEŞTI,"ȘCOALA CIPRIAN PORUMBESCU",193,"Alegeri Prezidentiale",1,1255,623,498,44,81,607,16,1400,777,348,259
4,BACĂU,"ORAŞ COMĂNEŞTI",20821,COMĂNEŞTI,"SCOALA CIPRIAN PORUMBESCU",194,"Alegeri Prezidentiale",1,493,224,196,28,0,220,4,500,276,164,56
4,BACĂU,"ORAŞ COMĂNEŞTI",20821,COMĂNEŞTI,"BIBLIOTECA ORAŞULUI COMĂNEȘTI",195,"Alegeri Prezidentiale",1,1438,638,563,75,0,622,16,1600,962,382,240
4,BACĂU,"ORAŞ COMĂNEŞTI",20821,COMĂNEŞTI,"SCOALA LIVIU REBREANU",196,"Alegeri Prezidentiale",1,1598,627,620,7,0,603,24,1700,1073,385,218
4,BACĂU,"ORAŞ COMĂNEŞTI",20821,COMĂNEŞTI,"ŞCOALA LIVIU REBREANU",197,"Alegeri Prezidentiale",1,1004,382,356,26,0,368,14,1100,718,246,122
4,BACĂU,"ORAŞ COMĂNEŞTI",20821,COMĂNEŞTI,"ŞCOALA LIVIU REBREANU",198,"Alegeri Prezidentiale",1,630,287,216,71,0,274,13,707,420,185,89
4,BACĂU,"ORAŞ COMĂNEŞTI",20821,COMĂNEŞTI,"PRIMĂRIA ORAȘULUI COMĂNEȘTI",199,"Alegeri Prezidentiale",1,1390,546,507,39,0,538,8,1500,954,318,220
4,BACĂU,"ORAŞ COMĂNEŞTI",20821,COMĂNEŞTI,"ŞCOALA ŞUPAN",200,"Alegeri Prezidentiale",1,1461,538,522,16,0,530,8,1600,1062,294,236
4,BACĂU,"ORAŞ COMĂNEŞTI",20821,COMĂNEŞTI,"ŞCOALA LĂLOAIA",201,"Alegeri Prezidentiale",1,1194,562,525,37,0,549,13,1300,738,276,273
4,BACĂU,"ORAŞ COMĂNEŞTI",20821,COMĂNEŞTI,"ŞCOALA NR.5 BIS SUBLĂLOAIA",202,"Alegeri Prezidentiale",1,1498,673,609,64,0,658,15,1600,927,357,301
4,BACĂU,"ORAŞ COMĂNEŞTI",20821,COMĂNEŞTI,"ŞCOALA COSTACHI S.CIOCAN LĂLOAIA",203,"Alegeri Prezidentiale",1,727,296,279,17,0,293,3,800,504,167,126
4,BACĂU,"ORAŞ COMĂNEŞTI",20821,COMĂNEŞTI,"ŞCOALA NR.3 LEORDA",204,"Alegeri Prezidentiale",1,1312,576,546,30,0,570,6,1400,824,318,252
4,BACĂU,"ORAŞ COMĂNEŞTI",20821,COMĂNEŞTI,"ŞCOALA DIMITRIE GHICA ZĂVOI",205,"Alegeri Prezidentiale",1,1257,551,510,41,0,536,15,1400,849,281,255
4,BACĂU,"ORAŞ COMĂNEŞTI",20821,COMĂNEŞTI,"ŞCOALA VERMEŞTI",206,"Alegeri Prezidentiale",1,1071,372,348,24,0,360,12,1200,828,244,116
4,BACĂU,"ORAŞ COMĂNEŞTI",20821,COMĂNEŞTI,"CLĂDIRE ŞIPOTENI (FOSTĂ ȘCOALĂ ȘIPOTENI)",207,"Alegeri Prezidentiale",1,636,283,264,19,0,274,9,700,417,171,103
4,BACĂU,"ORAŞ DĂRMĂNEŞTI",22166,DĂRMĂNEŞTI,"ŞCOALA NR.2",208,"Alegeri Prezidentiale",1,1352,626,593,33,0,615,11,1500,874,374,241
4,BACĂU,"ORAŞ DĂRMĂNEŞTI",22166,DĂRMĂNEŞTI,"ŞCOALA NR.2",209,"Alegeri Prezidentiale",1,982,419,399,20,0,407,12,1100,681,291,116
4,BACĂU,"ORAŞ DĂRMĂNEŞTI",22166,DĂRMĂNEŞTI,"LICEUL TEHNOLOGIC DĂRMĂNEȘTI",210,"Alegeri Prezidentiale",1,1527,618,593,25,0,600,18,1700,1082,354,246
4,BACĂU,"ORAŞ DĂRMĂNEŞTI",22166,DĂRMĂNEŞTI,"CENTRUL CULTURAL NEMIRA",211,"Alegeri Prezidentiale",1,769,389,352,37,0,380,9,800,411,234,146
4,BACĂU,"ORAŞ DĂRMĂNEŞTI",22166,DĂRMĂNEŞTI,"ŞCOALA NR.3 DĂRMĂNEȘTI",212,"Alegeri Prezidentiale",1,695,289,275,14,0,284,5,800,511,185,99
4,BACĂU,"ORAŞ DĂRMĂNEŞTI",22166,DĂRMĂNEŞTI,"ŞCOALA NR.3 DĂRMĂNEȘTI",213,"Alegeri Prezidentiale",1,1030,308,300,8,0,296,12,1100,792,168,128
4,BACĂU,"ORAŞ DĂRMĂNEŞTI",22166,LAPOŞ,"SCOALA LAPOȘ",214,"Alegeri Prezidentiale",1,798,331,316,15,0,328,3,900,569,222,106
4,BACĂU,"ORAŞ DĂRMĂNEŞTI",22166,PLOPU,"ŞCOALA CU CLASELE I-VIII PLOPU",215,"Alegeri Prezidentiale",1,1248,461,418,25,18,452,9,1400,939,255,197
4,BACĂU,"ORAŞ DĂRMĂNEŞTI",22166,DĂRMĂNEŞTI,"GRĂDINIŢA SĂLĂTRUC",216,"Alegeri Prezidentiale",2,631,293,264,29,0,286,7,700,407,181,105
4,BACĂU,"ORAŞ DĂRMĂNEŞTI",22166,DĂRMĂNEŞTI,"ŞCOALA CU CLASELE L-IV PĂGUBENI",217,"Alegeri Prezidentiale",1,306,151,137,14,0,144,7,400,249,82,62
4,BACĂU,"ORAŞ DĂRMĂNEŞTI",22166,DĂRMĂNEŞTI,"PRIMĂRIA DĂRMĂNEȘTI",218,"Alegeri Prezidentiale",1,1297,520,484,36,0,512,8,1400,880,340,172
4,BACĂU,"ORAŞ DĂRMĂNEŞTI",22166,DĂRMĂNEŞTI,"SCOALA CU CLASELE I-IV DĂRMĂNEASCA",219,"Alegeri Prezidentiale",1,706,293,277,16,0,283,10,800,507,183,100
4,BACĂU,"ORAŞ SLĂNIC-MOLDOVA",20910,CERDAC,"SCOALA GIMNAZIALA NR. 3",220,"Alegeri Prezidentiale",1,1091,485,455,30,0,475,10,1200,715,353,122
4,BACĂU,"ORAŞ SLĂNIC-MOLDOVA",20910,SLĂNIC-MOLDOVA,"SCOALA NR. 1 SLĂNIC",221,"Alegeri Prezidentiale",2,1536,881,568,313,0,866,15,1700,819,553,313
4,BACĂU,"ORAŞ SLĂNIC-MOLDOVA",20910,CIREŞOAIA,"SCOALA NR. 2 CIRESOAIA",222,"Alegeri Prezidentiale",1,1501,711,673,37,1,700,11,1600,889,555,145
4,BACĂU,"ORAŞ TÂRGU OCNA",20965,"TÂRGU OCNA","SCOALA GENERALA NR. 1",223,"Alegeri Prezidentiale",1,1368,768,588,76,104,748,20,1500,732,460,288
4,BACĂU,"ORAŞ TÂRGU OCNA",20965,"TÂRGU OCNA","CLUBUL ELEVILOR",224,"Alegeri Prezidentiale",1,1354,787,613,172,2,770,17,1500,713,469,301
4,BACĂU,"ORAŞ TÂRGU OCNA",20965,"TÂRGU OCNA","COLEGIUL NATIONAL COSTACHE NEGRI",225,"Alegeri Prezidentiale",1,1434,771,628,140,3,747,24,1600,829,462,285
4,BACĂU,"ORAŞ TÂRGU OCNA",20965,"TÂRGU OCNA","SCOALA GENERALA NR. 2",226,"Alegeri Prezidentiale",1,1495,645,599,46,0,627,18,1600,955,424,203
4,BACĂU,"ORAŞ TÂRGU OCNA",20965,"TÂRGU OCNA","SCOALA GENERALA NR. 3",227,"Alegeri Prezidentiale",1,1046,447,421,26,0,439,8,1100,653,288,151
4,BACĂU,"ORAŞ TÂRGU OCNA",20965,"TÂRGU OCNA","SCOALA GENERALA NR. 4",228,"Alegeri Prezidentiale",2,1188,720,580,94,46,708,12,1300,580,447,261
4,BACĂU,"ORAŞ TÂRGU OCNA",20965,POIENI,"SCOALA GENERALA NR. 5",229,"Alegeri Prezidentiale",2,778,322,303,19,0,318,4,800,478,247,71
4,BACĂU,"ORAŞ TÂRGU OCNA",20965,VÂLCELE,"SCOALA GENERALA NR. 6",230,"Alegeri Prezidentiale",2,985,425,392,33,0,418,7,1100,675,280,138
4,BACĂU,"ORAŞ TÂRGU OCNA",20965,"TÂRGU OCNA","SCOALA GENERALA NR. 3-SALA DE SPORT",231,"Alegeri Prezidentiale",1,893,414,383,31,0,409,5,1000,586,265,144
4,BACĂU,AGĂŞ,21007,AGĂŞ,"CONSILIUL LOCAL AGĂŞ",232,"Alegeri Prezidentiale",1,998,389,354,35,0,384,5,1100,711,236,148
4,BACĂU,AGĂŞ,21007,COTUMBA,"ŞCOALA CU CLASELE I-IV COTUMBA",233,"Alegeri Prezidentiale",1,1120,440,396,44,0,436,4,1200,760,220,216
4,BACĂU,AGĂŞ,21007,SULŢA,"ŞCOALA GENERALĂ SULŢA",234,"Alegeri Prezidentiale",1,810,321,290,31,0,314,7,900,579,186,128
4,BACĂU,AGĂŞ,21007,COŞNEA,"ȘCOALA GIMNAZIALĂ COȘNEA",235,"Alegeri Prezidentiale",1,348,129,106,23,0,129,0,400,271,78,51
4,BACĂU,AGĂŞ,21007,PRELUCI,"ŞCOALA GENERALĂ PRELUCI",236,"Alegeri Prezidentiale",1,969,340,326,14,0,334,6,1100,760,180,154
4,BACĂU,AGĂŞ,21007,GOIOASA,"ŞCOALA GENERALĂ GOIOASA",237,"Alegeri Prezidentiale",1,694,245,227,18,0,238,7,800,555,131,107
4,BACĂU,ARDEOANI,21098,ARDEOANI,"ŞCOALA NR.1 ARDEOANI",238,"Alegeri Prezidentiale",1,1283,834,513,321,0,828,6,1400,566,605,223
4,BACĂU,ARDEOANI,21098,LEONTINEŞTI,"ŞCOALA LEONTINEŞTI",239,"Alegeri Prezidentiale",1,673,381,293,88,0,376,5,700,319,254,122
4,BACĂU,ASĂU,21123,ASĂU,"ŞCOALA GENERALA CU CLASELE I-VIII ASAU",240,"Alegeri Prezidentiale",1,874,380,350,30,0,373,7,1000,620,174,199
4,BACĂU,ASĂU,21123,ASĂU,"ŞCOALA GENERALĂ CU CLASELE I-VIII ASAU",241,"Alegeri Prezidentiale",1,916,426,393,33,0,422,4,1000,574,216,206
4,BACĂU,ASĂU,21123,"LUNCA ASĂU","ŞCOALA CU CLASELE I-IV LUNCA ASĂU",242,"Alegeri Prezidentiale",1,633,297,281,16,0,289,8,700,403,123,166
4,BACĂU,ASĂU,21123,STRAJA,"ŞCOALA CU CLASELE I-IV STRAJA",243,"Alegeri Prezidentiale",1,984,361,333,28,0,356,5,1100,739,196,160
4,BACĂU,ASĂU,21123,CIOBĂNUŞ,"ŞCOALA CU CLASELE I-IV CIOBĂNUŞ",244,"Alegeri Prezidentiale",1,450,208,176,32,0,203,5,500,292,111,92
4,BACĂU,ASĂU,21123,"APA ASĂU","ŞCOALA GENERALĂ CU CLASELE I-VIII APA-ASĂU",245,"Alegeri Prezidentiale",1,677,300,284,16,0,289,11,697,397,167,122
4,BACĂU,ASĂU,21123,"APA ASĂU","ŞCOALA GENERALĂ CU CLASELE I-VIII APA-ASĂU",246,"Alegeri Prezidentiale",1,592,267,251,16,0,259,8,598,331,127,132
4,BACĂU,ASĂU,21123,PĂLTINIŞ,"ŞCOALA CU CLASELE I-IV PĂLTINIŞ",247,"Alegeri Prezidentiale",1,521,258,244,14,0,253,5,600,342,128,125
4,BACĂU,BALCANI,21196,BALCANI,"BIBLIOTECA PUBLICA ”CALISTRAT HOGAS” BALCANI",248,"Alegeri Prezidentiale",1,1137,375,362,13,0,368,7,1300,925,219,149
4,BACĂU,BALCANI,21196,FRUMOASA,"GRĂDINIŢA FRUMOASA",249,"Alegeri Prezidentiale",1,1032,362,347,15,0,361,1,1100,738,246,115
4,BACĂU,BALCANI,21196,FRUMOASA,"GRĂDINIŢA FRUMOASA",250,"Alegeri Prezidentiale",1,1417,483,459,24,0,477,6,1500,1017,314,163
4,BACĂU,BALCANI,21196,FRUMOASA,"GRĂDINIŢA FRUMOASA",251,"Alegeri Prezidentiale",1,535,168,154,14,0,167,1,600,432,91,76
4,BACĂU,BALCANI,21196,"SCHITU FRUMOASA","GRADINITA NR.2 SCHITU-FRUMOASA",252,"Alegeri Prezidentiale",1,632,225,209,16,0,223,2,700,475,147,76
4,BACĂU,BALCANI,21196,"SCHITU FRUMOASA","ŞCOALA GIMNAZIALA SCHITU-FRUMOASA",253,"Alegeri Prezidentiale",1,939,337,316,21,0,333,4,1000,663,218,115
4,BACĂU,BALCANI,21196,LUDAŞI,"ŞCOALA GIMNAZIALA LUDAŞI",254,"Alegeri Prezidentiale",1,785,237,218,19,0,233,4,900,663,137,96
4,BACĂU,BÂRSĂNEŞTI,21454,BÂRSĂNEŞTI,"PRIMĂRIA BÎRSĂNEŞTI",255,"Alegeri Prezidentiale",1,1438,566,532,34,0,562,4,1600,1034,330,232
4,BACĂU,BÂRSĂNEŞTI,21454,ALBELE,"ŞCOALA GIMNAZIALĂ ALBELE",256,"Alegeri Prezidentiale",1,530,234,204,30,0,231,3,600,366,129,102
4,BACĂU,BÂRSĂNEŞTI,21454,BRĂTEŞTI,"ŞCOALA GIMNAZIALĂ BRĂTEŞTI",257,"Alegeri Prezidentiale",1,896,387,367,20,0,380,7,1000,613,279,101
4,BACĂU,BÂRSĂNEŞTI,21454,CARACLĂU,"ŞCOALA GIMNAZIALĂ CARACLĂU",258,"Alegeri Prezidentiale",1,920,437,393,44,0,425,12,1000,563,234,191
4,BACĂU,BEREŞTI-BISTRIŢA,21249,BEREŞTI-BISTRIŢA,"SCOALA GIMNAZIALA ”VASILE BORCEA”",259,"Alegeri Prezidentiale",1,927,434,355,79,0,430,4,1000,566,251,179
4,BACĂU,BEREŞTI-BISTRIŢA,21249,PĂDURENI,"SCOALA CU CLASELE I-IV PĂDURENI",260,"Alegeri Prezidentiale",1,356,126,97,29,0,122,4,401,275,78,44
4,BACĂU,BEREŞTI-BISTRIŢA,21249,CLIMEŞTI,"ŞCOALA CU CLASELE I-IV CLIMEŞTI",261,"Alegeri Prezidentiale",1,250,147,104,43,0,145,2,300,153,92,53
4,BACĂU,BEREŞTI-BISTRIŢA,21249,BRAD,"ŞCOALA CU CLASELE I-IV BRAD",262,"Alegeri Prezidentiale",1,139,89,67,22,0,89,0,200,111,46,43
4,BACĂU,BEREŞTI-TAZLĂU,21338,BEREŞTI-TAZLĂU,"ŞCOALA CU CLASELEI-VIII BEREŞTI-TAZLĂU",263,"Alegeri Prezidentiale",1,949,393,361,32,0,388,5,1000,607,170,218
4,BACĂU,BEREŞTI-TAZLĂU,21338,BOŞOTENI,"ŞCOALA GENERALĂ BOŞOTENI",264,"Alegeri Prezidentiale",1,352,166,135,24,7,164,2,400,234,91,73
4,BACĂU,BEREŞTI-TAZLĂU,21338,ENĂCHEŞTI,"ŞCOALA GENERALĂ ENĂCHEŞTI",265,"Alegeri Prezidentiale",1,617,271,231,40,0,267,4,700,429,129,138
4,BACĂU,BEREŞTI-TAZLĂU,21338,PRISACA,"ŞCOALA GENERALĂ PRISACA",266,"Alegeri Prezidentiale",1,416,188,161,25,2,187,1,500,312,105,82
4,BACĂU,BEREŞTI-TAZLĂU,21338,ROMÂNEŞTI,"ŞCOALA GENERALĂ ROMÂNEŞTI",267,"Alegeri Prezidentiale",2,360,218,183,27,8,213,5,400,182,92,121
4,BACĂU,BEREŞTI-TAZLĂU,21338,TESCANI,"ŞCOALA GENERALĂ TESCANI",268,"Alegeri Prezidentiale",1,618,281,250,28,3,274,7,700,419,117,157
4,BACĂU,BEREŞTI-TAZLĂU,21338,TURLUIANU,"ŞCOALA GENERALĂ TURLUIANU",269,"Alegeri Prezidentiale",1,1066,356,339,17,0,355,1,1200,844,229,126
4,BACĂU,BERZUNŢI,21418,BERZUNŢI,"ŞCOALA CU CLASELE I-VIII ALEXANDRU CEL BUN BERZUNŢI",270,"Alegeri Prezidentiale",1,1392,556,518,38,0,554,2,1500,944,325,229
4,BACĂU,BERZUNŢI,21418,BERZUNŢI,"ŞCOALA CU CLASELE I-IV NR. 2 BERZUNŢI",271,"Alegeri Prezidentiale",1,673,249,234,15,0,246,3,700,451,128,118
4,BACĂU,BERZUNŢI,21418,DRAGOMIR,"SCOALA CU CLASELE I-IV NR. 1 DRAGOMIR",272,"Alegeri Prezidentiale",1,940,374,359,15,0,371,3,1000,626,172,199
4,BACĂU,BERZUNŢI,21418,DRAGOMIR,"ŞCOALA CU CLASELE I-VIII NR.2 DRAGOMIR",273,"Alegeri Prezidentiale",1,706,184,174,10,0,177,7,800,616,40,137
4,BACĂU,BERZUNŢI,21418,BUDA,"SCOALA CU CLASELE I-IV BUDA",274,"Alegeri Prezidentiale",1,452,177,154,23,0,173,4,500,323,67,106
4,BACĂU,BLĂGEŞTI,21506,BLĂGEŞTI,"ŞCOALA CU CLASELE I-VIII NR.1 BLĂGEŞTI",275,"Alegeri Prezidentiale",1,953,343,318,25,0,340,3,1000,657,173,167
4,BACĂU,BLĂGEŞTI,21506,BLĂGEŞTI,"ŞCOALA CU CLASELE .I-VIII NR.1 BLĂGEŞTI",276,"Alegeri Prezidentiale",1,949,307,281,24,2,302,5,1000,693,173,129
4,BACĂU,BLĂGEŞTI,21506,BUDA,"ŞCOALA CU CLASELE I-VIII NR.1 BUDA",277,"Alegeri Prezidentiale",1,1561,538,491,47,0,532,6,1700,1162,297,235
4,BACĂU,BLĂGEŞTI,21506,"VALEA LUI ION","ŞCOALA CU CLASELE.I-VIII NR.1 VALEA LUI ION",278,"Alegeri Prezidentiale",1,1147,463,432,31,0,456,7,1300,837,266,190
4,BACĂU,BLĂGEŞTI,21506,"ŢÂRDENII MARI","ŞCOALA CU CLASELE I-IV ŢÎRDENII MARI",279,"Alegeri Prezidentiale",1,593,243,221,22,0,241,2,600,357,150,91
4,BACĂU,BLĂGEŞTI,21506,"POIANA NEGUSTORULUI","ŞCOALA CU CLASELE I-IV POIANA NEGUSTORULUI",280,"Alegeri Prezidentiale",1,551,319,304,15,0,310,9,600,281,82,228
4,BACĂU,BOGDĂNEŞTI,21560,BOGDĂNEŞTI,"ŞCOALA GIMNAZIALĂ BOGDĂNEŞTI",281,"Alegeri Prezidentiale",1,902,334,284,50,0,331,3,1000,666,201,130
4,BACĂU,BOGDĂNEŞTI,21560,BOGDĂNEŞTI,"ŞCOALA GIMNAZIALĂ BOGDĂNEŞTI",282,"Alegeri Prezidentiale",2,862,334,316,18,0,327,7,900,566,185,142
4,BACĂU,BOGDĂNEŞTI,21560,FILIPEŞTI,"GRĂDINIŢA FILIPEŞTI",283,"Alegeri Prezidentiale",1,511,247,209,37,1,244,3,600,353,142,102
4,BACĂU,BRUSTUROASA,21597,BRUSTUROASA,"PRIMĂRIA BRUSTUROASA",284,"Alegeri Prezidentiale",1,1283,493,446,47,0,484,9,1400,907,259,225
4,BACĂU,BRUSTUROASA,21597,CAMENCA,"ŞCOALA PRIMARĂ CAMENCA",285,"Alegeri Prezidentiale",1,777,349,330,19,0,345,4,800,451,203,142
4,BACĂU,BRUSTUROASA,21597,BRUSTUROASA,"ŞCOALA PRIMARĂ CUCHINIŞ",286,"Alegeri Prezidentiale",1,633,235,220,15,0,230,5,700,465,122,108
4,BACĂU,BUCIUMI,26338,BUCIUMI,"ŞCOALA GIMNAZIALĂ BUCIUMI",287,"Alegeri Prezidentiale",1,1177,625,554,71,0,615,10,1300,675,273,342
4,BACĂU,BUCIUMI,26338,RĂCĂUŢI,"ŞCOALA GIMNAZIALĂ RĂCĂUŢI",288,"Alegeri Prezidentiale",1,1247,631,586,45,0,600,31,1400,769,189,411
4,BACĂU,BUHOCI,21668,BUHOCI,"ŞCOALA CU CLASELE I-VIII BUHOCI",289,"Alegeri Prezidentiale",1,1406,580,515,65,0,569,11,1500,920,417,152
4,BACĂU,BUHOCI,21668,BIJGHIR,"SCOALA CU CLASELE I-VIII BIJGHIR",290,"Alegeri Prezidentiale",1,1080,419,383,36,0,413,6,1200,781,352,61
4,BACĂU,BUHOCI,21668,BIJGHIR,"SCOALA CU CLASELE I-VIII BIJGHIR",291,"Alegeri Prezidentiale",1,959,326,296,30,0,324,2,1000,674,280,44
4,BACĂU,BUHOCI,21668,COTENI,"ŞCOALA CU CLASELE I-IV COTENI",292,"Alegeri Prezidentiale",1,618,272,239,33,0,268,4,708,436,192,76
4,BACĂU,CAŞIN,21720,CAŞIN,"ŞCOALA GIMNAZIALĂ N.PÂSLARU CAŞIN",293,"Alegeri Prezidentiale",2,1389,589,558,31,0,579,10,1500,911,354,225
4,BACĂU,CAŞIN,21720,CAŞIN,"ŞCOALA GIMNAZIALĂ N.PÂSLARU CAŞIN",294,"Alegeri Prezidentiale",1,1266,503,472,31,0,495,8,1400,897,301,194
4,BACĂU,CAŞIN,21720,CURIŢA,"GRĂDINIŢA CURIŢA",295,"Alegeri Prezidentiale",1,615,299,265,34,0,297,2,700,401,205,92
4,BACĂU,CĂIUŢI,21757,CĂIUŢI,"SCOALA GIMNAZIALA CAIUTI",296,"Alegeri Prezidentiale",1,1352,559,510,49,0,554,5,1500,941,323,231
4,BACĂU,CĂIUŢI,21757,POPENI,"ŞCOALA POPENI",297,"Alegeri Prezidentiale",1,663,306,279,27,0,299,7,700,394,175,124
4,BACĂU,CĂIUŢI,21757,BLIDARI,"ŞCOALA BLIDARI",298,"Alegeri Prezidentiale",1,595,241,212,29,0,239,2,600,359,132,107
4,BACĂU,CĂIUŢI,21757,PRALEA,"ŞCOALA PRALEA",299,"Alegeri Prezidentiale",2,745,338,305,33,0,333,5,800,462,183,150
4,BACĂU,CĂIUŢI,21757,BOIŞTEA,"ŞCOALA BOIŞTEA",300,"Alegeri Prezidentiale",1,142,76,59,17,0,76,0,200,124,49,27
4,BACĂU,CĂIUŢI,21757,HELTIU,"ŞCOALA HELTIU",301,"Alegeri Prezidentiale",1,312,147,123,24,0,145,2,401,254,105,40
4,BACĂU,CĂIUŢI,21757,VRÂNCENI,"ŞCOALA VRÂNCENI",302,"Alegeri Prezidentiale",1,312,135,112,23,0,135,0,400,265,101,34
4,BACĂU,CĂIUŢI,21757,MĂRCEŞTI,"SCOALA PRIMARA MARCESTI",303,"Alegeri Prezidentiale",1,113,57,43,14,0,56,1,200,143,13,43
4,BACĂU,CLEJA,21855,CLEJA,"ŞCOALA NR.1 CLEJA",304,"Alegeri Prezidentiale",1,772,299,259,40,0,291,8,800,501,258,33
4,BACĂU,CLEJA,21855,CLEJA,"SCOALA NR.1 CLEJA",305,"Alegeri Prezidentiale",1,1510,542,508,34,0,536,6,1600,1058,473,63
4,BACĂU,CLEJA,21855,CLEJA,"ŞCOALA NR.2 CLEJA",306,"Alegeri Prezidentiale",1,1445,565,543,22,0,555,10,1600,1035,482,73
4,BACĂU,CLEJA,21855,SOMUŞCA,"ŞCOALA SOMUŞCA",307,"Alegeri Prezidentiale",2,1178,441,425,16,0,432,9,1300,859,378,54
4,BACĂU,CLEJA,21855,"VALEA MICĂ","ŞCOALA VALEA MICĂ",308,"Alegeri Prezidentiale",1,561,220,205,15,0,215,5,600,380,173,42
4,BACĂU,COLONEŞTI,21891,COLONEŞTI,"ŞCOALA GIMNAZIALĂ COLONEŞTI",309,"Alegeri Prezidentiale",1,1111,444,410,34,0,439,5,1200,756,169,270
4,BACĂU,COLONEŞTI,21891,SPRIA,"ŞCOALA GIMNAZIALĂ SPRIA",310,"Alegeri Prezidentiale",1,276,168,128,40,0,168,0,300,132,76,92
4,BACĂU,COLONEŞTI,21891,"SATU NOU","ŞCOALA PRIMARĂ SATU NOU",311,"Alegeri Prezidentiale",1,268,116,107,9,0,114,2,300,184,66,48
4,BACĂU,CORBASCA,21971,CORBASCA,"SCOALA GIMNAZIALA CU CLASELE I - VIII",312,"Alegeri Prezidentiale",1,603,249,224,25,0,244,5,700,451,120,124
4,BACĂU,CORBASCA,21971,SCĂRIŞOARA,"ŞCOALA CU CLASELE I -IV SCARISOARA",313,"Alegeri Prezidentiale",1,636,255,231,24,0,253,2,700,445,118,135
4,BACĂU,CORBASCA,21971,MARVILA,"ŞCOALA CU CLASELE I-VIII MARVILA",314,"Alegeri Prezidentiale",2,474,165,141,24,0,164,1,500,335,100,64
4,BACĂU,CORBASCA,21971,VÂLCELE,"ŞCOALA CU CLASELE.I-IV VÎLCELE",315,"Alegeri Prezidentiale",1,498,136,128,8,0,135,1,500,364,75,60
4,BACĂU,CORBASCA,21971,BĂCIOIU,"ŞCOALA CU CLASELE.I-VIII BĂCIOIU",316,"Alegeri Prezidentiale",1,1581,267,245,22,0,262,5,1700,1433,100,162
4,BACĂU,CORBASCA,21971,ROGOAZA,"ŞCOALA CU CLASELE .I-IV ROGOAZA",317,"Alegeri Prezidentiale",1,261,110,89,21,0,107,3,300,190,59,48
4,BACĂU,COŢOFĂNEŞTI,22059,COŢOFĂNEŞTI,"PRIMĂRIA COŢOFĂNEŞTI",318,"Alegeri Prezidentiale",1,985,572,522,50,0,559,13,1100,528,168,391
4,BACĂU,COŢOFĂNEŞTI,22059,BORŞANI,"ŞCOALA CU CLASELE I-VIII BORŞANI",319,"Alegeri Prezidentiale",1,584,318,292,26,0,314,4,600,282,150,164
4,BACĂU,COŢOFĂNEŞTI,22059,BÂLCA,"ŞCOALA CU CLASELE I-IV BÎLCA",320,"Alegeri Prezidentiale",1,591,300,270,30,0,295,5,599,299,80,215
4,BACĂU,COŢOFĂNEŞTI,22059,TĂMĂŞOAIA,"ŞCOALA CU CLASELE I-IV TĂMĂSOAIA",321,"Alegeri Prezidentiale",1,364,224,206,18,0,223,1,400,176,35,188
4,BACĂU,DĂMIENEŞTI,22111,DĂMIENEŞTI,"ŞCOALA GENERALĂ CU CLASELE I-IV DĂMIENEŞTI",322,"Alegeri Prezidentiale",1,450,208,163,45,0,202,6,500,292,88,114
4,BACĂU,DĂMIENEŞTI,22111,CĂLUGĂRENI,"ŞCOALA GENERALĂ CU CLASELE I-VIII CĂLUGĂRENI",323,"Alegeri Prezidentiale",1,780,305,295,10,0,294,11,900,595,179,115
4,BACĂU,DĂMIENEŞTI,22111,DRĂGEŞTI,"ŞCOALA GENERALĂ CU CASELE I-IV DRĂGEŞTI",324,"Alegeri Prezidentiale",1,224,142,98,44,0,138,4,297,155,77,61
4,BACĂU,"DEALU MORII",22237,"DEALU MORII","CAMIN CULTURAL DEALU MORII",325,"Alegeri Prezidentiale",1,865,439,355,67,17,435,4,1000,561,171,264
4,BACĂU,"DEALU MORII",22237,CĂUIA,"ŞCOALA CU CLASELE I-IV CĂUIA",326,"Alegeri Prezidentiale",1,531,264,214,34,16,259,5,600,336,129,130
4,BACĂU,"DEALU MORII",22237,NEGULEŞTI,"ŞCOALA CU CLASELE I-VIII NEGULEŞTI",327,"Alegeri Prezidentiale",1,462,254,212,37,5,252,2,508,254,158,94
4,BACĂU,"DEALU MORII",22237,TĂVĂDĂREŞTI,"ŞCOALA TĂVĂDĂRĂŞTI",328,"Alegeri Prezidentiale",1,296,159,116,28,15,156,3,300,141,84,72
4,BACĂU,DOFTEANA,22380,DOFTEANA,"SCOALA SCARLAT LONGHIN DOFTEANA",329,"Alegeri Prezidentiale",1,1402,570,534,27,9,560,10,1500,930,297,263
4,BACĂU,DOFTEANA,22380,DOFTEANA,"SCOALA SCARLAT LONGHIN DOFTEANA",330,"Alegeri Prezidentiale",1,1207,497,470,17,10,489,8,1300,803,304,185
4,BACĂU,DOFTEANA,22380,HĂGHIAC,"ŞCOALA GENERALA CU CLASELE I-VIII HĂGHIAC",331,"Alegeri Prezidentiale",1,1222,583,555,17,11,576,7,1300,717,379,197
4,BACĂU,DOFTEANA,22380,BOGATA,"ȘCOALA CU CLASELE I-IV BOGATA",332,"Alegeri Prezidentiale",1,713,333,299,32,2,328,5,800,467,195,133
4,BACĂU,DOFTEANA,22380,CUCUIEŢI,"SCOALA GENERALA CU CLASELE I-VIII CUCUIETI",333,"Alegeri Prezidentiale",1,900,421,394,17,10,417,4,1000,579,227,190
4,BACĂU,DOFTEANA,22380,CUCUIEŢI,"SCOALA GENERALA CU CLASELE I-VIII CUCUIETI",334,"Alegeri Prezidentiale",1,1037,475,453,16,6,468,7,1100,625,257,211
4,BACĂU,DOFTEANA,22380,LARGA,"ŞCOALA GENERALA CU CLASELE I-VIII LARGA",335,"Alegeri Prezidentiale",1,1042,548,500,26,22,533,15,1100,552,264,269
4,BACĂU,DOFTEANA,22380,"ŞTEFAN VODĂ","ŞCOALA GENERALA CU CLASELE I-IV ŞTEFAN VODĂ",336,"Alegeri Prezidentiale",1,901,366,351,11,4,359,7,1000,634,241,118
4,BACĂU,DOFTEANA,22380,SEACA,"ŞCOALA GENERALA CU CLASELE I-IV SEACA",337,"Alegeri Prezidentiale",2,372,191,177,9,5,189,2,400,209,116,73
4,BACĂU,FARAOANI,22460,FARAOANI,"ŞCOALA GIMNAZIALA NR.1 FARAOANI",338,"Alegeri Prezidentiale",1,1114,430,398,32,0,423,7,1200,770,367,56
4,BACĂU,FARAOANI,22460,FARAOANI,"ŞCOALA GIMNAZIALA NR.1 FARAOANI",339,"Alegeri Prezidentiale",1,1373,538,516,22,0,526,12,1486,948,468,58
4,BACĂU,FARAOANI,22460,FARAOANI,"ŞCOALA GIMNAZIALA NR.2 FARAOANI",340,"Alegeri Prezidentiale",1,986,400,351,49,0,395,5,1100,700,321,74
4,BACĂU,FARAOANI,22460,FARAOANI,"ŞCOALA GIMNAZIALA NR.2 FARAOANI",341,"Alegeri Prezidentiale",2,919,351,334,17,0,349,2,1000,649,295,54
4,BACĂU,FILIPENI,22488,FILIPENI,"PRIMĂRIA FILIPENI",342,"Alegeri Prezidentiale",1,539,348,264,59,25,339,9,600,252,130,209
4,BACĂU,FILIPENI,22488,MĂRĂŞTI,"ŞCOALA CU CLASELE I-IV MĂRĂŞTI",343,"Alegeri Prezidentiale",1,581,386,275,89,22,383,3,600,214,236,147
4,BACĂU,FILIPENI,22488,FRUNTEŞTI,"ŞCOALA CU CLASELE I-IV FRUNTEŞTI",344,"Alegeri Prezidentiale",1,612,325,282,43,0,320,5,700,375,145,175
4,BACĂU,FILIPEŞTI,22576,FILIPEŞTI,"ŞCOALA FILIPEŞTI",345,"Alegeri Prezidentiale",1,799,358,285,73,0,352,6,900,542,209,143
4,BACĂU,FILIPEŞTI,22576,GALBENI,"ŞCOALA GALBENI",346,"Alegeri Prezidentiale",1,705,251,216,35,0,249,2,800,549,152,97
4,BACĂU,FILIPEŞTI,22576,CÂRLIGI,"ŞCOALA CÎRLIGI",347,"Alegeri Prezidentiale",1,923,323,275,48,0,320,3,1000,677,224,96
4,BACĂU,FILIPEŞTI,22576,ONIŞCANI,"ŞCOALA ONIŞCANI",348,"Alegeri Prezidentiale",1,402,178,135,43,0,177,1,500,322,107,70
4,BACĂU,FILIPEŞTI,22576,BOANŢA,"ŞCOALA BOANŢA",349,"Alegeri Prezidentiale",1,264,104,73,31,0,101,3,300,196,47,54
4,BACĂU,FILIPEŞTI,22576,HÂRLEŞTI,"ŞCOALA HÎRLEŞTI",350,"Alegeri Prezidentiale",1,639,275,239,36,0,270,5,700,425,179,91
4,BACĂU,GĂICEANA,22665,GĂICEANA,"PRIMĂRIA GĂICEANA",351,"Alegeri Prezidentiale",1,742,383,327,49,7,372,11,800,417,201,171
4,BACĂU,GĂICEANA,22665,ARINI,"ŞCOALA ARINI",352,"Alegeri Prezidentiale",1,981,449,421,21,7,445,4,1100,651,252,193
4,BACĂU,GĂICEANA,22665,HUŢU,"ŞCOALA HUŢU",353,"Alegeri Prezidentiale",1,458,306,252,40,14,302,4,500,194,135,167
4,BACĂU,GÂRLENI,22781,"GÂRLENII DE SUS","ŞCOALA CU CL.I-VIII GÎRLENII DE SUS",354,"Alegeri Prezidentiale",1,1463,508,470,38,0,508,0,1600,1092,445,63
4,BACĂU,GÂRLENI,22781,GÂRLENI,"ŞCOALA CU CL.I-VIII GÎRLENI",355,"Alegeri Prezidentiale",1,1041,403,363,40,0,399,4,1100,697,308,91
4,BACĂU,GÂRLENI,22781,GÂRLENI,"ŞCOALA CU CL.I-VIII GÎRLENI",356,"Alegeri Prezidentiale",2,945,371,342,29,0,366,5,1000,629,266,100
4,BACĂU,GÂRLENI,22781,LESPEZI,"ŞCOALA CU CL.I-VIII LESPEZI",357,"Alegeri Prezidentiale",1,967,354,327,27,0,351,3,1100,746,293,58
4,BACĂU,GÂRLENI,22781,LESPEZI,"ŞCOALA CU CL.I-VIII LESPEZI",358,"Alegeri Prezidentiale",1,1224,462,442,20,0,456,6,1300,838,395,61
4,BACĂU,GHIMEŞ-FĂGET,22718,FĂGET,"PRIMĂRIA FĂGET",359,"Alegeri Prezidentiale",1,1096,325,285,40,0,320,5,1200,875,250,70
4,BACĂU,GHIMEŞ-FĂGET,22718,TĂRHĂUŞI,"ŞCOALA GENERALA CU CLASELE I-VIII TĂRHĂUŞI",360,"Alegeri Prezidentiale",1,659,191,177,14,0,186,5,600,409,150,36
4,BACĂU,GHIMEŞ-FĂGET,22718,GHIMEŞ,"ŞCOALA GENERALA CU CLASELE I-VIII GHIMEŞ",361,"Alegeri Prezidentiale",1,878,208,180,28,0,204,4,1000,792,158,46
4,BACĂU,GHIMEŞ-FĂGET,22718,"FĂGETU DE SUS","ŞCOALA GENERALA CU CLASELE I-IV FĂGETUL DE SUS",362,"Alegeri Prezidentiale",1,208,75,61,14,0,73,2,300,225,54,19
4,BACĂU,GHIMEŞ-FĂGET,22718,BOLOVĂNIŞ,"ŞCOALA GENERALA CU CLASELE I-VIII BOLOVĂNIŞ",363,"Alegeri Prezidentiale",1,732,220,196,24,0,218,2,800,580,171,47
4,BACĂU,GHIMEŞ-FĂGET,22718,RĂCHITIŞ,"ŞCOALA GENERALA CU CLASELE I-IV RĂCHITIŞ",364,"Alegeri Prezidentiale",1,187,93,76,17,0,92,1,200,107,41,51
4,BACĂU,GIOSENI,26346,GIOSENI,"ŞCOALA GENERALA CU CLASELE I-VIII ION STRAT GIOSENI",365,"Alegeri Prezidentiale",1,955,394,345,49,0,391,3,1000,606,295,96
4,BACĂU,GIOSENI,26346,GIOSENI,"ŞCOALA GENERALA CU CLASELE I-VIII ION STRAT GIOSENI",366,"Alegeri Prezidentiale",1,1137,433,408,25,0,427,6,1300,867,354,73
4,BACĂU,GIOSENI,26346,GIOSENI,"SCOALA GENERALA CU CLASELE I-VIII ION STRAT GIOSENI",367,"Alegeri Prezidentiale",1,1092,364,358,6,0,358,6,1200,836,247,111
4,BACĂU,GLĂVĂNEŞTI,22834,GLĂVĂNEŞTI,"CĂMINUL CULTURAL GLĂVĂNEŞTI",368,"Alegeri Prezidentiale",1,1417,557,502,55,0,551,6,1600,1043,293,258
4,BACĂU,GLĂVĂNEŞTI,22834,FRUMUŞELU,"CĂMINUL CULTURAL FRUMUŞELU",369,"Alegeri Prezidentiale",1,1033,360,317,43,0,357,3,1100,740,224,133
4,BACĂU,GLĂVĂNEŞTI,22834,MUNCELU,"SCOALA MUNCELU",370,"Alegeri Prezidentiale",1,192,93,77,16,0,93,0,200,107,62,31
4,BACĂU,"GURA VĂII",20607,"GURA VĂII","PRIMĂRIA GURA VĂII",371,"Alegeri Prezidentiale",1,1233,558,519,39,0,552,6,1400,842,384,168
4,BACĂU,"GURA VĂII",20607,"GURA VĂII","GRĂDINIŢA PĂTRĂŞCANI",372,"Alegeri Prezidentiale",1,318,160,146,14,0,155,5,400,240,122,33
4,BACĂU,"GURA VĂII",20607,MOTOCEŞTI,"CASA PRAZNICALĂ BISERICA ORTODOXĂ SF.TREIME - MOTOCEŞTI",373,"Alegeri Prezidentiale",1,116,61,45,16,0,60,1,200,139,40,20
4,BACĂU,"GURA VĂII",20607,TEMELIA,"ŞCOALA TEMELIA",374,"Alegeri Prezidentiale",1,766,195,183,12,0,189,6,800,605,123,66
4,BACĂU,"GURA VĂII",20607,PĂLTINATA,"ŞCOALA PĂLTINATA",375,"Alegeri Prezidentiale",1,361,148,121,27,0,145,3,400,252,97,48
4,BACĂU,"GURA VĂII",20607,DUMBRAVA,"SCOALA GENERALA CU CLASELE I-VIII DUMBRAVA",376,"Alegeri Prezidentiale",1,982,403,377,26,0,393,10,1100,697,252,141
4,BACĂU,"GURA VĂII",20607,CAPĂTA,"ŞCOALA CAPĂTA",377,"Alegeri Prezidentiale",1,287,143,127,16,0,143,0,300,157,98,45
4,BACĂU,HELEGIU,22898,HELEGIU,"ŞCOALA GIMNAZIALĂ HELEGIU",378,"Alegeri Prezidentiale",1,951,372,338,34,0,366,6,1000,628,207,159
4,BACĂU,HELEGIU,22898,BRĂTILA,"ŞCOALA GIMNAZIALĂ BRĂTILA 2",379,"Alegeri Prezidentiale",2,668,243,214,28,1,237,6,700,457,122,115
4,BACĂU,HELEGIU,22898,BRĂTILA,"SCOALA CU CLASELE I-VIII BRATILA 1",380,"Alegeri Prezidentiale",1,865,322,297,25,0,319,3,1000,678,182,137
4,BACĂU,HELEGIU,22898,DELENI,"SCOALA GIMNAZIALA DELENI",381,"Alegeri Prezidentiale",1,1339,407,384,23,0,399,8,1500,1093,206,193
4,BACĂU,HELEGIU,22898,DRĂGUGEŞTI,"ŞCOALA GIMNAZIALĂ NR.1 DRĂGUGEŞTI",382,"Alegeri Prezidentiale",1,1214,411,393,18,0,403,8,1400,989,251,152
4,BACĂU,HELEGIU,22898,DRĂGUGEŞTI,"ŞCOALA PRIMARĂ NR.2 DRĂGUGEŞTI",383,"Alegeri Prezidentiale",1,376,125,113,12,0,122,3,400,275,74,48
4,BACĂU,HEMEIUŞ,20313,HEMEIUŞ,"CĂMINUL CULTURAL HEMEIUŞ",384,"Alegeri Prezidentiale",1,1467,772,657,115,0,754,18,1600,828,565,189
4,BACĂU,HEMEIUŞ,20313,HEMEIUŞ,"ŞCOALA GENERALA GRIGORE TĂBĂCARU HEMEIUŞ",385,"Alegeri Prezidentiale",1,835,523,425,98,0,513,10,900,377,378,135
4,BACĂU,HEMEIUŞ,20313,LILIECI,"SCOALA GENERALA ION SIMIONESCU, LILIECI",386,"Alegeri Prezidentiale",1,1509,791,704,87,0,779,12,1600,809,591,188
4,BACĂU,HEMEIUŞ,20313,LILIECI,"ŞCOALA GENERALA ION SIMIONESCU LILIECI",387,"Alegeri Prezidentiale",1,1174,653,573,80,0,639,14,1300,647,492,147
4,BACĂU,HORGEŞTI,22941,HORGEŞTI,"PRIMĂRIA HORGEŞTI",388,"Alegeri Prezidentiale",1,1393,470,431,39,0,460,10,1500,1030,248,212
4,BACĂU,HORGEŞTI,22941,SOHODOR,"ŞCOALA SOHODOR",389,"Alegeri Prezidentiale",1,1010,354,336,18,0,354,0,1100,746,51,303
4,BACĂU,HORGEŞTI,22941,RECEA,"ŞCOALA RECEA",390,"Alegeri Prezidentiale",1,658,266,240,26,0,261,5,700,434,70,191
4,BACĂU,HORGEŞTI,22941,RĂCĂTĂU-RĂZEŞI,"ŞCOALA RĂCĂTĂU",391,"Alegeri Prezidentiale",1,905,344,315,29,0,340,4,1000,656,100,240
4,BACĂU,HURUIEŞTI,23047,HURUIEŞTI,"PRIMĂRIA HURUIEŞTI",392,"Alegeri Prezidentiale",1,582,247,207,40,0,243,4,600,353,125,118
4,BACĂU,HURUIEŞTI,23047,PERCHIU,"FOSTUL LOCAL AL ŞCOLII PERCHIU",393,"Alegeri Prezidentiale",1,124,58,47,11,0,58,0,200,142,38,20
4,BACĂU,HURUIEŞTI,23047,PRĂDAIŞ,"FOSTUL LOCAL AL ŞCOLII PRADAIŞ",394,"Alegeri Prezidentiale",1,254,165,110,55,0,165,0,300,135,75,90
4,BACĂU,HURUIEŞTI,23047,CĂPOTEŞTI,"FOSTUL LOCAL AL ŞCOLII CAPOTEŞTI",395,"Alegeri Prezidentiale",1,165,121,81,40,0,120,1,200,79,65,55
4,BACĂU,HURUIEŞTI,23047,OCHENI,"LOCALUL ŞCOLII OCHENI",396,"Alegeri Prezidentiale",1,288,162,135,27,0,160,2,300,138,64,96
4,BACĂU,HURUIEŞTI,23047,FLOREŞTI,"FOSTUL LOCAL AL ŞCOLII FLOREŞTI",397,"Alegeri Prezidentiale",1,134,70,57,13,0,70,0,203,133,49,21
4,BACĂU,HURUIEŞTI,23047,FUNDOAIA,"LOCALUL ŞCOLII FUNDOAIA",398,"Alegeri Prezidentiale",1,317,181,163,18,0,177,4,400,219,48,129
4,BACĂU,ITEŞTI,26379,ITEŞTI,"ŞCOALA CL.I-VIII ITEŞTI",399,"Alegeri Prezidentiale",2,713,357,295,62,0,350,7,800,443,238,112
4,BACĂU,ITEŞTI,26379,DUMBRAVA,"ŞCOALA DUMBRAVA",400,"Alegeri Prezidentiale",1,364,220,166,54,0,217,3,401,181,152,65
4,BACĂU,ITEŞTI,26379,CIUMAŞI,"CĂMINUL CULTURAL CIUMAŞI",401,"Alegeri Prezidentiale",1,137,83,54,29,0,83,0,200,117,63,20
4,BACĂU,"IZVORU BERHECIULUI",23127,"IZVORU BERHECIULUI","ŞCOALA CONSTANTIN MOSCU IZV.BERHECIULUI",402,"Alegeri Prezidentiale",1,646,259,226,31,2,257,2,700,441,140,117
4,BACĂU,"IZVORU BERHECIULUI",23127,ANTOHEŞTI,"ŞCOALA GENERALĂ ANTOHEŞTI",403,"Alegeri Prezidentiale",1,311,141,113,28,0,141,0,400,259,74,67
4,BACĂU,"IZVORU BERHECIULUI",23127,OBÂRŞIA,"ŞCOALA GENERALĂ OBÎRŞIA",404,"Alegeri Prezidentiale",1,311,166,122,43,1,165,1,400,234,114,51
4,BACĂU,"LETEA VECHE",20359,"LETEA VECHE","ŞCOALA COORDONATOARE LETEA VECHE",405,"Alegeri Prezidentiale",1,1426,694,626,68,0,682,12,1600,906,452,230
4,BACĂU,"LETEA VECHE",20359,"LETEA VECHE","SCOALA COORDONATOARE LETEA VECHE",406,"Alegeri Prezidentiale",1,1608,823,751,72,0,802,21,1800,977,578,224
4,BACĂU,"LETEA VECHE",20359,HOLT,"ŞCOALA HOLT",407,"Alegeri Prezidentiale",1,1459,779,698,81,0,763,16,1600,821,512,251
4,BACĂU,"LETEA VECHE",20359,RADOMIREŞTI,"ŞCOALA RADOMIREŞTI",408,"Alegeri Prezidentiale",1,336,172,146,26,0,171,1,400,228,123,48
4,BACĂU,"LETEA VECHE",20359,RUŞI-CIUTEA,"ŞCOALA RUŞI CIUTEA",409,"Alegeri Prezidentiale",1,587,344,282,62,0,339,5,600,256,205,134
4,BACĂU,"LETEA VECHE",20359,SIRETU,"ŞCOALA SIRETU",410,"Alegeri Prezidentiale",1,457,258,213,45,0,254,4,500,242,154,100
4,BACĂU,LIPOVA,23207,LIPOVA,"ŞCOALA CU CLASELE I-VIII M.EMINESCU LIPOVA",411,"Alegeri Prezidentiale",2,509,281,241,22,18,277,4,600,319,93,184
4,BACĂU,LIPOVA,23207,"VALEA HOGEI","ŞCOALA CU CLASELE I-IV VALEA HOGEI",412,"Alegeri Prezidentiale",1,224,129,94,32,3,127,2,300,171,58,69
4,BACĂU,LIPOVA,23207,"SATU NOU","ŞCOALA CU CLASELE I-VIII SATU NOU",413,"Alegeri Prezidentiale",2,396,184,165,12,7,181,3,401,217,56,125
4,BACĂU,LIPOVA,23207,"VALEA CASELOR","ŞCOALA CU CLASELE I-IV VALEA CASELOR",414,"Alegeri Prezidentiale",1,370,195,167,24,4,193,2,400,205,61,132
4,BACĂU,LIPOVA,23207,MÂLOSU,"ŞCOALA CU CLASELE I-VIII MÎLOSU",415,"Alegeri Prezidentiale",1,757,348,311,32,5,345,3,800,452,121,224
4,BACĂU,LIVEZI,23289,LIVEZI,"ŞCOALA GIMNAZIALĂ NR.1 LIVEZI",416,"Alegeri Prezidentiale",1,777,250,225,25,0,248,2,900,650,120,128
4,BACĂU,LIVEZI,23289,ORĂŞA,"ŞCOALA PRIMARĂ ORĂŞA",417,"Alegeri Prezidentiale",1,705,320,297,23,0,310,10,800,480,140,170
4,BACĂU,LIVEZI,23289,PRĂJOAIA,"ŞCOALA PRIMARĂ PRĂJOAIA",418,"Alegeri Prezidentiale",1,792,269,249,20,0,263,6,900,631,133,130
4,BACĂU,LIVEZI,23289,SCĂRIGA,"ŞCOALA PRIMARĂ SCĂRIGA",419,"Alegeri Prezidentiale",1,447,203,190,13,0,201,2,497,294,132,69
4,BACĂU,LIVEZI,23289,POIANA,"ŞCOALA GIMNAZIALĂ POIANA",420,"Alegeri Prezidentiale",2,737,267,246,21,0,266,1,800,533,176,90
4,BACĂU,LIVEZI,23289,BĂLĂNEASA,"ŞCOALA PRIMARĂ BĂLĂNEASA",421,"Alegeri Prezidentiale",1,916,338,303,35,0,331,7,1000,662,194,137
4,BACĂU,LUIZI-CĂLUGĂRA,23350,LUIZI-CĂLUGĂRA,"ŞCOALA CU CLASELE I-VIII LUIZI CĂLUGĂRA",422,"Alegeri Prezidentiale",1,1227,424,384,40,0,420,4,1400,976,333,87
4,BACĂU,LUIZI-CĂLUGĂRA,23350,LUIZI-CĂLUGĂRA,"ŞCOALA CU CLASELE I-VIII LUIZI CĂLUGĂRA",423,"Alegeri Prezidentiale",1,1214,397,359,38,0,391,6,1300,903,340,51
4,BACĂU,LUIZI-CĂLUGĂRA,23350,OSEBIŢI,"ŞCOALA CU CLASELE I-VIII OSEBIŢI",424,"Alegeri Prezidentiale",1,861,310,288,22,0,310,0,900,590,244,66
4,BACĂU,LUIZI-CĂLUGĂRA,23350,OSEBIŢI,"ŞCOALA CU CLASELE I-VIII OSEBIŢI",425,"Alegeri Prezidentiale",1,891,317,293,24,0,313,4,1000,683,257,56
4,BACĂU,MĂGIREŞTI,23387,MĂGIREŞTI,"CAMINUL CULTURAL MAGIRESTI",426,"Alegeri Prezidentiale",1,1489,614,587,27,0,609,5,1600,986,406,203
4,BACĂU,MĂGIREŞTI,23387,STĂNEŞTI,"ŞCOALA CU CLASELE.I-IV STĂNEŞTI (CORP NOU)",427,"Alegeri Prezidentiale",1,500,190,177,13,0,188,2,500,310,129,59
4,BACĂU,MĂGIREŞTI,23387,"VALEA ARINILOR","ŞCOALA CU CLASELE I-VIII VALEA ARINILOR",428,"Alegeri Prezidentiale",1,976,443,415,28,0,434,9,1100,657,306,128
4,BACĂU,MĂGIREŞTI,23387,PRĂJEŞTI,"SCOALA CU CLASELE I-IV PRAJESTII",429,"Alegeri Prezidentiale",1,497,234,213,21,0,223,11,499,265,163,60
4,BACĂU,MĂGURA,20411,MĂGURA,"ŞCOALA NR.2 MĂGURA-SALA 1",430,"Alegeri Prezidentiale",1,1067,579,518,61,0,568,11,1200,621,416,152
4,BACĂU,MĂGURA,20411,MĂGURA,"SCOALA NR.2 SAT MAGURA - SALA 2",431,"Alegeri Prezidentiale",1,833,374,326,48,0,366,8,900,526,263,103
4,BACĂU,MĂGURA,20411,MĂGURA,"ŞCOALA GENERALA NR.1 EMIL BRĂIESCU MĂGURA",432,"Alegeri Prezidentiale",1,1378,684,582,102,0,678,6,1500,816,530,148
4,BACĂU,MĂGURA,20411,SOHODOL,"CAMIN CULTURAL SOHODOL",433,"Alegeri Prezidentiale",1,1096,451,401,50,0,448,3,1200,749,364,84
4,BACĂU,"MĂNĂSTIREA CAŞIN",23449,"MĂNĂSTIREA CAŞIN","CĂMINUL CULTURAL SATUL MĂNĂSTIREA CAŞIN",434,"Alegeri Prezidentiale",1,1587,596,561,35,0,586,10,1700,1104,391,195
4,BACĂU,"MĂNĂSTIREA CAŞIN",23449,PÂRVULEŞTI,"CĂMINUL CULTURAL SATUL MĂNĂSTIREA CAŞIN",435,"Alegeri Prezidentiale",1,600,204,197,7,0,202,2,700,496,146,56
4,BACĂU,"MĂNĂSTIREA CAŞIN",23449,SCUTARU,"ŞCOALA GENERALA.NR.2 MĂNĂSTIREA CAŞIN",436,"Alegeri Prezidentiale",1,1641,599,580,19,0,591,8,1800,1201,380,211
4,BACĂU,"MĂNĂSTIREA CAŞIN",23449,LUPEŞTI,"ŞCOALA LUPEŞTI",437,"Alegeri Prezidentiale",1,621,255,229,26,0,252,3,700,445,166,86
4,BACĂU,MĂRGINENI,20466,MĂRGINENI,"ŞCOALA CU CLASELE I-VIII MĂRGINENI",438,"Alegeri Prezidentiale",3,1097,501,445,56,0,491,10,1200,699,392,99
4,BACĂU,MĂRGINENI,20466,MĂRGINENI,"ŞCOALA CU CLASELE I-VIII MĂRGINENI",439,"Alegeri Prezidentiale",1,1293,504,460,44,0,499,5,1400,896,390,109
4,BACĂU,MĂRGINENI,20466,MĂRGINENI,"ŞCOALA CU CLASELE I-VIII MĂRGINENI",440,"Alegeri Prezidentiale",1,1081,448,404,44,0,445,3,1200,752,352,93
4,BACĂU,MĂRGINENI,20466,BARAŢI,"ŞCOALA CU CLASELE I-VIII BARAŢI",441,"Alegeri Prezidentiale",1,1724,761,688,73,0,750,11,1900,1139,569,181
4,BACĂU,MĂRGINENI,20466,TREBEŞ,"ŞCOALA CU CLASELE I-VIII TREBEŞ",442,"Alegeri Prezidentiale",1,703,294,260,34,0,286,8,800,506,218,68
4,BACĂU,MĂRGINENI,20466,"VALEA BUDULUI","ŞCOALA CU CLASELE I - IV VALEA BUDULUI",443,"Alegeri Prezidentiale",1,415,234,198,36,0,229,5,499,265,174,55
4,BACĂU,MĂRGINENI,20466,PĂDURENI,"ŞCOALA CU CLASELE I - IV PĂDURENI",444,"Alegeri Prezidentiale",1,313,135,107,28,0,135,0,400,265,109,26
4,BACĂU,MĂRGINENI,20466,LUNCANI,"ŞCOALA CU CLASELE I-VIII LUNCANI",445,"Alegeri Prezidentiale",1,1028,481,389,92,0,476,5,1100,619,339,137
4,BACĂU,MĂRGINENI,20466,PODIŞ,"ŞCOALA CU CLASELE I - IV PODIȘ",446,"Alegeri Prezidentiale",1,552,278,209,69,0,275,3,600,322,178,97
4,BACĂU,MOTOŞENI,23494,MOTOŞENI,"PRIMĂRIA MOTOŞENI",447,"Alegeri Prezidentiale",1,863,408,352,56,0,405,3,900,492,168,237
4,BACĂU,MOTOŞENI,23494,ŢEPOAIA,"ŞCOALA SATUL ŢEPOAIA",448,"Alegeri Prezidentiale",1,422,224,196,28,0,222,2,500,276,88,134
4,BACĂU,MOTOŞENI,23494,COCIU,"ŞCOALA SATUL COCIU",449,"Alegeri Prezidentiale",1,246,108,95,13,0,108,0,300,192,32,76
4,BACĂU,MOTOŞENI,23494,POIANA,"ŞCOALA SATUL POIANA",450,"Alegeri Prezidentiale",2,260,157,109,48,0,154,3,300,143,41,113
4,BACĂU,MOTOŞENI,23494,FÂNTÂNELE,"ŞCOALA SATUL FÎNTÎNELE",451,"Alegeri Prezidentiale",1,536,267,222,45,0,266,1,600,333,101,165
4,BACĂU,MOTOŞENI,23494,ŞENDREŞTI,"ŞCOALA SATUL ŞENDREŞTI",452,"Alegeri Prezidentiale",1,301,203,165,38,0,203,0,400,197,74,129
4,BACĂU,NEGRI,23644,NEGRI,"ŞCOALA COSTACHE NEGRI SATUL NEGRI",453,"Alegeri Prezidentiale",3,1074,469,392,77,0,464,5,1200,731,235,229
4,BACĂU,NEGRI,23644,POIANA,"ŞCOALA ION IONESCU DE LA BRAD SATUL POIANA-NEGRI",454,"Alegeri Prezidentiale",1,1193,430,410,20,0,425,5,1300,870,241,184
4,BACĂU,"NICOLAE BĂLCESCU",23715,"NICOLAE BĂLCESCU","SCOALA NICOLAE BALCESCU",455,"Alegeri Prezidentiale",1,1185,458,428,30,0,453,5,1300,842,393,60
4,BACĂU,"NICOLAE BĂLCESCU",23715,"NICOLAE BĂLCESCU","SCOALA NICOLAE BALCESCU",456,"Alegeri Prezidentiale",1,1530,613,566,47,0,605,8,1700,1087,524,81
4,BACĂU,"NICOLAE BĂLCESCU",23715,"NICOLAE BĂLCESCU","SCOALA NICOLAE BALCESCU",457,"Alegeri Prezidentiale",1,1595,605,568,37,0,596,9,1800,1195,513,83
4,BACĂU,"NICOLAE BĂLCESCU",23715,GALBENI,"ŞCOALA SATUL GALBENI",458,"Alegeri Prezidentiale",1,1200,563,522,41,0,555,8,1300,737,496,59
4,BACĂU,"NICOLAE BĂLCESCU",23715,"VALEA SEACĂ","GRADINITA NR.1 VALEA SEACA",459,"Alegeri Prezidentiale",1,794,287,268,19,0,285,2,900,613,236,49
4,BACĂU,"NICOLAE BĂLCESCU",23715,"VALEA SEACĂ","GRADINITA NR.1 VALEA SEACA",460,"Alegeri Prezidentiale",2,1011,368,345,23,0,364,4,1100,732,309,55
4,BACĂU,"NICOLAE BĂLCESCU",23715,"VALEA SEACĂ","GRADINITA NR.1 VALEA SEACA",461,"Alegeri Prezidentiale",1,676,233,212,21,0,233,0,700,467,174,59
4,BACĂU,"NICOLAE BĂLCESCU",23715,LĂRGUŢA,"ŞCOALA SATUL LĂRGUŢA",462,"Alegeri Prezidentiale",1,178,89,79,10,0,88,1,200,111,63,25
4,BACĂU,ODOBEŞTI,26353,ODOBEŞTI,"ŞCOALA CU CLASELE I-IV ODOBEŞTI",463,"Alegeri Prezidentiale",1,365,193,144,49,0,190,3,400,207,96,94
4,BACĂU,ODOBEŞTI,26353,TISA-SILVESTRI,"ŞCOALA CU CLASELE I-VIII TISA SILVESTRI",464,"Alegeri Prezidentiale",1,890,488,426,62,0,476,12,1000,512,170,306
4,BACĂU,ODOBEŞTI,26353,CIUTUREŞTI,"ŞCOALA CU CLASELE I-VIII CIUTUREŞTI",465,"Alegeri Prezidentiale",1,632,289,263,26,0,283,6,699,410,155,128
4,BACĂU,OITUZ,23797,OITUZ,"SCOALA GIMNAZIALA, COMUNA OITUZ",466,"Alegeri Prezidentiale",1,523,220,193,27,0,217,3,600,380,146,71
4,BACĂU,OITUZ,23797,OITUZ,"SCOALA GIMNAZIALA NR. 1 OITUZ",467,"Alegeri Prezidentiale",1,1324,481,451,30,0,473,8,1500,1019,341,132
4,BACĂU,OITUZ,23797,OITUZ,"GRADINITA NR. 1 OITUZ",468,"Alegeri Prezidentiale",1,1501,515,494,21,0,511,4,1700,1185,373,138
4,BACĂU,OITUZ,23797,OITUZ,"GRADINITA NR. 2 OITUZ",469,"Alegeri Prezidentiale",2,916,388,352,36,0,384,4,1000,612,246,138
4,BACĂU,OITUZ,23797,OITUZ,"GRADINITA NR.3 OITUZ",470,"Alegeri Prezidentiale",1,1037,329,321,8,0,328,1,1100,771,243,85
4,BACĂU,OITUZ,23797,MARGINEA,"GRĂDINIŢA MARGINEA",471,"Alegeri Prezidentiale",1,603,230,220,10,0,227,3,700,470,136,91
4,BACĂU,OITUZ,23797,CĂLCÂI,"GRĂDINIŢA CĂLCÂI",472,"Alegeri Prezidentiale",1,384,163,148,15,0,159,4,400,237,130,29
4,BACĂU,OITUZ,23797,FERESTRĂU-OITUZ,"ŞCOALA GIMNAZIALA FERESTRAU",473,"Alegeri Prezidentiale",1,888,370,339,31,0,366,4,1000,630,245,121
4,BACĂU,OITUZ,23797,HÂRJA,"AŞEZĂMÂNT FILANTROPIC ”SFÂNTUL VOIEVOD ŞTEFAN CEL MARE” HÎRJA",474,"Alegeri Prezidentiale",1,263,182,95,87,0,178,4,300,118,99,79
4,BACĂU,OITUZ,23797,"POIANA SĂRATĂ","SCOALA POIANA-SĂRATĂ",475,"Alegeri Prezidentiale",1,217,134,96,38,0,133,1,300,166,88,45
4,BACĂU,ONCEŞTI,23868,ONCEŞTI,"CĂMINUL CULTURAL SATUL ONCEŞTI",476,"Alegeri Prezidentiale",1,739,346,300,46,0,338,8,800,454,150,188
4,BACĂU,ONCEŞTI,23868,TARNIŢA,"SALA DE FESTIVITĂŢI SATUL TARNIŢA",477,"Alegeri Prezidentiale",1,527,284,260,24,0,281,3,600,316,96,185
4,BACĂU,ORBENI,23948,ORBENI,"ŞCOALA CU CLASELE I-VIII SATUL ORBENI",478,"Alegeri Prezidentiale",1,917,396,335,61,0,392,4,1000,604,227,165
4,BACĂU,ORBENI,23948,ORBENI,"ŞCOALA PRIMARĂ NR.2 SATUL ORBENI",479,"Alegeri Prezidentiale",1,669,251,219,32,0,248,3,700,449,140,108
4,BACĂU,ORBENI,23948,SCURTA,"ŞCOALA GIMNAZIALA NR. 1 SATUL SCURTA",480,"Alegeri Prezidentiale",1,1380,503,460,43,0,495,8,1500,997,257,238
4,BACĂU,PALANCA,23975,PALANCA,"PRIMĂRIA PALANCA",481,"Alegeri Prezidentiale",2,1252,530,481,48,1,511,19,1400,870,244,267
4,BACĂU,PALANCA,23975,CIUGHEŞ,"CĂMINUL CULTURAL SATUL CIUGHEŞ",482,"Alegeri Prezidentiale",1,1452,601,550,51,0,578,23,1600,999,234,344
4,BACĂU,PALANCA,23975,CĂDĂREŞTI,"ŞCOALA SATUL CĂDĂRĂŞTI",483,"Alegeri Prezidentiale",1,86,52,19,33,0,50,2,100,48,27,23
4,BACĂU,PARAVA,24034,PARAVA,"PRIMARIA COMUNEI PARAVA (SALA DE FESTIVITATI)",484,"Alegeri Prezidentiale",2,740,281,236,45,0,278,3,800,519,188,90
4,BACĂU,PARAVA,24034,DRĂGUŞANI,"ŞCOALA GIMNAZIALĂ SATUL DRĂGUŞANI",485,"Alegeri Prezidentiale",2,697,303,247,56,0,300,3,800,497,196,104
4,BACĂU,PARAVA,24034,RĂDOAIA,"ŞCOALA GIMNAZIALĂ SATUL RĂDOAIA",486,"Alegeri Prezidentiale",1,973,134,114,20,0,129,5,1100,966,74,55
4,BACĂU,PARAVA,24034,TEIUŞ,"ŞCOALA PRIMARĂ SATUL TEIUŞ",487,"Alegeri Prezidentiale",1,207,109,92,17,0,108,1,300,191,63,45
4,BACĂU,PARINCEA,24089,PARINCEA,"LICEUL TEHNOLOGIC ”G.J.CANCICOV” PARINCEA",488,"Alegeri Prezidentiale",1,733,346,287,59,0,341,5,800,454,167,174
4,BACĂU,PARINCEA,24089,VĂLENI,"ŞCOALA VĂLENI",489,"Alegeri Prezidentiale",2,443,164,139,25,0,157,7,500,336,110,47
4,BACĂU,PARINCEA,24089,VLADNIC,"ŞCOALA VLADNIC",490,"Alegeri Prezidentiale",1,675,344,299,45,0,338,6,700,356,222,116
4,BACĂU,PARINCEA,24089,NĂNEŞTI,"ŞCOALA NĂNEŞTI",491,"Alegeri Prezidentiale",1,590,260,235,25,0,258,2,700,440,131,127
4,BACĂU,PARINCEA,24089,POIENI,"CENTRU EVENIMENTE POIENI",492,"Alegeri Prezidentiale",1,232,98,76,22,0,98,0,300,202,44,54
4,BACĂU,PARINCEA,24089,"MILEŞTII DE JOS","ŞCOALA MILEŞTII DE JOS",493,"Alegeri Prezidentiale",1,227,105,87,18,0,100,5,300,195,41,59
4,BACĂU,PÂNCEŞTI,24187,PÂNCEŞTI,"ŞCOALA NR.1 PÎNCEŞTI",494,"Alegeri Prezidentiale",1,1146,407,341,66,0,400,7,1300,893,194,206
4,BACĂU,PÂNCEŞTI,24187,DIENEŢ,"ŞCOALA SATUL DIENEŢ",495,"Alegeri Prezidentiale",1,533,273,232,41,0,270,3,600,327,143,127
4,BACĂU,PÂNCEŞTI,24187,PETREŞTI,"ŞCOALA GENERALĂ SATUL PETREŞTI",496,"Alegeri Prezidentiale",1,661,261,224,37,0,253,8,700,439,138,115
4,BACĂU,PÂNCEŞTI,24187,SOCI,"ŞCOALA GENERALĂ SATUL SOCI",497,"Alegeri Prezidentiale",1,638,205,178,27,0,200,5,700,495,85,115
4,BACĂU,PÂNCEŞTI,24187,FULGERIŞ,"ŞCOALA GENERALĂ SATUL FULGERIŞ",498,"Alegeri Prezidentiale",1,402,129,115,14,0,127,2,500,371,68,59
4,BACĂU,PÂRGĂREŞTI,24276,"PÂRÂU BOGHII","GRĂDINIŢA CU PROGRAM NORMAL SATUL PÎRÎU BOGHII",499,"Alegeri Prezidentiale",1,366,184,167,17,0,180,4,400,216,108,72
4,BACĂU,PÂRGĂREŞTI,24276,PÂRGĂREŞTI,"ŞCOALA GIMNAZIALĂ DUMITRU MĂRTINAŞ SATUL PÎRGĂREŞTI",500,"Alegeri Prezidentiale",1,805,245,222,23,0,244,1,900,655,183,61
4,BACĂU,PÂRGĂREŞTI,24276,"SATU NOU","ŞCOALA GIMNAZIALĂ VASILE GH.RADUSATUL SATU NOU",501,"Alegeri Prezidentiale",1,1333,413,396,17,0,409,4,1500,1087,365,44
4,BACĂU,PÂRGĂREŞTI,24276,NICOREŞTI,"ŞCOALA GIMNAZIALĂ CONSTANTIN MUŞAT SATUL NICOREŞTI",502,"Alegeri Prezidentiale",1,823,272,265,7,0,268,4,900,628,229,39
4,BACĂU,PÂRGĂREŞTI,24276,BAHNA,"GRĂDINIŢA CU PROGRAM NORMAL BAHNA",503,"Alegeri Prezidentiale",1,475,169,153,16,0,168,1,500,331,138,30
4,BACĂU,PÂRJOL,24338,PÂRJOL,"ŞCOALA SATUL PÎRJOL",504,"Alegeri Prezidentiale",1,732,310,261,48,1,307,3,800,490,198,109
4,BACĂU,PÂRJOL,24338,TĂRÂŢA,"CĂMINUL CULTURAL TĂRÂŢA",505,"Alegeri Prezidentiale",1,830,314,280,32,2,311,3,900,586,232,79
4,BACĂU,PÂRJOL,24338,BĂHNĂŞENI,"ŞCOALA SATUL BĂHNĂŞENI",506,"Alegeri Prezidentiale",1,710,256,236,20,0,249,7,800,544,164,85
4,BACĂU,PÂRJOL,24338,BĂRNEŞTI,"ŞCOALA SATUL BĂRNEŞTI",507,"Alegeri Prezidentiale",1,185,94,74,20,0,94,0,200,106,58,36
4,BACĂU,PÂRJOL,24338,BĂSĂŞTI,"ŞCOALA SATUL BĂSEŞTI",508,"Alegeri Prezidentiale",1,500,172,158,14,0,170,2,601,429,104,66
4,BACĂU,PÂRJOL,24338,HĂINEALA,"ŞCOALA SATUL HĂINEALA",509,"Alegeri Prezidentiale",2,216,91,68,23,0,90,1,300,209,54,36
4,BACĂU,PÂRJOL,24338,CÂMPENI,"ŞCOALA SATUL CÎMPENI",510,"Alegeri Prezidentiale",1,500,180,163,17,0,179,1,600,420,124,55
4,BACĂU,PÂRJOL,24338,PUSTIANA,"GRĂDINIŢA PUSTIANA",511,"Alegeri Prezidentiale",1,669,227,204,23,0,220,7,700,473,167,53
4,BACĂU,PÂRJOL,24338,PUSTIANA,"ŞCOALA CU CLASELE .I-VIII PUSTIANA",512,"Alegeri Prezidentiale",1,873,299,267,32,0,296,3,1000,701,234,62
4,BACĂU,PLOPANA,24427,PLOPANA,"PRIMĂRIA PLOPANA",513,"Alegeri Prezidentiale",1,749,318,267,40,11,314,4,800,482,154,160
4,BACĂU,PLOPANA,24427,"FUNDU TUTOVEI","ŞCOALA CU CLASELE I-IV SATUL FUNDU TUTOVEI",514,"Alegeri Prezidentiale",1,465,206,183,23,0,202,4,500,294,78,124
4,BACĂU,PLOPANA,24427,IŢCANI,"ŞCOALA CU CLASELE I-IV SATUL IŢCANI",515,"Alegeri Prezidentiale",1,630,290,257,31,2,283,7,700,410,90,193
4,BACĂU,PLOPANA,24427,"RUSENII RĂZEŞI","ŞCOALA CU CLASELE I-VIII SATUL RUSENII-RĂZEŞI",516,"Alegeri Prezidentiale",1,314,181,148,27,6,179,2,400,219,72,107
4,BACĂU,PLOPANA,24427,STRĂMINOASA,"ŞCOALA CU CLASELE I-IV SATUL STRĂMINOASA",517,"Alegeri Prezidentiale",1,342,165,136,29,0,159,6,400,235,55,104
4,BACĂU,"PODU TURCULUI",24524,"PODU TURCULUI","CĂMINUL CULTURAL PODU TURCULUI",518,"Alegeri Prezidentiale",1,1797,904,774,130,0,892,12,2000,1096,485,407
4,BACĂU,"PODU TURCULUI",24524,"PODU TURCULUI","ȘCOALA GENERALĂ NR. 3 PODU TURCULUI",519,"Alegeri Prezidentiale",1,519,265,250,15,0,264,1,600,335,103,161
4,BACĂU,"PODU TURCULUI",24524,CĂBEŞTI,"CĂMINUL CULTURAL SATUL CĂBEŞTI",520,"Alegeri Prezidentiale",1,717,313,248,65,0,302,11,800,487,180,122
4,BACĂU,"PODU TURCULUI",24524,LEHANCEA,"ŞCOALA GENERALĂ SATUL LEHANCEA",521,"Alegeri Prezidentiale",2,523,220,191,29,0,219,1,600,380,137,82
4,BACĂU,"PODU TURCULUI",24524,SÂRBI,"ŞCOALA GENERALĂ SATUL SÎRBI",522,"Alegeri Prezidentiale",1,365,181,172,9,0,178,3,400,219,74,104
4,BACĂU,PODURI,24631,PODURI,"ŞCOALA SATUL PODURI",523,"Alegeri Prezidentiale",1,1197,481,431,50,0,470,11,1300,819,258,212
4,BACĂU,PODURI,24631,PODURI,"ŞCOALA SATUL PODURI",524,"Alegeri Prezidentiale",1,1019,443,408,35,0,434,9,1100,657,209,225
4,BACĂU,PODURI,24631,"VALEA ŞOŞII","ŞCOALA SATUL VALEA ŞOSII",525,"Alegeri Prezidentiale",1,957,416,375,38,3,407,9,1100,684,212,195
4,BACĂU,PODURI,24631,PROHOZEŞTI,"ŞCOALA SATUL PROHOZEŞTI",526,"Alegeri Prezidentiale",1,799,325,301,24,0,323,2,900,575,179,144
4,BACĂU,PODURI,24631,BUCŞEŞTI,"ŞCOALA SATUL BUCŞEŞTI",527,"Alegeri Prezidentiale",1,1335,528,494,34,0,514,14,1500,972,302,212
4,BACĂU,PODURI,24631,CERNU,"ŞCOALA SATUL CERNU",528,"Alegeri Prezidentiale",1,1192,462,431,31,0,458,4,1300,838,224,234
4,BACĂU,PRĂJEŞTI,26361,PRĂJEŞTI,"SCOALA GIMNAZIALA GHEORGHE AVRAMESCU PRAJESTI-SALA DE SPORT",529,"Alegeri Prezidentiale",1,970,381,335,46,0,376,5,1100,719,263,113
4,BACĂU,PRĂJEŞTI,26361,PRĂJEŞTI,"SCOALA GIMNAZIALA GHEORGHE AVRAMESCU PRĂJEŞTI - SALA CANCELARIEI",530,"Alegeri Prezidentiale",1,931,315,268,46,1,312,3,1000,685,208,104
4,BACĂU,RACOVA,24711,RACOVA,"ŞCOALA NR.1 IOAN BORCEA RACOVA",531,"Alegeri Prezidentiale",1,1315,566,497,69,0,560,6,1400,834,318,242
4,BACĂU,RACOVA,24711,RACOVA,"ŞCOALA NR.2 RACOVA-ŞES",532,"Alegeri Prezidentiale",1,611,300,261,39,0,296,4,700,400,173,123
4,BACĂU,RACOVA,24711,"GURA VĂII","ŞCOALA SATUL GURA VĂII",533,"Alegeri Prezidentiale",1,1029,378,342,36,0,376,2,1100,722,232,144
4,BACĂU,RĂCĂCIUNI,24766,RĂCĂCIUNI,"CASA DE CULTURĂ NICOLAE STROESATUL RĂCĂCIUNI",534,"Alegeri Prezidentiale",1,1551,521,478,43,0,512,9,1700,1179,364,148
4,BACĂU,RĂCĂCIUNI,24766,RĂCĂCIUNI,"GRĂDINIŢA NR.2 SATUL RĂCĂCIUNI",535,"Alegeri Prezidentiale",1,1335,433,388,45,0,422,11,1500,1067,289,133
4,BACĂU,RĂCĂCIUNI,24766,"GHEORGHE DOJA","ŞCOALA CU CLASELE I-VIII SATUL GHEORGHE DOJA",536,"Alegeri Prezidentiale",1,924,323,300,23,0,319,4,1000,677,256,63
4,BACĂU,RĂCĂCIUNI,24766,GÂŞTENI,"ŞCOALA CU CLASELE I-VIII SATUL GÎŞTENI",537,"Alegeri Prezidentiale",1,761,363,278,76,9,337,26,800,437,245,92
4,BACĂU,RĂCĂCIUNI,24766,"FUNDU RĂCĂCIUNI","ŞCOALA CU CLASELE I-VIII SATUL FUNDU RĂCĂCIUNI",538,"Alegeri Prezidentiale",1,1493,511,485,26,0,503,8,1600,1089,429,74
4,BACĂU,RĂCĂCIUNI,24766,CIUCANI,"ŞCOALA CU CLASELE I-IV SATUL CIUCANI",539,"Alegeri Prezidentiale",1,467,211,196,15,0,209,2,500,289,194,15
4,BACĂU,RĂCHITOASA,24837,RĂCHITOASA,"CĂMINUL CULTURAL SATUL RĂCHITOASA",540,"Alegeri Prezidentiale",1,1097,473,398,52,23,470,3,1200,727,188,282
4,BACĂU,RĂCHITOASA,24837,"FUNDĂTURA RĂCHITOASA","ŞCOALA CU CLASELE .I-IV SATUL FUNDĂTURA-RĂCHITOASA",541,"Alegeri Prezidentiale",1,227,88,72,16,0,86,2,300,212,48,38
4,BACĂU,RĂCHITOASA,24837,DUMBRAVA,"CASA PRASNICALĂ DIN SATUL DUMBRAVA",542,"Alegeri Prezidentiale",1,535,182,163,19,0,180,2,600,418,50,130
4,BACĂU,RĂCHITOASA,24837,BURDUSACI,"ŞCOALA CU CLASELE.I-VIII SATUL BURDUSACI",543,"Alegeri Prezidentiale",1,694,247,218,29,0,246,1,800,553,80,166
4,BACĂU,RĂCHITOASA,24837,BARCANA,"ŞCOALA CU CLASELE .I-IV SATUL BARCANA",544,"Alegeri Prezidentiale",1,522,167,155,12,0,161,6,600,433,63,98
4,BACĂU,RĂCHITOASA,24837,BUDA,"ŞCOALA CU CLASELE .I-VIII SATUL BUDA",545,"Alegeri Prezidentiale",1,534,247,196,45,6,244,3,600,353,97,147
4,BACĂU,ROŞIORI,24999,ROŞIORI,"ŞCOALA GIMNAZIALĂ NR.1 SATUL ROŞIORI",546,"Alegeri Prezidentiale",1,1009,410,380,30,0,405,5,1100,690,202,203
4,BACĂU,ROŞIORI,24999,POIENI,"ŞCOALA PRIMARĂ SATUL POIENI",547,"Alegeri Prezidentiale",1,289,135,103,32,0,135,0,300,165,63,72
4,BACĂU,ROŞIORI,24999,"VALEA MARE","ŞCOALA PRIMARĂ SATUL VALEA MARE",548,"Alegeri Prezidentiale",1,480,225,185,40,0,222,3,500,275,111,111
4,BACĂU,SASCUT,25068,SASCUT,"LICEUL JACQUES MENACHEN ELIAS SASCUT",549,"Alegeri Prezidentiale",1,1342,604,514,86,4,594,10,1500,896,361,233
4,BACĂU,SASCUT,25068,SASCUT,"LICEUL JACQUES MENACHEN ELIAS SASCUT",550,"Alegeri Prezidentiale",1,1252,577,497,76,4,565,12,1400,823,358,207
4,BACĂU,SASCUT,25068,BEREŞTI,"SCOALA GENERALA CU CLASELE I-IV BERESTI",551,"Alegeri Prezidentiale",1,1143,659,527,106,26,651,8,1299,640,337,314
4,BACĂU,SASCUT,25068,CONŢEŞTI,"SCOALA CU CLASELE I-IV SATUL CONTESTI",552,"Alegeri Prezidentiale",1,443,322,222,89,11,320,2,495,173,143,177
4,BACĂU,SASCUT,25068,PĂNCEŞTI,"SCOALA CU CLASELE I-VIII NR 1 PANCESTI",553,"Alegeri Prezidentiale",1,915,423,388,32,3,419,4,1000,577,259,160
4,BACĂU,SASCUT,25068,PĂNCEŞTI,"SCOALA CU CLASELE I-VIII NR 1 PANCESTI",554,"Alegeri Prezidentiale",1,1244,562,499,58,5,558,4,1400,838,342,216
4,BACĂU,SASCUT,25068,SASCUT-SAT,"SCOALA CU CLASELE I-VIII SATUL SASCUT-SAT",555,"Alegeri Prezidentiale",2,902,445,372,61,12,440,5,1000,555,247,193
4,BACĂU,SASCUT,25068,SASCUT-SAT,"SCOALA CU CLASELE I-VIII SATUL SASCUT-SAT",556,"Alegeri Prezidentiale",1,763,410,340,61,9,405,5,800,390,227,178
4,BACĂU,SĂNDULENI,25148,SĂNDULENI,"ŞOALA GENERALĂ CU CLASELE I-VIII SĂNDULENI",557,"Alegeri Prezidentiale",1,1605,517,470,47,0,510,7,1800,1283,260,250
4,BACĂU,SĂNDULENI,25148,VERŞEŞTI,"ŞCOALA GENERALA CU CLASELE I-VIII VERŞEŞTI",558,"Alegeri Prezidentiale",1,675,293,265,28,0,283,10,700,407,96,187
4,BACĂU,SĂNDULENI,25148,COMAN,"ŞCOALA GENERALĂ CU CLASELE I-VIII COMAN",559,"Alegeri Prezidentiale",1,1078,366,344,22,0,358,8,1200,834,164,194
4,BACĂU,SĂNDULENI,25148,STUFU,"ŞCOALA GENERALĂ CU CLASELE I-IV STUFU",560,"Alegeri Prezidentiale",1,299,154,128,26,0,152,2,401,247,98,54
4,BACĂU,SĂRATA,26320,SĂRATA,"SCOALA NR. 1 SĂRATA",561,"Alegeri Prezidentiale",1,603,271,232,39,0,267,4,700,429,176,91
4,BACĂU,SĂRATA,26320,SĂRATA,"SCOALA NR. 2 SĂRATA",562,"Alegeri Prezidentiale",1,813,381,322,58,1,376,5,900,519,248,128
4,BACĂU,SĂRATA,26320,SĂRATA,"SCOALA NR. 3 SĂRATA",563,"Alegeri Prezidentiale",1,384,182,155,27,0,178,4,400,218,117,61
4,BACĂU,SĂUCEŞTI,25228,SĂUCEŞTI,"ŞCOALA I.S.STURZA SATUL SĂUCEŞTI",564,"Alegeri Prezidentiale",1,1085,532,482,50,0,523,9,1200,668,315,208
4,BACĂU,SĂUCEŞTI,25228,SĂUCEŞTI,"ŞCOALA I.S.STURZA SATUL SĂUCEŞTI",565,"Alegeri Prezidentiale",1,947,482,385,97,0,474,8,1000,518,274,200
4,BACĂU,SĂUCEŞTI,25228,SCHINENI,"ŞCOALA SATUL SCHINENI",566,"Alegeri Prezidentiale",1,674,389,317,72,0,383,6,700,311,209,174
4,BACĂU,SĂUCEŞTI,25228,SIRETU,"ŞCOALA SATUL SIRETU",567,"Alegeri Prezidentiale",1,631,329,273,56,0,320,9,700,371,156,164
4,BACĂU,SĂUCEŞTI,25228,ŞERBEŞTI,"ŞCOALA SATUL ŞERBEŞTI",568,"Alegeri Prezidentiale",1,478,242,205,37,0,240,2,500,258,113,127
4,BACĂU,SĂUCEŞTI,25228,"BOGDAN VODĂ","ŞCOALA SATUL BOGDAN VODĂ",569,"Alegeri Prezidentiale",1,576,370,292,78,0,360,10,600,230,248,112
4,BACĂU,SCORŢENI,25291,SCORŢENI,"ŞCOALA CU CLASELE I-VIII SATUL SCORŢENI",570,"Alegeri Prezidentiale",1,1247,439,407,32,0,433,6,1400,961,247,186
4,BACĂU,SCORŢENI,25291,GRIGORENI,"CAMIN CULTURAL GRIGORENI",571,"Alegeri Prezidentiale",1,681,320,248,72,0,312,8,695,375,170,142
4,BACĂU,SCORŢENI,25291,FLOREŞTI,"CAMIN CULTURAL FLORESTI",572,"Alegeri Prezidentiale",1,567,208,182,26,0,204,4,600,392,118,86
4,BACĂU,SECUIENI,25362,SECUIENI,"ŞCOALA GIMNAZIALĂ SATUL SECUIENI",573,"Alegeri Prezidentiale",2,1119,476,427,49,0,471,5,1200,724,318,153
4,BACĂU,SECUIENI,25362,FUNDENI,"ŞCOALA SATUL FUNDENI",574,"Alegeri Prezidentiale",1,279,174,119,55,0,171,3,300,126,98,73
4,BACĂU,SECUIENI,25362,CHITICENI,"ŞCOALA SATUL CHITICENI",575,"Alegeri Prezidentiale",2,150,96,75,21,0,96,0,202,106,51,45
4,BACĂU,SECUIENI,25362,GLODIŞOARELE,"ŞCOALA SATUL GLODIŞOARELE",576,"Alegeri Prezidentiale",1,218,92,79,13,0,91,1,300,208,37,54
4,BACĂU,SOLONŢ,25488,SOLONŢ,"ŞCOALA CU CLASELE I-VIII SATUL SOLONŢ",577,"Alegeri Prezidentiale",1,1191,438,393,45,0,430,8,1298,860,191,239
4,BACĂU,SOLONŢ,25488,SĂRATA,"CABINET MEDICAL",578,"Alegeri Prezidentiale",1,679,229,207,22,0,228,1,700,471,89,139
4,BACĂU,SOLONŢ,25488,CUCUIEŢI,"ŞCOALA CU CLASELE I-VIII SATUL CUCUIEȚI",579,"Alegeri Prezidentiale",1,1029,366,340,26,0,363,3,1100,734,172,191
4,BACĂU,STĂNIŞEŞTI,25521,STĂNIŞEŞTI,"PRIMĂRIA STĂNIŞEŞTI",580,"Alegeri Prezidentiale",1,795,349,316,33,0,347,2,900,551,125,222
4,BACĂU,STĂNIŞEŞTI,25521,BENEŞTI,"SCOALA BENESTI",581,"Alegeri Prezidentiale",1,371,151,135,16,0,147,4,400,249,59,88
4,BACĂU,STĂNIŞEŞTI,25521,CRĂIEŞTI,"SCOALA SATUL CRĂIEŞTI",582,"Alegeri Prezidentiale",1,371,163,137,26,0,161,2,400,237,59,102
4,BACĂU,STĂNIŞEŞTI,25521,SLOBOZIA,"SCOALA SLOBOZIA NR. 2",583,"Alegeri Prezidentiale",1,481,198,167,31,0,191,7,500,302,90,101
4,BACĂU,STĂNIŞEŞTI,25521,SLOBOZIA,"ŞCOALA 1 SATUL SLOBOZIA",584,"Alegeri Prezidentiale",1,735,245,210,35,0,238,7,800,555,85,153
4,BACĂU,STĂNIŞEŞTI,25521,"SLOBOZIA NOUĂ","ŞCOALA SATUL SLOBOZIA NOUĂ",585,"Alegeri Prezidentiale",1,571,252,229,23,0,246,6,600,348,83,163
4,BACĂU,STRUGARI,25629,STRUGARI,"ŞCOALA GENERALĂ SATUL STRUGARI",586,"Alegeri Prezidentiale",1,833,326,298,25,3,317,9,900,574,110,207
4,BACĂU,STRUGARI,25629,RĂCHITIŞU,"ŞCOALA GENERALĂ SATUL RĂCHITIŞ",587,"Alegeri Prezidentiale",1,335,167,144,18,5,166,1,400,233,77,89
4,BACĂU,STRUGARI,25629,PETRICICA,"ŞCOALA GENERALĂ SATUL PETRICICA",588,"Alegeri Prezidentiale",1,569,217,181,36,0,217,0,600,383,120,97
4,BACĂU,STRUGARI,25629,CETĂŢUIA,"SCOALA GENERALA CETATUIA",589,"Alegeri Prezidentiale",1,220,107,79,28,0,107,0,300,193,57,50
4,BACĂU,"ŞTEFAN CEL MARE",20670,"ŞTEFAN CEL MARE","GRĂDINIŢA CU PROGRAM NORMAL SATUL ŞTEFAN CEL MARE",590,"Alegeri Prezidentiale",1,743,346,304,41,1,340,6,800,454,188,152
4,BACĂU,"ŞTEFAN CEL MARE",20670,BOGDANA,"SCOALA GENERALA SATUL BOGDANA",591,"Alegeri Prezidentiale",1,477,248,221,27,0,243,5,500,252,117,126
4,BACĂU,"ŞTEFAN CEL MARE",20670,NEGOIEŞTI,"BIBLIOTECA COMUNALĂ SATUL NEGOIEŞTI",592,"Alegeri Prezidentiale",1,725,400,348,49,3,394,6,800,400,182,212
4,BACĂU,"ŞTEFAN CEL MARE",20670,VIIŞOARA,"GRĂDINIŢA CU PROGRAM NORMAL SATUL VIIŞOARA",593,"Alegeri Prezidentiale",1,494,248,210,38,0,244,4,499,251,162,82
4,BACĂU,"ŞTEFAN CEL MARE",20670,GUTINAŞ,"GRĂDINIŢA CU PROGRAM NORMAL SATUL GUTINAŞ",594,"Alegeri Prezidentiale",1,337,174,144,30,0,171,3,400,226,69,102
4,BACĂU,"ŞTEFAN CEL MARE",20670,RĂDEANA,"GRĂDINIŢA CU PROGRAM NORMAL SATUL RĂDEANA",595,"Alegeri Prezidentiale",1,1215,669,626,40,3,654,15,1300,631,234,420
4,BACĂU,TAMAŞI,25692,TAMAŞI,"CENTRUL EDUCAŢIONAL ÎNV.DUMITRU NEDIŢĂ TAMAŞI",596,"Alegeri Prezidentiale",1,1258,680,607,73,0,670,10,1400,720,284,386
4,BACĂU,TAMAŞI,25692,CHETRIŞ,"ŞCOALA CU CLASELE I-VIII SATUL CHETRIŞ",597,"Alegeri Prezidentiale",1,655,366,316,50,0,361,5,700,334,189,172
4,BACĂU,TAMAŞI,25692,FURNICARI,"ŞCOALA CU CLASELE I-IV SATUL FURNICARI",598,"Alegeri Prezidentiale",1,530,268,246,22,0,267,1,600,332,115,152
4,BACĂU,TĂTĂRĂŞTI,25745,TĂTĂRĂŞTI,"PRIMĂRIA TĂTĂRĂŞTI",599,"Alegeri Prezidentiale",1,381,181,159,22,0,177,4,400,219,67,110
4,BACĂU,TĂTĂRĂŞTI,25745,"CORNII DE SUS","ŞCOALA GIMNAZIALA SATUL CORNII DE SUS",600,"Alegeri Prezidentiale",1,729,316,283,33,0,311,5,800,484,139,172
4,BACĂU,TĂTĂRĂŞTI,25745,GIURGENI,"ŞCOALA PRIMARA SATUL GIURGENI",601,"Alegeri Prezidentiale",1,203,111,95,16,0,109,2,300,189,48,61
4,BACĂU,TĂTĂRĂŞTI,25745,DRĂGEŞTI,"ŞCOALA PRIMARA SATUL DRĂGEŞTI",602,"Alegeri Prezidentiale",1,300,152,131,21,0,150,2,300,148,54,96
4,BACĂU,TĂTĂRĂŞTI,25745,GHERDANA,"ŞCOALA PRIMARA SATUL GHERDANA",603,"Alegeri Prezidentiale",1,283,123,105,18,0,122,1,300,177,71,51
4,BACĂU,"TÂRGU TROTUŞ",25825,VIIŞOARA,"GRĂDINIŢA CU PROGRAM NORMAL SATUL VIIŞOARA",604,"Alegeri Prezidentiale",1,913,374,339,35,0,370,4,1000,626,250,120
4,BACĂU,"TÂRGU TROTUŞ",25825,"TÂRGU TROTUŞ","GRĂDINIŢA CU PROGRAM NORMAL TG.TROTUŞ",605,"Alegeri Prezidentiale",1,937,390,344,46,0,382,8,1000,610,275,107
4,BACĂU,"TÂRGU TROTUŞ",25825,"TÂRGU TROTUŞ","GRĂDINIŢA CU PROGRAM NORMAL TG.TROTUŞ",606,"Alegeri Prezidentiale",1,889,384,369,15,0,376,8,1000,616,261,115
4,BACĂU,"TÂRGU TROTUŞ",25825,TUTA,"GRĂDINIŢA CU PROGRAM NORMAL SATUL TUTA",607,"Alegeri Prezidentiale",1,829,349,329,20,0,341,8,900,551,251,90
4,BACĂU,"TÂRGU TROTUŞ",25825,TUTA,"GRĂDINIŢA CU PROGRAM NORMAL SATUL TUTA",608,"Alegeri Prezidentiale",1,930,428,420,8,0,423,5,1000,572,293,130
4,BACĂU,TRAIAN,25861,TRAIAN,"ŞCOALA CU CLASELE I-VIII SATUL TRAIAN",609,"Alegeri Prezidentiale",1,1439,614,502,112,0,607,7,1600,986,457,150
4,BACĂU,TRAIAN,25861,BOGDĂNEŞTI,"ŞCOALA CU CLASELE I-IV SATUL BOGDĂNEŞTI",610,"Alegeri Prezidentiale",1,451,156,139,17,0,153,3,500,344,122,31
4,BACĂU,TRAIAN,25861,ZĂPODIA,"ŞCOALA CU CLASELE I-IV SATUL ZĂPODIA",611,"Alegeri Prezidentiale",1,524,183,148,35,0,182,1,600,417,143,39
4,BACĂU,TRAIAN,25861,"HERTIOANA DE JOS","ŞCOALA CU CLASELE I-IV SATUL HERTIOANA DE JOS",612,"Alegeri Prezidentiale",1,146,91,52,39,0,89,2,200,109,48,41
4,BACĂU,UNGURENI,25932,UNGURENI,"CĂMINUL CULTURAL UNGURENI",613,"Alegeri Prezidentiale",1,758,373,308,65,0,363,10,800,427,134,229
4,BACĂU,UNGURENI,25932,VIFORENI,"SCOALA VIFORENI",614,"Alegeri Prezidentiale",1,372,165,135,30,0,165,0,400,235,77,88
4,BACĂU,UNGURENI,25932,BĂRTĂŞEŞTI,"ŞCOALA SATUL BĂRTĂŞEŞTI",615,"Alegeri Prezidentiale",1,301,146,132,14,0,146,0,300,154,48,98
4,BACĂU,UNGURENI,25932,BOTEŞTI,"CĂMINUL CULTURAL SATUL BOTEŞTI",616,"Alegeri Prezidentiale",1,685,265,237,28,0,265,0,700,435,105,160
4,BACĂU,UNGURENI,25932,BIBIREŞTI,"SCOALA BIBIRESTI II",617,"Alegeri Prezidentiale",1,762,380,348,32,0,377,3,800,420,161,216
4,BACĂU,URECHEŞTI,26029,URECHEŞTI,"SALA DE CEREMONII",618,"Alegeri Prezidentiale",1,1374,544,492,52,0,537,7,1500,956,316,221
4,BACĂU,URECHEŞTI,26029,CORNĂŢEL,"CĂMINUL CULTURAL SATUL CORNĂŢEL",619,"Alegeri Prezidentiale",1,698,324,277,47,0,309,15,800,476,192,117
4,BACĂU,URECHEŞTI,26029,SLOBOZIA,"GRĂDINIŢA SATUL SLOBOZIA",620,"Alegeri Prezidentiale",2,447,172,153,19,0,169,3,500,328,111,58
4,BACĂU,URECHEŞTI,26029,"LUNCA DOCHIEI","ŞCOALA GENERALA CU CASELE I-IV SATUL LUNCA DOCHIEI",621,"Alegeri Prezidentiale",1,256,118,95,23,0,116,2,300,182,56,60
4,BACĂU,URECHEŞTI,26029,"SATU NOU","ŞCOALA GENERALA CU CLASELE I-IV SATUL SATU NOU",622,"Alegeri Prezidentiale",1,259,134,111,22,1,132,2,300,166,73,59
4,BACĂU,"VALEA SEACĂ",26083,"VALEA SEACĂ","ŞCOALA GIMNAZIALĂ NR.1 VALEA SEACĂ",623,"Alegeri Prezidentiale",1,936,358,297,51,10,356,2,1000,642,111,245
4,BACĂU,"VALEA SEACĂ",26083,"VALEA SEACĂ","ŞCOALA PRIMARĂ NR.2 VALEA SEACĂ",624,"Alegeri Prezidentiale",1,667,345,265,66,14,335,10,700,355,136,199
4,BACĂU,"VALEA SEACĂ",26083,"VALEA SEACĂ","ŞCOALA PRIMARĂ NR.3 VALEA SEACĂ",625,"Alegeri Prezidentiale",1,732,318,275,39,4,310,8,800,482,102,208
4,BACĂU,"VALEA SEACĂ",26083,CUCOVA,"ŞCOALA PRIMARĂ CUCOVA",626,"Alegeri Prezidentiale",1,532,274,218,53,3,273,1,600,326,129,144
4,BACĂU,VULTURENI,26118,VULTURENI,"SCOALA VULTURENI",627,"Alegeri Prezidentiale",1,402,184,151,33,0,179,5,500,316,98,81
4,BACĂU,VULTURENI,26118,LICHITIŞENI,"CENTRU DE ZI LICHITISENI",628,"Alegeri Prezidentiale",1,435,141,128,13,0,140,1,500,359,69,71
4,BACĂU,VULTURENI,26118,"GODINEŞTII DE JOS","CENTRUL EDUCAŢIONAL COMUNITARGODINEŞTII DE JOS",629,"Alegeri Prezidentiale",1,300,136,112,24,0,134,2,400,264,87,47
4,BACĂU,VULTURENI,26118,MEDELENI,"ŞCOALA MEDELENI",630,"Alegeri Prezidentiale",1,142,91,70,21,0,88,3,200,109,59,29
4,BACĂU,VULTURENI,26118,GHILĂVEŞTI,"ŞCOALA GHILĂVEŞTI",631,"Alegeri Prezidentiale",1,229,137,118,19,0,134,3,300,163,102,32
4,BACĂU,ZEMEŞ,26289,ZEMEŞ,"ŞCOALA MIHAI EMINESCU ZEMEŞ",632,"Alegeri Prezidentiale",2,1108,487,459,28,0,484,3,1200,713,319,165
4,BACĂU,ZEMEŞ,26289,ZEMEŞ,"ŞCOALA ŞTEFAN CEL MARE ZEMEŞ",633,"Alegeri Prezidentiale",1,1197,552,534,18,0,544,8,1300,748,319,225
4,BACĂU,ZEMEŞ,26289,ZEMEŞ,"ŞCOALA ŞTEFAN CEL MARE ZEMEŞ",634,"Alegeri Prezidentiale",1,706,330,321,9,0,325,5,800,470,208,117
4,BACĂU,ZEMEŞ,26289,BOLĂTĂU,"ŞCOALA ION CREANGĂ ZEMEŞ",635,"Alegeri Prezidentiale",1,872,408,385,23,0,406,2,1000,592,315,91
5,BIHOR,"MUNICIPIUL ORADEA",26564,ORADEA,"COLEGIUL ECONOMIC ” PARTENIE COSMA ”",1,"Alegeri Prezidentiale",1,729,616,325,291,0,602,14,802,186,471,131
5,BIHOR,"MUNICIPIUL ORADEA",26564,ORADEA,"ȘCOALA GIMNAZIALĂ ” LUCREŢIA SUCIU ”",2,"Alegeri Prezidentiale",1,1226,537,443,52,42,523,14,1349,812,386,137
5,BIHOR,"MUNICIPIUL ORADEA",26564,ORADEA,"LICEUL TEHNOLOGIC SANITAR ”VASILE VOICULESCU”",3,"Alegeri Prezidentiale",1,1303,559,533,25,1,548,11,1433,874,363,185
5,BIHOR,"MUNICIPIUL ORADEA",26564,ORADEA,"LICEUL TEHNOLOGIC SANITAR ”VASILE VOICULESCU”",4,"Alegeri Prezidentiale",1,1416,579,526,53,0,570,9,1558,979,412,158
5,BIHOR,"MUNICIPIUL ORADEA",26564,ORADEA,"GRĂDINIŢA CU PROGRAM PRELUNGIT NR.22",5,"Alegeri Prezidentiale",1,1411,542,514,28,0,531,11,1552,1010,408,123
5,BIHOR,"MUNICIPIUL ORADEA",26564,ORADEA,"GRĂDINIŢA CU PROGRAM PRELUNGIT NR.22",6,"Alegeri Prezidentiale",1,1521,776,714,62,0,765,11,1673,897,562,203
5,BIHOR,"MUNICIPIUL ORADEA",26564,ORADEA,"CREȘA NR. 2 ” PICIORUȘE VESELE ”",7,"Alegeri Prezidentiale",1,786,373,299,74,0,365,7,865,493,247,118
5,BIHOR,"MUNICIPIUL ORADEA",26564,ORADEA,"GRĂDINIȚA CU PROGRAM PRELUNGIT NR. 22",8,"Alegeri Prezidentiale",1,1174,483,456,26,1,471,12,1291,808,344,127
5,BIHOR,"MUNICIPIUL ORADEA",26564,ORADEA,"CREŞA NR.2 ”PICIORUŞE VESELE”",9,"Alegeri Prezidentiale",1,1261,568,527,41,0,554,14,1387,819,401,153
5,BIHOR,"MUNICIPIUL ORADEA",26564,ORADEA,"ŞCOALA GIMNAZIALĂ ”IOAN SLAVICI”",10,"Alegeri Prezidentiale",1,1428,729,675,54,0,716,13,1571,842,467,249
5,BIHOR,"MUNICIPIUL ORADEA",26564,ORADEA,"ŞCOALA GIMNAZIALĂ ”IOAN SLAVICI”",11,"Alegeri Prezidentiale",1,1568,715,685,30,0,698,17,1725,1010,500,198
5,BIHOR,"MUNICIPIUL ORADEA",26564,ORADEA,"ŞCOALA GIMNAZIALĂ ”IOAN SLAVICI”",12,"Alegeri Prezidentiale",1,1367,642,618,24,0,633,9,1504,862,463,170
5,BIHOR,"MUNICIPIUL ORADEA",26564,ORADEA,"ŞCOALA GIMNAZIALĂ ”IOAN SLAVICI”",13,"Alegeri Prezidentiale",1,1463,565,506,59,0,553,12,1609,1044,416,137
5,BIHOR,"MUNICIPIUL ORADEA",26564,ORADEA,"ŞCOALA GIMNAZIALĂ ”IOAN SLAVICI”",14,"Alegeri Prezidentiale",1,785,352,326,26,0,343,9,864,512,235,108
5,BIHOR,"MUNICIPIUL ORADEA",26564,ORADEA,"GRĂDINIŢA CU PROGRAM PRELUNGIT NR.25",15,"Alegeri Prezidentiale",1,753,307,283,24,0,300,7,828,521,209,91
5,BIHOR,"MUNICIPIUL ORADEA",26564,ORADEA,"GRĂDINIŢA CU PROGRAM PRELUNGIT NR.25",16,"Alegeri Prezidentiale",1,1091,427,408,19,0,415,12,1200,773,314,101
5,BIHOR,"MUNICIPIUL ORADEA",26564,ORADEA,"ŞCOALA GIMNAZIALĂ ”DIMITRIE CANTEMIR”",17,"Alegeri Prezidentiale",1,1121,628,537,91,0,615,13,1233,605,420,195
5,BIHOR,"MUNICIPIUL ORADEA",26564,ORADEA,"ŞCOALA GIMNAZIALĂ ”DIMITRIE CANTEMIR”",18,"Alegeri Prezidentiale",1,1058,596,529,66,1,582,14,1164,568,428,154
5,BIHOR,"MUNICIPIUL ORADEA",26564,ORADEA,"ŞCOALA GIMNAZIALĂ ”DIMITRIE CANTEMIR”",19,"Alegeri Prezidentiale",1,1488,670,645,25,0,652,18,1637,967,483,169
5,BIHOR,"MUNICIPIUL ORADEA",26564,ORADEA,"ŞCOALA GIMNAZIALĂ ”DIMITRIE CANTEMIR”",20,"Alegeri Prezidentiale",1,1788,870,782,77,11,852,18,1967,1097,603,249
5,BIHOR,"MUNICIPIUL ORADEA",26564,ORADEA,"ŞCOALA GIMNAZIALĂ ”DIMITRIE CANTEMIR”",21,"Alegeri Prezidentiale",1,1448,660,596,64,0,648,12,1593,933,454,194
5,BIHOR,"MUNICIPIUL ORADEA",26564,ORADEA,"GRĂDINIŢA CU PROGRAM PRELUNGIT NR.24",22,"Alegeri Prezidentiale",1,1411,744,677,67,0,727,17,1552,808,504,223
5,BIHOR,"MUNICIPIUL ORADEA",26564,ORADEA,"COLEGIUL NAȚIONAL ”ONISIFOR GHIBU”",23,"Alegeri Prezidentiale",1,1423,724,654,70,0,709,15,1565,841,595,114
5,BIHOR,"MUNICIPIUL ORADEA",26564,ORADEA,"COLEGIUL NAȚIONAL ”ONISIFOR GHIBU”",24,"Alegeri Prezidentiale",1,1489,678,626,52,0,653,25,1638,960,459,194
5,BIHOR,"MUNICIPIUL ORADEA",26564,ORADEA,"COLEGIUL NAȚIONAL ”ONISIFOR GHIBU”",25,"Alegeri Prezidentiale",1,1815,800,723,77,0,785,15,1197,397,558,227
5,BIHOR,"MUNICIPIUL ORADEA",26564,ORADEA,"COLEGIUL NAȚIONAL ”ONISIFOR GHIBU”",26,"Alegeri Prezidentiale",1,1622,790,603,187,0,780,10,1784,994,598,182
5,BIHOR,"MUNICIPIUL ORADEA",26564,ORADEA,"COLEGIUL NAȚIONAL ”ONISIFOR GHIBU”",27,"Alegeri Prezidentiale",1,1487,685,598,87,0,668,17,1636,951,474,194
5,BIHOR,"MUNICIPIUL ORADEA",26564,ORADEA,"GRĂDINIȚA CU PROGRAM PRELUNGIT NR. 56",28,"Alegeri Prezidentiale",1,1285,758,681,76,1,742,16,1414,656,536,206
5,BIHOR,"MUNICIPIUL ORADEA",26564,ORADEA,"GRĂDINIȚA CU PROGRAM PRELUNGIT NR. 56",29,"Alegeri Prezidentiale",1,1827,983,929,54,0,967,16,2010,1027,632,335
5,BIHOR,"MUNICIPIUL ORADEA",26564,ORADEA,"GRĂDINIȚA CU PROGRAM PRELUNGIT NR. 56",30,"Alegeri Prezidentiale",1,1724,916,841,75,0,902,14,1896,980,629,273
5,BIHOR,"MUNICIPIUL ORADEA",26564,ORADEA,"GRĂDINIȚA CU PROGRAM PRELUNGIT NR. 56",31,"Alegeri Prezidentiale",1,1810,898,846,52,0,883,15,1991,1093,606,277
5,BIHOR,"MUNICIPIUL ORADEA",26564,ORADEA,"GRĂDINIȚA CU PROGRAM PRELUNGIT NR. 56",32,"Alegeri Prezidentiale",1,1896,915,862,53,0,897,18,2086,1171,603,294
5,BIHOR,"MUNICIPIUL ORADEA",26564,ORADEA,"GRĂDINIŢA CU PROGRAM NORMAL NR.2",33,"Alegeri Prezidentiale",1,1732,1044,854,190,0,1007,37,1905,861,698,309
5,BIHOR,"MUNICIPIUL ORADEA",26564,ORADEA,"GRĂDINIŢA CU PROGRAM PRELUNGIT NR. 28",34,"Alegeri Prezidentiale",1,1455,752,671,81,0,739,13,1601,849,534,205
5,BIHOR,"MUNICIPIUL ORADEA",26564,ORADEA,"CREȘA NR. 3 ”SCUFIȚA ROȘIE”",35,"Alegeri Prezidentiale",1,1533,729,665,64,0,712,17,1686,957,489,223
5,BIHOR,"MUNICIPIUL ORADEA",26564,ORADEA,"CREȘA NR.13 ”LIZUCA ȘI PATROCLE”",36,"Alegeri Prezidentiale",1,1497,860,749,111,0,828,32,1647,787,581,247
5,BIHOR,"MUNICIPIUL ORADEA",26564,ORADEA,"CREȘA NR.13 ”LIZUCA ȘI PATROCLE”",37,"Alegeri Prezidentiale",1,1469,729,655,74,0,710,19,1611,882,480,230
5,BIHOR,"MUNICIPIUL ORADEA",26564,ORADEA,"GRĂDINIŢA CU PROGRAM PRELUNGIT NR.46",38,"Alegeri Prezidentiale",1,751,368,314,54,0,362,6,826,458,248,114
5,BIHOR,"MUNICIPIUL ORADEA",26564,ORADEA,"GRĂDINIŢA CU PROGRAM PRELUNGIT NR.46",39,"Alegeri Prezidentiale",4,1135,478,440,36,2,474,4,1249,771,310,164
5,BIHOR,"MUNICIPIUL ORADEA",26564,ORADEA,"ŞCOALA GIMNAZIALĂ ”NICOLAE BĂLCESCU”",40,"Alegeri Prezidentiale",1,1126,558,509,49,0,540,18,1239,681,395,145
5,BIHOR,"MUNICIPIUL ORADEA",26564,ORADEA,"ŞCOALA GIMNAZIALĂ ”NICOLAE BĂLCESCU”",41,"Alegeri Prezidentiale",1,944,416,371,45,0,411,5,1038,622,294,117
5,BIHOR,"MUNICIPIUL ORADEA",26564,ORADEA,"ŞCOALA GIMNAZIALĂ",42,"Alegeri Prezidentiale",1,727,329,312,17,0,327,2,800,471,245,82
5,BIHOR,"MUNICIPIUL ORADEA",26564,ORADEA,"GRĂDINIŢA CU PROGRAM PRELUNGIT NR.53",43,"Alegeri Prezidentiale",1,870,394,352,42,0,386,8,957,563,304,82
5,BIHOR,"MUNICIPIUL ORADEA",26564,ORADEA,"GRĂDINIŢA CU PROGRAM PRELUNGIT NR.53",44,"Alegeri Prezidentiale",1,847,433,398,35,0,428,5,932,499,289,139
5,BIHOR,"MUNICIPIUL ORADEA",26564,ORADEA,"GRĂDINIŢA CU PROGRAM PRELUNGIT NR.52",45,"Alegeri Prezidentiale",1,850,316,292,24,0,304,12,935,619,228,76
5,BIHOR,"MUNICIPIUL ORADEA",26564,ORADEA,"GRĂDINIŢA CU PROGRAM PRELUNGIT NR.52",46,"Alegeri Prezidentiale",1,1340,536,510,26,0,529,7,1474,938,406,123
5,BIHOR,"MUNICIPIUL ORADEA",26564,ORADEA,"GRĂDINIŢA CU PROGRAM PRELUNGIT NR.52",47,"Alegeri Prezidentiale",1,1073,399,372,27,0,396,3,1180,781,279,117
5,BIHOR,"MUNICIPIUL ORADEA",26564,ORADEA,"ŞCOALA GIMNAZIALĂ NR.16",48,"Alegeri Prezidentiale",1,1052,527,468,59,0,514,13,1157,630,395,119
5,BIHOR,"MUNICIPIUL ORADEA",26564,ORADEA,"ŞCOALA GIMNAZIALĂ NR.16",49,"Alegeri Prezidentiale",1,846,403,358,45,0,394,9,931,528,259,135
5,BIHOR,"MUNICIPIUL ORADEA",26564,ORADEA,"ŞCOALA GIMNAZIALĂ NR.16",50,"Alegeri Prezidentiale",1,1008,506,456,50,0,495,11,1109,603,361,134
5,BIHOR,"MUNICIPIUL ORADEA",26564,ORADEA,"ŞCOALA GIMNAZIALĂ NR.16",51,"Alegeri Prezidentiale",1,1435,675,641,34,0,658,17,1579,904,477,181
5,BIHOR,"MUNICIPIUL ORADEA",26564,ORADEA,"LICEUL TEORETIC ”LUCIAN BLAGA”",52,"Alegeri Prezidentiale",1,1253,652,561,91,0,633,19,1378,726,434,199
5,BIHOR,"MUNICIPIUL ORADEA",26564,ORADEA,"LICEUL TEORETIC ”LUCIAN BLAGA”",53,"Alegeri Prezidentiale",1,1595,707,663,44,0,691,16,1755,1048,501,190
5,BIHOR,"MUNICIPIUL ORADEA",26564,ORADEA,"LICEUL TEORETIC ”LUCIAN BLAGA”",54,"Alegeri Prezidentiale",1,1364,730,659,71,0,715,15,1500,770,510,205
5,BIHOR,"MUNICIPIUL ORADEA",26564,ORADEA,"LICEUL TEORETIC ”LUCIAN BLAGA”",55,"Alegeri Prezidentiale",1,1455,565,515,50,0,547,18,1596,1031,376,171
5,BIHOR,"MUNICIPIUL ORADEA",26564,ORADEA,"GRĂDINIŢA CU PROGRAM NORMAL NR.17",56,"Alegeri Prezidentiale",1,1620,806,741,64,1,785,21,1782,976,555,230
5,BIHOR,"MUNICIPIUL ORADEA",26564,ORADEA,"GRĂDINIŢA CU PROGRAM PRELUNGIT NR.20",57,"Alegeri Prezidentiale",1,1429,690,582,108,0,676,14,1567,877,502,174
5,BIHOR,"MUNICIPIUL ORADEA",26564,ORADEA,"LICEUL ORTODOX ”EPISCOP ROMAN CIOROGARIU”",58,"Alegeri Prezidentiale",1,833,491,337,154,0,483,8,916,425,362,121
5,BIHOR,"MUNICIPIUL ORADEA",26564,ORADEA,"LICEUL ORTODOX ”EPISCOP ROMAN CIOROGARIU”",59,"Alegeri Prezidentiale",1,878,460,415,45,0,443,17,966,506,321,122
5,BIHOR,"MUNICIPIUL ORADEA",26564,ORADEA,"LICEUL ORTODOX ”EPISCOP ROMAN CIOROGARIU”",60,"Alegeri Prezidentiale",1,899,416,390,26,0,401,15,989,573,289,112
5,BIHOR,"MUNICIPIUL ORADEA",26564,ORADEA,"LICEUL ORTODOX ”EPISCOP ROMAN CIOROGARIU”",61,"Alegeri Prezidentiale",1,1233,578,543,35,0,565,13,1356,778,422,143
5,BIHOR,"MUNICIPIUL ORADEA",26564,ORADEA,"LICEUL ORTODOX ”EPISCOP ROMAN CIOROGARIU”",62,"Alegeri Prezidentiale",1,1458,648,626,21,1,639,9,1599,951,474,165
5,BIHOR,"MUNICIPIUL ORADEA",26564,ORADEA,"LICEUL ORTODOX ”EPISCOP ROMAN CIOROGARIU”",63,"Alegeri Prezidentiale",1,1306,671,641,30,0,656,15,1437,766,476,180
5,BIHOR,"MUNICIPIUL ORADEA",26564,ORADEA,"GRĂDINIŢA CU PROGRAM PRELUNGIT NR. 54",64,"Alegeri Prezidentiale",1,1016,603,506,97,0,586,17,1118,515,400,186
5,BIHOR,"MUNICIPIUL ORADEA",26564,ORADEA,"GRĂDINIŢA CU PROGRAM PRELUNGIT NR. 54",65,"Alegeri Prezidentiale",1,1018,560,522,36,2,550,10,1120,560,404,146
5,BIHOR,"MUNICIPIUL ORADEA",26564,ORADEA,"ŞCOALA GIMNAZIALĂ ”DACIA”",66,"Alegeri Prezidentiale",1,1216,679,555,124,0,658,21,1338,659,458,200
5,BIHOR,"MUNICIPIUL ORADEA",26564,ORADEA,"ŞCOALA GIMNAZIALĂ ”DACIA”",67,"Alegeri Prezidentiale",1,1438,651,601,50,0,636,15,1582,931,436,200
5,BIHOR,"MUNICIPIUL ORADEA",26564,ORADEA,"ŞCOALA GIMNAZIALĂ ”DACIA”",68,"Alegeri Prezidentiale",1,1098,547,503,44,0,540,7,1208,661,385,155
5,BIHOR,"MUNICIPIUL ORADEA",26564,ORADEA,"GRĂDINIŢA CU PROGRAM PRELUNGIT NR. 45",69,"Alegeri Prezidentiale",1,1042,615,515,100,0,604,11,1146,531,442,162
5,BIHOR,"MUNICIPIUL ORADEA",26564,ORADEA,"GRĂDINIŢA CU PROGRAM PRELUNGIT NR. 45",70,"Alegeri Prezidentiale",1,1364,783,701,81,1,768,15,1500,717,550,218
5,BIHOR,"MUNICIPIUL ORADEA",26564,ORADEA,"GRĂDINIŢA CU PROGRAM PRELUNGIT NR. 45",71,"Alegeri Prezidentiale",1,1435,698,659,39,0,682,16,1579,881,499,183
5,BIHOR,"MUNICIPIUL ORADEA",26564,ORADEA,"GRĂDINIŢA CU PROGRAM PRELUNGIT NR. 45",72,"Alegeri Prezidentiale",1,1171,576,549,27,0,560,16,1240,664,392,168
5,BIHOR,"MUNICIPIUL ORADEA",26564,ORADEA,"LICEUL DE ARTE",73,"Alegeri Prezidentiale",1,1682,798,741,57,0,776,22,1850,1052,602,174
5,BIHOR,"MUNICIPIUL ORADEA",26564,ORADEA,"LICEUL DE ARTE",74,"Alegeri Prezidentiale",1,1521,822,748,74,0,791,31,1673,851,588,203
5,BIHOR,"MUNICIPIUL ORADEA",26564,ORADEA,"LICEUL DE ARTE",75,"Alegeri Prezidentiale",1,1608,869,776,93,0,850,19,1769,900,632,218
5,BIHOR,"MUNICIPIUL ORADEA",26564,ORADEA,"LICEUL DE ARTE",76,"Alegeri Prezidentiale",1,1345,623,603,20,0,604,19,1475,852,427,177
5,BIHOR,"MUNICIPIUL ORADEA",26564,ORADEA,"LICEUL DE ARTE",77,"Alegeri Prezidentiale",1,1356,580,556,23,1,558,22,1492,912,370,188
5,BIHOR,"MUNICIPIUL ORADEA",26564,ORADEA,"LICEUL DE ARTE",78,"Alegeri Prezidentiale",1,1501,696,656,40,0,682,14,1651,955,499,183
5,BIHOR,"MUNICIPIUL ORADEA",26564,ORADEA,"LICEUL DE ARTE",79,"Alegeri Prezidentiale",1,1055,582,455,75,52,568,14,1161,579,402,166
5,BIHOR,"MUNICIPIUL ORADEA",26564,ORADEA,"ORĂŞELUL COPIILOR",80,"Alegeri Prezidentiale",1,1540,816,679,83,54,801,15,1689,873,592,209
5,BIHOR,"MUNICIPIUL ORADEA",26564,ORADEA,"GRĂDINIŢA CU PROGRAM NORMAL NR. 15",81,"Alegeri Prezidentiale",1,1978,756,707,49,0,738,18,1376,620,584,154
5,BIHOR,"MUNICIPIUL ORADEA",26564,ORADEA,"ŞCOALA GIMNAZIALĂ ”JUHASZ GYULA”",82,"Alegeri Prezidentiale",1,1043,460,430,30,0,443,17,1147,687,345,98
5,BIHOR,"MUNICIPIUL ORADEA",26564,ORADEA,"ŞCOALA GIMNAZIALĂ ”JUHASZ GYULA”",83,"Alegeri Prezidentiale",1,1096,355,340,15,0,347,8,357,2,274,73
5,BIHOR,"MUNICIPIUL ORADEA",26564,ORADEA,"GRĂDINIȚA CU PROGRAM PRELUNGIT NR.42",84,"Alegeri Prezidentiale",1,1551,815,762,53,0,798,17,1706,891,576,222
5,BIHOR,"MUNICIPIUL ORADEA",26564,ORADEA,"GRĂDINIȚA CU PROGRAM PRELUNGIT NR.42",85,"Alegeri Prezidentiale",1,882,489,440,49,0,479,10,970,481,308,171
5,BIHOR,"MUNICIPIUL ORADEA",26564,ORADEA,"GRĂDINIȚA CU PROGRAM PRELUNGIT NR.42",86,"Alegeri Prezidentiale",1,1476,730,694,36,0,711,19,1624,894,552,159
5,BIHOR,"MUNICIPIUL ORADEA",26564,ORADEA,"ŞCOALA GIMNAZIALĂ ”OCTAVIAN GOGA”",87,"Alegeri Prezidentiale",1,1366,739,659,80,0,723,16,1503,764,503,220
5,BIHOR,"MUNICIPIUL ORADEA",26564,ORADEA,"ŞCOALA GIMNAZIALĂ ”OCTAVIAN GOGA”",88,"Alegeri Prezidentiale",1,1104,597,513,84,0,585,12,1165,568,394,191
5,BIHOR,"MUNICIPIUL ORADEA",26564,ORADEA,"ŞCOALA GIMNAZIALĂ ”OCTAVIAN GOGA”",89,"Alegeri Prezidentiale",1,886,469,428,38,3,460,9,975,506,316,144
5,BIHOR,"MUNICIPIUL ORADEA",26564,ORADEA,"COLEGIUL TEHNIC ”CONSTANTIN BRÂNCUȘI”",90,"Alegeri Prezidentiale",1,1572,753,674,79,0,738,15,1729,976,513,225
5,BIHOR,"MUNICIPIUL ORADEA",26564,ORADEA,"COLEGIUL TEHNIC ”CONSTANTIN BRÂNCUȘI”",91,"Alegeri Prezidentiale",1,1559,776,720,56,0,760,16,1715,939,535,225
5,BIHOR,"MUNICIPIUL ORADEA",26564,ORADEA,"GRĂDINIŢA CU PROGRAM PRELUNGIT NR. 55",92,"Alegeri Prezidentiale",1,1142,676,637,39,0,660,16,1256,580,430,230
5,BIHOR,"MUNICIPIUL ORADEA",26564,ORADEA,"FUNDAŢIA DE SCLEROZĂ MULTIPLĂ",93,"Alegeri Prezidentiale",1,1129,531,502,29,0,512,19,1242,711,370,142
5,BIHOR,"MUNICIPIUL ORADEA",26564,ORADEA,"FUNDAŢIA DE SCLEROZĂ MULTIPLĂ",94,"Alegeri Prezidentiale",1,1273,550,511,39,0,536,14,1400,850,386,150
5,BIHOR,"MUNICIPIUL ORADEA",26564,ORADEA,"GRĂDINIŢA CU PROGRAM PRELUNGIT NR. 35",95,"Alegeri Prezidentiale",1,1144,552,462,90,0,545,7,1258,706,392,153
5,BIHOR,"MUNICIPIUL ORADEA",26564,ORADEA,"GRĂDINIŢA CU PROGRAM PRELUNGIT NR. 35",96,"Alegeri Prezidentiale",1,1004,555,483,72,0,543,12,1104,549,380,163
5,BIHOR,"MUNICIPIUL ORADEA",26564,ORADEA,"CENTRUL DE ÎNGRIJIRE DE ZI",97,"Alegeri Prezidentiale",1,1336,621,595,26,0,608,13,1470,849,433,175
5,BIHOR,"MUNICIPIUL ORADEA",26564,ORADEA,"CENTRUL DE ÎNGRIJIRE DE ZI",98,"Alegeri Prezidentiale",1,1215,532,496,36,0,526,6,1332,800,365,161
5,BIHOR,"MUNICIPIUL ORADEA",26564,ORADEA,"CENTRU ŞCOLAR PENTRU EDUCAŢIE INCLUZIVĂ ”ORIZONT”",99,"Alegeri Prezidentiale",1,1381,613,559,54,0,601,12,1519,906,409,192
5,BIHOR,"MUNICIPIUL ORADEA",26564,ORADEA,"ŞCOALA GIMNAZIALĂ NR. 11",100,"Alegeri Prezidentiale",1,1097,681,479,74,128,663,18,1207,526,473,190
5,BIHOR,"MUNICIPIUL ORADEA",26564,ORADEA,"ŞCOALA GIMNAZIALĂ NR. 11",101,"Alegeri Prezidentiale",1,1547,684,659,25,0,647,37,1702,1018,439,208
5,BIHOR,"MUNICIPIUL ORADEA",26564,ORADEA,"ŞCOALA GIMNAZIALĂ NR. 11",102,"Alegeri Prezidentiale",1,1216,535,512,23,0,524,11,1338,803,370,154
5,BIHOR,"MUNICIPIUL ORADEA",26564,ORADEA,"ŞCOALA GIMNAZIALĂ NR. 11",103,"Alegeri Prezidentiale",1,1018,441,418,23,0,434,7,1120,679,299,135
5,BIHOR,"MUNICIPIUL ORADEA",26564,ORADEA,"ŞCOALA GIMNAZIALĂ NR. 11",104,"Alegeri Prezidentiale",1,1462,754,647,107,0,735,19,1608,854,515,220
5,BIHOR,"MUNICIPIUL ORADEA",26564,ORADEA,"ŞCOALA GIMNAZIALĂ NR. 11",105,"Alegeri Prezidentiale",1,1297,716,633,81,2,694,22,1427,711,495,199
5,BIHOR,"MUNICIPIUL ORADEA",26564,ORADEA,"ŞCOALA GIMNAZIALĂ NR. 11",106,"Alegeri Prezidentiale",1,804,403,369,34,0,397,6,884,481,274,123
5,BIHOR,"MUNICIPIUL ORADEA",26564,ORADEA,"ŞCOALA GIMNAZIALĂ NR. 11",107,"Alegeri Prezidentiale",1,1369,621,598,22,1,610,11,1506,885,425,185
5,BIHOR,"MUNICIPIUL ORADEA",26564,ORADEA,"GRĂDINIŢA CU PROGRAM PRELUNGIT NR. 41",108,"Alegeri Prezidentiale",1,1745,807,756,51,0,789,18,1920,1113,572,217
5,BIHOR,"MUNICIPIUL ORADEA",26564,ORADEA,"GRĂDINIŢA CU PROGRAM PRELUNGIT NR. 41",109,"Alegeri Prezidentiale",1,1694,803,744,59,0,786,17,1863,1060,569,217
5,BIHOR,"MUNICIPIUL ORADEA",26564,ORADEA,"ŞCOALA GIMNAZIALĂ ”ION BOGDAN”",110,"Alegeri Prezidentiale",1,1177,638,593,45,0,621,17,1295,657,457,164
5,BIHOR,"MUNICIPIUL ORADEA",26564,ORADEA,"ŞCOALA GIMNAZIALĂ ”ION BOGDAN”",111,"Alegeri Prezidentiale",2,1368,740,663,76,1,721,19,1505,765,550,171
5,BIHOR,"MUNICIPIUL ORADEA",26564,ORADEA,"ŞCOALA GIMNAZIALĂ ”ION BOGDAN”",112,"Alegeri Prezidentiale",1,1404,829,783,46,0,794,35,1544,715,610,184
5,BIHOR,"MUNICIPIUL ORADEA",26564,ORADEA,"GRĂDINIȚA CU PROGRAM PRELUNGIT NR.5",113,"Alegeri Prezidentiale",1,1230,674,623,50,1,659,15,1353,679,506,153
5,BIHOR,"MUNICIPIUL ORADEA",26564,ORADEA,"GRĂDINIȚA CU PROGRAM PRELUNGIT NR.5",114,"Alegeri Prezidentiale",2,1589,813,721,33,59,785,28,1748,929,530,255
5,BIHOR,"MUNICIPIUL ORADEA",26564,ORADEA,"LICEUL ORTODOX ” EPISCOP ROMAN CIOROGARIU ”",115,"Alegeri Prezidentiale",1,1074,646,442,110,94,631,15,1181,535,470,161
5,BIHOR,"MUNICIPIUL ORADEA",26564,ORADEA,"LICEUL ORTODOX ” EPISCOP ROMAN CIOROGARIU ”",116,"Alegeri Prezidentiale",1,1836,1048,854,39,155,1015,33,2020,972,736,279
5,BIHOR,"MUNICIPIUL ORADEA",26564,ORADEA,"GRĂDINIŢA CU PROGRAM NORMAL NR. 16",117,"Alegeri Prezidentiale",1,1887,1036,912,124,0,1013,23,2076,1040,749,264
5,BIHOR,"MUNICIPIUL ORADEA",26564,ORADEA,"UNIVERSITATEA DIN ORADEA FACULTATEA DE TEXTILE-PIELĂRIE",118,"Alegeri Prezidentiale",1,1108,494,425,69,0,480,14,1219,725,354,126
5,BIHOR,"MUNICIPIUL ORADEA",26564,ORADEA,"UNIVERSITATEA DIN ORADEA FACULTATEA DE TEXTILE-PIELĂRIE",119,"Alegeri Prezidentiale",1,1020,525,503,21,1,513,12,1122,597,327,186
5,BIHOR,"MUNICIPIUL ORADEA",26564,ORADEA,"PALATUL COPIILOR ŞI ELEVILOR",120,"Alegeri Prezidentiale",1,1470,714,613,80,21,699,15,1612,898,491,208
5,BIHOR,"MUNICIPIUL ORADEA",26564,ORADEA,"COLEGIUL NAŢIONAL ”MIHAI EMINESCU”",121,"Alegeri Prezidentiale",1,1142,495,405,90,0,480,15,1256,761,381,99
5,BIHOR,"MUNICIPIUL ORADEA",26564,ORADEA,"ŞCOALA GIMNAZIALĂ ”SZACSVAY IMRE”",122,"Alegeri Prezidentiale",1,1337,717,606,53,58,693,24,1471,754,489,204
5,BIHOR,"MUNICIPIUL ORADEA",26564,ORADEA,"LICEUL TEORETIC ”ADY ENDRE”",123,"Alegeri Prezidentiale",1,1295,611,516,95,0,597,14,1425,814,441,156
5,BIHOR,"MUNICIPIUL ORADEA",26564,ORADEA,"LICEUL REFORMAT ”LORANTFFY ZSUZSANNA”",124,"Alegeri Prezidentiale",1,1476,1081,590,132,359,1057,24,1624,543,562,495
5,BIHOR,"MUNICIPIUL ORADEA",26564,ORADEA,"COLEGIUL NAŢIONAL ”EMANUIL GOJDU”",125,"Alegeri Prezidentiale",1,795,448,359,89,0,439,9,875,427,306,133
5,BIHOR,"MUNICIPIUL ORADEA",26564,ORADEA,"COLEGIUL NAŢIONAL ”EMANUIL GOJDU”",126,"Alegeri Prezidentiale",1,790,539,393,146,0,529,10,869,330,364,165
5,BIHOR,"MUNICIPIUL ORADEA",26564,ORADEA,"LICEUL TEORETIC ”AUREL LAZĂR”",127,"Alegeri Prezidentiale",1,1223,582,387,195,0,567,15,1345,763,425,142
5,BIHOR,"MUNICIPIUL ORADEA",26564,ORADEA,"LICEUL GRECO-CATOLIC ”IULIU MANIU”",128,"Alegeri Prezidentiale",1,1097,452,359,93,0,441,11,1207,755,327,114
5,BIHOR,"MUNICIPIUL ORADEA",26564,ORADEA,"LICEUL GRECO-CATOLIC ”IULIU MANIU”",129,"Alegeri Prezidentiale",1,1076,416,373,43,0,410,6,1184,768,307,103
5,BIHOR,"MUNICIPIUL ORADEA",26564,ORADEA,"COLEGIUL NAŢIONAL ”IOSIF VULCAN”",130,"Alegeri Prezidentiale",1,813,357,325,32,0,349,8,894,537,277,72
5,BIHOR,"MUNICIPIUL ORADEA",26564,ORADEA,"COLEGIUL NAŢIONAL ”IOSIF VULCAN”",131,"Alegeri Prezidentiale",1,961,415,335,80,0,401,14,1057,642,292,109
5,BIHOR,"MUNICIPIUL ORADEA",26564,ORADEA,"COLEGIUL NAȚIONAL ”IOSIF VULCAN”",132,"Alegeri Prezidentiale",1,1749,998,810,188,0,957,41,1924,926,729,228
5,BIHOR,"MUNICIPIUL ORADEA",26564,ORADEA,"COLEGIUL NAȚIONAL ”IOSIF VULCAN”",133,"Alegeri Prezidentiale",1,1290,754,603,151,0,742,12,1419,665,536,206
5,BIHOR,"MUNICIPIUL ORADEA",26564,ORADEA,"COLEGIUL NAȚIONAL ”IOSIF VULCAN”",134,"Alegeri Prezidentiale",1,1126,628,528,100,0,602,26,1239,611,423,179
5,BIHOR,"MUNICIPIUL ORADEA",26564,ORADEA,"COLEGIUL NAȚIONAL ”IOSIF VULCAN”",135,"Alegeri Prezidentiale",1,1054,567,489,78,0,551,16,1159,592,375,176
5,BIHOR,"MUNICIPIUL ORADEA",26564,ORADEA,"LICEUL TEORETIC GERMAN ”FRIEDRICH SCHILLER”",136,"Alegeri Prezidentiale",1,956,435,400,35,0,429,6,1052,617,342,87
5,BIHOR,"MUNICIPIUL ORADEA",26564,ORADEA,"LICEUL TEORETIC GERMAN ”FRIEDRICH SCHILLER”",137,"Alegeri Prezidentiale",1,1546,616,584,32,0,592,24,1701,1085,433,159
5,BIHOR,"MUNICIPIUL ORADEA",26564,ORADEA,"LICEUL TEORETIC GERMAN ”FRIEDRICH SCHILLER”",138,"Alegeri Prezidentiale",1,1033,539,417,121,1,524,15,1137,598,405,119
5,BIHOR,"MUNICIPIUL ORADEA",26564,ORADEA,"LICEUL TEORETIC GERMAN ”FRIEDRICH SCHILLER”",139,"Alegeri Prezidentiale",1,998,502,462,40,0,482,20,1098,596,323,159
5,BIHOR,"MUNICIPIUL ORADEA",26564,ORADEA,"ŞCOALA GIMNAZIALĂ ”AVRAM IANCU”",140,"Alegeri Prezidentiale",1,1129,630,591,39,0,610,20,1242,612,412,198
5,BIHOR,"MUNICIPIUL ORADEA",26564,ORADEA,"ŞCOALA GIMNAZIALĂ ”AVRAM IANCU”",141,"Alegeri Prezidentiale",1,1459,760,728,32,0,726,34,1605,845,480,246
5,BIHOR,"MUNICIPIUL ORADEA",26564,ORADEA,"GRĂDINIŢA CU PROGRAM PRELUNGIT NR. 44",142,"Alegeri Prezidentiale",1,1169,794,636,158,0,773,21,1286,492,517,256
5,BIHOR,"MUNICIPIUL ORADEA",26564,ORADEA,"GRĂDINIŢA CU PROGRAM PRELUNGIT NR. 44",143,"Alegeri Prezidentiale",1,1838,1094,1006,87,1,1076,18,2022,928,720,356
5,BIHOR,"MUNICIPIUL ORADEA",26564,ORADEA,"IMPRIMERIA DE VEST",144,"Alegeri Prezidentiale",1,1834,1115,943,172,0,1083,32,1984,869,775,308
5,BIHOR,"MUNICIPIUL ORADEA",26564,ORADEA,"BLOCURILE ANL",145,"Alegeri Prezidentiale",1,831,553,500,52,1,541,12,914,361,426,115
5,BIHOR,"MUNICIPIUL BEIUŞ",26804,BEIUŞ,"PRIMĂRIA MUNICIPIULUI BEIUŞ",146,"Alegeri Prezidentiale",1,1360,696,595,101,0,676,20,1496,800,448,228
5,BIHOR,"MUNICIPIUL BEIUŞ",26804,BEIUŞ,"LICEUL PEDAGOGIC",147,"Alegeri Prezidentiale",2,1274,723,647,74,2,697,26,1401,678,426,271
5,BIHOR,"MUNICIPIUL BEIUŞ",26804,BEIUŞ,"GRĂDINIŢA CU PROGRAM PRELUNGIT",148,"Alegeri Prezidentiale",1,1183,583,493,69,21,569,14,1301,718,334,235
5,BIHOR,"MUNICIPIUL BEIUŞ",26804,BEIUŞ,"COLEGIUL TEHNIC ”IOAN CIORDAŞ”",149,"Alegeri Prezidentiale",1,1194,597,523,62,12,573,24,1313,716,348,225
5,BIHOR,"MUNICIPIUL BEIUŞ",26804,BEIUŞ,"ŞCOALA GIMNAZIALĂ ”NICOLAE POPOVICIU”",150,"Alegeri Prezidentiale",1,1448,864,730,133,1,852,12,1593,729,533,319
5,BIHOR,"MUNICIPIUL BEIUŞ",26804,BEIUŞ,"GRĂDINIŢA ” FLOARE DE COLŢ”",151,"Alegeri Prezidentiale",1,1268,613,577,36,0,593,20,1395,782,372,221
5,BIHOR,"MUNICIPIUL BEIUŞ",26804,BEIUŞ,"BLOC PARTER",152,"Alegeri Prezidentiale",1,1178,626,582,44,0,606,20,1296,670,353,253
5,BIHOR,"MUNICIPIUL BEIUŞ",26804,DELANI,"CĂMINUL CULTURAL",153,"Alegeri Prezidentiale",1,290,148,135,13,0,145,3,319,171,95,50
5,BIHOR,"MUNICIPIUL MARGHITA",26877,MARGHITA,"COLEGIUL NAŢIONAL ”OCTAVIAN GOGA”",154,"Alegeri Prezidentiale",1,1513,651,565,49,37,642,9,1664,1013,452,190
5,BIHOR,"MUNICIPIUL MARGHITA",26877,MARGHITA,"COLEGIUL NAŢIONAL ”OCTAVIAN GOGA”",155,"Alegeri Prezidentiale",1,1477,580,555,25,0,573,7,1625,1045,394,179
5,BIHOR,"MUNICIPIUL MARGHITA",26877,MARGHITA,"COLEGIUL NAŢIONAL ”OCTAVIAN GOGA”",156,"Alegeri Prezidentiale",1,1287,522,476,46,0,502,20,1416,894,349,153
5,BIHOR,"MUNICIPIUL MARGHITA",26877,MARGHITA,"COLEGIUL NAŢIONAL ”OCTAVIAN GOGA”",157,"Alegeri Prezidentiale",1,1191,487,450,36,1,474,13,1310,823,327,147
5,BIHOR,"MUNICIPIUL MARGHITA",26877,MARGHITA,"COLEGIUL NAŢIONAL ”OCTAVIAN GOGA”",158,"Alegeri Prezidentiale",1,1329,510,482,28,0,500,10,1462,952,350,150
5,BIHOR,"MUNICIPIUL MARGHITA",26877,MARGHITA,"CASA DE CULTURĂ MARGHITA",159,"Alegeri Prezidentiale",1,1254,460,399,61,0,450,10,1379,919,326,124
5,BIHOR,"MUNICIPIUL MARGHITA",26877,MARGHITA,"CLUBUL COPIILOR",160,"Alegeri Prezidentiale",1,1314,441,398,43,0,431,10,1445,1004,312,119
5,BIHOR,"MUNICIPIUL MARGHITA",26877,MARGHITA,"LICEUL TEORETIC ”HORVÁTH JÁNOS”",161,"Alegeri Prezidentiale",1,1368,524,476,48,0,505,19,1505,981,349,156
5,BIHOR,"MUNICIPIUL MARGHITA",26877,MARGHITA,"GRĂDINIŢA CU PROGRAM PRELUNGIT NR.4",162,"Alegeri Prezidentiale",1,1060,317,299,18,0,311,6,1166,849,220,91
5,BIHOR,"MUNICIPIUL MARGHITA",26877,MARGHITA,"GRĂDINIŢA CU PROGRAM PRELUNGIT NR.4",163,"Alegeri Prezidentiale",1,1362,531,509,22,0,524,7,1498,967,394,130
5,BIHOR,"MUNICIPIUL MARGHITA",26877,CHEŢ,"ŞCOALA CU CLASELE I-VIII CHEŢ",164,"Alegeri Prezidentiale",1,929,247,230,17,0,239,8,1022,775,146,93
5,BIHOR,"MUNICIPIUL MARGHITA",26877,GHENETEA,"ŞCOALA CU CLASELE I-VIII GHENETEA",165,"Alegeri Prezidentiale",1,591,239,211,28,0,238,1,650,411,168,70
5,BIHOR,"MUNICIPIUL SALONTA",26975,SALONTA,"FOSTUL MAGAZIN WAGNER",166,"Alegeri Prezidentiale",1,1485,441,415,26,0,432,9,1634,1193,337,95
5,BIHOR,"MUNICIPIUL SALONTA",26975,SALONTA,"GRĂDINIȚA FLOAREA SOARELUI",167,"Alegeri Prezidentiale",1,1543,493,417,29,47,482,11,1697,1204,364,118
5,BIHOR,"MUNICIPIUL SALONTA",26975,SALONTA,"LICEUL TEORETIC ARANY JANOS",168,"Alegeri Prezidentiale",1,1165,400,362,31,7,389,11,1282,882,288,101
5,BIHOR,"MUNICIPIUL SALONTA",26975,SALONTA,"GRĂDINIȚA CURCUBEU",169,"Alegeri Prezidentiale",1,801,245,237,8,0,242,3,881,636,192,50
5,BIHOR,"MUNICIPIUL SALONTA",26975,SALONTA,"CASA DE CULTURĂ ZILAHY LAJOS",170,"Alegeri Prezidentiale",1,1444,458,419,38,1,450,8,1588,1130,301,149
5,BIHOR,"MUNICIPIUL SALONTA",26975,SALONTA,"GRĂDINIȚA TOLDI",171,"Alegeri Prezidentiale",1,1117,413,356,56,1,405,8,1229,816,278,127
5,BIHOR,"MUNICIPIUL SALONTA",26975,SALONTA,"COLEGIUL NAȚIONAL TEODOR NEŞ",172,"Alegeri Prezidentiale",1,771,278,251,26,1,269,9,848,570,186,83
5,BIHOR,"MUNICIPIUL SALONTA",26975,SALONTA,"GRĂDINIȚA URSULEȚ",173,"Alegeri Prezidentiale",1,1330,475,455,20,0,466,9,1463,988,306,160
5,BIHOR,"MUNICIPIUL SALONTA",26975,SALONTA,"GRĂDINIȚA URSULEȚ",174,"Alegeri Prezidentiale",1,587,197,177,20,0,194,3,646,449,123,71
5,BIHOR,"MUNICIPIUL SALONTA",26975,SALONTA,"CASA SFÂNTUL ANTON",175,"Alegeri Prezidentiale",1,474,192,175,17,0,188,4,521,329,126,62
5,BIHOR,"MUNICIPIUL SALONTA",26975,SALONTA,"ȘCOALA GENERALĂ",176,"Alegeri Prezidentiale",1,1131,382,353,29,0,374,8,1244,862,242,132
5,BIHOR,"MUNICIPIUL SALONTA",26975,SALONTA,"GRĂDINIȚA FLUIERAȘUL FERMECAT",177,"Alegeri Prezidentiale",1,1598,536,516,19,1,518,18,1758,1222,394,124
5,BIHOR,"MUNICIPIUL SALONTA",26975,SALONTA,"LICEUL TEHNOLOGIC NR.1",178,"Alegeri Prezidentiale",1,832,353,322,31,0,347,6,915,562,226,121
5,BIHOR,"MUNICIPIUL SALONTA",26975,SALONTA,"GRĂDINIȚA PRICHINDEL",179,"Alegeri Prezidentiale",1,822,279,264,15,0,269,10,904,625,184,85
5,BIHOR,"MUNICIPIUL SALONTA",26975,SALONTA,"ȘCOALA GENERALĂ FÜVESKERT",180,"Alegeri Prezidentiale",1,769,341,316,25,0,336,5,846,505,216,120
5,BIHOR,"ORAŞ ALEŞD",26699,ALEŞD,"PRIMĂRIA ALEȘD- SALA MARE",181,"Alegeri Prezidentiale",1,1314,785,610,146,29,764,21,1445,660,586,178
5,BIHOR,"ORAŞ ALEŞD",26699,ALEŞD,"LICEUL TEORETIC CONSTANTIN ȘERBAN",182,"Alegeri Prezidentiale",1,1429,676,602,73,1,661,15,1572,896,499,162
5,BIHOR,"ORAŞ ALEŞD",26699,ALEŞD,"COLEGIUL TEHNIC ALEXANDRU ROMAN",183,"Alegeri Prezidentiale",1,1527,697,637,60,0,688,9,1680,983,552,136
5,BIHOR,"ORAŞ ALEŞD",26699,ALEŞD,"GRĂDINIȚA CU PROGRAM NORMAL NR. 1",184,"Alegeri Prezidentiale",1,1202,566,530,36,0,548,18,1322,756,426,122
5,BIHOR,"ORAŞ ALEŞD",26699,ALEŞD,"CENTRUL MULTIFUNCȚIONAL",185,"Alegeri Prezidentiale",1,1071,506,476,30,0,486,20,1178,672,274,212
5,BIHOR,"ORAŞ ALEŞD",26699,PEŞTIŞ,"CĂMIN CULTURAL",186,"Alegeri Prezidentiale",1,1106,598,540,58,0,582,16,1217,619,461,121
5,BIHOR,"ORAŞ ALEŞD",26699,TINĂUD,"ŞCOALA PRIMARĂ NR. 2",187,"Alegeri Prezidentiale",1,653,389,353,36,0,385,4,718,329,281,104
5,BIHOR,"ORAŞ ALEŞD",26699,"PĂDUREA NEAGRĂ","ȘCOALA PRIMARĂ NR. 2",188,"Alegeri Prezidentiale",1,577,235,195,40,0,232,3,635,400,180,52
5,BIHOR,"ORAŞ NUCET",26920,NUCET,"ŞCOALA GIMNAZIALĂ NR. 1 NUCET",189,"Alegeri Prezidentiale",1,1233,844,696,112,36,826,18,1355,511,348,478
5,BIHOR,"ORAŞ NUCET",26920,BĂIŢA,"CĂMINUL CULTURAL BĂIŢA",190,"Alegeri Prezidentiale",1,515,408,298,56,54,404,4,566,158,183,221
5,BIHOR,"ORAŞ SĂCUENI",30915,CADEA,"ŞCOALA GENERALĂ",191,"Alegeri Prezidentiale",1,926,185,165,20,0,175,10,1019,834,126,49
5,BIHOR,"ORAŞ SĂCUENI",30915,CUBULCUT,"ŞCOALA GENERALĂ",192,"Alegeri Prezidentiale",1,697,101,92,9,0,98,3,767,666,62,36
5,BIHOR,"ORAŞ SĂCUENI",30915,OLOSIG,"ŞCOALA GENERALĂ",193,"Alegeri Prezidentiale",1,443,80,71,9,0,72,8,487,407,38,34
5,BIHOR,"ORAŞ SĂCUENI",30915,"SÂNNICOLAU DE MUNTE","ŞCOALA GENERALĂ",194,"Alegeri Prezidentiale",1,716,142,125,17,0,134,8,788,646,86,48
5,BIHOR,"ORAŞ SĂCUENI",30915,SĂCUENI,"ȘCOALA CU CLASELE I-IV",195,"Alegeri Prezidentiale",1,1142,180,168,12,0,167,13,1256,1076,97,70
5,BIHOR,"ORAŞ SĂCUENI",30915,SĂCUENI,"GRĂDINIȚA ȘI ȘCOALA CU CLASELE I-IV",196,"Alegeri Prezidentiale",1,1410,187,175,12,0,176,11,1551,1364,108,68
5,BIHOR,"ORAŞ SĂCUENI",30915,SĂCUENI,"GRĂDINIȚĂ CU PROGRAM PRELUNGIT",197,"Alegeri Prezidentiale",1,1182,238,222,16,0,229,9,1300,1062,175,54
5,BIHOR,"ORAŞ SĂCUENI",30915,SĂCUENI,"GRĂDINIȚA DE LA LOCUL DE CASĂ",198,"Alegeri Prezidentiale",1,919,200,186,14,0,195,5,1011,811,122,73
5,BIHOR,"ORAŞ SĂCUENI",30915,SĂCUENI,"CLĂDIREA MUZEULUI",199,"Alegeri Prezidentiale",1,1496,288,259,29,0,275,13,1646,1358,188,87
5,BIHOR,"ORAŞ SĂCUENI",30915,CIOCAIA,"CLUBUL TINERETULUI",200,"Alegeri Prezidentiale",1,769,166,143,23,0,158,8,846,680,124,34
5,BIHOR,"ORAŞ ŞTEI",26840,ŞTEI,"CASA DE CULTURĂ „MIRON POMPILIU” ŞTEI",201,"Alegeri Prezidentiale",1,1111,649,465,184,0,630,19,1222,573,368,262
5,BIHOR,"ORAŞ ŞTEI",26840,ŞTEI,"ŞCOALA GIMNAZIALĂ CU CLASELE I-VIII „MIRON POMPILIU” ŞTEI - ŞCOALA MICĂ",202,"Alegeri Prezidentiale",1,995,496,464,32,0,483,13,1095,599,254,229
5,BIHOR,"ORAŞ ŞTEI",26840,ŞTEI,"COLEGIUL TEHNIC„UNIREA” ŞTEI",203,"Alegeri Prezidentiale",1,1250,554,506,46,2,544,10,1375,821,309,235
5,BIHOR,"ORAŞ ŞTEI",26840,ŞTEI,"COLEGIUL TEHNIC „UNIREA” ŞTEI - ŞCOALA DE ŞOFERI",204,"Alegeri Prezidentiale",1,1352,602,543,59,0,591,11,1487,885,389,202
5,BIHOR,"ORAŞ ŞTEI",26840,ŞTEI,"ŞCOALA GIMNAZIALĂ CU CLASELE I-VIII „MIRON POMPILIU” ŞTEI",205,"Alegeri Prezidentiale",1,1273,650,601,48,1,632,18,1400,750,359,273
5,BIHOR,"ORAŞ VALEA LUI MIHAI",32027,"VALEA LUI MIHAI","ŞCOALA GIMNAZIALĂ VALEA LUI MIHAI",206,"Alegeri Prezidentiale",1,1266,242,212,30,0,223,19,1393,1151,153,70
5,BIHOR,"ORAŞ VALEA LUI MIHAI",32027,"VALEA LUI MIHAI","ŞCOALA GIMNAZIALĂ VALEA LUI MIHAI",207,"Alegeri Prezidentiale",1,1406,277,258,19,0,259,18,1547,1270,182,77
5,BIHOR,"ORAŞ VALEA LUI MIHAI",32027,"VALEA LUI MIHAI","ŞCOALA GIMNAZIALĂ VALEA LUI MIHAI",208,"Alegeri Prezidentiale",1,1230,274,232,42,0,263,11,1353,1079,166,97
5,BIHOR,"ORAŞ VALEA LUI MIHAI",32027,"VALEA LUI MIHAI","ŞCOALA GIMNAZIALĂ VALEA LUI MIHAI",209,"Alegeri Prezidentiale",1,1339,239,223,16,0,235,4,1473,1234,152,83
5,BIHOR,"ORAŞ VALEA LUI MIHAI",32027,"VALEA LUI MIHAI","ŞCOALA GIMNAZIALĂ VALEA LUI MIHAI",210,"Alegeri Prezidentiale",1,1174,221,188,9,24,215,6,1291,1070,151,64
5,BIHOR,"ORAŞ VALEA LUI MIHAI",32027,"VALEA LUI MIHAI","ŞCOALA GIMNAZIALĂ VALEA LUI MIHAI",211,"Alegeri Prezidentiale",1,1317,230,214,16,0,223,7,1449,1219,154,69
5,BIHOR,"ORAŞ VALEA LUI MIHAI",32027,"VALEA LUI MIHAI","LICEUL TEHNOLOGIC NR.1 - VALEA LUI MIHAI",212,"Alegeri Prezidentiale",1,1222,209,191,18,0,200,9,1344,1135,148,52
5,BIHOR,"ORAŞ VAŞCĂU",27007,VAŞCĂU,"CASA DE CULTURĂ",213,"Alegeri Prezidentiale",1,1337,785,695,74,16,767,18,1421,636,467,300
5,BIHOR,"ORAŞ VAŞCĂU",27007,CÂMP,"CĂMINUL CULTURAL",214,"Alegeri Prezidentiale",1,191,122,110,12,0,121,1,210,88,77,44
5,BIHOR,"ORAŞ VAŞCĂU",27007,COLEŞTI,"CĂMINUL CULTURAL",215,"Alegeri Prezidentiale",1,108,89,72,17,0,88,1,119,30,45,43
5,BIHOR,"ORAŞ VAŞCĂU",27007,"VĂRZARII DE JOS","CĂMINUL CULTURAL",216,"Alegeri Prezidentiale",1,180,114,99,15,0,111,3,198,84,48,63
5,BIHOR,"ORAŞ VAŞCĂU",27007,"VĂRZARII DE SUS","CĂMINUL CULTURAL",217,"Alegeri Prezidentiale",1,105,128,56,25,47,128,0,166,38,94,34
5,BIHOR,"ORAŞ VAŞCĂU",27007,CÂMP-MOŢI,"ŞCOALA GENERALĂ",218,"Alegeri Prezidentiale",1,45,37,24,10,3,37,0,50,13,13,24
5,BIHOR,ABRAM,27070,ABRAM,"PRIMĂRIA ABRAM",219,"Alegeri Prezidentiale",1,769,312,290,22,0,305,7,846,534,226,79
5,BIHOR,ABRAM,27070,DIJIR,"CĂMIN CULTURAL",220,"Alegeri Prezidentiale",1,227,107,92,15,0,104,3,250,143,79,25
5,BIHOR,ABRAM,27070,ITEU,"CĂMIN CULTURAL",221,"Alegeri Prezidentiale",1,239,122,100,22,0,121,1,263,141,59,62
5,BIHOR,ABRAM,27070,"SATU BARBĂ","CĂMIN CULTURAL",222,"Alegeri Prezidentiale",1,234,130,114,16,0,130,0,257,127,87,43
5,BIHOR,ABRAM,27070,"ITEU NOU","ȘCOALĂ PRIMARĂ",223,"Alegeri Prezidentiale",1,113,70,59,11,0,69,1,124,54,51,18
5,BIHOR,ABRAM,27070,MARGINE,"ȘCOALĂ PRIMARĂ NR. 1",224,"Alegeri Prezidentiale",1,413,220,205,15,0,217,3,454,234,154,63
5,BIHOR,ABRAM,27070,SUIUG,"ȘCOALĂ PRIMARĂ NR. 3",225,"Alegeri Prezidentiale",1,460,234,201,33,0,226,8,506,272,169,57
5,BIHOR,ABRĂMUŢ,27169,ABRĂMUŢ,"ȘCOALA GENERALĂ ABRĂMUȚ",226,"Alegeri Prezidentiale",1,382,130,109,21,0,130,0,420,290,97,33
5,BIHOR,ABRĂMUŢ,27169,CRESTUR,"CĂMINUL CULTURAL CRESTUR",227,"Alegeri Prezidentiale",1,364,106,85,21,0,106,0,400,294,77,29
5,BIHOR,ABRĂMUŢ,27169,FĂNCICA,"ȘCOALA GENERALĂ FĂNCICA",228,"Alegeri Prezidentiale",1,254,103,85,18,0,102,1,279,176,66,36
5,BIHOR,ABRĂMUŢ,27169,PETREU,"GRĂDINIȚA CU PROGRAM NORMAL NR.1 PETREU",229,"Alegeri Prezidentiale",1,1429,407,374,33,0,400,7,1572,1165,314,86
5,BIHOR,AŞTILEU,26742,CHISTAG,"CĂMIN CULTURAL",230,"Alegeri Prezidentiale",1,500,292,256,36,0,288,4,550,258,205,83
5,BIHOR,AŞTILEU,26742,AŞTILEU,"ȘCOALA GIMNAZIALĂ NR 1 AȘTILEU",231,"Alegeri Prezidentiale",1,1273,610,581,29,0,600,10,1400,790,428,172
5,BIHOR,AŞTILEU,26742,CĂLĂŢEA,"ȘCOALA GIMNAZIALĂ NR 2 CĂLĂȚEA",232,"Alegeri Prezidentiale",1,288,190,161,29,0,187,3,317,127,122,65
5,BIHOR,AŞTILEU,26742,CĂLĂŢEA,"BLOC CORNET",233,"Alegeri Prezidentiale",1,226,160,132,28,0,158,2,249,89,102,56
5,BIHOR,AŞTILEU,26742,PEŞTERE,"ȘCOALA PRIMARĂ NR 2 PEŞTERE",234,"Alegeri Prezidentiale",1,701,387,362,25,0,379,8,771,384,232,147
5,BIHOR,AUŞEU,27212,AUŞEU,"PRIMĂRIA COMUNEI AUŞEU",235,"Alegeri Prezidentiale",1,779,458,381,77,0,445,13,857,399,311,134
5,BIHOR,AUŞEU,27212,GROŞI,"ŞCOALA PRIMARĂ",236,"Alegeri Prezidentiale",1,818,389,345,44,0,381,8,900,511,259,122
5,BIHOR,AUŞEU,27212,LUNCŞOARA,"CĂMIN CULTURAL",237,"Alegeri Prezidentiale",1,738,392,352,40,0,386,6,812,420,277,109
5,BIHOR,"AVRAM IANCU",27285,"AVRAM IANCU","SALA SPORT ȘCOALA",238,"Alegeri Prezidentiale",1,1557,779,723,54,2,774,5,1713,934,398,376
5,BIHOR,"AVRAM IANCU",27285,ANT,"CĂMINUL CULTURAL",239,"Alegeri Prezidentiale",1,151,53,33,20,0,52,1,166,113,36,16
5,BIHOR,"AVRAM IANCU",27285,TĂMAŞDA,"ȘCOALA NOUĂ TĂMAȘDA",240,"Alegeri Prezidentiale",1,917,450,432,18,0,447,3,1009,559,278,169
5,BIHOR,BALC,27329,BALC,"CĂMINUL CULTURAL BALC",241,"Alegeri Prezidentiale",1,1050,365,338,27,0,342,23,1155,790,249,93
5,BIHOR,BALC,27329,"ALMAŞU MARE","CĂMINUL CULTURAL ALMAŞU MARE",242,"Alegeri Prezidentiale",1,622,303,272,31,0,294,9,684,381,196,98
5,BIHOR,BALC,27329,"ALMAŞU MIC","CĂMINUL CULTURAL ALMAŞU MIC",243,"Alegeri Prezidentiale",1,283,152,124,28,0,151,1,311,159,111,40
5,BIHOR,BALC,27329,"SĂLDĂBAGIU DE BARCĂU","CĂMINUL CULTURAL SĂLDĂBAGIU DE BARCĂU",244,"Alegeri Prezidentiale",1,435,215,180,32,3,210,5,479,264,103,107
5,BIHOR,BALC,27329,GHIDA,"CĂMINUL CULTURAL GHIDA",245,"Alegeri Prezidentiale",1,127,65,48,17,0,62,3,140,75,26,36
5,BIHOR,BATĂR,27383,BATĂR,"ȘCOALA GIMNAZIALĂ NR.1 BATĂR",246,"Alegeri Prezidentiale",1,1328,508,458,50,0,498,10,1461,953,215,283
5,BIHOR,BATĂR,27383,ARPĂŞEL,"ȘCOALA GIMNAZIALĂ NR. 4 ARPĂȘEL",247,"Alegeri Prezidentiale",1,748,181,167,14,0,180,1,823,642,133,47
5,BIHOR,BATĂR,27383,TALPOŞ,"GRĂDINIȚA TALPOȘ",248,"Alegeri Prezidentiale",1,1323,504,463,41,0,483,21,1455,951,189,294
5,BIHOR,BATĂR,27383,TĂUT,"ŞCOALA GIMNAZIALĂ NR.3",249,"Alegeri Prezidentiale",1,757,366,325,40,1,363,3,833,467,185,178
5,BIHOR,BIHARIA,27436,BIHARIA,"ȘCOALA GENERALĂ CU CLASELE V-VIII GASPAR ANDRAS",250,"Alegeri Prezidentiale",1,1703,543,492,51,0,528,15,1873,1330,417,111
5,BIHOR,BIHARIA,27436,BIHARIA,"GRĂDINIȚA DE COPII BIHARIA",251,"Alegeri Prezidentiale",1,1556,542,471,71,0,526,16,1712,1170,437,89
5,BIHOR,BIHARIA,27436,CAUACEU,"ȘCOALA GENERALĂ CU CLASELE I-IV CAUACEU",252,"Alegeri Prezidentiale",1,628,187,149,38,0,181,6,691,504,131,50
5,BIHOR,"BOIANU MARE",27506,"BOIANU MARE","ȘCOALA CU CLASELE I- IV, BOIANU-MARE",253,"Alegeri Prezidentiale",1,465,234,222,12,0,228,6,512,278,185,43
5,BIHOR,"BOIANU MARE",27506,PĂGAIA,"ȘCOALA CU CLASELE I- VIII ” ÎNVĂȚĂTOR GÂLGĂU IOSIF” PĂGAIA",254,"Alegeri Prezidentiale",1,555,272,255,17,0,269,3,611,339,210,59
5,BIHOR,BOROD,27560,BOROD,"CĂMIN CULTURAL BOROD",255,"Alegeri Prezidentiale",1,1250,803,687,116,0,776,27,1375,572,377,399
5,BIHOR,BOROD,27560,BOROZEL,"ŞCOALA CU CLASELE I-IV",256,"Alegeri Prezidentiale",1,510,362,326,36,0,355,7,561,199,170,185
5,BIHOR,BOROD,27560,CETEA,"GRĂDINIȚA CETEA",257,"Alegeri Prezidentiale",1,170,144,106,38,0,144,0,187,43,67,77
5,BIHOR,BOROD,27560,CORNIŢEL,"CĂMINUL CULTURAL CORNIȚEL",258,"Alegeri Prezidentiale",1,413,325,260,65,0,315,10,454,129,142,173
5,BIHOR,BOROD,27560,"VALEA MARE DE CRIŞ","ȘCOALA CU CLASELE I-IV",259,"Alegeri Prezidentiale",1,377,263,240,23,0,250,13,415,152,144,106
5,BIHOR,BOROD,27560,ŞERANI,"ȘCOALA CU CLASELE I-IV",260,"Alegeri Prezidentiale",1,99,67,45,22,0,66,1,109,42,48,18
5,BIHOR,BOROD,27560,ŞERANI,"ȘCOALA CU CLASELE. I-VIII",261,"Alegeri Prezidentiale",1,223,137,93,44,0,134,3,245,108,89,45
5,BIHOR,BORŞ,27631,BORŞ,"LICEUL TECHNOLOGIC AGROINDUSTRIAL ”TAMASI ARON” BORȘ",262,"Alegeri Prezidentiale",1,1192,539,419,112,8,521,18,1311,772,424,97
5,BIHOR,BORŞ,27631,SÂNTION,"GRĂDINIȚA SÎNTION",263,"Alegeri Prezidentiale",1,1623,713,634,74,5,698,15,1785,1072,620,78
5,BIHOR,BORŞ,27631,"SANTĂUL MARE","ȘCOALA GENERALĂ SANTĂUL MARE",264,"Alegeri Prezidentiale",1,329,162,91,46,25,159,3,362,200,129,30
5,BIHOR,BORŞ,27631,"SANTĂUL MIC","ȘCOALA PRIMARĂ SANTĂUL MIC",265,"Alegeri Prezidentiale",1,470,201,174,23,4,199,2,517,316,174,25
5,BIHOR,BRATCA,27686,BRATCA,"CENTRUL DE INFORMARE TURISTICĂ BRATCA",266,"Alegeri Prezidentiale",1,1195,674,573,101,0,667,7,1315,641,350,317
5,BIHOR,BRATCA,27686,BEZNEA,"CĂMINUL CULTURAL",267,"Alegeri Prezidentiale",1,1075,533,483,50,0,525,8,1183,650,285,240
5,BIHOR,BRATCA,27686,DAMIŞ,"CĂMINUL CULTURAL",268,"Alegeri Prezidentiale",1,437,232,190,42,0,230,2,481,249,102,128
5,BIHOR,BRATCA,27686,PONOARĂ,"CĂMINUL CULTURAL",269,"Alegeri Prezidentiale",1,475,274,241,33,0,270,4,523,249,231,39
5,BIHOR,BRATCA,27686,LORĂU,"CĂMINUL CULTURAL",270,"Alegeri Prezidentiale",1,362,175,156,19,0,173,2,398,223,92,81
5,BIHOR,BRATCA,27686,"VALEA CRIŞULUI","CĂMINUL CULTURAL",271,"Alegeri Prezidentiale",1,360,225,192,33,0,220,5,396,171,138,82
5,BIHOR,BRUSTURI,27757,BRUSTURI,"CĂMINUL CULTURAL BRUSTURI",272,"Alegeri Prezidentiale",1,932,548,452,96,0,539,9,1025,477,284,255
5,BIHOR,BRUSTURI,27757,CUIEŞD,"ŞCOALA CUIEŞD",273,"Alegeri Prezidentiale",1,393,242,192,49,1,239,3,432,190,107,132
5,BIHOR,BRUSTURI,27757,ORVIŞELE,"ŞCOALA ORVIŞELE",274,"Alegeri Prezidentiale",1,312,160,128,32,0,159,1,343,183,98,61
5,BIHOR,BRUSTURI,27757,PĂULEŞTI,"CĂMINUL CULTURAL PĂULEȘTI",275,"Alegeri Prezidentiale",1,238,146,107,39,0,143,3,262,116,67,76
5,BIHOR,BRUSTURI,27757,PICLEU,"CĂMINUL CULTURAL PICLEU",276,"Alegeri Prezidentiale",1,721,462,371,91,0,458,4,793,331,236,222
5,BIHOR,BRUSTURI,27757,"ŢIGĂNEŞTII DE CRIŞ","ŞCOALA GIMNAZIALĂ ȚIGĂNEȘTII DE CRIȘ",277,"Alegeri Prezidentiale",1,264,162,126,36,0,161,1,291,129,70,91
5,BIHOR,BUDUREASA,27846,BUDUREASA,"CĂMINUL CULTURAL",278,"Alegeri Prezidentiale",1,852,555,506,49,0,544,11,937,382,287,257
5,BIHOR,BUDUREASA,27846,BUDUREASA,"ȘCOALA I-IV BUDUREASA",279,"Alegeri Prezidentiale",1,415,202,187,15,0,201,1,457,255,52,149
5,BIHOR,BUDUREASA,27846,BURDA,"CĂMINUL CULTURAL",280,"Alegeri Prezidentiale",1,321,203,188,15,0,201,2,353,150,107,94
5,BIHOR,BUDUREASA,27846,SACA,"CĂMINUL CULTURAL",281,"Alegeri Prezidentiale",1,172,103,87,16,0,102,1,189,86,55,47
5,BIHOR,BUDUREASA,27846,"SĂLIŞTE DE BEIUŞ","CĂMINUL CULTURAL",282,"Alegeri Prezidentiale",1,212,126,116,10,0,124,2,233,107,72,52
5,BIHOR,BUDUREASA,27846,TELEAC,"CĂMINUL CULTURAL",283,"Alegeri Prezidentiale",1,134,107,87,20,0,106,1,147,40,47,59
5,BIHOR,BUDUSLĂU,27908,BUDUSLĂU,"PRIMĂRIA BUDUSLĂU",284,"Alegeri Prezidentiale",1,827,182,166,16,0,178,4,910,728,89,89
5,BIHOR,BUDUSLĂU,27908,ALBIŞ,"ŞCOALA GENERALĂ ALBIŞ",285,"Alegeri Prezidentiale",1,786,82,71,11,0,77,5,865,783,53,24
5,BIHOR,BULZ,27935,BULZ,"PRIMĂRIA COMUNEI BULZ",286,"Alegeri Prezidentiale",1,689,435,380,55,0,433,2,758,323,209,224
5,BIHOR,BULZ,27935,MUNTENI,"ȘCOALA PRIMARĂ NR.3 MUNTENI",287,"Alegeri Prezidentiale",1,401,286,245,41,0,285,1,441,155,140,145
5,BIHOR,BULZ,27935,REMEŢI,"ȘCOALA GIMNAZIALĂ NR.2 REMEȚI",288,"Alegeri Prezidentiale",1,615,485,371,105,9,478,7,677,192,347,131
5,BIHOR,BUNTEŞTI,27971,BUNTEŞTI,"PRIMĂRIA COMUNEI BUNTEȘTI",289,"Alegeri Prezidentiale",1,478,414,316,88,10,410,4,526,112,304,106
5,BIHOR,BUNTEŞTI,27971,BRĂDET,"CĂMIN CULTURAL",290,"Alegeri Prezidentiale",1,571,348,309,39,0,343,5,628,280,185,158
5,BIHOR,BUNTEŞTI,27971,DUMBRĂVANI,"CĂMIN CULTURAL",291,"Alegeri Prezidentiale",1,238,157,142,15,0,155,2,262,105,103,52
5,BIHOR,BUNTEŞTI,27971,FERICE,"ȘCOALA GIMNAZIALĂ FERICE",292,"Alegeri Prezidentiale",1,397,200,178,22,0,199,1,437,237,144,55
5,BIHOR,BUNTEŞTI,27971,LELEŞTI,"CĂMIN CULTURAL LELEȘTI",293,"Alegeri Prezidentiale",1,329,237,209,28,0,233,4,362,125,135,98
5,BIHOR,BUNTEŞTI,27971,"POIENII DE JOS","ŞCOALA CU CLASELE I-VIII",294,"Alegeri Prezidentiale",1,502,277,248,29,0,273,4,552,275,176,97
5,BIHOR,BUNTEŞTI,27971,"POIENII DE SUS","CĂMIN CULTURAL",295,"Alegeri Prezidentiale",1,554,330,297,33,0,325,5,609,279,207,118
5,BIHOR,BUNTEŞTI,27971,SĂUD,"GRĂDINIŢA CU PROGRAM NORMAL",296,"Alegeri Prezidentiale",1,357,283,242,41,0,275,8,393,110,162,113
5,BIHOR,BUNTEŞTI,27971,STÂNCEŞTI,"ȘCOALA GIMNAZIALĂ NR.3",297,"Alegeri Prezidentiale",1,252,208,176,32,0,206,2,277,69,139,67
5,BIHOR,CĂBEŞTI,28077,CĂBEŞTI,"CĂMINUL CULTURAL",298,"Alegeri Prezidentiale",1,748,417,382,35,0,414,3,823,406,239,175
5,BIHOR,CĂBEŞTI,28077,JOSANI,"ȘCOALA CU CLASELE. I-IV JOSANI",299,"Alegeri Prezidentiale",1,387,228,207,21,0,226,2,425,197,115,111
5,BIHOR,CĂBEŞTI,28077,GOILA,"CĂMINUL CULTURAL",300,"Alegeri Prezidentiale",1,150,105,88,17,0,103,2,165,60,60,43
5,BIHOR,CĂBEŞTI,28077,SOHODOL,"CĂMINUL CULTURAL",301,"Alegeri Prezidentiale",1,239,132,112,20,0,130,2,263,131,71,59
5,BIHOR,CĂPÂLNA,28139,CĂPÂLNA,"PRIMĂRIA CĂPÎLNA",302,"Alegeri Prezidentiale",1,248,206,146,49,11,205,1,274,68,67,138
5,BIHOR,CĂPÂLNA,28139,ROHANI,"CĂMIN CULTURAL ROHANI",303,"Alegeri Prezidentiale",1,83,56,31,18,7,56,0,91,35,19,37
5,BIHOR,CĂPÂLNA,28139,GINTA,"ȘCOALA GENERALĂ",304,"Alegeri Prezidentiale",1,222,123,71,52,0,112,11,244,121,76,36
5,BIHOR,CĂPÂLNA,28139,"SUPLACU DE TINCA","ȘCOALA GENERALĂ",305,"Alegeri Prezidentiale",1,318,223,158,53,12,222,1,350,127,109,113
5,BIHOR,CĂPÂLNA,28139,"SĂLDĂBAGIU MIC","GRĂDINIȚA SĂLDĂBAGIU MIC",306,"Alegeri Prezidentiale",1,343,202,160,42,0,202,0,377,175,81,121
5,BIHOR,CĂRPINET,28193,CĂRPINET,"ȘCOALA PRIMARĂ NR.2 CĂRPINET",307,"Alegeri Prezidentiale",1,434,259,223,36,0,253,6,477,218,95,158
5,BIHOR,CĂRPINET,28193,CĂLUGĂRI,"CĂMIN CULTURAL CĂLUGĂRI",308,"Alegeri Prezidentiale",1,389,262,212,50,0,256,6,428,166,88,168
5,BIHOR,CĂRPINET,28193,IZBUC,"CĂMIN CULTURAL IZBUC",309,"Alegeri Prezidentiale",1,402,253,235,18,0,251,2,442,189,105,146
5,BIHOR,CĂRPINET,28193,LEHECENI,"CĂMIN CULTURAL LEHECENI",310,"Alegeri Prezidentiale",1,308,169,147,22,0,167,2,339,170,71,96
5,BIHOR,CÂMPANI,28709,CÂMPANI,"CĂMINUL CULTURAL CÎMPANI",311,"Alegeri Prezidentiale",1,707,391,357,34,0,380,10,778,388,204,176
5,BIHOR,CÂMPANI,28709,FÂNAŢE,"ŞCOALA PRIMARĂ FÎNAŢE",312,"Alegeri Prezidentiale",1,506,338,317,21,0,334,4,557,219,174,160
5,BIHOR,CÂMPANI,28709,HÂRSEŞTI,"ŞCOALA PRIMARĂ HÎRSEŞTI",313,"Alegeri Prezidentiale",1,270,163,150,13,0,160,3,297,134,78,82
5,BIHOR,CÂMPANI,28709,SIGHIŞTEL,"ŞCOALA PRIMARĂ SIGHIŞTEL",314,"Alegeri Prezidentiale",1,259,155,139,16,0,152,3,285,130,79,73
5,BIHOR,CÂMPANI,28709,"VALEA DE SUS","ŞCOALA PRIMARĂ VALEA DE SUS",315,"Alegeri Prezidentiale",1,240,168,143,23,2,167,1,263,95,48,119
5,BIHOR,CEFA,28246,CEFA,"CENTRUL DE AFACERI",316,"Alegeri Prezidentiale",1,1002,550,502,46,2,547,3,1102,552,358,189
5,BIHOR,CEFA,28246,ATEAŞ,GRĂDINIŢA,317,"Alegeri Prezidentiale",1,162,121,90,31,0,120,1,178,57,102,18
5,BIHOR,CEFA,28246,INAND,"CĂMIN CULTURAL",318,"Alegeri Prezidentiale",1,738,433,362,71,0,426,7,812,379,256,170
5,BIHOR,CEICA,28335,CEICA,"PRIMĂRIA COMUNEI CEICA",319,"Alegeri Prezidentiale",1,772,436,372,61,3,428,8,849,413,239,189
5,BIHOR,CEICA,28335,BUCIUM,"ȘCOALA BUCIUM",320,"Alegeri Prezidentiale",1,175,125,91,34,0,125,0,193,68,59,66
5,BIHOR,CEICA,28335,CEIŞOARA,"ȘCOALA CEIȘOARA",321,"Alegeri Prezidentiale",1,456,219,189,30,0,217,2,502,283,111,106
5,BIHOR,CEICA,28335,CORBEŞTI,"ȘCOALA CORBEȘTI",322,"Alegeri Prezidentiale",1,374,194,171,23,0,191,3,411,217,116,75
5,BIHOR,CEICA,28335,COTIGLET,"ȘCOALA COTIGLET",323,"Alegeri Prezidentiale",1,307,178,154,24,0,178,0,338,160,93,85
5,BIHOR,CEICA,28335,DUŞEŞTI,"CĂMIN CULTURAL DUȘEȘTI",324,"Alegeri Prezidentiale",1,422,256,205,51,0,251,5,464,208,150,101
5,BIHOR,CEICA,28335,INCEŞTI,"ȘCOALA INCEȘTI",325,"Alegeri Prezidentiale",1,293,175,135,40,0,168,7,322,147,83,85
5,BIHOR,CETARIU,28415,ŞIŞTEREA,"ŞCOALA GENERALĂ",326,"Alegeri Prezidentiale",1,498,132,100,32,0,132,0,548,416,112,20
5,BIHOR,CETARIU,28415,ŞUŞTUROGI,"ŞCOALA GENERALĂ",327,"Alegeri Prezidentiale",1,198,96,55,41,0,93,3,218,122,51,42
5,BIHOR,CETARIU,28415,CETARIU,"CĂMIN CULTURAL",328,"Alegeri Prezidentiale",1,915,271,237,34,0,264,7,1007,736,225,39
5,BIHOR,CETARIU,28415,TĂUTELEC,"CĂMIN CULTURAL",329,"Alegeri Prezidentiale",1,196,87,56,31,0,83,4,216,129,57,26
5,BIHOR,CHERECHIU,28497,CHERECHIU,"ȘCOALA GIMNAZIALĂ ”BOCSKAI ISTVAN”",330,"Alegeri Prezidentiale",1,579,115,105,10,0,112,3,637,522,79,33
5,BIHOR,CHERECHIU,28497,CHEŞEREU,"ȘCOALA GIMNAZIALĂ ” BOCSKAI ISTVAN”",331,"Alegeri Prezidentiale",1,793,214,198,16,0,204,10,872,658,137,67
5,BIHOR,CHERECHIU,28497,TÂRGUŞOR,"ȘCOALA PRIMARĂ ”KUTHY SÁNDOR”",332,"Alegeri Prezidentiale",1,438,131,115,16,0,126,5,482,351,96,30
5,BIHOR,CHIŞLAZ,28530,CHIŞLAZ,"ȘCOALA GIMNAZIALĂ CHIȘLAZ",333,"Alegeri Prezidentiale",1,389,165,127,38,0,159,6,428,263,114,45
5,BIHOR,CHIŞLAZ,28530,CHIRALEU,"ȘCOALA PRIMARĂ CHIRALEU",334,"Alegeri Prezidentiale",1,485,214,195,19,0,213,1,534,320,132,81
5,BIHOR,CHIŞLAZ,28530,MIŞCA,"GRĂDINIȚA MIȘCA",335,"Alegeri Prezidentiale",1,762,269,237,32,0,248,21,838,569,205,43
5,BIHOR,CHIŞLAZ,28530,"POCLUŞA DE BARCĂU","ȘCOALA POCLUȘA DE BARCĂU",336,"Alegeri Prezidentiale",1,308,116,99,17,0,109,7,339,223,91,18
5,BIHOR,CHIŞLAZ,28530,SĂRSIG,"CĂMINUL CULTURAL SĂRSIG",337,"Alegeri Prezidentiale",1,235,118,91,26,1,117,1,259,141,67,50
5,BIHOR,CHIŞLAZ,28530,SÂNLAZĂR,"FOSTA ȘCOALĂ PRIMARĂ SÎNLAZĂR",338,"Alegeri Prezidentiale",1,327,185,151,34,0,185,0,360,175,113,72
5,BIHOR,CIUMEGHIU,28665,CIUMEGHIU,"PRIMĂRIA COMUNEI CIUMEGHIU",339,"Alegeri Prezidentiale",1,1510,611,563,48,0,609,2,1661,1050,414,195
5,BIHOR,CIUMEGHIU,28665,BOIU,"GRĂDINIȚA DIN SATUL BOIU",340,"Alegeri Prezidentiale",1,605,276,239,37,0,269,7,666,390,170,99
5,BIHOR,CIUMEGHIU,28665,GHIORAC,"ȘCOALA GENERALĂ GHIORAC",341,"Alegeri Prezidentiale",1,1281,480,426,54,0,470,10,1409,929,306,164
5,BIHOR,"COCIUBA MARE",28763,"COCIUBA MARE","CĂMINUL CULTURAL",342,"Alegeri Prezidentiale",1,731,527,424,81,22,521,6,804,277,333,188
5,BIHOR,"COCIUBA MARE",28763,CHEŞA,"CĂMINUL CULTURAL",343,"Alegeri Prezidentiale",1,454,372,268,75,29,367,5,499,127,280,87
5,BIHOR,"COCIUBA MARE",28763,CĂRĂSĂU,"CĂMINUL CULTURAL",344,"Alegeri Prezidentiale",1,586,271,225,27,19,267,4,645,374,204,63
5,BIHOR,"COCIUBA MARE",28763,PETID,"GRĂDINIȚA PETID",345,"Alegeri Prezidentiale",1,509,368,291,52,25,364,4,560,192,233,131
5,BIHOR,COPĂCEL,28816,BUCUROAIA,"ȘCOALA GIMNAZIALĂ NR.2",346,"Alegeri Prezidentiale",1,266,193,154,39,0,191,2,284,91,125,66
5,BIHOR,COPĂCEL,28816,CHIJIC,"CĂMIN CULTURAL",347,"Alegeri Prezidentiale",1,222,176,123,53,0,172,4,244,68,118,54
5,BIHOR,COPĂCEL,28816,SURDUC,"CĂMIN CULTURAL",348,"Alegeri Prezidentiale",1,328,249,165,84,0,249,0,367,118,142,107
5,BIHOR,COPĂCEL,28816,COPĂCEL,"GRĂDINIȚĂ CU PROGRAM NORMAL NR.3",349,"Alegeri Prezidentiale",1,339,220,154,66,0,214,6,373,153,124,90
5,BIHOR,COPĂCEL,28816,"POIANA TĂŞAD","ȘCOALA PRIMARĂ NR.4",350,"Alegeri Prezidentiale",1,115,89,58,31,0,89,0,127,38,51,38
5,BIHOR,COPĂCEL,28816,SĂRAND,"ȘCOALA PRIMARĂ NR.1",351,"Alegeri Prezidentiale",1,404,285,218,59,8,282,3,444,159,176,106
5,BIHOR,"CRIŞTIORU DE JOS",28889,"CRIŞTIORU DE JOS","CĂMINUL CULTURAL",352,"Alegeri Prezidentiale",1,288,188,153,31,4,186,2,317,129,113,73
5,BIHOR,"CRIŞTIORU DE JOS",28889,"CRIŞTIORU DE SUS","CĂMINUL CULTURAL",353,"Alegeri Prezidentiale",1,73,30,18,12,0,29,1,80,50,18,11
5,BIHOR,"CRIŞTIORU DE JOS",28889,POIANA,"CĂMINUL CULTURAL",354,"Alegeri Prezidentiale",1,391,247,215,32,0,242,5,430,183,142,100
5,BIHOR,"CRIŞTIORU DE JOS",28889,"SĂLIŞTE DE VAŞCĂU","ȘCOALA GIMNAZIALĂ NR. 1 SĂLIȘTE DE VAȘCĂU",355,"Alegeri Prezidentiale",1,329,220,185,35,0,217,3,362,142,118,99
5,BIHOR,CURĂŢELE,28941,CURĂŢELE,"ŞCOALA GIMNAZIALĂ NR.1 CURĂŢELE",356,"Alegeri Prezidentiale",1,650,363,328,35,0,355,8,715,352,245,110
5,BIHOR,CURĂŢELE,28941,BEIUŞELE,"ŞCOALA GENERALĂ CU CLASELE I-IV BEIUŞELE",357,"Alegeri Prezidentiale",1,355,249,235,14,0,244,5,391,142,183,61
5,BIHOR,CURĂŢELE,28941,CRESUIA,"ŞCOALA GENERALĂ CU CLASELE I-IV CRESUIA",358,"Alegeri Prezidentiale",1,363,243,226,17,0,241,2,399,156,146,95
5,BIHOR,CURĂŢELE,28941,NIMĂIEŞTI,"CĂMIN CULTURAL NIMĂIEŞTI",359,"Alegeri Prezidentiale",1,681,415,387,28,0,411,4,749,334,262,149
5,BIHOR,CURTUIŞENI,29001,CURTUIŞENI,"ŞCOALA GENERALĂ CU CLASELE I-VIII NR. 542",360,"Alegeri Prezidentiale",1,1017,277,257,20,0,270,7,1119,842,155,115
5,BIHOR,CURTUIŞENI,29001,CURTUIŞENI,"PRIMĂRIA CURTUIŞENI",361,"Alegeri Prezidentiale",1,1275,403,384,19,0,399,4,1403,1000,190,209
5,BIHOR,CURTUIŞENI,29001,VĂŞAD,"ŞCOALA GENERALĂ CU CLASELE I-VIII NR. 24",362,"Alegeri Prezidentiale",1,669,362,307,55,0,355,7,736,374,179,176
5,BIHOR,DERNA,29038,DERNA,"PRIMĂRIA DERNA",363,"Alegeri Prezidentiale",1,738,327,293,33,1,327,0,812,485,192,135
5,BIHOR,DERNA,29038,DERNIŞOARA,"ȘCOALA GIMNAZIALĂ NR.2",364,"Alegeri Prezidentiale",1,419,236,209,27,0,235,1,461,225,129,106
5,BIHOR,DERNA,29038,SACALASĂU,"ȘCOALA PRIMARĂ NR.1",365,"Alegeri Prezidentiale",1,416,228,182,46,0,228,0,458,230,159,69
5,BIHOR,DERNA,29038,"SACALASĂU NOU","ȘCOALA PRIMARĂ NR.2",366,"Alegeri Prezidentiale",1,216,60,49,11,0,60,0,238,178,27,33
5,BIHOR,DERNA,29038,TRIA,"GRĂDINIȚA CU PROGRAM NORMAL NR.3",367,"Alegeri Prezidentiale",1,237,144,113,31,0,142,2,261,117,63,79
5,BIHOR,DIOSIG,29092,DIOSIG,"PRIMĂRIA COMUNEI DIOSIG",368,"Alegeri Prezidentiale",1,996,236,200,36,0,228,8,1096,860,173,55
5,BIHOR,DIOSIG,29092,DIOSIG,"ŞCOALA GIMNAZIALĂ NR.1 DIOSIG,",369,"Alegeri Prezidentiale",1,953,192,176,16,0,183,9,1048,856,142,41
5,BIHOR,DIOSIG,29092,DIOSIG,"ŞCOALA GIMNAZIALĂ NR.1 DIOSIG",370,"Alegeri Prezidentiale",1,952,191,179,12,0,187,4,1047,856,137,50
5,BIHOR,DIOSIG,29092,DIOSIG,"ŞCOALA GIMNAZIALĂ NR.1 DIOSIG",371,"Alegeri Prezidentiale",1,1298,528,469,59,0,523,5,1428,900,369,154
5,BIHOR,DIOSIG,29092,DIOSIG,"ŞCOALA GIMNAZIALĂ NR.1 DIOSIG",372,"Alegeri Prezidentiale",3,1082,391,357,34,0,375,16,1190,799,232,143
5,BIHOR,DIOSIG,29092,DIOSIG,"ŞCOALA GIMNAZIALĂ NR.1 DIOSIG",373,"Alegeri Prezidentiale",1,231,57,43,14,0,57,0,254,197,46,11
5,BIHOR,DOBREŞTI,29154,DOBREŞTI,"CĂMINUL CULTURAL DOBREŞTI",374,"Alegeri Prezidentiale",1,1530,731,664,67,0,720,11,1683,952,361,359
5,BIHOR,DOBREŞTI,29154,LUNCASPRIE,"CĂMINUL CULTURAL LUNCASPRIE",375,"Alegeri Prezidentiale",1,771,390,358,31,1,386,4,848,458,214,172
5,BIHOR,DOBREŞTI,29154,HIDIŞEL,"CĂMINUL CULTURAL HIDIŞEL",376,"Alegeri Prezidentiale",1,545,330,286,43,1,327,3,600,270,180,147
5,BIHOR,DOBREŞTI,29154,CRÂNCEŞTI,"CĂMINUL CULTURAL CRINCEŞTI",377,"Alegeri Prezidentiale",1,333,186,156,30,0,185,1,366,180,75,110
5,BIHOR,DOBREŞTI,29154,CORNIŞEŞTI,"CĂMINUL CULTURAL CORNIŞEŞTI",378,"Alegeri Prezidentiale",1,162,99,73,26,0,99,0,178,79,60,39
5,BIHOR,DOBREŞTI,29154,"TOPA DE JOS","ŞCOALA S04 TOPA DE JOS",379,"Alegeri Prezidentiale",1,148,94,80,14,0,94,0,163,69,59,35
5,BIHOR,DOBREŞTI,29154,"TOPA DE SUS","CĂMINUL CULTURAL TOPA DE SUS",380,"Alegeri Prezidentiale",1,485,293,251,39,3,284,9,534,241,134,150
5,BIHOR,DRĂGĂNEŞTI,29243,DRĂGĂNEŞTI,"PRIMARIA DRAGANESTI",381,"Alegeri Prezidentiale",1,367,250,228,22,0,248,2,404,154,135,113
5,BIHOR,DRĂGĂNEŞTI,29243,BELEJENI,"SCOALA PRIMARA BELEJENI",382,"Alegeri Prezidentiale",1,261,189,168,21,0,185,4,287,98,95,90
5,BIHOR,DRĂGĂNEŞTI,29243,GRĂDINARI,"SCOALA MAGHIARA GRADINARI",383,"Alegeri Prezidentiale",1,386,187,168,19,0,184,3,425,238,138,46
5,BIHOR,DRĂGĂNEŞTI,29243,"LIVADA BEIUŞULUI","SCOALA PRIMARA LIVADA",384,"Alegeri Prezidentiale",1,109,92,78,14,0,89,3,120,28,31,58
5,BIHOR,DRĂGĂNEŞTI,29243,MIZIEŞ,"FOSTUL SFAT POPULAR MIZIES",385,"Alegeri Prezidentiale",1,436,248,231,17,0,242,6,480,232,147,95
5,BIHOR,DRĂGĂNEŞTI,29243,PĂNTĂŞEŞTI,"CAMINUL CULTURAL PANTASESTI",386,"Alegeri Prezidentiale",1,114,91,79,12,0,89,2,125,34,57,32
5,BIHOR,DRĂGĂNEŞTI,29243,ŞEBIŞ,"SCOALA SEBIS",387,"Alegeri Prezidentiale",1,258,161,138,23,0,159,2,284,123,97,62
5,BIHOR,DRĂGĂNEŞTI,29243,TALPE,"SCOALA PRIMARA TALPE",388,"Alegeri Prezidentiale",1,200,127,118,9,0,123,4,220,93,68,55
5,BIHOR,DRĂGĂNEŞTI,29243,"ŢIGĂNEŞTII DE BEIUŞ","CAMINUL CULTURAL TIGANESTI",389,"Alegeri Prezidentiale",1,121,72,66,6,0,68,4,133,61,37,31
5,BIHOR,DRĂGĂNEŞTI,29243,PĂCĂLEŞTI,"CAMINUL CULTURAL PACALESTI",390,"Alegeri Prezidentiale",1,166,135,109,26,0,132,3,183,48,62,70
5,BIHOR,DRĂGEŞTI,29341,DRĂGEŞTI,"PRIMĂRIA DRĂGEŞTI",391,"Alegeri Prezidentiale",1,273,199,147,50,2,196,3,300,101,135,61
5,BIHOR,DRĂGEŞTI,29341,DICĂNEŞTI,"CĂMINUL CULTURAL",392,"Alegeri Prezidentiale",1,219,150,121,26,3,147,3,241,91,102,45
5,BIHOR,DRĂGEŞTI,29341,STRACOŞ,"ŞCOALA CU CLASELE I-IV",393,"Alegeri Prezidentiale",1,173,123,89,27,7,123,0,190,67,67,56
5,BIHOR,DRĂGEŞTI,29341,TĂŞAD,"ŞCOALA CU CLASELE I-VIII",394,"Alegeri Prezidentiale",1,999,502,426,71,5,496,6,1099,597,325,171
5,BIHOR,DRĂGEŞTI,29341,TOPEŞTI,"CĂMINUL CULTURAL TOPEŞTI",395,"Alegeri Prezidentiale",1,178,116,83,32,1,114,2,196,80,76,38
5,BIHOR,FINIŞ,29403,FINIŞ,"PRIMĂRIA FINIŞ",396,"Alegeri Prezidentiale",1,1359,716,677,39,0,693,23,1495,779,360,333
5,BIHOR,FINIŞ,29403,FIZIŞ,"GRĂDINIŢA FIZIŞ",397,"Alegeri Prezidentiale",1,197,116,104,11,1,110,6,217,101,52,58
5,BIHOR,FINIŞ,29403,IOANIŞ,"ŞCOALA GENERALĂ IOANIŞ",398,"Alegeri Prezidentiale",1,595,274,250,24,0,268,6,655,381,129,139
5,BIHOR,FINIŞ,29403,ŞUNCUIŞ,"GRĂDINIŢA ŞUNCUIŞ",399,"Alegeri Prezidentiale",1,674,254,237,17,0,252,2,741,487,125,127
5,BIHOR,GEPIU,32195,GEPIU,"ŞCOALA CU CLASELE I.-VIII GEPIU",400,"Alegeri Prezidentiale",1,1010,823,586,217,20,808,15,1111,288,360,448
5,BIHOR,GEPIU,32195,BICACI,"ŞCOALA CU CLASELE I.-IV BICACI",401,"Alegeri Prezidentiale",1,498,331,263,68,0,325,6,548,217,210,115
5,BIHOR,"GIRIŞU DE CRIŞ",29467,"GIRIŞU DE CRIŞ","PRIMĂRIA GIRIŞU DE CRIŞ",402,"Alegeri Prezidentiale",1,1255,597,522,74,1,590,7,1381,784,413,177
5,BIHOR,"GIRIŞU DE CRIŞ",29467,TĂRIAN,"GRĂDINIȚA TĂRIAN",403,"Alegeri Prezidentiale",1,928,420,381,39,0,410,10,1021,601,331,79
5,BIHOR,"GIRIŞU DE CRIŞ",29467,TĂRIAN,"CĂMIN CULTURAL TĂRIAN",404,"Alegeri Prezidentiale",1,875,401,362,39,0,398,3,963,562,322,76
5,BIHOR,"HIDIŞELU DE SUS",29519,"HIDIŞELU DE SUS","ȘCOALA GIMNAZIALĂ HIDIȘELU DE SUS",405,"Alegeri Prezidentiale",1,868,557,459,96,2,551,6,955,398,327,224
5,BIHOR,"HIDIŞELU DE SUS",29519,"HIDIŞELU DE JOS","ȘCOALA PRIMARĂ HIDIȘELU DE JOS",406,"Alegeri Prezidentiale",1,497,314,254,60,0,311,3,547,233,226,85
5,BIHOR,"HIDIŞELU DE SUS",29519,MIERLĂU,"ȘCOALA GIMNAZIALĂ MIERLĂU",407,"Alegeri Prezidentiale",1,587,372,307,65,0,366,6,646,274,254,112
5,BIHOR,"HIDIŞELU DE SUS",29519,SÂNTELEC,"ȘCOALA PRIMARĂ SÎNTELEC",408,"Alegeri Prezidentiale",1,312,191,157,31,3,189,2,343,152,117,72
5,BIHOR,"HIDIŞELU DE SUS",29519,ŞUMUGIU,"ȘCOALA PRIMARĂ ȘUMUGIU",409,"Alegeri Prezidentiale",1,323,222,156,59,7,218,4,355,133,142,76
5,BIHOR,HOLOD,29573,HOLOD,"ȘCOALA GIMNAZIALĂ ”IOSIF VULCAN”",410,"Alegeri Prezidentiale",1,377,225,176,49,0,223,2,415,190,116,107
5,BIHOR,HOLOD,29573,DUMBRAVA,"CĂMIN CULTURAL",411,"Alegeri Prezidentiale",1,513,205,165,40,0,201,4,564,359,128,73
5,BIHOR,HOLOD,29573,DUMBRĂVIŢA,"CĂMIN CULTURAL",412,"Alegeri Prezidentiale",1,142,90,60,30,0,90,0,156,66,43,47
5,BIHOR,HOLOD,29573,FOROSIG,"CĂMIN CULTURAL",413,"Alegeri Prezidentiale",1,118,76,58,18,0,75,1,130,54,42,33
5,BIHOR,HOLOD,29573,HODIŞ,"CĂMIN CULTURAL HODIȘ",414,"Alegeri Prezidentiale",1,128,90,61,29,0,89,1,141,51,41,48
5,BIHOR,HOLOD,29573,LUPOAIA,"ȘCOALA CU CLASELE I-IV LUPOAIA",415,"Alegeri Prezidentiale",1,461,153,125,28,0,150,3,507,354,78,72
5,BIHOR,HOLOD,29573,"VALEA MARE DE CODRU","ȘCOALA CU CLASELE I-IV",416,"Alegeri Prezidentiale",1,69,64,27,37,0,64,0,76,12,27,37
5,BIHOR,HOLOD,29573,VINTERE,"CĂMIN CULTURAL VINTERE",417,"Alegeri Prezidentiale",1,591,303,247,56,0,302,1,650,347,127,175
5,BIHOR,"HUSASĂU DE TINCA",29662,"HUSASĂU DE TINCA","GRĂDINIȚA DE COPII",418,"Alegeri Prezidentiale",1,608,385,271,77,37,379,6,669,284,165,214
5,BIHOR,"HUSASĂU DE TINCA",29662,FONĂU,"ȘCOALA CU CLASELE I-IV FONĂU",419,"Alegeri Prezidentiale",1,157,91,70,20,1,89,2,173,82,33,56
5,BIHOR,"HUSASĂU DE TINCA",29662,MIERSIG,"ȘCOALA CU CLASELE I-IV MIERSIG",420,"Alegeri Prezidentiale",1,318,221,155,55,11,214,7,350,129,121,93
5,BIHOR,"HUSASĂU DE TINCA",29662,OŞAND,"ȘCOALA CU CLASELE I-IV OȘAND",421,"Alegeri Prezidentiale",1,386,198,151,36,11,197,1,425,227,71,126
5,BIHOR,"HUSASĂU DE TINCA",29662,SITITELEC,"ȘCOALA CU CLASELE I-IV SITITELEC",422,"Alegeri Prezidentiale",1,258,216,125,83,8,211,5,284,68,101,110
5,BIHOR,INEU,29724,INEU,"CĂMINUL CULTURAL INEU",423,"Alegeri Prezidentiale",1,867,451,367,84,0,444,7,954,503,310,134
5,BIHOR,INEU,29724,INEU,"CĂMINUL CULTURAL INEU",424,"Alegeri Prezidentiale",1,1128,490,446,44,0,477,13,1241,751,143,334
5,BIHOR,INEU,29724,BOTEAN,"ȘCOALA NR. 1 BOTEAN",425,"Alegeri Prezidentiale",1,526,247,219,28,0,245,2,579,332,130,115
5,BIHOR,INEU,29724,"HUSASĂU DE CRIŞ","CĂMINUL CULTURAL HUSASĂU DE CRIȘ",426,"Alegeri Prezidentiale",1,1003,564,494,70,0,557,7,1103,539,270,287
5,BIHOR,"LAZURI DE BEIUŞ",29760,"LAZURI DE BEIUŞ",PRIMĂRIA,427,"Alegeri Prezidentiale",1,285,213,181,28,4,209,4,314,101,159,50
5,BIHOR,"LAZURI DE BEIUŞ",29760,HINCHIRIŞ,"CĂMIN CULTURAL",428,"Alegeri Prezidentiale",1,524,325,290,32,3,322,3,576,251,217,105
5,BIHOR,"LAZURI DE BEIUŞ",29760,CUSUIUŞ,"ȘCOALA CU CLASELE I-IV",429,"Alegeri Prezidentiale",1,367,202,180,21,1,199,3,404,202,129,70
5,BIHOR,"LAZURI DE BEIUŞ",29760,BĂLENI,"ȘCOALA CU CLASELE I-IV",430,"Alegeri Prezidentiale",1,165,112,97,14,1,112,0,182,70,79,33
5,BIHOR,LĂZĂRENI,29813,LĂZĂRENI,"PRIMĂRIA COMUNEI LĂZĂRENI",431,"Alegeri Prezidentiale",1,657,468,391,74,3,453,15,723,255,151,302
5,BIHOR,LĂZĂRENI,29813,CĂRĂNDENI,"ȘCOALA PRIMARĂ",432,"Alegeri Prezidentiale",1,330,186,136,50,0,185,1,333,147,100,85
5,BIHOR,LĂZĂRENI,29813,CĂRĂNZEL,"CĂMIN CULTURAL CĂRĂNZEL",433,"Alegeri Prezidentiale",1,78,89,41,47,1,88,1,116,27,44,44
5,BIHOR,LĂZĂRENI,29813,"CALEA MARE","CĂMIN CULTURAL",434,"Alegeri Prezidentiale",1,491,327,252,73,2,321,6,540,213,177,144
5,BIHOR,LĂZĂRENI,29813,GEPIŞ,"CĂMIN CULTURAL",435,"Alegeri Prezidentiale",1,559,321,260,58,3,312,9,615,294,93,219
5,BIHOR,LĂZĂRENI,29813,GRUILUNG,"CĂMIN CULTURAL",436,"Alegeri Prezidentiale",1,92,77,46,31,0,74,3,101,24,46,28
5,BIHOR,LĂZĂRENI,29813,MIHELEU,"CĂMIN CULTURAL",437,"Alegeri Prezidentiale",1,135,106,56,50,0,104,2,149,43,44,60
5,BIHOR,"LUGAŞU DE JOS",29902,"LUGAŞU DE JOS","CĂMINUL CULTURAL LUGAȘU DE JOS",438,"Alegeri Prezidentiale",1,1291,704,626,60,18,687,17,1420,716,299,388
5,BIHOR,"LUGAŞU DE JOS",29902,"LUGAŞU DE SUS","CĂMINUL CULTURAL LUGAȘU DE SUS",439,"Alegeri Prezidentiale",1,655,388,355,32,1,382,6,721,333,242,140
5,BIHOR,"LUGAŞU DE JOS",29902,URVIND,"CĂMINUL CULTURAL URVIND",440,"Alegeri Prezidentiale",1,745,446,369,40,37,426,20,820,374,232,194
5,BIHOR,LUNCA,29948,LUNCA,"CĂMINUL CULTURAL LUNCA",441,"Alegeri Prezidentiale",1,774,497,395,93,9,487,10,851,354,294,193
5,BIHOR,LUNCA,29948,BRIHENI,"CĂMINUL CULTURAL BRIHENI",442,"Alegeri Prezidentiale",1,248,214,164,43,7,210,4,273,59,161,49
5,BIHOR,LUNCA,29948,HOTĂREL,"CĂMINUL CULTURAL HOTĂREL",443,"Alegeri Prezidentiale",1,237,177,140,34,3,175,2,261,84,117,58
5,BIHOR,LUNCA,29948,SEGHIŞTE,"CĂMINUL CULTURAL SEGHIŞTE",444,"Alegeri Prezidentiale",1,462,377,297,68,12,373,4,508,131,287,86
5,BIHOR,LUNCA,29948,SÂRBEŞTI,"CAMINUL CULTURAL SIRBESTI",445,"Alegeri Prezidentiale",1,218,156,132,24,0,153,3,240,84,103,50
5,BIHOR,LUNCA,29948,ŞUŞTIU,"CĂMINUL CULTURAL ŞUŞTIU",446,"Alegeri Prezidentiale",1,362,238,210,22,6,236,2,398,160,170,66
5,BIHOR,MĂDĂRAS,30014,MARŢIHAZ,"CĂMINUL CULTURAL",447,"Alegeri Prezidentiale",1,165,104,75,29,0,102,2,182,78,70,32
5,BIHOR,MĂDĂRAS,30014,MĂDĂRAS,"ȘCOALA CU CLASELE I.-VIII",448,"Alegeri Prezidentiale",1,755,348,296,52,0,343,5,831,483,234,109
5,BIHOR,MĂDĂRAS,30014,HOMOROG,"FOSTA ȘCOALĂ CU CLASELE I.-IV",449,"Alegeri Prezidentiale",1,571,307,256,51,0,301,6,628,321,190,111
5,BIHOR,MĂDĂRAS,30014,IANOŞDA,"ŞCOALA CU CLASELE I-VIII",450,"Alegeri Prezidentiale",1,755,409,334,75,0,402,7,831,422,234,168
5,BIHOR,MĂGEŞTI,30069,MĂGEŞTI,"PRIMĂRIA MĂGEŞTI",451,"Alegeri Prezidentiale",1,215,118,97,21,0,116,2,237,119,76,40
5,BIHOR,MĂGEŞTI,30069,BUTANI,"ŞCOALA GENERALĂ",452,"Alegeri Prezidentiale",1,299,178,155,20,3,174,4,328,150,121,53
5,BIHOR,MĂGEŞTI,30069,ORTITEAG,"ŞCOALA GENERALĂ",453,"Alegeri Prezidentiale",1,422,225,201,24,0,221,4,464,239,135,86
5,BIHOR,MĂGEŞTI,30069,"CACUCIU NOU","ŞCOALA GENERALĂ",454,"Alegeri Prezidentiale",1,280,140,118,22,0,137,3,308,168,104,33
5,BIHOR,MĂGEŞTI,30069,JOSANI,"ŞCOALA GENERALĂ",455,"Alegeri Prezidentiale",1,292,152,140,11,1,148,4,321,169,95,53
5,BIHOR,MĂGEŞTI,30069,GĂLĂŞENI,"ŞCOALA GENERALĂ",456,"Alegeri Prezidentiale",1,215,126,114,12,0,124,2,238,112,89,35
5,BIHOR,MĂGEŞTI,30069,DOBRICIONEŞTI,"CĂMIN CULTURAL",457,"Alegeri Prezidentiale",1,417,263,216,41,6,257,6,459,196,191,66
5,BIHOR,NOJORID,30149,NOJORID,"ȘCOALA GIMNAZIALĂ NR 1 NOJORID STR. PRINCIPALĂ NR 185 LOC. NOJORID",458,"Alegeri Prezidentiale",1,1105,718,595,123,0,711,7,1216,498,514,197
5,BIHOR,NOJORID,30149,NOJORID,"ȘCOALA GIMNAZIALĂ NR.1",459,"Alegeri Prezidentiale",1,1004,668,545,123,0,659,9,1104,436,487,172
5,BIHOR,NOJORID,30149,APATEU,"SCOALA CU CLASELE I-IV APATEU , LOC. APATEU NR 41",460,"Alegeri Prezidentiale",1,260,197,131,66,0,193,4,286,89,132,61
5,BIHOR,NOJORID,30149,CHIŞIRID,"ȘCOALA CU CL. I-IV CHIȘIRID, LOC CHIȘIRID NR 168",461,"Alegeri Prezidentiale",1,194,148,81,67,0,143,5,213,65,95,48
5,BIHOR,NOJORID,30149,LEŞ,"ȘCOALA PRIMARĂ NR.1",462,"Alegeri Prezidentiale",1,688,344,279,65,0,341,3,757,413,279,62
5,BIHOR,NOJORID,30149,"LIVADA DE BIHOR","GRĂDINIȚA - LIVADA DE BIHOR LOC. LIVADA DE BIHOR NR. 228",463,"Alegeri Prezidentiale",1,1162,671,573,98,0,659,12,1278,607,501,158
5,BIHOR,NOJORID,30149,PĂUŞA,"ȘCOALA CU CL.I-IV PĂUȘA , NR 37/B",464,"Alegeri Prezidentiale",1,261,162,122,40,0,159,3,287,125,82,77
5,BIHOR,NOJORID,30149,ŞAUAIEU,"ȘCOALA CU CL. I-IV ȘAUAIEU, LOC. ȘAUAIEU NR 101",465,"Alegeri Prezidentiale",1,238,130,91,39,0,128,2,262,132,98,30
5,BIHOR,OLCEA,30229,OLCEA,"ŞCOALA GIMNAZIALĂ NR. 1 OLCEA",466,"Alegeri Prezidentiale",1,461,242,216,21,5,241,1,507,265,157,84
5,BIHOR,OLCEA,30229,CĂLACEA,"ŞCOALA GIMNAZIALĂ NR. 2 CĂLACEA",467,"Alegeri Prezidentiale",1,981,461,419,36,6,456,5,1079,618,312,144
5,BIHOR,OLCEA,30229,HODIŞEL,"ŞCOALA PRIMARĂ NR. 1 HODIŞEL",468,"Alegeri Prezidentiale",1,247,141,112,17,12,141,0,272,131,92,49
5,BIHOR,OLCEA,30229,UCURIŞ,"GRĂDINIŢA CU PROGRAM NORMAL NR. 4 UCURIŞ",469,"Alegeri Prezidentiale",1,445,214,166,43,5,212,2,490,276,148,64
5,BIHOR,OŞORHEI,30274,OŞORHEI,"ȘCOALA GIMNAZIALA „AUREL POP” OȘORHEI",470,"Alegeri Prezidentiale",1,1385,632,542,90,0,613,19,1524,892,492,121
5,BIHOR,OŞORHEI,30274,OŞORHEI,"ȘCOALA GIMNAZIALA „AUREL POP” OȘORHEI",471,"Alegeri Prezidentiale",1,1439,633,531,102,0,614,19,1583,950,463,151
5,BIHOR,OŞORHEI,30274,ALPAREA,"ȘCOALA PRIMARĂ NR.1 ALPAREA",472,"Alegeri Prezidentiale",1,850,532,427,105,0,520,12,935,403,346,174
5,BIHOR,OŞORHEI,30274,CHERIU,"ȘCOALA PRIMARĂ NR.2 CHERIU",473,"Alegeri Prezidentiale",1,651,335,275,60,0,328,7,716,381,237,91
5,BIHOR,OŞORHEI,30274,FELCHERIU,"CĂMIN CULTURAL FELCHERIU",474,"Alegeri Prezidentiale",1,267,204,128,76,0,202,2,294,90,131,71
5,BIHOR,OŞORHEI,30274,FUGHIU,"CĂMIN CULTURAL FUGHIU",475,"Alegeri Prezidentiale",1,955,446,381,65,0,437,9,1051,605,346,91
5,BIHOR,PALEU,32161,PALEU,"ȘCOALA CU CLASELE I-IV",476,"Alegeri Prezidentiale",1,1390,716,609,107,0,703,13,1529,813,564,139
5,BIHOR,PALEU,32161,"UILEACU DE MUNTE","ȘCOALA CU CLASELE I-IV",477,"Alegeri Prezidentiale",1,402,158,129,29,0,155,3,442,284,127,28
5,BIHOR,PALEU,32161,"SĂLDĂBAGIU DE MUNTE","ȘCOALA CU CLASELE I-IV",478,"Alegeri Prezidentiale",1,776,318,268,48,2,309,9,854,536,255,54
5,BIHOR,PIETROASA,30336,PIETROASA,"ȘCOALA GIMNAZIALĂ NR.1 PIETROASA",479,"Alegeri Prezidentiale",1,645,398,341,56,1,395,3,709,311,192,203
5,BIHOR,PIETROASA,30336,GURANI,"ȘCOALA PRIMARĂ NR.1 GURANI",480,"Alegeri Prezidentiale",1,481,252,219,33,0,252,0,529,277,115,137
5,BIHOR,PIETROASA,30336,"COCIUBA MICĂ","ȘCOALA PRIMARĂ NR.2 COCIUBA MICĂ",481,"Alegeri Prezidentiale",1,366,164,155,9,0,162,2,404,240,101,61
5,BIHOR,PIETROASA,30336,CHIŞCĂU,"ȘCOALA GIMAZIALĂ NR.2 CHIȘCĂU",482,"Alegeri Prezidentiale",1,591,301,268,33,0,299,2,649,348,150,149
5,BIHOR,PIETROASA,30336,GIULEŞTI,"ȘCOALA PRIMARĂ NR.4 GIULEȘTI",483,"Alegeri Prezidentiale",1,132,59,53,6,0,59,0,145,86,32,27
5,BIHOR,PIETROASA,30336,MĂGURA,"ȘCOALA PRIMARĂ NR.3 MĂGURA",484,"Alegeri Prezidentiale",1,248,140,124,16,0,139,1,273,133,65,74
5,BIHOR,PIETROASA,30336,MOŢEŞTI,"ȘCOALA PRIMARĂ NR.5 MOȚEȘTI",485,"Alegeri Prezidentiale",1,74,52,44,8,0,52,0,81,29,20,32
5,BIHOR,POCOLA,30416,POCOLA,"CAMINUL CULTURAL POCOLA",486,"Alegeri Prezidentiale",1,442,301,244,51,6,298,3,485,184,126,172
5,BIHOR,POCOLA,30416,FENERIŞ,"CAMINUL CULTURAL FENERIȘ",487,"Alegeri Prezidentiale",1,294,271,186,77,8,266,5,323,52,107,159
5,BIHOR,POCOLA,30416,PETRANI,"CAMIN CULTURAL PETRANI",488,"Alegeri Prezidentiale",1,276,227,172,54,1,217,10,304,77,97,120
5,BIHOR,POCOLA,30416,"SÂNMARTIN DE BEIUŞ","CAMIN CULTURAL SINMARTIN DE BEIUȘ",489,"Alegeri Prezidentiale",1,191,172,126,44,2,171,1,210,38,102,69
5,BIHOR,POMEZEU,30470,COŞDENI,"CĂMIN CULTURAL COȘDENI",490,"Alegeri Prezidentiale",1,447,305,257,43,5,298,7,492,187,124,174
5,BIHOR,POMEZEU,30470,HIDIŞ,"CĂMIN CULTURAL HIDIȘ",491,"Alegeri Prezidentiale",1,271,238,177,54,7,238,0,298,60,91,147
5,BIHOR,POMEZEU,30470,"SPINUŞ DE POMEZEU","CĂMIN CULTURAL SPINUȘ DE POMEZEU",492,"Alegeri Prezidentiale",1,175,151,109,29,13,148,3,193,42,89,59
5,BIHOR,POMEZEU,30470,"VĂLANI DE POMEZEU","CĂMIN CULTURAL VĂLANI DE POMEZEU",493,"Alegeri Prezidentiale",1,454,315,261,39,15,313,2,499,184,169,144
5,BIHOR,POMEZEU,30470,SITANI,"GRĂDINIȚA CU PROGRAM NORMAL NR.2 SITANI",494,"Alegeri Prezidentiale",1,363,243,207,33,3,236,7,399,156,131,105
5,BIHOR,POMEZEU,30470,POMEZEU,"ȘCOALA GIMNAZIALĂ NR.1 POMEZEU",495,"Alegeri Prezidentiale",1,110,97,69,26,2,95,2,121,24,51,44
5,BIHOR,POMEZEU,30470,"LACU SĂRAT","ȘCOALA GENERALĂ LACU SĂRAT",496,"Alegeri Prezidentiale",1,35,35,27,8,0,35,0,39,4,31,4
5,BIHOR,POMEZEU,30470,"CÂMPANI DE POMEZEU","ȘCOALA PRIMARĂ NR.2 CÎMPANI",497,"Alegeri Prezidentiale",1,339,226,185,41,0,222,4,373,147,126,96
5,BIHOR,POPEŞTI,30568,POPEŞTI,"LICEUL TEHNOLOGIC NR 1 POPESTI",498,"Alegeri Prezidentiale",1,933,337,316,21,0,333,4,1025,688,208,125
5,BIHOR,POPEŞTI,30568,POPEŞTI,"LICEUL TEHNOLOGIC NR 1 POPESTI",499,"Alegeri Prezidentiale",1,937,504,417,28,59,499,5,1031,527,296,203
5,BIHOR,POPEŞTI,30568,VOIVOZI,"ŞCOALA GENERALĂ VOIVOZI",500,"Alegeri Prezidentiale",1,764,380,354,26,0,374,6,840,460,187,187
5,BIHOR,POPEŞTI,30568,VOIVOZI,"ŞCOALA GENERALĂ VOIVOZI",501,"Alegeri Prezidentiale",1,630,287,252,35,0,283,4,693,406,150,133
5,BIHOR,POPEŞTI,30568,BISTRA,"ȘCOALA GENERALĂ BISTRA",502,"Alegeri Prezidentiale",1,831,332,319,13,0,327,5,914,582,197,130
5,BIHOR,POPEŞTI,30568,BUDOI,"LICEUL ”JOSEF KOZACEK” BUDOI",503,"Alegeri Prezidentiale",1,743,227,217,10,0,225,2,817,590,136,89
5,BIHOR,POPEŞTI,30568,CUZAP,"ȘCOALA GENERALĂ CUZAP",504,"Alegeri Prezidentiale",1,932,456,420,36,0,450,6,1025,569,231,219
5,BIHOR,POPEŞTI,30568,VARVIZ,"ȘCOALA GENERALĂ VARVIZ",505,"Alegeri Prezidentiale",1,410,219,201,18,0,216,3,451,232,111,105
5,BIHOR,POPEŞTI,30568,VĂRZARI,"ȘCOALA GENERALĂ VĂRZARI",506,"Alegeri Prezidentiale",1,251,114,104,10,0,110,4,276,162,66,44
5,BIHOR,RĂBĂGANI,30648,RĂBĂGANI,"CĂMINUL CULTURAL",507,"Alegeri Prezidentiale",1,522,313,257,56,0,308,5,574,261,151,157
5,BIHOR,RĂBĂGANI,30648,ALBEŞTI,"FOSTA ȘCOALĂ CU CLASELE I-IV ALBEȘTI",508,"Alegeri Prezidentiale",1,214,156,124,32,0,156,0,235,79,69,87
5,BIHOR,RĂBĂGANI,30648,"SĂLIŞTE DE POMEZEU","CĂMINUL CULTURAL",509,"Alegeri Prezidentiale",1,92,91,70,21,0,91,0,101,10,54,37
5,BIHOR,RĂBĂGANI,30648,SĂUCANI,"CĂMINUL CULTURAL",510,"Alegeri Prezidentiale",1,373,228,182,46,0,226,2,410,182,127,99
5,BIHOR,RĂBĂGANI,30648,VĂRĂŞENI,"CĂMINUL CULTURAL",511,"Alegeri Prezidentiale",1,312,189,159,30,0,188,1,343,154,92,96
5,BIHOR,RĂBĂGANI,30648,BRĂTEŞTI,"FOSTA GRĂDINIȚĂ CU PROGRAM NORMAL",512,"Alegeri Prezidentiale",1,101,78,54,24,0,77,1,111,33,41,36
5,BIHOR,REMETEA,30719,REMETEA,"ȘCOALA GIMNAZIALĂ NR 1",513,"Alegeri Prezidentiale",1,655,472,404,66,2,465,7,721,249,246,219
5,BIHOR,REMETEA,30719,MEZIAD,"ȘCOALA GIMNAZIALĂ NR 2",514,"Alegeri Prezidentiale",1,910,699,635,52,12,691,8,1001,302,167,524
5,BIHOR,REMETEA,30719,DRĂGOTENI,"ȘCOALA PRIMARĂ NR. 2",515,"Alegeri Prezidentiale",1,321,270,217,46,7,268,2,353,83,119,149
5,BIHOR,REMETEA,30719,PETREASA,"ȘCOALA PRIMARĂ NR. 1",516,"Alegeri Prezidentiale",1,364,233,185,47,1,227,6,400,167,82,145
5,BIHOR,REMETEA,30719,ŞOIMUŞ,"CĂMINUL CULTURAL ŞOIMUŞ",517,"Alegeri Prezidentiale",1,99,93,57,36,0,91,2,109,16,63,28
5,BIHOR,RIENI,30773,RIENI,"CĂMIN CULTURAL RIENI",518,"Alegeri Prezidentiale",1,434,537,246,279,12,537,0,587,50,432,105
5,BIHOR,RIENI,30773,GHIGHIŞENI,"CĂMIN CULTURAL GHIGHIȘENI",519,"Alegeri Prezidentiale",1,781,539,449,85,5,529,10,659,120,376,153
5,BIHOR,RIENI,30773,"VALEA DE JOS","ȘCOALA PRIMARĂ NR.1 VALEA DE JOS",520,"Alegeri Prezidentiale",1,466,363,289,69,5,360,3,513,150,251,109
5,BIHOR,RIENI,30773,PETRILENI,"CĂMIN CULTURAL PETRILENI",521,"Alegeri Prezidentiale",1,461,325,204,119,2,321,4,507,182,256,65
5,BIHOR,RIENI,30773,SUDRIGIU,"CĂMIN CULTURAL SUDRIGIU",522,"Alegeri Prezidentiale",1,262,221,163,56,2,219,2,288,67,138,81
5,BIHOR,ROŞIA,30844,ROŞIA,"CĂMINUL CULTURAL ROŞIA",523,"Alegeri Prezidentiale",1,1617,994,917,77,0,977,17,1779,785,471,506
5,BIHOR,ROŞIA,30844,LAZURI,"ŞCOALA CU CLASELE I-IV LAZURI",524,"Alegeri Prezidentiale",1,318,244,224,20,0,240,4,350,106,135,105
5,BIHOR,ROŞIORI,32187,ROŞIORI,"ŞCOALA GIMNAZIALĂ ”JAKO ZSIGMOND”",525,"Alegeri Prezidentiale",1,1142,327,304,23,0,324,3,1256,929,263,61
5,BIHOR,ROŞIORI,32187,"MIHAI BRAVU","ŞCOALA GIMNAZIALĂ NR.1",526,"Alegeri Prezidentiale",1,827,369,320,48,1,363,6,910,541,224,139
5,BIHOR,ROŞIORI,32187,VAIDA,"ŞCOALA PRIMARĂ NR.1",527,"Alegeri Prezidentiale",1,361,116,91,25,0,109,7,397,281,79,30
5,BIHOR,SĂCĂDAT,30871,SĂCĂDAT,"CĂMIN CULTURAL",528,"Alegeri Prezidentiale",1,718,477,344,133,0,472,5,790,313,252,220
5,BIHOR,SĂCĂDAT,30871,SĂBOLCIU,"CĂMIN CULTURAL",529,"Alegeri Prezidentiale",1,613,318,252,66,0,315,3,674,356,191,124
5,BIHOR,SĂCĂDAT,30871,BORŞA,"FOSTA ȘCOALĂ CU CLS.I-IV",530,"Alegeri Prezidentiale",1,134,118,61,57,0,117,1,147,29,60,57
5,BIHOR,SĂLACEA,30988,OTOMANI,"CĂMINUL CULTURAL",531,"Alegeri Prezidentiale",1,598,138,115,23,0,127,11,658,520,75,52
5,BIHOR,SĂLACEA,30988,SĂLACEA,"PRIMĂRIA COMUNEI SĂLACEA",532,"Alegeri Prezidentiale",1,945,133,113,20,0,131,2,1040,907,86,45
5,BIHOR,SĂLACEA,30988,SĂLACEA,"SCOALĂ GENERALĂ",533,"Alegeri Prezidentiale",1,923,139,131,8,0,130,9,1015,876,62,68
5,BIHOR,SĂLARD,31011,SĂLARD,"ȘCOALA GIMNAZIALĂ SZALARDI JANOS SĂLARD",534,"Alegeri Prezidentiale",1,1187,378,322,56,0,374,4,1306,928,265,109
5,BIHOR,SĂLARD,31011,SĂLARD,"ȘCOALA GIMNAZIALĂ SZALARDI JANOS SĂLARD",535,"Alegeri Prezidentiale",1,1281,375,355,19,1,368,7,1409,1034,281,87
5,BIHOR,SĂLARD,31011,HODOŞ,"ȘCOALA PRIMARĂ NR.1",536,"Alegeri Prezidentiale",1,605,106,85,21,0,102,4,666,560,72,30
5,BIHOR,SĂLARD,31011,SÂNTIMREU,"ȘCOALA PRIMARĂ NR. 2",537,"Alegeri Prezidentiale",1,489,141,116,25,0,139,2,538,397,83,56
5,BIHOR,SÂMBĂTA,31057,SÂMBĂTA,"CAMINUL CULTURAL",538,"Alegeri Prezidentiale",1,287,242,152,81,9,237,5,316,74,127,110
5,BIHOR,SÂMBĂTA,31057,COPĂCENI,"CAMINUL CULTURAL",539,"Alegeri Prezidentiale",1,105,113,63,48,2,109,4,128,15,50,59
5,BIHOR,SÂMBĂTA,31057,OGEŞTI,"GRĂDINIȚA CU PROGRAM NORMAL NR. 3 OGEȘTI",540,"Alegeri Prezidentiale",1,169,151,122,23,6,150,1,186,35,80,70
5,BIHOR,SÂMBĂTA,31057,ROTĂREŞTI,"CAMINUL CULTURAL",541,"Alegeri Prezidentiale",1,108,105,64,36,5,105,0,119,14,47,58
5,BIHOR,SÂMBĂTA,31057,ROGOZ,"GRĂDINIȚA CU PROGRAM NORMAL NR.4 ROGOZ",542,"Alegeri Prezidentiale",1,225,183,115,56,12,182,1,248,65,73,109
5,BIHOR,SÂMBĂTA,31057,ZĂVOIU,"GRĂDINIȚA CU PROGRAM NORMAL NR. 2 ZĂVOIU",543,"Alegeri Prezidentiale",1,200,174,115,52,7,173,1,220,46,62,111
5,BIHOR,SÂNIOB,28610,SÂNIOB,"CASA DE NUNTĂ",544,"Alegeri Prezidentiale",1,1062,341,305,36,0,327,14,1168,827,271,56
5,BIHOR,SÂNIOB,28610,CIUHOI,"ŞCOALA GENERALĂ",545,"Alegeri Prezidentiale",1,296,150,109,41,0,148,2,326,176,94,54
5,BIHOR,SÂNIOB,28610,CENALOŞ,"ŞCOALA GENERALĂ",546,"Alegeri Prezidentiale",1,218,99,76,23,0,98,1,240,141,64,34
5,BIHOR,SÂNIOB,28610,SFÂRNAŞ,"CĂMIN CULTURAL SFÂRNAȘ",547,"Alegeri Prezidentiale",1,208,122,88,34,0,121,1,229,107,94,27
5,BIHOR,SÂNMARTIN,26582,SÂNMARTIN,"GRĂDINIŢA CU PROGRAM PRELUNGIT ”PRIETENII COPILĂRIEI” SÂNMARTIN",548,"Alegeri Prezidentiale",1,1726,1064,864,199,1,1037,27,1899,835,716,321
5,BIHOR,SÂNMARTIN,26582,SÂNMARTIN,"ŞCOALA GIMNAZIALĂ ”FLOARE DE LOTUS” SÂNMARTIN",549,"Alegeri Prezidentiale",1,1966,1468,1144,323,1,1431,37,2163,695,1003,428
5,BIHOR,SÂNMARTIN,26582,BETFIA,"GRĂDINIŢA CU PROGRAM PRELUNGIT ”CĂSUŢA POVEŞTILOR” BETFIA",550,"Alegeri Prezidentiale",1,382,284,218,66,0,282,2,420,136,188,94
5,BIHOR,SÂNMARTIN,26582,"BĂILE FELIX","GRĂDINIŢA CU PROGRAM PRELUNGIT ”ALBĂ CA ZĂPADA” BĂILE FELIX",551,"Alegeri Prezidentiale",1,482,1770,282,1408,80,1739,31,2130,360,1100,639
5,BIHOR,SÂNMARTIN,26582,CIHEI,"ŞCOALA PRIMARĂ",552,"Alegeri Prezidentiale",1,1229,918,701,217,0,900,18,1352,434,578,322
5,BIHOR,SÂNMARTIN,26582,HAIEU,"GRĂDINIŢA CU PROGRAM PRELUNGIT ”PINOCCHIO” HAIEU",553,"Alegeri Prezidentiale",1,1039,1092,621,471,0,1083,9,1343,251,674,409
5,BIHOR,SÂNMARTIN,26582,RONTĂU,"GRĂDINIŢA CU PROGRAM PRELUNGIT ”5 URSULEŢI” RONTĂU",554,"Alegeri Prezidentiale",1,974,539,479,60,0,536,3,1071,532,245,291
5,BIHOR,SÂNMARTIN,26582,CORDĂU,"GRĂDINIŢA CU PROGRAM NORMAL ”101 DALMAŢIENI” CORDĂU",555,"Alegeri Prezidentiale",1,1315,737,663,74,0,730,7,1247,510,465,265
5,BIHOR,"SÂNNICOLAU ROMÂN",32179,"SÂNNICOLAU ROMÂN","CAMIN CULTURAL",556,"Alegeri Prezidentiale",1,933,607,491,113,3,597,10,1026,419,426,171
5,BIHOR,"SÂNNICOLAU ROMÂN",32179,BERECHIU,"SCOALA GENERALA",557,"Alegeri Prezidentiale",1,262,223,170,52,1,221,2,288,65,175,46
5,BIHOR,"SÂNNICOLAU ROMÂN",32179,ROIT,GRADINITA,558,"Alegeri Prezidentiale",1,537,354,313,41,0,347,7,591,237,252,95
5,BIHOR,SÂNTANDREI,26653,SÂNTANDREI,"SCOALA GIMNAZIALA NR.1 SINTANDREI",559,"Alegeri Prezidentiale",1,1583,1012,855,157,0,991,21,1741,729,778,213
5,BIHOR,SÂNTANDREI,26653,SÂNTANDREI,"SCOALA GIMNAZIALA NR.1 SINTANDREI",560,"Alegeri Prezidentiale",1,1534,909,815,94,0,884,25,1687,778,713,171
5,BIHOR,SÂNTANDREI,26653,SÂNTANDREI,"SCOALA GIMNAZIALA NR.1 SINTANDREI",561,"Alegeri Prezidentiale",1,1923,1240,1046,194,0,1221,19,2115,875,946,275
5,BIHOR,SÂNTANDREI,26653,PALOTA,"CAMIN CULTURAL PALOTA",562,"Alegeri Prezidentiale",1,609,296,256,40,0,290,6,670,374,260,30
5,BIHOR,SÂRBI,31128,SÂRBI,"CAMIN CULTURAL",563,"Alegeri Prezidentiale",1,827,580,472,93,15,575,5,910,330,297,278
5,BIHOR,SÂRBI,31128,BURZUC,"CAMIN CULTURAL",564,"Alegeri Prezidentiale",1,618,403,334,69,0,402,1,680,277,238,164
5,BIHOR,SÂRBI,31128,"ALMAŞU MIC","SCOALA GENERALA",565,"Alegeri Prezidentiale",1,85,62,40,22,0,61,1,94,32,40,21
5,BIHOR,SÂRBI,31128,CHIOAG,"SPAȚIU PENTRU ALEGERI GENERALE",566,"Alegeri Prezidentiale",1,119,78,58,20,0,78,0,131,53,50,28
5,BIHOR,SÂRBI,31128,FEGERNIC,"SCOALA GENERALA",567,"Alegeri Prezidentiale",1,281,178,118,57,3,177,1,309,131,116,61
5,BIHOR,SÂRBI,31128,SARCĂU,"CASĂ PAROHIALĂ PAROHIA GRECO CATOLICĂ",568,"Alegeri Prezidentiale",1,48,43,28,15,0,43,0,53,10,26,17
5,BIHOR,SPINUŞ,31208,SPINUŞ,"SCOALA GIMNAZIALA NR.1 SPINUS",569,"Alegeri Prezidentiale",1,297,207,151,56,0,203,4,327,120,142,61
5,BIHOR,SPINUŞ,31208,NĂDAR,"FOSTA SCOALA CU CLASELE I-IV NĂDAR",570,"Alegeri Prezidentiale",1,187,105,80,23,2,105,0,206,101,67,38
5,BIHOR,SPINUŞ,31208,CIULEŞTI,"FOSTA SCOALA CU CLASELE I-IV CIULEȘTI",571,"Alegeri Prezidentiale",1,150,96,67,29,0,96,0,165,69,74,22
5,BIHOR,SPINUŞ,31208,SĂLIŞTE,"SCOALA PRIMARĂ NR.1 SĂLIŞTE",572,"Alegeri Prezidentiale",1,209,169,106,61,2,167,2,230,61,143,24
5,BIHOR,SPINUŞ,31208,GURBEŞTI,"FOSTA SCOALA CU CLASELE I-IV GURBEŞTI",573,"Alegeri Prezidentiale",1,104,61,46,15,0,61,0,114,53,45,16
5,BIHOR,"SUPLACU DE BARCĂU",31262,"SUPLACU DE BARCĂU","LIC. TEHNOLOGIC NR1 SUPLACU DE BARCAU",574,"Alegeri Prezidentiale",1,976,429,393,34,2,412,17,1074,645,339,73
5,BIHOR,"SUPLACU DE BARCĂU",31262,"SUPLACU DE BARCĂU","FOST SEDIU PRIMARIE",575,"Alegeri Prezidentiale",1,1032,470,415,52,3,464,6,1135,665,357,107
5,BIHOR,"SUPLACU DE BARCĂU",31262,BORUMLACA,"CAMIN CULTURAL",576,"Alegeri Prezidentiale",1,744,433,409,24,0,429,4,818,385,314,115
5,BIHOR,"SUPLACU DE BARCĂU",31262,DOLEA,"SCOALA PRIMARA NR. 2",577,"Alegeri Prezidentiale",1,130,71,48,23,0,71,0,143,72,61,10
5,BIHOR,"SUPLACU DE BARCĂU",31262,FOGLAŞ,"SCOALA PRIMARA NR. 5",578,"Alegeri Prezidentiale",1,167,89,76,13,0,88,1,184,95,69,19
5,BIHOR,"SUPLACU DE BARCĂU",31262,"VALEA CERULUI","SCOALA PRIMARA NR. 3",579,"Alegeri Prezidentiale",1,369,157,141,16,0,154,3,406,249,120,34
5,BIHOR,"SUPLACU DE BARCĂU",31262,VÂLCELELE,"SCOALA PRIMARA NR. 4",580,"Alegeri Prezidentiale",1,196,98,82,16,0,97,1,216,118,77,20
5,BIHOR,ŞIMIAN,31333,ŞIMIAN,"GRĂDINIȚA CU PROGRAM NORMAL NR,3",581,"Alegeri Prezidentiale",1,238,61,50,11,0,61,0,262,201,38,23
5,BIHOR,ŞIMIAN,31333,ŞIMIAN,"ȘCOALA GIMNAZIALĂ ”KAZINCZY FERENC” ȘIMIAN",582,"Alegeri Prezidentiale",1,1624,293,279,14,0,286,7,1786,1493,182,104
5,BIHOR,ŞIMIAN,31333,ŞIMIAN,"FOSTA ȘCOALĂ PRIMARĂ CU CLASELE I-IV",583,"Alegeri Prezidentiale",1,141,59,41,18,0,58,1,155,96,41,17
5,BIHOR,ŞIMIAN,31333,ŞILINDRU,"ȘCOALA PRIMARĂ CU NR,1",584,"Alegeri Prezidentiale",1,745,260,225,35,0,256,4,820,560,144,112
5,BIHOR,ŞIMIAN,31333,VOIVOZI,"ȘCOALA PRIMARĂ NR,2",585,"Alegeri Prezidentiale",1,325,118,86,32,0,117,1,362,244,79,38
5,BIHOR,ŞINTEU,31379,ŞINTEU,"PRIMARIA COMUNEI SINTEU",586,"Alegeri Prezidentiale",1,956,317,252,65,0,312,5,1052,735,227,85
5,BIHOR,ŞOIMI,31422,ŞOIMI,"SEDIUL PRIMĂRIEI ȘOIMI",587,"Alegeri Prezidentiale",1,589,206,141,65,0,205,1,648,442,124,81
5,BIHOR,ŞOIMI,31422,"SÂNNICOLAU DE BEIUŞ","FOSTA ŞCOALĂ CU CLASELE I - IV",588,"Alegeri Prezidentiale",1,95,80,48,32,0,78,2,105,25,41,37
5,BIHOR,ŞOIMI,31422,URSAD,"FOSTA ȘCOALĂ CU CLASELE I - VIII",589,"Alegeri Prezidentiale",1,119,99,62,37,0,98,1,131,32,60,38
5,BIHOR,ŞOIMI,31422,"POCLUŞA DE BEIUŞ","FOSTA ȘCOALĂ CU CLASELE I - IV",590,"Alegeri Prezidentiale",1,71,70,51,19,0,69,1,78,8,48,21
5,BIHOR,ŞOIMI,31422,CODRU,"FOSTA ȘCOALĂ CU CLASELE I- IV",591,"Alegeri Prezidentiale",1,133,109,79,30,0,107,2,146,37,75,32
5,BIHOR,ŞOIMI,31422,BORZ,"FOSTA ȘCOALĂ CU CLASELE I - IV",592,"Alegeri Prezidentiale",1,147,72,56,16,0,72,0,162,90,39,33
5,BIHOR,ŞOIMI,31422,"URVIŞ DE BEIUŞ","ŞCOALA CU CLASELE I - VIII",593,"Alegeri Prezidentiale",1,485,281,244,37,0,280,1,534,253,149,131
5,BIHOR,ŞOIMI,31422,"DUMBRĂVIŢA DE CODRU","FOSTA ȘCOALĂ CU CLASELE I - IV",594,"Alegeri Prezidentiale",1,259,172,143,28,1,172,0,285,113,78,94
5,BIHOR,ŞUNCUIUŞ,31510,ŞUNCUIUŞ,"LICEUL TEHNOLOGIC NR. 1 - ŞUNCUIUŞ",595,"Alegeri Prezidentiale",1,1256,732,556,141,35,716,16,1382,650,431,285
5,BIHOR,ŞUNCUIUŞ,31510,ŞUNCUIUŞ,"SCOALA CU CLS. I+IV ”POJORATA”",596,"Alegeri Prezidentiale",1,99,54,43,11,0,52,2,109,55,34,18
5,BIHOR,ŞUNCUIUŞ,31510,BĂLNACA,"SCOALA CU CLASELE I-VIII BALNACA",597,"Alegeri Prezidentiale",1,770,407,366,41,0,404,3,847,440,274,130
5,BIHOR,ŞUNCUIUŞ,31510,BĂLNACA-GROŞI,"CAMIN CULTURAL SAT BALNACA GROSI",598,"Alegeri Prezidentiale",1,55,44,28,16,0,43,1,61,17,27,16
5,BIHOR,ŞUNCUIUŞ,31510,"ZECE HOTARE","CAMIN CULTURAL CATUN CARMAZAN",599,"Alegeri Prezidentiale",1,141,62,53,9,0,62,0,155,93,41,21
5,BIHOR,ŞUNCUIUŞ,31510,"ZECE HOTARE","SCOALA CU CLASELE I-VIII ZECEHOTARE",600,"Alegeri Prezidentiale",1,144,93,73,20,0,93,0,158,65,56,37
5,BIHOR,TARCEA,31565,TARCEA,"CĂMINUL CULTURAL",601,"Alegeri Prezidentiale",1,742,175,153,22,0,174,1,816,641,97,77
5,BIHOR,TARCEA,31565,ADONI,"CĂMINUL CULTURAL",602,"Alegeri Prezidentiale",1,612,130,115,15,0,130,0,674,544,98,32
5,BIHOR,TARCEA,31565,GALOŞPETREU,"CASA ROTH",603,"Alegeri Prezidentiale",1,750,138,119,19,0,131,7,825,687,89,42
5,BIHOR,TĂMĂŞEU,32153,"SATU NOU","CĂMINUL CULTURAL",604,"Alegeri Prezidentiale",1,190,76,44,32,0,73,3,209,133,46,27
5,BIHOR,TĂMĂŞEU,32153,TĂMĂŞEU,"CĂMINUL CULTURAL",605,"Alegeri Prezidentiale",1,903,312,274,38,0,299,13,993,681,241,58
5,BIHOR,TĂMĂŞEU,32153,NIUVED,"CĂMINUL CULTURAL",606,"Alegeri Prezidentiale",1,193,68,55,13,0,61,7,212,144,45,16
5,BIHOR,TĂMĂŞEU,32153,PARHIDA,"ŞCOALA GENERALĂ",607,"Alegeri Prezidentiale",1,396,165,137,28,0,156,9,436,271,105,51
5,BIHOR,TĂRCAIA,31609,TĂRCAIA,"PRIMARIA TARCAIA",608,"Alegeri Prezidentiale",1,924,361,346,12,3,334,27,1016,655,195,139
5,BIHOR,TĂRCAIA,31609,TĂRCĂIŢA,"CAMIN CULTURAL",609,"Alegeri Prezidentiale",1,333,241,209,32,0,239,2,366,125,55,184
5,BIHOR,TĂRCAIA,31609,TOTORENI,"CAMIN CULTURAL",610,"Alegeri Prezidentiale",1,219,160,133,27,0,157,3,241,81,71,86
5,BIHOR,TĂRCAIA,31609,MIERAG,"SCOALA CU CLASELE I-IV",611,"Alegeri Prezidentiale",1,165,143,115,23,5,143,0,182,39,45,98
5,BIHOR,TĂUTEU,31654,CIUTELEC,"ŞCOALA GIMNAZIALĂ NR.4 CIUTELEC",612,"Alegeri Prezidentiale",1,528,260,214,26,20,255,5,581,321,144,111
5,BIHOR,TĂUTEU,31654,POIANA,"SCOALA PRIMARA",613,"Alegeri Prezidentiale",1,215,89,69,20,0,88,1,237,148,62,26
5,BIHOR,TĂUTEU,31654,TĂUTEU,"SCOALA GIMNAZIALA",614,"Alegeri Prezidentiale",1,918,224,205,19,0,221,3,1010,786,172,49
5,BIHOR,TĂUTEU,31654,BOGEI,"SCOALA GIMNAZIALA",615,"Alegeri Prezidentiale",1,1165,381,364,17,0,377,4,1282,901,174,203
5,BIHOR,TĂUTEU,31654,CHIRIBIŞ,"SCOALA GIMNAZIALA",616,"Alegeri Prezidentiale",1,642,282,256,26,0,281,1,706,424,195,86
5,BIHOR,TILEAGD,31716,TILEAGD,"CENTRUL CULTURAL MULTIFUNCTIONAL",617,"Alegeri Prezidentiale",1,1866,759,678,81,0,742,17,2053,1294,535,207
5,BIHOR,TILEAGD,31716,TILEAGD,"SCOALA CU CLS.I-IV",618,"Alegeri Prezidentiale",1,1380,535,462,54,19,525,10,1518,983,340,185
5,BIHOR,TILEAGD,31716,CĂLĂTANI,"SCOALA CU CLS.I-IV",619,"Alegeri Prezidentiale",1,158,100,76,24,0,96,4,174,74,58,38
5,BIHOR,TILEAGD,31716,BĂLAIA,"SCOALA CU CLS.I-IV",620,"Alegeri Prezidentiale",1,507,250,224,26,0,248,2,558,308,165,83
5,BIHOR,TILEAGD,31716,TILECUŞ,"CĂMIN CULTURAL",621,"Alegeri Prezidentiale",1,663,399,332,67,0,393,6,729,330,254,139
5,BIHOR,TILEAGD,31716,POŞOLOACA,"CĂMIN CULTURAL",622,"Alegeri Prezidentiale",1,329,129,110,19,0,129,0,362,233,89,40
5,BIHOR,TILEAGD,31716,"UILEACU DE CRIŞ","CĂMIN CULTURAL",623,"Alegeri Prezidentiale",1,687,292,248,44,0,289,3,756,464,229,60
5,BIHOR,TINCA,31789,TINCA,"LICEUL TEORETIC N.JIGA",624,"Alegeri Prezidentiale",1,1334,450,410,40,0,436,14,1467,1017,277,159
5,BIHOR,TINCA,31789,TINCA,"SCOALA PRIMARA I-IV",625,"Alegeri Prezidentiale",1,1287,655,545,72,38,641,14,1416,761,425,216
5,BIHOR,TINCA,31789,TINCA,"GRĂDINIȚA CU PROGRAM PRELUNGIT NR.1 TINCA",626,"Alegeri Prezidentiale",1,1094,482,419,46,17,471,11,1203,721,344,127
5,BIHOR,TINCA,31789,GURBEDIU,"SCOALA GENERALA",627,"Alegeri Prezidentiale",1,916,393,351,38,4,387,6,1008,615,291,96
5,BIHOR,TINCA,31789,"GIRIŞU NEGRU","SCOALA PRIMARA I-IV",628,"Alegeri Prezidentiale",1,587,287,233,54,0,284,3,646,359,150,134
5,BIHOR,TINCA,31789,RÂPA,"SCOALA GENERALA",629,"Alegeri Prezidentiale",1,450,241,183,58,0,237,4,495,254,138,99
5,BIHOR,TINCA,31789,BELFIR,"SCOALA PRIMARA I-IV",630,"Alegeri Prezidentiale",1,480,150,130,20,0,149,1,528,378,116,33
5,BIHOR,TOBOLIU,32201,TOBOLIU,"ȘCOALA GIMNAZIALĂ TOBOLIU",631,"Alegeri Prezidentiale",1,766,388,306,82,0,384,4,843,455,273,111
5,BIHOR,TOBOLIU,32201,CHERESIG,"ȘCOALA GENERALĂ CHERESIG",632,"Alegeri Prezidentiale",1,932,472,406,66,0,468,4,1025,553,326,142
5,BIHOR,TULCA,31841,TULCA,"CĂMINUL CULTURAL TULCA",633,"Alegeri Prezidentiale",1,1551,828,754,74,0,817,11,1706,878,499,318
5,BIHOR,TULCA,31841,TULCA,"ȘCOALA CU CLASELE I-IV TULCA NOUĂ",634,"Alegeri Prezidentiale",1,229,108,97,11,0,104,4,252,144,56,48
5,BIHOR,TULCA,31841,CĂUAŞD,"CĂMINUL CULTURAL CĂUAȘD",635,"Alegeri Prezidentiale",1,365,212,187,25,0,212,0,402,190,145,67
5,BIHOR,ŢEŢCHEA,31878,ŢEŢCHEA,"CĂMIN CULTURAL",636,"Alegeri Prezidentiale",1,681,340,301,37,2,337,3,749,409,158,179
5,BIHOR,ŢEŢCHEA,31878,SUBPIATRĂ,"CĂMIN CULTURAL",637,"Alegeri Prezidentiale",1,476,261,239,22,0,259,2,524,263,158,101
5,BIHOR,ŢEŢCHEA,31878,TELECHIU,"CĂMIN CULTURAL",638,"Alegeri Prezidentiale",1,641,325,300,23,2,314,11,705,380,172,142
5,BIHOR,ŢEŢCHEA,31878,HOTAR,"CĂMIN CULTURAL",639,"Alegeri Prezidentiale",1,708,359,317,42,0,353,6,779,420,161,192
5,BIHOR,"UILEACU DE BEIUŞ",31921,FORĂU,"ŞCOALA PRIMARĂ NR.1",640,"Alegeri Prezidentiale",1,657,402,373,29,0,398,4,723,321,153,245
5,BIHOR,"UILEACU DE BEIUŞ",31921,"UILEACU DE BEIUŞ","ŞCOALA GIMNAZIALĂ NR.1",641,"Alegeri Prezidentiale",1,490,306,252,49,5,293,13,539,233,162,131
5,BIHOR,"UILEACU DE BEIUŞ",31921,PRISACA,"GRĂDINIŢA CU PROGRAM NORMAL NR.3",642,"Alegeri Prezidentiale",1,357,274,226,28,20,267,7,393,119,67,200
5,BIHOR,"UILEACU DE BEIUŞ",31921,"VĂLANII DE BEIUŞ","CĂMIN CULTURAL VĂLANII DE BEIUȘ",643,"Alegeri Prezidentiale",1,203,154,132,14,8,154,0,223,69,40,114
5,BIHOR,"VADU CRIŞULUI",31976,"VADU CRIŞULUI","CĂMIN CULTURAL VADU CRIŞULUI",644,"Alegeri Prezidentiale",1,1472,728,640,88,0,714,14,1619,891,558,156
5,BIHOR,"VADU CRIŞULUI",31976,"VADU CRIŞULUI","ŞCOALA GENERALĂ VADU CRIŞULUI",645,"Alegeri Prezidentiale",1,861,360,323,37,0,347,13,947,587,252,95
5,BIHOR,"VADU CRIŞULUI",31976,TOMNATIC,"ŞCOALA GENERALĂ TOMNATIC",646,"Alegeri Prezidentiale",1,217,84,68,16,0,84,0,239,155,46,38
5,BIHOR,"VADU CRIŞULUI",31976,"TOPA DE CRIŞ","ŞCOALA GENERALĂ TOPA DE CRIŞ",647,"Alegeri Prezidentiale",1,356,209,166,43,0,204,5,392,183,126,78
5,BIHOR,"VADU CRIŞULUI",31976,BIRTIN,"CĂMIN CULTURAL BIRTIN",648,"Alegeri Prezidentiale",1,287,196,170,26,0,191,5,316,120,136,55
5,BIHOR,VÂRCIOROG,32090,VÂRCIOROG,"CĂMINUL CULTURAL",649,"Alegeri Prezidentiale",1,854,508,449,59,0,500,8,939,431,360,140
5,BIHOR,VÂRCIOROG,32090,FÂŞCA,"CĂMINUL CULTURAL FÂȘCA",650,"Alegeri Prezidentiale",1,353,246,213,33,0,242,4,388,142,198,44
5,BIHOR,VÂRCIOROG,32090,ŞERGHIŞ,"GRĂDINIŢA DE COPII CU PROGRAM NORMAL",651,"Alegeri Prezidentiale",1,430,310,242,68,0,301,9,473,163,200,101
5,BIHOR,VIIŞOARA,32045,VIIŞOARA,"CĂMIN CULTURAL",652,"Alegeri Prezidentiale",1,890,397,370,26,1,385,12,979,582,302,83
5,BIHOR,VIIŞOARA,32045,IZVOARELE,"CĂMIN CULTURAL",653,"Alegeri Prezidentiale",1,169,82,62,20,0,82,0,186,104,62,20
6,BISTRIŢA-NĂSĂUD,"MUNICIPIUL BISTRIŢA",32394,BISTRIŢA,"CENTRUL CULTURAL MUNICIPAL GEORGE COȘBUC",1,"Alegeri Prezidentiale",1,1294,693,626,58,9,683,10,1450,757,447,236
6,BISTRIŢA-NĂSĂUD,"MUNICIPIUL BISTRIŢA",32394,BISTRIŢA,"GRĂDINIŢA CU PROGRAM SĂPTĂMÂNAL ”DUMBRAVA MINUNATĂ”",2,"Alegeri Prezidentiale",1,1150,471,409,60,2,465,6,1250,779,373,92
6,BISTRIŢA-NĂSĂUD,"MUNICIPIUL BISTRIŢA",32394,BISTRIŢA,"LICEUL DE MUZICĂ ”TUDOR JARDA”",3,"Alegeri Prezidentiale",1,1192,607,500,75,32,596,11,1350,743,470,126
6,BISTRIŢA-NĂSĂUD,"MUNICIPIUL BISTRIŢA",32394,BISTRIŢA,"PRIMĂRIA MUNICIPIULUI BISTRIŢA, DIRECŢIA ECONOMICĂ-VENITURI",4,"Alegeri Prezidentiale",1,1715,896,845,49,2,885,11,1850,954,697,188
6,BISTRIŢA-NĂSĂUD,"MUNICIPIUL BISTRIŢA",32394,BISTRIŢA,"GRĂDINIŢA CU PROGRAM PRELUNGIT NR. 6",5,"Alegeri Prezidentiale",1,1463,744,703,41,0,734,10,1650,906,574,160
6,BISTRIŢA-NĂSĂUD,"MUNICIPIUL BISTRIŢA",32394,BISTRIŢA,"GRĂDINIŢA CU PROGRAM PRELUNGIT NR. 6",6,"Alegeri Prezidentiale",1,1380,622,593,29,0,614,8,1501,879,475,139
6,BISTRIŢA-NĂSĂUD,"MUNICIPIUL BISTRIŢA",32394,BISTRIŢA,"ȘCOALA PROFESIONALĂ SPECIALĂ ”SFÂNTA MARIA” BISTRIŢA",7,"Alegeri Prezidentiale",1,1299,709,616,93,0,693,16,1392,683,545,148
6,BISTRIŢA-NĂSĂUD,"MUNICIPIUL BISTRIŢA",32394,BISTRIŢA,"ŞCOALA GIMNAZIALĂ NR. 1",8,"Alegeri Prezidentiale",1,1102,598,526,72,0,588,10,1200,602,469,119
6,BISTRIŢA-NĂSĂUD,"MUNICIPIUL BISTRIŢA",32394,BISTRIŢA,"ŞCOALA GIMNAZIALĂ NR. 1",9,"Alegeri Prezidentiale",1,1179,658,577,81,0,649,9,1300,642,467,182
6,BISTRIŢA-NĂSĂUD,"MUNICIPIUL BISTRIŢA",32394,BISTRIŢA,"ŞCOALA GIMNAZIALĂ NR. 1",10,"Alegeri Prezidentiale",1,1433,744,714,30,0,730,14,1550,806,556,174
6,BISTRIŢA-NĂSĂUD,"MUNICIPIUL BISTRIŢA",32394,BISTRIŢA,"ŞCOALA GIMNAZIALĂ NR. 1",11,"Alegeri Prezidentiale",1,1214,681,630,42,9,672,9,1300,619,446,226
6,BISTRIŢA-NĂSĂUD,"MUNICIPIUL BISTRIŢA",32394,BISTRIŢA,"GRĂDINIŢA CU PROGRAM NORMAL NR. 10",12,"Alegeri Prezidentiale",1,1332,746,654,92,0,735,11,1450,704,552,183
6,BISTRIŢA-NĂSĂUD,"MUNICIPIUL BISTRIŢA",32394,BISTRIŢA,"ŞCOALA GIMNAZIALĂ ”LUCIAN BLAGA”",13,"Alegeri Prezidentiale",1,1706,932,832,67,33,922,10,1850,918,741,181
6,BISTRIŢA-NĂSĂUD,"MUNICIPIUL BISTRIŢA",32394,BISTRIŢA,"ŞCOALA GIMNAZIALĂ ”LUCIAN BLAGA”",14,"Alegeri Prezidentiale",1,1633,870,812,58,0,860,10,1750,880,692,168
6,BISTRIŢA-NĂSĂUD,"MUNICIPIUL BISTRIŢA",32394,BISTRIŢA,"ŞCOALA GIMNAZIALĂ ”LUCIAN BLAGA”",15,"Alegeri Prezidentiale",1,1685,897,843,54,0,889,8,1800,903,707,182
6,BISTRIŢA-NĂSĂUD,"MUNICIPIUL BISTRIŢA",32394,BISTRIŢA,"LICEUL TEHNOLOGIC ”GRIGORE MOISIL”",16,"Alegeri Prezidentiale",1,1804,923,884,39,0,909,14,1951,1028,726,183
6,BISTRIŢA-NĂSĂUD,"MUNICIPIUL BISTRIŢA",32394,BISTRIŢA,"LICEUL TEHNOLOGIC ”GRIGORE MOISIL”",17,"Alegeri Prezidentiale",1,1357,712,644,68,0,706,6,1493,781,536,170
6,BISTRIŢA-NĂSĂUD,"MUNICIPIUL BISTRIŢA",32394,BISTRIŢA,"GRĂDINIŢA CU PROGRAM NORMAL NR. 18",18,"Alegeri Prezidentiale",1,1243,687,608,79,0,677,10,1359,672,549,128
6,BISTRIŢA-NĂSĂUD,"MUNICIPIUL BISTRIŢA",32394,BISTRIŢA,"GRĂDINIŢA CU PROGRAM NORMAL NR.18",19,"Alegeri Prezidentiale",2,1635,789,739,50,0,781,8,1749,960,630,151
6,BISTRIŢA-NĂSĂUD,"MUNICIPIUL BISTRIŢA",32394,BISTRIŢA,"GRĂDINIŢA CU PROGRAM PRELUNGIT ”TRENULEŢUL VESELIEI”",20,"Alegeri Prezidentiale",1,1321,762,642,94,26,751,11,1450,688,571,180
6,BISTRIŢA-NĂSĂUD,"MUNICIPIUL BISTRIŢA",32394,BISTRIŢA,"LICEUL TEHNOLOGIC",21,"Alegeri Prezidentiale",1,1733,1170,805,57,308,1162,8,2300,1130,728,434
6,BISTRIŢA-NĂSĂUD,"MUNICIPIUL BISTRIŢA",32394,BISTRIŢA,"GRĂDINIŢA CU PROGRAM NORMAL ”CĂSUŢA CU POVEŞTI”",22,"Alegeri Prezidentiale",1,1873,1102,999,103,0,1086,16,2050,948,880,206
6,BISTRIŢA-NĂSĂUD,"MUNICIPIUL BISTRIŢA",32394,BISTRIŢA,"COLEGIUL NAŢIONAL ”ANDREI MUREŞANU”",23,"Alegeri Prezidentiale",1,1419,807,698,109,0,791,16,1550,743,615,176
6,BISTRIŢA-NĂSĂUD,"MUNICIPIUL BISTRIŢA",32394,BISTRIŢA,"GRĂDINIŢA CU PROGRAM PRELUNGIT ”CĂSUŢA CU POVEŞTI”",24,"Alegeri Prezidentiale",1,1269,630,597,33,0,618,12,1400,770,468,150
6,BISTRIŢA-NĂSĂUD,"MUNICIPIUL BISTRIŢA",32394,BISTRIŢA,"GRĂDINIŢA CU PROGRAM NORMAL NR. 15",25,"Alegeri Prezidentiale",1,1153,596,528,68,0,591,5,1258,662,477,114
6,BISTRIŢA-NĂSĂUD,"MUNICIPIUL BISTRIŢA",32394,BISTRIŢA,"COLEGIUL NAŢIONAL ”LIVIU REBREANU”, ŞCOALA PRIMARĂ",26,"Alegeri Prezidentiale",1,1271,672,595,77,0,665,7,1400,728,526,139
6,BISTRIŢA-NĂSĂUD,"MUNICIPIUL BISTRIŢA",32394,BISTRIŢA,"COLEGIUL NAŢIONAL ”LIVIU REBREANU”",27,"Alegeri Prezidentiale",1,1346,698,618,80,0,692,6,1450,752,483,209
6,BISTRIŢA-NĂSĂUD,"MUNICIPIUL BISTRIŢA",32394,BISTRIŢA,"GRĂDINIŢA CU PROGRAM NORMAL NR. 9",28,"Alegeri Prezidentiale",1,1248,764,666,98,0,744,20,1350,586,554,190
6,BISTRIŢA-NĂSĂUD,"MUNICIPIUL BISTRIŢA",32394,BISTRIŢA,"UNIVERSITATEA ”BABEŞ-BOLYAI” CLUJ-NAPOCA, EXTENSIA UNIVERSITARĂ BISTRIŢA",29,"Alegeri Prezidentiale",1,1794,896,841,54,1,881,15,1950,1054,664,217
6,BISTRIŢA-NĂSĂUD,"MUNICIPIUL BISTRIŢA",32394,BISTRIŢA,"UNIVERSITATEA ”BABEŞ-BOLYAI” CLUJ-NAPOCA, EXTENSIA UNIVERSITARĂ BISTRIŢA",30,"Alegeri Prezidentiale",1,1527,762,659,103,0,751,11,1800,1038,591,160
6,BISTRIŢA-NĂSĂUD,"MUNICIPIUL BISTRIŢA",32394,BISTRIŢA,"ŞCOALA GIMNAZIALĂ NR. 4",31,"Alegeri Prezidentiale",1,1879,1053,989,64,0,1049,4,2050,997,797,252
6,BISTRIŢA-NĂSĂUD,"MUNICIPIUL BISTRIŢA",32394,BISTRIŢA,"ŞCOALA GIMNAZIALĂ NR. 4",32,"Alegeri Prezidentiale",1,1323,719,636,83,0,707,12,1400,681,535,172
6,BISTRIŢA-NĂSĂUD,"MUNICIPIUL BISTRIŢA",32394,BISTRIŢA,"CREȘA NR. 5",33,"Alegeri Prezidentiale",1,1389,670,609,61,0,665,5,1508,838,518,147
6,BISTRIŢA-NĂSĂUD,"MUNICIPIUL BISTRIŢA",32394,BISTRIŢA,"GRĂDINIŢA CU PROGRAM PRELUNGIT NR. 12",34,"Alegeri Prezidentiale",1,1350,705,664,40,1,698,7,1450,745,465,233
6,BISTRIŢA-NĂSĂUD,"MUNICIPIUL BISTRIŢA",32394,BISTRIŢA,"GRĂDINIŢA CU PROGRAM NORMAL NR. 16",35,"Alegeri Prezidentiale",1,1272,657,613,44,0,652,5,1350,693,500,152
6,BISTRIŢA-NĂSĂUD,"MUNICIPIUL BISTRIŢA",32394,BISTRIŢA,"ŞCOALA GIMNAZIALĂ ”AVRAM IANCU”",36,"Alegeri Prezidentiale",1,1287,767,689,78,0,755,12,1400,633,544,211
6,BISTRIŢA-NĂSĂUD,"MUNICIPIUL BISTRIŢA",32394,BISTRIŢA,"ŞCOALA GIMNAZIALĂ ”AVRAM IANCU”",37,"Alegeri Prezidentiale",1,1262,688,632,56,0,682,6,1350,662,505,177
6,BISTRIŢA-NĂSĂUD,"MUNICIPIUL BISTRIŢA",32394,BISTRIŢA,"GRĂDINIŢA CU PROGRAM PRELUNGIT NR. 13",38,"Alegeri Prezidentiale",1,1343,752,704,47,1,742,10,1450,698,545,197
6,BISTRIŢA-NĂSĂUD,"MUNICIPIUL BISTRIŢA",32394,BISTRIŢA,"ŞCOALA GIMNAZIALĂ ”ŞTEFAN CEL MARE”",39,"Alegeri Prezidentiale",1,1285,888,662,42,184,875,13,1600,712,650,225
6,BISTRIŢA-NĂSĂUD,"MUNICIPIUL BISTRIŢA",32394,BISTRIŢA,"ŞCOALA GIMNAZIALĂ ”ŞTEFAN CEL MARE”",40,"Alegeri Prezidentiale",1,1411,778,686,92,0,768,10,1550,772,596,172
6,BISTRIŢA-NĂSĂUD,"MUNICIPIUL BISTRIŢA",32394,BISTRIŢA,"GRĂDINIŢA CU PROGRAM PRELUNGIT NR. 3",41,"Alegeri Prezidentiale",1,1431,755,719,36,0,747,8,1600,845,569,178
6,BISTRIŢA-NĂSĂUD,"MUNICIPIUL BISTRIŢA",32394,BISTRIŢA,"CREŞA NR. 3",42,"Alegeri Prezidentiale",1,918,468,424,44,0,461,7,1000,532,352,109
6,BISTRIŢA-NĂSĂUD,"MUNICIPIUL BISTRIŢA",32394,BISTRIŢA,"GRĂDINIŢA CU PROGRAM NORMAL NR. 7",43,"Alegeri Prezidentiale",1,1195,729,642,87,0,712,17,1300,571,556,156
6,BISTRIŢA-NĂSĂUD,"MUNICIPIUL BISTRIŢA",32394,BISTRIŢA,"GRĂDINIŢA CU PROGRAM NORMAL NR. 7",44,"Alegeri Prezidentiale",1,932,523,487,35,1,519,4,992,469,398,121
6,BISTRIŢA-NĂSĂUD,"MUNICIPIUL BISTRIŢA",32394,BISTRIŢA,"”ROTARY CLUB” BISTRIŢA NOSA",45,"Alegeri Prezidentiale",1,1715,1053,903,140,10,1035,18,1950,897,829,206
6,BISTRIŢA-NĂSĂUD,"MUNICIPIUL BISTRIŢA",32394,BISTRIŢA,"GRĂDINIŢA CU PROGRAM PRELUNGIT ”RAZĂ DE SOARE”",46,"Alegeri Prezidentiale",1,1350,752,683,69,0,745,7,1450,698,602,143
6,BISTRIŢA-NĂSĂUD,"MUNICIPIUL BISTRIŢA",32394,BISTRIŢA,"COLEGIUL TEHNIC ”INFOEL”",47,"Alegeri Prezidentiale",1,1713,854,785,69,0,831,23,1850,996,636,195
6,BISTRIŢA-NĂSĂUD,"MUNICIPIUL BISTRIŢA",32394,BISTRIŢA,"LICEUL CU PROGRAM SPORTIV",48,"Alegeri Prezidentiale",1,1286,686,583,103,0,677,9,1400,714,554,123
6,BISTRIŢA-NĂSĂUD,"MUNICIPIUL BISTRIŢA",32394,BISTRIŢA,"LICEUL CU PROGRAM SPORTIV",49,"Alegeri Prezidentiale",1,1371,822,714,108,0,816,6,1500,678,650,166
6,BISTRIŢA-NĂSĂUD,"MUNICIPIUL BISTRIŢA",32394,UNIREA,"GRĂDINIŢA CU PROGRAM NORMAL UNIREA",50,"Alegeri Prezidentiale",1,1564,877,809,68,0,871,6,1700,823,701,170
6,BISTRIŢA-NĂSĂUD,"MUNICIPIUL BISTRIŢA",32394,UNIREA,"GRĂDINIŢA CU PROGRAM NORMAL UNIREA",51,"Alegeri Prezidentiale",1,1355,740,685,55,0,730,10,1450,710,576,154
6,BISTRIŢA-NĂSĂUD,"MUNICIPIUL BISTRIŢA",32394,SLĂTINIŢA,"ŞCOALA PRIMARĂ ”DIMITRIE COJOCARU” SLĂTINIŢA",52,"Alegeri Prezidentiale",1,627,266,251,15,0,266,0,654,388,226,40
6,BISTRIŢA-NĂSĂUD,"MUNICIPIUL BISTRIŢA",32394,GHINDA,"GRĂDINIŢA CU PROGRAM NORMAL GHINDA",53,"Alegeri Prezidentiale",1,658,322,309,13,0,320,2,700,378,269,51
6,BISTRIŢA-NĂSĂUD,"MUNICIPIUL BISTRIŢA",32394,SIGMIR,"CASA DE CULTURĂ SIGMIR",54,"Alegeri Prezidentiale",1,869,441,409,32,0,433,8,950,509,339,94
6,BISTRIŢA-NĂSĂUD,"MUNICIPIUL BISTRIŢA",32394,VIIŞOARA,"ŞCOALA GIMNAZIALĂ NR. 7 VIIŞOARA",55,"Alegeri Prezidentiale",1,1336,646,588,58,0,639,7,1451,805,517,122
6,BISTRIŢA-NĂSĂUD,"MUNICIPIUL BISTRIŢA",32394,VIIŞOARA,"ŞCOALA GIMNAZIALĂ NR.7 VIIŞOARA",56,"Alegeri Prezidentiale",1,1082,571,539,32,0,561,10,1150,579,452,109
6,BISTRIŢA-NĂSĂUD,"MUNICIPIUL BISTRIŢA",32394,SĂRATA,"ŞCOALA PRIMARĂ SĂRATA",57,"Alegeri Prezidentiale",1,970,435,411,24,0,434,1,1050,615,364,70
6,BISTRIŢA-NĂSĂUD,"ORAŞ BECLEAN",32483,BECLEAN,"SALA DE CĂSĂTORII",58,"Alegeri Prezidentiale",2,1518,863,767,96,0,843,20,1650,787,569,274
6,BISTRIŢA-NĂSĂUD,"ORAŞ BECLEAN",32483,BECLEAN,"POLICLINICA ORĂŞENEASCĂ BECLEAN",59,"Alegeri Prezidentiale",1,1506,875,722,141,12,851,24,1758,883,512,339
6,BISTRIŢA-NĂSĂUD,"ORAŞ BECLEAN",32483,BECLEAN,"CLUBUL COPIILOR BECLEAN",60,"Alegeri Prezidentiale",1,799,402,360,41,1,394,8,900,498,269,125
6,BISTRIŢA-NĂSĂUD,"ORAŞ BECLEAN",32483,BECLEAN,"CLUBUL COPIILOR BECLEAN",61,"Alegeri Prezidentiale",1,816,407,357,49,1,399,8,900,493,277,122
6,BISTRIŢA-NĂSĂUD,"ORAŞ BECLEAN",32483,BECLEAN,"ŞCOALA GIMNAZIALĂ ”GRIGORE SILAŞI”",62,"Alegeri Prezidentiale",1,1559,840,753,86,1,819,21,1700,860,559,260
6,BISTRIŢA-NĂSĂUD,"ORAŞ BECLEAN",32483,BECLEAN,"CASA DE CULTURĂ ”RADU SĂPLĂCAN” BECLEAN",63,"Alegeri Prezidentiale",1,1542,763,719,42,2,754,9,1650,887,505,249
6,BISTRIŢA-NĂSĂUD,"ORAŞ BECLEAN",32483,BECLEAN,"ŞCOALA GENERALĂ BECLENUŢ",64,"Alegeri Prezidentiale",1,335,186,168,17,1,185,1,350,164,119,66
6,BISTRIŢA-NĂSĂUD,"ORAŞ BECLEAN",32483,BECLEAN,"GRĂDINIȚA CU PROGRAM NORMAL VALEA VIILOR",65,"Alegeri Prezidentiale",1,355,179,168,11,0,179,0,400,221,112,67
6,BISTRIŢA-NĂSĂUD,"ORAŞ BECLEAN",32483,COLDĂU,"GRĂDINIȚA CU PROGRAM NORMAL COLDĂU",66,"Alegeri Prezidentiale",1,642,335,309,26,0,329,6,700,365,236,93
6,BISTRIŢA-NĂSĂUD,"ORAŞ BECLEAN",32483,FIGA,"ȘCOALA PRIMARĂ FIGA",67,"Alegeri Prezidentiale",1,423,238,223,15,0,237,1,450,212,110,127
6,BISTRIŢA-NĂSĂUD,"ORAŞ BECLEAN",32483,"RUSU DE JOS","GRĂDINIȚA CU PROGRAM NORMAL RUSU DE JOS",68,"Alegeri Prezidentiale",1,285,171,162,9,0,169,2,300,129,83,86
6,BISTRIŢA-NĂSĂUD,"ORAŞ NĂSĂUD",32544,NĂSĂUD,"ŞCOALA DE APLICAŢIE",69,"Alegeri Prezidentiale",1,1396,736,657,79,0,723,13,1500,764,506,217
6,BISTRIŢA-NĂSĂUD,"ORAŞ NĂSĂUD",32544,NĂSĂUD,"ŞCOALA GIMNAZIALĂ ”MIHAI EMINESCU”",70,"Alegeri Prezidentiale",1,1492,758,640,76,42,744,14,1700,942,488,256
6,BISTRIŢA-NĂSĂUD,"ORAŞ NĂSĂUD",32544,NĂSĂUD,"LICEUL TEHNOLOGIC ECONOMIC NĂSĂUD",71,"Alegeri Prezidentiale",1,1164,466,446,20,0,461,5,1250,784,345,116
6,BISTRIŢA-NĂSĂUD,"ORAŞ NĂSĂUD",32544,NĂSĂUD,"LICEUL TEHNOLOGIC SILVIC ”TRANSILVANIA” NĂSĂUD",72,"Alegeri Prezidentiale",1,1424,643,611,32,0,635,8,1550,907,448,187
6,BISTRIŢA-NĂSĂUD,"ORAŞ NĂSĂUD",32544,NĂSĂUD,"AUTOGARA CĂLĂTORI",73,"Alegeri Prezidentiale",1,1760,811,710,101,0,790,21,1900,1089,548,242
6,BISTRIŢA-NĂSĂUD,"ORAŞ NĂSĂUD",32544,NĂSĂUD,"ŞCOALA GIMNAZIALĂ ” VALEA SPINULUI”",74,"Alegeri Prezidentiale",1,1018,493,466,27,0,476,17,1100,607,288,188
6,BISTRIŢA-NĂSĂUD,"ORAŞ NĂSĂUD",32544,"LIVIU REBREANU","CĂMINUL CULTURAL LIVIU REBREANU",75,"Alegeri Prezidentiale",1,603,338,318,20,0,337,1,650,312,203,134
6,BISTRIŢA-NĂSĂUD,"ORAŞ NĂSĂUD",32544,LUŞCA,"CĂMINUL CULTURAL LUŞCA",76,"Alegeri Prezidentiale",1,532,258,241,17,0,254,4,550,292,181,73
6,BISTRIŢA-NĂSĂUD,"ORAŞ SÂNGEORZ-BĂI",32599,SÂNGEORZ-BĂI,"ȘCOALA GIMNAZIALĂ ”ARTEMIU PUBLIU ALEXI” SÎNGEORZ-BĂI",77,"Alegeri Prezidentiale",1,1349,582,541,41,0,577,5,1450,868,435,142
6,BISTRIŢA-NĂSĂUD,"ORAŞ SÂNGEORZ-BĂI",32599,SÂNGEORZ-BĂI,"ŞCOALA GIMNAZIALĂ ”ARTEMIU PUBLIU ALEXI” SÎNGEORZ-BĂI",78,"Alegeri Prezidentiale",1,1406,618,588,30,0,612,6,1550,932,426,186
6,BISTRIŢA-NĂSĂUD,"ORAŞ SÂNGEORZ-BĂI",32599,SÂNGEORZ-BĂI,"ŞCOALA GIMNAZIALĂ ”ARTEMIU PUBLIU ALEXI” SÎNGEORZ-BĂI",79,"Alegeri Prezidentiale",1,1310,488,468,20,0,486,2,1450,962,383,103
6,BISTRIŢA-NĂSĂUD,"ORAŞ SÂNGEORZ-BĂI",32599,SÂNGEORZ-BĂI,"LICEUL TEORETIC ”SOLOMON HALIȚĂ”, SALA 2",80,"Alegeri Prezidentiale",1,1310,598,574,24,0,594,4,1450,852,460,134
6,BISTRIŢA-NĂSĂUD,"ORAŞ SÂNGEORZ-BĂI",32599,SÂNGEORZ-BĂI,"LICEUL TEORETIC ”SOLOMON HALIȚĂ”",81,"Alegeri Prezidentiale",1,1282,477,450,27,0,475,2,1400,923,362,113
6,BISTRIŢA-NĂSĂUD,"ORAŞ SÂNGEORZ-BĂI",32599,SÂNGEORZ-BĂI,"GRĂDINIȚA CU PROGRAM NORMAL SÎNGEORZ-BĂI",82,"Alegeri Prezidentiale",1,1393,591,550,41,0,589,2,1500,909,507,82
6,BISTRIŢA-NĂSĂUD,"ORAŞ SÂNGEORZ-BĂI",32599,CORMAIA,"ŞCOALA GIMNAZIALĂ CORMAIA",83,"Alegeri Prezidentiale",1,694,242,225,17,0,241,1,750,508,182,59
6,BISTRIŢA-NĂSĂUD,"BISTRIŢA BÂRGĂULUI",32633,"BISTRIŢA BÂRGĂULUI","CĂMINUL CULTURAL BISTRIŢA BÎRGĂULUI",84,"Alegeri Prezidentiale",1,1356,777,728,48,1,766,11,1500,723,530,236
6,BISTRIŢA-NĂSĂUD,"BISTRIŢA BÂRGĂULUI",32633,"BISTRIŢA BÂRGĂULUI","ŞCOALA GIMNAZIALĂ NR. 2 BISTRIŢA BÎRGĂULUI",85,"Alegeri Prezidentiale",1,978,469,432,37,0,466,3,1100,631,366,100
6,BISTRIŢA-NĂSĂUD,"BISTRIŢA BÂRGĂULUI",32633,"BISTRIŢA BÂRGĂULUI","SALA DE NUNŢI BISTRIŢA BÎRGĂULUI",86,"Alegeri Prezidentiale",1,1055,503,462,41,0,496,7,1150,647,392,104
6,BISTRIŢA-NĂSĂUD,"BISTRIŢA BÂRGĂULUI",32633,COLIBIŢA,"ŞCOALA GIMNAZIALĂ COLIBIŢA",87,"Alegeri Prezidentiale",1,250,179,126,53,0,177,2,300,121,133,44
6,BISTRIŢA-NĂSĂUD,BRANIŞTEA,32660,BRANIŞTEA,"PRIMĂRIA COMUNEI BRANIŞTEA",88,"Alegeri Prezidentiale",1,944,482,429,51,2,472,10,1058,576,386,86
6,BISTRIŢA-NĂSĂUD,BRANIŞTEA,32660,CIREŞOAIA,"CĂMINUL CULTURAL CIREŞOAIA",89,"Alegeri Prezidentiale",1,1168,300,280,18,2,291,9,1250,950,220,71
6,BISTRIŢA-NĂSĂUD,BRANIŞTEA,32660,MĂLUŢ,"CĂMINUL CULTURAL MĂLUŢ",90,"Alegeri Prezidentiale",1,473,270,237,33,0,269,1,500,230,190,79
6,BISTRIŢA-NĂSĂUD,"BUDACU DE JOS",32704,"BUDACU DE JOS","PRIMĂRIA COMUNEI BUDACU DE JOS",91,"Alegeri Prezidentiale",1,774,369,339,28,2,364,5,850,481,219,145
6,BISTRIŢA-NĂSĂUD,"BUDACU DE JOS",32704,BUDUŞ,"ŞCOALA GIMNAZIALĂ BUDUŞ",92,"Alegeri Prezidentiale",1,447,270,239,31,0,268,2,500,230,167,101
6,BISTRIŢA-NĂSĂUD,"BUDACU DE JOS",32704,JELNA,"CENTRUL LOCAL DE INFORMARE TURISTICĂ",93,"Alegeri Prezidentiale",1,781,513,457,56,0,510,3,850,337,305,205
6,BISTRIŢA-NĂSĂUD,"BUDACU DE JOS",32704,MONARIU,"ŞCOALA GIMNAZIALĂ MONARIU",94,"Alegeri Prezidentiale",1,420,243,201,39,3,241,2,451,208,182,59
6,BISTRIŢA-NĂSĂUD,"BUDACU DE JOS",32704,SIMIONEŞTI,"ŞCOALA GIMNAZIALĂ SIMIONEŞTI",95,"Alegeri Prezidentiale",1,171,112,91,21,0,110,2,200,88,76,34
6,BISTRIŢA-NĂSĂUD,BUDEŞTI,32768,BUDEŞTI,"ŞCOALA GIMNAZIALĂ BUDEŞTI",96,"Alegeri Prezidentiale",1,480,237,207,30,0,234,3,550,313,176,58
6,BISTRIŢA-NĂSĂUD,BUDEŞTI,32768,BUDEŞTI-FÂNAŢE,"ŞCOALA PRIMARĂ BUDEŞTI-FÎNAŢE",97,"Alegeri Prezidentiale",1,254,160,134,26,0,160,0,300,140,130,30
6,BISTRIŢA-NĂSĂUD,BUDEŞTI,32768,ŢAGU,"ŞCOALA PRIMARĂ ŢAGU",98,"Alegeri Prezidentiale",1,480,228,196,32,0,224,4,550,322,177,47
6,BISTRIŢA-NĂSĂUD,BUDEŞTI,32768,ŢĂGŞORU,"CĂMINUL CULTURAL ŢĂGŞORU",99,"Alegeri Prezidentiale",1,204,109,89,20,0,109,0,250,141,86,23
6,BISTRIŢA-NĂSĂUD,"CĂIANU MIC",32811,"CĂIANU MIC","PRIMĂRIA COMUNEI CĂIANU MIC",100,"Alegeri Prezidentiale",1,1232,622,566,33,23,616,6,1350,728,247,369
6,BISTRIŢA-NĂSĂUD,"CĂIANU MIC",32811,"CĂIANU MARE","GRĂDINIȚA CU PROGRAM NORMAL CĂIANU MARE",101,"Alegeri Prezidentiale",1,455,245,216,20,9,242,3,500,255,87,155
6,BISTRIŢA-NĂSĂUD,"CĂIANU MIC",32811,DOBRIC,"ŞCOALA GIMNAZIALĂ DOBRIC",102,"Alegeri Prezidentiale",1,1110,463,395,41,27,453,10,1250,787,163,290
6,BISTRIŢA-NĂSĂUD,"CĂIANU MIC",32811,CICEU-POIENI,"CĂMINUL CULTURAL CICEU-POIENI",103,"Alegeri Prezidentiale",1,555,316,265,33,18,312,4,600,284,76,236
6,BISTRIŢA-NĂSĂUD,CETATE,32884,"SATU NOU","BIBLIOTECA COMUNALĂ SATU NOU",104,"Alegeri Prezidentiale",1,584,304,277,27,0,302,2,650,346,227,75
6,BISTRIŢA-NĂSĂUD,CETATE,32884,PETRIŞ,"ŞCOALA CLASELE I - IV PETRIŞ",105,"Alegeri Prezidentiale",1,1000,521,489,32,0,516,5,1100,579,410,106
6,BISTRIŢA-NĂSĂUD,CETATE,32884,"ORHEIU BISTRIŢEI","CĂMINUL CULTURAL ORHEIU BISTRIŢEI",106,"Alegeri Prezidentiale",1,662,337,301,36,0,335,2,750,413,270,65
6,BISTRIŢA-NĂSĂUD,CHIOCHIŞ,33015,CHIOCHIŞ,"PRIMĂRIA COMUNEI CHIOCHIŞ",107,"Alegeri Prezidentiale",1,308,150,124,26,0,150,0,350,200,88,62
6,BISTRIŢA-NĂSĂUD,CHIOCHIŞ,33015,APATIU,"ŞCOALA PRIMARĂ APATIU",108,"Alegeri Prezidentiale",1,257,109,101,8,0,109,0,300,191,76,33
6,BISTRIŢA-NĂSĂUD,CHIOCHIŞ,33015,STRUGURENI,"ŞCOALA PRIMARĂ STRUGURENI",109,"Alegeri Prezidentiale",1,159,96,75,21,0,96,0,200,104,87,9
6,BISTRIŢA-NĂSĂUD,CHIOCHIŞ,33015,BOZIEŞ,"GRĂDINIȚA BOZIEŞ",110,"Alegeri Prezidentiale",1,530,247,218,26,3,247,0,600,353,201,46
6,BISTRIŢA-NĂSĂUD,CHIOCHIŞ,33015,CHEŢIU,"ŞCOALA PRIMARĂ CHEŢIU",111,"Alegeri Prezidentiale",1,269,126,116,10,0,126,0,300,174,96,30
6,BISTRIŢA-NĂSĂUD,CHIOCHIŞ,33015,SÂNNICOARĂ,"ŞCOALA PRIMARĂ SÎNNICOARĂ",112,"Alegeri Prezidentiale",1,90,70,43,27,0,69,1,100,30,42,27
6,BISTRIŢA-NĂSĂUD,CHIOCHIŞ,33015,ŢENTEA,"ŞCOALA PRIMARĂ ŢENTEA",113,"Alegeri Prezidentiale",1,99,67,51,16,0,67,0,150,83,47,20
6,BISTRIŢA-NĂSĂUD,CHIOCHIŞ,33015,MANIC,"ŞCOALA PRIMARĂ MANIC",114,"Alegeri Prezidentiale",1,196,103,91,12,0,102,1,250,147,74,28
6,BISTRIŢA-NĂSĂUD,CHIOCHIŞ,33015,JIMBOR,"CĂMINUL CULTURAL JIMBOR",115,"Alegeri Prezidentiale",1,348,161,137,24,0,160,1,400,239,101,59
6,BISTRIŢA-NĂSĂUD,CHIOCHIŞ,33015,"BUZA CĂTUN","CĂMINUL CULTURAL BUZA-CĂTUN",116,"Alegeri Prezidentiale",1,95,48,40,8,0,48,0,100,52,30,18
6,BISTRIŢA-NĂSĂUD,CHIUZA,33122,CHIUZA,"ŞCOALA GIMNAZIALĂ ”LIVIU REBREANU” CHIUZA",117,"Alegeri Prezidentiale",1,738,384,353,31,0,384,0,800,416,256,128
6,BISTRIŢA-NĂSĂUD,CHIUZA,33122,SĂSARM,"CĂMINUL CULTURAL SĂSARM",118,"Alegeri Prezidentiale",1,545,300,256,43,1,293,7,600,300,222,71
6,BISTRIŢA-NĂSĂUD,CHIUZA,33122,PIATRA,"ŞCOALA PRIMARĂ PIATRA",119,"Alegeri Prezidentiale",1,409,188,177,11,0,184,4,450,262,124,60
6,BISTRIŢA-NĂSĂUD,CHIUZA,33122,MIREŞ,"CĂMINUL CULTURAL MIREŞ",120,"Alegeri Prezidentiale",1,116,70,58,9,3,69,1,150,80,26,43
6,BISTRIŢA-NĂSĂUD,"CICEU - MIHĂIEŞTI",179953,CICEU-MIHĂIEŞTI,"CĂMINUL CULTURAL CICEU-MIHĂIEŞTI",121,"Alegeri Prezidentiale",1,745,341,294,47,0,337,4,850,509,251,86
6,BISTRIŢA-NĂSĂUD,"CICEU - MIHĂIEŞTI",179953,LELEŞTI,"ŞCOALA GENERALĂ LELEŞTI",122,"Alegeri Prezidentiale",1,115,77,49,28,0,77,0,150,73,53,24
6,BISTRIŢA-NĂSĂUD,"CICEU - MIHĂIEŞTI",179953,CICEU-CORABIA,"ŞCOALA GENERALĂ CICEU-CORABIA",123,"Alegeri Prezidentiale",1,105,97,58,39,0,93,4,150,53,64,29
6,BISTRIŢA-NĂSĂUD,CICEU-GIURGEŞTI,32955,CICEU-GIURGEŞTI,"ŞCOALA GIMNAZIALĂ CICEU-GIURGEŞTI",124,"Alegeri Prezidentiale",1,742,435,359,50,26,430,5,800,365,313,117
6,BISTRIŢA-NĂSĂUD,CICEU-GIURGEŞTI,32955,DUMBRĂVENI,"ŞCOALA PRIMARĂ DUMBRĂVENI",125,"Alegeri Prezidentiale",1,507,337,275,44,18,336,1,550,213,186,150
6,BISTRIŢA-NĂSĂUD,COŞBUC,33177,COŞBUC,"ŞCOALA GIMNAZIALĂ „GEORGE COŞBUC”",126,"Alegeri Prezidentiale",1,1622,719,681,38,0,717,2,1800,1081,316,401
6,BISTRIŢA-NĂSĂUD,DUMITRA,33202,DUMITRA,"ŞCOALA GENERALĂ DUMITRA",127,"Alegeri Prezidentiale",1,1083,451,416,35,0,446,5,1200,749,361,85
6,BISTRIŢA-NĂSĂUD,DUMITRA,33202,DUMITRA,"ŞCOALA GENERALĂ DUMITRA",128,"Alegeri Prezidentiale",1,1344,607,575,32,0,603,4,1500,893,498,105
6,BISTRIŢA-NĂSĂUD,DUMITRA,33202,CEPARI,"ŞCOALA GENERALĂ CEPARI",129,"Alegeri Prezidentiale",1,909,421,386,34,1,419,2,1000,579,356,63
6,BISTRIŢA-NĂSĂUD,DUMITRA,33202,TĂRPIU,"ŞCOALA GENERALĂ TĂRPIU",130,"Alegeri Prezidentiale",1,756,255,209,46,0,252,3,800,545,203,49
6,BISTRIŢA-NĂSĂUD,DUMITRIŢA,179686,DUMITRIŢA,"ȘCOALA GIMNAZIALĂ DUMITRIȚA",131,"Alegeri Prezidentiale",1,1014,450,419,31,0,446,4,1100,650,341,105
6,BISTRIŢA-NĂSĂUD,DUMITRIŢA,179686,"BUDACU DE SUS","ŞCOALA DE ARTE ŞI MESERII BUDACU DE SUS",132,"Alegeri Prezidentiale",1,1503,618,591,27,0,612,6,1650,1032,461,151
6,BISTRIŢA-NĂSĂUD,FELDRU,33248,FELDRU,"PRIMĂRIA COMUNEI FELDRU",133,"Alegeri Prezidentiale",1,1489,488,446,42,0,483,5,1650,1162,398,85
6,BISTRIŢA-NĂSĂUD,FELDRU,33248,FELDRU,"LICEUL TEHNOLOGIC FELDRU",134,"Alegeri Prezidentiale",1,1401,468,449,19,0,463,5,1550,1082,358,105
6,BISTRIŢA-NĂSĂUD,FELDRU,33248,FELDRU,"AFTER-SCHOOL FELDRU",135,"Alegeri Prezidentiale",1,1380,454,427,26,1,452,2,1500,1046,366,86
6,BISTRIŢA-NĂSĂUD,FELDRU,33248,FELDRU,"ŞCOALA PRIMARĂ PODEREI",136,"Alegeri Prezidentiale",1,368,129,117,12,0,129,0,400,271,109,20
6,BISTRIŢA-NĂSĂUD,FELDRU,33248,NEPOS,"ȘCOALA GIMNAZIALĂ „GAVRIL ISTRATE” NEPOS",137,"Alegeri Prezidentiale",1,1525,549,520,29,0,546,3,1650,1101,475,71
6,BISTRIŢA-NĂSĂUD,"GALAŢII BISTRIŢEI",33275,"GALAŢII BISTRIŢEI","CĂMINUL CULTURAL GALAŢII BISTRIŢEI",138,"Alegeri Prezidentiale",1,554,324,268,54,2,319,5,600,276,154,165
6,BISTRIŢA-NĂSĂUD,"GALAŢII BISTRIŢEI",33275,DIPŞA,"ŞCOALA GENERALĂ DIPŞA CLASELE I - IV",139,"Alegeri Prezidentiale",1,694,365,321,43,1,361,4,750,385,193,168
6,BISTRIŢA-NĂSĂUD,"GALAŢII BISTRIŢEI",33275,HERINA,"ŞCOALA GENERALĂ HERINA CLASELE I - IV",140,"Alegeri Prezidentiale",1,426,286,238,47,1,285,1,450,164,111,174
6,BISTRIŢA-NĂSĂUD,"GALAŢII BISTRIŢEI",33275,"ALBEŞTII BISTRIŢEI","CĂMINUL CULTURAL ALBEŞTII BISTRIŢEI",141,"Alegeri Prezidentiale",1,129,91,61,29,1,90,1,150,59,54,36
6,BISTRIŢA-NĂSĂUD,"GALAŢII BISTRIŢEI",33275,TONCIU,"CĂMINUL CULTURAL TONCIU",142,"Alegeri Prezidentiale",1,187,129,86,39,4,128,1,200,71,94,34
6,BISTRIŢA-NĂSĂUD,"ILVA MARE",33337,"ILVA MARE","PRIMĂRIA COMUNEI ILVA MARE",143,"Alegeri Prezidentiale",1,1061,499,471,28,0,494,5,1150,651,348,146
6,BISTRIŢA-NĂSĂUD,"ILVA MARE",33337,"ILVA MARE","PRIMĂRIA COMUNEI ILVA MARE",144,"Alegeri Prezidentiale",1,892,383,359,24,0,378,5,1000,617,311,67
6,BISTRIŢA-NĂSĂUD,"ILVA MICĂ",33364,"ILVA MICĂ","ŞCOALA GIMNAZIALĂ NR. 2",145,"Alegeri Prezidentiale",1,1292,584,519,49,16,578,6,1400,816,383,195
6,BISTRIŢA-NĂSĂUD,"ILVA MICĂ",33364,"ILVA MICĂ","ŞCOALA GIMNAZIALĂ ”DEMIAN NECHITI”",146,"Alegeri Prezidentiale",1,1439,679,625,39,15,674,5,1550,871,455,219
6,BISTRIŢA-NĂSĂUD,"JOSENII BÂRGĂULUI",33382,"JOSENII BÂRGĂULUI","CĂMINUL CULTURAL JOSENII BÎRGĂULUI",147,"Alegeri Prezidentiale",1,833,427,399,27,1,424,3,900,473,345,79
6,BISTRIŢA-NĂSĂUD,"JOSENII BÂRGĂULUI",33382,"JOSENII BÂRGĂULUI","ȘCOALA GIMNAZIALĂ JOSENII BÎRGĂULUI",148,"Alegeri Prezidentiale",1,876,441,424,16,1,437,4,950,509,321,116
6,BISTRIŢA-NĂSĂUD,"JOSENII BÂRGĂULUI",33382,"MIJLOCENII BÂRGĂULUI","GRĂDINIȚĂ MIJLOCENII BÎRGĂULUI",149,"Alegeri Prezidentiale",1,1393,668,623,45,0,664,4,1550,882,482,182
6,BISTRIŢA-NĂSĂUD,"JOSENII BÂRGĂULUI",33382,"RUSU BÂRGĂULUI","CĂMINUL CULTURAL RUSU BÎRGĂULUI",150,"Alegeri Prezidentiale",1,768,413,373,40,0,410,3,850,437,309,101
6,BISTRIŢA-NĂSĂUD,"JOSENII BÂRGĂULUI",33382,STRÂMBA,"ŞCOALA PRIMARĂ STRÎMBA",151,"Alegeri Prezidentiale",1,359,145,130,15,0,141,4,400,255,106,35
6,BISTRIŢA-NĂSĂUD,LECHINŢA,33435,LECHINŢA,"PRIMĂRIA COMUNEI LECHINȚA",152,"Alegeri Prezidentiale",1,1188,570,483,80,7,565,5,1300,730,310,255
6,BISTRIŢA-NĂSĂUD,LECHINŢA,33435,LECHINŢA,"ȘCOALA PROFESIONALĂ LECHINȚA, NR.394",153,"Alegeri Prezidentiale",1,1194,566,516,40,10,562,4,1300,734,329,233
6,BISTRIŢA-NĂSĂUD,LECHINŢA,33435,"SÂNGEORZU NOU","CĂMINUL CULTURAL SÎNGEORZU- NOU",154,"Alegeri Prezidentiale",1,801,391,341,48,2,385,6,900,509,262,123
6,BISTRIŢA-NĂSĂUD,LECHINŢA,33435,CHIRALEŞ,"CĂMINUL CULTURAL CHIRALEŞ",155,"Alegeri Prezidentiale",1,415,237,185,52,0,235,2,450,213,140,95
6,BISTRIŢA-NĂSĂUD,LECHINŢA,33435,SÂNIACOB,"CĂMINUL CULTURAL SÎNIACOB",156,"Alegeri Prezidentiale",1,176,136,106,26,4,136,0,200,64,58,78
6,BISTRIŢA-NĂSĂUD,LECHINŢA,33435,ŢIGĂU,"ŞCOALA PRIMARĂ ŢIGĂU",157,"Alegeri Prezidentiale",1,357,181,162,19,0,181,0,400,219,151,30
6,BISTRIŢA-NĂSĂUD,LECHINŢA,33435,VERMEŞ,"CĂMINUL CULTURAL VERMEŞ",158,"Alegeri Prezidentiale",1,733,309,287,20,2,308,1,800,491,126,182
6,BISTRIŢA-NĂSĂUD,LEŞU,33514,LEŞU,"ȘCOALA GIMNAZIALĂ NR. 1 - LEȘU",159,"Alegeri Prezidentiale",1,1351,591,542,35,14,589,2,1450,859,439,150
6,BISTRIŢA-NĂSĂUD,LEŞU,33514,"LUNCA LEŞULUI","ŞCOALA GENERALĂ NR. 2 LUNCA LEŞULUI",160,"Alegeri Prezidentiale",1,931,406,374,31,1,405,1,1000,594,356,49
6,BISTRIŢA-NĂSĂUD,LIVEZILE,33541,LIVEZILE,"CĂMINUL CULTURAL LIVEZILE",161,"Alegeri Prezidentiale",1,1225,507,463,44,0,500,7,1349,842,416,84
6,BISTRIŢA-NĂSĂUD,LIVEZILE,33541,LIVEZILE,"ŞCOALA GIMNAZIALĂ LIVEZILE",162,"Alegeri Prezidentiale",1,1196,513,447,66,0,511,2,1300,787,428,83
6,BISTRIŢA-NĂSĂUD,LIVEZILE,33541,DOROLEA,"ŞCOALA GIMNAZIALĂ DOROLEA",163,"Alegeri Prezidentiale",1,560,249,219,30,0,248,1,600,351,224,24
6,BISTRIŢA-NĂSĂUD,LIVEZILE,33541,CUŞMA,"ŞCOALA PRIMARĂ CUŞMA",164,"Alegeri Prezidentiale",1,530,281,259,17,5,276,5,650,369,211,65
6,BISTRIŢA-NĂSĂUD,LIVEZILE,33541,"VALEA POENII","ŞCOALA PRIMARĂ VALEA POENII",165,"Alegeri Prezidentiale",1,129,88,75,13,0,86,2,150,62,43,43
6,BISTRIŢA-NĂSĂUD,LIVEZILE,33541,DUMBRAVA,"ŞCOALA PRIMARĂ DUMBRAVA",166,"Alegeri Prezidentiale",1,334,148,133,15,0,147,1,400,252,124,23
6,BISTRIŢA-NĂSĂUD,"LUNCA ILVEI",33603,"LUNCA ILVEI","CĂMINUL CULTURAL LUNCA ILVEI",167,"Alegeri Prezidentiale",1,1503,588,588,0,0,585,3,1650,1062,466,119
6,BISTRIŢA-NĂSĂUD,"LUNCA ILVEI",33603,"LUNCA ILVEI","CĂMINUL CULTURAL LUNCA ILVEI",168,"Alegeri Prezidentiale",1,1182,528,478,50,0,520,8,1300,772,426,94
6,BISTRIŢA-NĂSĂUD,MAIERU,33621,MAIERU,"LICEUL TEHNOLOGIC MAIERU",169,"Alegeri Prezidentiale",1,1000,485,467,17,1,478,7,1100,615,329,149
6,BISTRIŢA-NĂSĂUD,MAIERU,33621,MAIERU,"LICEUL TEHNOLOGIC MAIERU",170,"Alegeri Prezidentiale",1,1299,589,572,17,0,586,3,1450,861,404,182
6,BISTRIŢA-NĂSĂUD,MAIERU,33621,MAIERU,"LICEUL TEHNOLOGIC MAIERU",171,"Alegeri Prezidentiale",1,941,414,408,6,0,413,1,1050,636,281,132
6,BISTRIŢA-NĂSĂUD,MAIERU,33621,MAIERU,"CENTRUL CULTURAL CATEHETIC SF. ARHIDIACON STEFAN",172,"Alegeri Prezidentiale",1,1525,701,668,33,0,697,4,1650,949,476,221
6,BISTRIŢA-NĂSĂUD,MAIERU,33621,ANIEŞ,"ŞCOALA GIMNAZIALĂ ANIEŞ",173,"Alegeri Prezidentiale",1,1468,713,697,16,0,707,6,1600,887,470,237
6,BISTRIŢA-NĂSĂUD,MATEI,33658,MATEI,"ŞCOALA GIMNAZIALĂ MATEI",174,"Alegeri Prezidentiale",1,587,368,336,26,6,365,3,650,282,330,35
6,BISTRIŢA-NĂSĂUD,MATEI,33658,BIDIU,"GRĂDINIŢA BIDIU",175,"Alegeri Prezidentiale",1,164,84,69,15,0,83,1,200,116,42,41
6,BISTRIŢA-NĂSĂUD,MATEI,33658,CORVINEŞTI,"ŞCOALA GIMNAZIALĂ CORVINEŞTI",176,"Alegeri Prezidentiale",1,533,317,280,35,2,313,4,601,284,232,81
6,BISTRIŢA-NĂSĂUD,MATEI,33658,ENCIU,"GRĂDINIŢA ENCIU",177,"Alegeri Prezidentiale",1,144,100,80,20,0,98,2,150,50,56,42
6,BISTRIŢA-NĂSĂUD,MATEI,33658,FÂNTÂNELE,"ŞCOALA PRIMARĂ FÎNTÎNELE",178,"Alegeri Prezidentiale",1,468,250,217,32,1,248,2,500,250,198,50
6,BISTRIŢA-NĂSĂUD,MATEI,33658,MORUŢ,"ŞCOALA PRIMARĂ MORUŢ",179,"Alegeri Prezidentiale",1,161,93,81,12,0,90,3,200,107,63,27
6,BISTRIŢA-NĂSĂUD,"MĂGURA ILVEI",33729,"MĂGURA ILVEI","CĂMINUL CULTURAL MĂGURA ILVEI",180,"Alegeri Prezidentiale",1,1369,596,541,22,33,591,5,1500,904,418,173
6,BISTRIŢA-NĂSĂUD,"MĂGURA ILVEI",33729,ARŞIŢA,"CĂMINUL CULTURAL ARŞIŢA",181,"Alegeri Prezidentiale",1,342,180,154,14,12,180,0,400,220,140,40
6,BISTRIŢA-NĂSĂUD,MĂRIŞELU,33765,MĂGURELE,"ŞCOALA GIMNAZIALĂ MĂRIŞELU",182,"Alegeri Prezidentiale",1,523,284,256,28,0,281,3,551,267,220,61
6,BISTRIŢA-NĂSĂUD,MĂRIŞELU,33765,DOMNEŞTI,"ŞCOALA PRIMARĂ DOMNEŞTI",183,"Alegeri Prezidentiale",1,721,335,285,50,0,334,1,793,458,223,111
6,BISTRIŢA-NĂSĂUD,MĂRIŞELU,33765,BÂRLA,"CĂMINUL CULTURAL BÎRLA",184,"Alegeri Prezidentiale",1,283,168,148,20,0,168,0,300,132,106,62
6,BISTRIŢA-NĂSĂUD,MĂRIŞELU,33765,SÂNTIOANA,"ŞCOALA PRIMARĂ SÎNTIOANA",185,"Alegeri Prezidentiale",1,384,176,166,10,0,176,0,400,224,124,52
6,BISTRIŢA-NĂSĂUD,MĂRIŞELU,33765,JEICA,"SOCIETATEA AGRICOLĂ",186,"Alegeri Prezidentiale",1,80,92,41,51,0,91,1,199,107,72,19
6,BISTRIŢA-NĂSĂUD,"MICEŞTII DE CÂMPIE",33845,"MICEŞTII DE CÂMPIE","CĂMINUL CULTURAL MICEŞTII DE CÎMPIE",187,"Alegeri Prezidentiale",1,248,143,107,36,0,143,0,300,157,77,66
6,BISTRIŢA-NĂSĂUD,"MICEŞTII DE CÂMPIE",33845,FÂNTÂNIŢA,"ȘCOALA GENERALĂ FÎNTÎNIŢA",188,"Alegeri Prezidentiale",1,297,122,106,16,0,121,1,300,178,99,22
6,BISTRIŢA-NĂSĂUD,"MICEŞTII DE CÂMPIE",33845,VISUIA,"ȘCOALA GENERALĂ VISUIA",189,"Alegeri Prezidentiale",1,320,145,127,18,0,145,0,350,205,114,31
6,BISTRIŢA-NĂSĂUD,MILAŞ,33881,MILAŞ,"GRADINITA CU PROGRAM NORMAL",190,"Alegeri Prezidentiale",1,594,318,271,47,0,314,4,650,332,171,143
6,BISTRIŢA-NĂSĂUD,MILAŞ,33881,OROSFAIA,"CAMINUL CULTURAL OROSFAIA",191,"Alegeri Prezidentiale",1,294,188,164,24,0,187,1,300,112,105,82
6,BISTRIŢA-NĂSĂUD,MILAŞ,33881,COMLOD,"CĂMINUL CULTURAL COMLOD",192,"Alegeri Prezidentiale",1,109,71,50,21,0,71,0,150,79,37,34
6,BISTRIŢA-NĂSĂUD,MONOR,33952,MONOR,"CĂMINUL CULTURAL MONOR",193,"Alegeri Prezidentiale",1,688,427,372,55,0,424,3,750,323,236,188
6,BISTRIŢA-NĂSĂUD,MONOR,33952,GLEDIN,"CĂMINUL CULTURAL GLEDIN",194,"Alegeri Prezidentiale",1,411,265,239,26,0,263,2,450,185,138,125
6,BISTRIŢA-NĂSĂUD,NEGRILEŞTI,179659,NEGRILEŞTI,"ŞCOALA GIMNAZIALĂ NEGRILEŞTI",195,"Alegeri Prezidentiale",1,1030,505,435,66,4,502,3,1100,595,326,176
6,BISTRIŢA-NĂSĂUD,NEGRILEŞTI,179659,PURCĂRETE,"ŞCOALA GENERALĂ PURCĂRETE",196,"Alegeri Prezidentiale",1,178,85,64,21,0,84,1,200,115,63,21
6,BISTRIŢA-NĂSĂUD,NEGRILEŞTI,179659,BREAZA,"ŞCOALA GIMNAZIALĂ ”VICTOR MOTOGNA” BREAZA",197,"Alegeri Prezidentiale",1,808,356,337,19,0,355,1,900,544,245,110
6,BISTRIŢA-NĂSĂUD,NIMIGEA,33989,"NIMIGEA DE JOS","ŞCOALA GIMNAZIALĂ NIMIGEA DE JOS",198,"Alegeri Prezidentiale",1,1310,633,581,49,3,630,3,1400,767,432,198
6,BISTRIŢA-NĂSĂUD,NIMIGEA,33989,MOCOD,"CĂMINUL CULTURAL MOCOD",199,"Alegeri Prezidentiale",1,497,245,219,26,0,242,3,550,305,173,69
6,BISTRIŢA-NĂSĂUD,NIMIGEA,33989,MITITEI,"ŞCOALA GIMNAZIALĂ MITITEI",200,"Alegeri Prezidentiale",1,586,346,315,31,0,343,3,650,304,191,152
6,BISTRIŢA-NĂSĂUD,NIMIGEA,33989,"NIMIGEA DE SUS","ŞCOALA PRIMARĂ NIMIGEA DE SUS",201,"Alegeri Prezidentiale",1,467,247,221,26,0,244,3,500,253,148,96
6,BISTRIŢA-NĂSĂUD,NIMIGEA,33989,MINTIU,"ŞCOALA PRIMARĂ MINTIU",202,"Alegeri Prezidentiale",1,354,211,170,41,0,209,2,400,189,106,103
6,BISTRIŢA-NĂSĂUD,NIMIGEA,33989,TĂURE,"ŞCOALA PRIMARĂ TĂURE",203,"Alegeri Prezidentiale",1,359,157,140,17,0,156,1,400,243,68,88
6,BISTRIŢA-NĂSĂUD,NIMIGEA,33989,MOGOŞENI,"ŞCOALA PRIMARĂ MOGOŞENI",204,"Alegeri Prezidentiale",1,293,165,143,20,2,162,3,300,135,114,48
6,BISTRIŢA-NĂSĂUD,NIMIGEA,33989,FLOREŞTI,"ŞCOALA PRIMARĂ FLOREŞTI",205,"Alegeri Prezidentiale",1,395,183,160,23,0,182,1,450,267,103,79
6,BISTRIŢA-NĂSĂUD,NUŞENI,34075,NUŞENI,"PRIMĂRIA COMUNEI NUŞENI",206,"Alegeri Prezidentiale",1,722,480,362,75,43,468,12,900,420,312,156
6,BISTRIŢA-NĂSĂUD,NUŞENI,34075,BEUDIU,"CAMINUL CULTURAL BEUDIU",207,"Alegeri Prezidentiale",1,465,286,249,30,7,279,7,500,214,187,92
6,BISTRIŢA-NĂSĂUD,NUŞENI,34075,FELEAC,"CĂMINUL CULTURAL FELEAC",208,"Alegeri Prezidentiale",1,265,155,130,25,0,153,2,300,145,117,36
6,BISTRIŢA-NĂSĂUD,NUŞENI,34075,MALIN,"ŞCOALA PRIMARĂ MALIN",209,"Alegeri Prezidentiale",1,348,223,179,41,3,219,4,400,177,175,44
6,BISTRIŢA-NĂSĂUD,NUŞENI,34075,"RUSU DE SUS","CAMINUL CULTURAL RUSU DE SUS",210,"Alegeri Prezidentiale",1,236,159,138,21,0,157,2,250,91,105,52
6,BISTRIŢA-NĂSĂUD,NUŞENI,34075,VIŢA,"ŞCOALA GIMNAZIALĂ VIŢA",211,"Alegeri Prezidentiale",1,308,128,111,14,3,127,1,350,222,108,19
6,BISTRIŢA-NĂSĂUD,PARVA,34155,PARVA,"ŞCOALA GIMNAZIALĂ PARVA",212,"Alegeri Prezidentiale",1,976,480,466,12,2,475,5,1050,570,235,240
6,BISTRIŢA-NĂSĂUD,PARVA,34155,PARVA,"CENTRUL DE INFORMARE TURISTICA",213,"Alegeri Prezidentiale",1,962,410,389,17,4,407,3,1050,640,194,213
6,BISTRIŢA-NĂSĂUD,"PETRU RAREŞ",34173,RETEAG,"PRIMĂRIA COMUNEI PETRU RAREŞ",214,"Alegeri Prezidentiale",1,1419,720,651,64,5,713,7,1550,830,459,254
6,BISTRIŢA-NĂSĂUD,"PETRU RAREŞ",34173,RETEAG,"ŞCOALA GENERALĂ RETEAG POIENI, CLASELE I - IV",215,"Alegeri Prezidentiale",1,756,273,248,25,0,270,3,850,577,159,111
6,BISTRIŢA-NĂSĂUD,"PETRU RAREŞ",34173,BAŢA,"CĂMINUL CULTURAL BAŢA",216,"Alegeri Prezidentiale",1,700,405,369,36,0,399,6,750,345,286,113
6,BISTRIŢA-NĂSĂUD,"POIANA ILVEI",179720,"POIANA ILVEI","ŞCOALA GIMNAZIALĂ ”SEVER POP” POIANA ILVEI",217,"Alegeri Prezidentiale",1,1245,645,598,33,14,643,2,1350,705,373,270
6,BISTRIŢA-NĂSĂUD,"PRUNDU BÂRGĂULUI",34235,"PRUNDU BÂRGĂULUI","ŞCOALA PRIMARĂ PRUNDU BÎRGĂULUI",218,"Alegeri Prezidentiale",1,1167,668,581,87,0,666,2,1300,632,533,133
6,BISTRIŢA-NĂSĂUD,"PRUNDU BÂRGĂULUI",34235,"PRUNDU BÂRGĂULUI","ȘCOALA PRIMARĂ PRUNDU BÎRGĂULUI",219,"Alegeri Prezidentiale",1,1361,707,666,41,0,703,4,1502,795,512,191
6,BISTRIŢA-NĂSĂUD,"PRUNDU BÂRGĂULUI",34235,"PRUNDU BÂRGĂULUI","CENTRU MULTIFUNCȚIONAL",220,"Alegeri Prezidentiale",1,1600,882,825,57,0,876,6,1750,868,667,209
6,BISTRIŢA-NĂSĂUD,"PRUNDU BÂRGĂULUI",34235,"SUSENII BÂRGĂULUI","ŞCOALA PRIMARĂ SUSENII BÎRGĂULUI",221,"Alegeri Prezidentiale",1,1142,565,509,37,19,559,6,1350,785,432,127
6,BISTRIŢA-NĂSĂUD,REBRA,34262,REBRA,"ȘCOALA GIMNAZIALĂ REBRA CLASELE I-IV",222,"Alegeri Prezidentiale",1,1003,371,343,27,1,370,1,1100,729,300,70
6,BISTRIŢA-NĂSĂUD,REBRA,34262,REBRA,"ȘCOALA GIMNAZIALĂ REBRA CLASELE I-IV",223,"Alegeri Prezidentiale",1,1093,353,343,10,0,350,3,1197,844,283,67
6,BISTRIŢA-NĂSĂUD,REBRIŞOARA,34280,REBRIŞOARA,"ŞCOALA GIMNAZIALĂ CLASELE I-IV REBRIŞOARA",224,"Alegeri Prezidentiale",1,1448,604,581,23,0,592,12,1550,946,410,182
6,BISTRIŢA-NĂSĂUD,REBRIŞOARA,34280,REBRIŞOARA,"ŞCOALA GIMNAZIALĂ CLASELE I-IV REBRIŞOARA",225,"Alegeri Prezidentiale",1,1654,641,612,29,0,633,8,1808,1167,446,187
6,BISTRIŢA-NĂSĂUD,REBRIŞOARA,34280,"GERSA I","ŞCOALA GIMNAZIALĂ NR.1 GERSA I",226,"Alegeri Prezidentiale",1,572,199,181,18,0,196,3,600,401,171,25
6,BISTRIŢA-NĂSĂUD,REBRIŞOARA,34280,"GERSA II","ŞCOALA PRIMARĂ ”VALEA BABII”",227,"Alegeri Prezidentiale",1,156,66,52,14,0,65,1,200,134,50,15
6,BISTRIŢA-NĂSĂUD,RODNA,34333,RODNA,"ŞCOALA GIMNAZIALĂ NR. 2 ”FLORIAN PORCIUS” RODNA",228,"Alegeri Prezidentiale",1,970,418,403,15,0,414,4,1050,632,248,166
6,BISTRIŢA-NĂSĂUD,RODNA,34333,RODNA,"ŞCOALA GIMNAZIALĂ NR. 2 ”FLORIAN PORCIUS” RODNA",229,"Alegeri Prezidentiale",1,953,411,395,16,0,406,5,1050,639,245,161
6,BISTRIŢA-NĂSĂUD,RODNA,34333,RODNA,"PRIMĂRIA COMUNEI RODNA",230,"Alegeri Prezidentiale",1,1478,722,695,27,0,718,4,1600,878,428,290
6,BISTRIŢA-NĂSĂUD,RODNA,34333,RODNA,"CĂMINUL CULTURAL ”GHERASIM DOMIDE” RODNA",231,"Alegeri Prezidentiale",1,1446,664,643,21,0,657,7,1600,936,398,259
6,BISTRIŢA-NĂSĂUD,RODNA,34333,"VALEA VINULUI","ŞCOALA PRIMARĂ VALEA VINULUI",232,"Alegeri Prezidentiale",1,160,98,82,16,0,97,1,200,102,57,40
6,BISTRIŢA-NĂSĂUD,ROMULI,34360,ROMULI,"ŞCOALA GIMNAZIALĂ CLASELE I-VIII, ROMULI",233,"Alegeri Prezidentiale",1,1034,528,482,45,1,521,7,1100,572,404,117
6,BISTRIŢA-NĂSĂUD,ROMULI,34360,"DEALU ŞTEFĂNIŢEI","GRĂDINIȚA CU PROGRAM NORMAL DEALU ŞTEFĂNIŢEI",234,"Alegeri Prezidentiale",1,352,196,179,17,0,196,0,400,204,154,42
6,BISTRIŢA-NĂSĂUD,"RUNCU SALVEI",179944,"RUNCU SALVEI","PRIMĂRIA COMUNEI RUNCU SALVEI",235,"Alegeri Prezidentiale",1,1049,632,592,26,14,624,8,1150,518,544,80
6,BISTRIŢA-NĂSĂUD,SALVA,34397,SALVA,"PRIMĂRIA COMUNEI SALVA",236,"Alegeri Prezidentiale",1,1086,572,520,28,24,563,9,1200,628,323,240
6,BISTRIŢA-NĂSĂUD,SALVA,34397,SALVA,"ŞCOALA GIMANZIALĂ SALVA",237,"Alegeri Prezidentiale",1,1227,606,560,25,21,604,2,1350,744,315,289
6,BISTRIŢA-NĂSĂUD,"SÂNMIHAIU DE CÂMPIE",34477,"SÂNMIHAIU DE CÂMPIE","CĂMINUL CULTURAL SÎNMIHAIU DE CÎMPIE",238,"Alegeri Prezidentiale",1,535,379,309,60,10,372,7,550,171,254,118
6,BISTRIŢA-NĂSĂUD,"SÂNMIHAIU DE CÂMPIE",34477,BRĂTENI,"CĂMINUL CULTURAL BRĂTENI",239,"Alegeri Prezidentiale",1,64,82,42,36,4,79,3,101,19,49,30
6,BISTRIŢA-NĂSĂUD,"SÂNMIHAIU DE CÂMPIE",34477,SĂLCUŢA,"CĂMINUL CULTURAL SĂLCUŢA",240,"Alegeri Prezidentiale",1,93,79,44,25,10,79,0,100,21,40,39
6,BISTRIŢA-NĂSĂUD,"SÂNMIHAIU DE CÂMPIE",34477,STUPINI,"ȘCOALA GIMNAZIALÂ STUPINI",241,"Alegeri Prezidentiale",1,156,105,77,19,9,103,2,200,95,57,46
6,BISTRIŢA-NĂSĂUD,"SÂNMIHAIU DE CÂMPIE",34477,ZORENI,"CĂMINUL CULTURAL ZORENI",242,"Alegeri Prezidentiale",1,240,138,111,21,6,135,3,250,112,73,62
6,BISTRIŢA-NĂSĂUD,"SILIVAŞU DE CÂMPIE",34422,"SILIVAŞU DE CÂMPIE","CĂMINUL CULTURAL",243,"Alegeri Prezidentiale",1,779,430,358,72,0,428,2,850,420,220,208
6,BISTRIŢA-NĂSĂUD,SPERMEZEU,34547,SPERMEZEU,"PRIMĂRIA COMUNEI SPERMEZEU",244,"Alegeri Prezidentiale",1,1427,726,649,77,0,721,5,1550,824,614,107
6,BISTRIŢA-NĂSĂUD,SPERMEZEU,34547,SITA,"ŞCOALA GIMNAZIALĂ SITA",245,"Alegeri Prezidentiale",1,253,154,137,17,0,154,0,300,146,123,31
6,BISTRIŢA-NĂSĂUD,SPERMEZEU,34547,HĂLMĂSĂU,"ŞCOALA PRIMARĂ HĂLMĂSĂU",246,"Alegeri Prezidentiale",1,223,140,123,17,0,140,0,250,110,135,5
6,BISTRIŢA-NĂSĂUD,SPERMEZEU,34547,DUMBRĂVIŢA,"ŞCOALA GIMNAZIALĂ ”TEODOR COTUŢIU” DUMBRĂVIŢA",247,"Alegeri Prezidentiale",1,649,290,269,20,1,287,3,700,410,227,60
6,BISTRIŢA-NĂSĂUD,SPERMEZEU,34547,DOBRICEL,"ŞCOALA PRIMARĂ DOBRICEL",248,"Alegeri Prezidentiale",1,438,240,224,16,0,240,0,500,260,190,50
6,BISTRIŢA-NĂSĂUD,ŞANŢ,34618,ŞANŢ,"PRIMĂRIA COMUNEI ŞANŢ",249,"Alegeri Prezidentiale",1,1320,751,710,39,2,747,4,1450,699,445,302
6,BISTRIŢA-NĂSĂUD,ŞANŢ,34618,ŞANŢ,"ȘCOALA GIMNAZIALĂ ”ENEA GRAPINI” ŞANŢ",250,"Alegeri Prezidentiale",1,1103,595,582,11,2,586,9,1200,605,384,202
6,BISTRIŢA-NĂSĂUD,ŞANŢ,34618,"VALEA MARE","ŞCOALA PRIMARĂ ”LUCIAN VALEA”",251,"Alegeri Prezidentiale",1,264,161,143,18,0,161,0,300,139,96,65
6,BISTRIŢA-NĂSĂUD,ŞIEU,34645,ŞIEU,"PRIMĂRIA COMUNEI ŞIEU",252,"Alegeri Prezidentiale",1,1084,626,573,52,1,624,2,1200,574,478,146
6,BISTRIŢA-NĂSĂUD,ŞIEU,34645,ARDAN,"ŞCOALA GENERALĂ ARDAN",253,"Alegeri Prezidentiale",1,590,286,273,13,0,285,1,650,364,248,37
6,BISTRIŢA-NĂSĂUD,ŞIEU,34645,POSMUŞ,"ŞCOALA GENERALĂ POSMUŞ",254,"Alegeri Prezidentiale",1,546,286,261,25,0,284,2,600,314,186,98
6,BISTRIŢA-NĂSĂUD,ŞIEU,34645,ŞOIMUŞ,"CĂMINUL CULTURAL ŞOIMUŞ",255,"Alegeri Prezidentiale",1,124,82,69,13,0,81,1,150,68,62,19
6,BISTRIŢA-NĂSĂUD,ŞIEU-MĂGHERUŞ,34690,ŞIEU-MĂGHERUŞ,"CĂMINUL CULTURAL ŞIEU-MĂGHERUŞ",256,"Alegeri Prezidentiale",1,968,421,382,39,0,418,3,1050,629,307,111
6,BISTRIŢA-NĂSĂUD,ŞIEU-MĂGHERUŞ,34690,CHINTELNIC,"CAMIN CULTURAL ”GRIGORE PLETOSU”",257,"Alegeri Prezidentiale",1,553,312,250,62,0,310,2,600,288,263,47
6,BISTRIŢA-NĂSĂUD,ŞIEU-MĂGHERUŞ,34690,CRAINIMĂT,"CĂMINUL CULTURAL CRAINIMĂT",258,"Alegeri Prezidentiale",1,835,434,390,44,0,431,3,900,466,363,68
6,BISTRIŢA-NĂSĂUD,ŞIEU-MĂGHERUŞ,34690,SĂRĂŢEL,"CĂMINUL CULTURAL SĂRĂŢEL",259,"Alegeri Prezidentiale",1,474,229,185,44,0,227,2,500,271,169,58
6,BISTRIŢA-NĂSĂUD,ŞIEU-MĂGHERUŞ,34690,ARCALIA,"ŞCOALA GENERALĂ ARCALIA, CLASELE V-VIII",260,"Alegeri Prezidentiale",1,748,365,282,83,0,359,6,850,485,321,38
6,BISTRIŢA-NĂSĂUD,ŞIEU-ODORHEI,34770,ŞIEU-ODORHEI,"PRIMĂRIA COMUNEI ŞIEU-ODORHEI",261,"Alegeri Prezidentiale",1,597,341,297,44,0,335,6,650,309,235,100
6,BISTRIŢA-NĂSĂUD,ŞIEU-ODORHEI,34770,"AGRIŞU DE JOS","ŞCOALA GENERALĂ AGRIŞU DE JOS",262,"Alegeri Prezidentiale",1,291,154,138,16,0,154,0,300,146,79,75
6,BISTRIŢA-NĂSĂUD,ŞIEU-ODORHEI,34770,"AGRIŞU DE SUS","CĂMINUL CULTURAL AGRIŞU DE SUS",263,"Alegeri Prezidentiale",1,137,79,59,20,0,75,4,150,71,46,29
6,BISTRIŢA-NĂSĂUD,ŞIEU-ODORHEI,34770,BRETEA,"CĂMINUL CULTURAL BRETEA",264,"Alegeri Prezidentiale",1,131,85,62,23,0,83,2,150,65,55,28
6,BISTRIŢA-NĂSĂUD,ŞIEU-ODORHEI,34770,COASTA,"CĂMINUL CULTURAL COASTA",265,"Alegeri Prezidentiale",2,166,111,82,29,0,109,2,200,89,73,36
6,BISTRIŢA-NĂSĂUD,ŞIEU-ODORHEI,34770,CRISTUR-ŞIEU,"ŞCOALA GENERALĂ CRISTUR-ŞIEU",266,"Alegeri Prezidentiale",1,414,217,179,38,0,212,5,450,233,161,51
6,BISTRIŢA-NĂSĂUD,ŞIEU-ODORHEI,34770,ŞIRIOARA,"ŞCOALA GENERALĂ ŞIRIOARA",267,"Alegeri Prezidentiale",1,195,156,113,43,0,154,2,200,44,110,44
6,BISTRIŢA-NĂSĂUD,ŞIEUŢ,34850,ŞIEUŢ,"PRIMĂRIA COMUNEI ŞIEUŢ",268,"Alegeri Prezidentiale",1,584,362,337,24,1,356,6,650,288,283,73
6,BISTRIŢA-NĂSĂUD,ŞIEUŢ,34850,RUŞTIOR,"ŞCOALA PRIMARĂ RUŞTIOR",269,"Alegeri Prezidentiale",1,490,266,256,10,0,265,1,500,234,204,61
6,BISTRIŢA-NĂSĂUD,ŞIEUŢ,34850,SEBIŞ,"ŞCOALA GIMNAZIALĂ SEBIŞ",270,"Alegeri Prezidentiale",1,682,384,367,17,0,383,1,750,366,288,95
6,BISTRIŢA-NĂSĂUD,ŞIEUŢ,34850,LUNCA,"ŞCOALA PRIMARĂ LUNCA",271,"Alegeri Prezidentiale",1,310,150,135,15,0,150,0,350,200,122,28
6,BISTRIŢA-NĂSĂUD,ŞINTEREAG,34903,ŞINTEREAG,"PRIMĂRIA COMUNEI ŞINTEREAG",272,"Alegeri Prezidentiale",1,851,450,367,68,15,444,6,901,451,365,79
6,BISTRIŢA-NĂSĂUD,ŞINTEREAG,34903,CAILA,"CĂMINUL CULTURAL",273,"Alegeri Prezidentiale",1,259,162,130,32,0,159,3,300,138,123,36
6,BISTRIŢA-NĂSĂUD,ŞINTEREAG,34903,COCIU,"ŞCOALA GIMNAZIALĂ COCIU",274,"Alegeri Prezidentiale",1,893,485,448,37,0,480,5,1000,515,326,154
6,BISTRIŢA-NĂSĂUD,ŞINTEREAG,34903,"BLĂJENII DE JOS","CĂMINUL CULTURAL BLĂJENII DE JOS",275,"Alegeri Prezidentiale",1,300,167,129,32,6,166,1,300,133,110,56
6,BISTRIŢA-NĂSĂUD,ŞINTEREAG,34903,"BLĂJENII DE SUS","ŞCOALA PRIMARĂ ”NICOLAE BĂLAN” BLĂJENII DE SUS",276,"Alegeri Prezidentiale",1,311,206,152,54,0,205,1,350,144,149,56
6,BISTRIŢA-NĂSĂUD,ŞINTEREAG,34903,ŞIEU-SFÂNTU,"ŞCOALA PRIMARĂ CLASELE I-IV ŞIEU-SFÎNTU (FOSTUL SEDIU)",277,"Alegeri Prezidentiale",1,392,305,245,52,8,303,2,450,145,182,121
6,BISTRIŢA-NĂSĂUD,TÂRLIŞUA,35152,TÂRLIŞUA,"LICEUL TEHNOLOGIC TÎRLIȘUA",278,"Alegeri Prezidentiale",1,1019,538,502,17,19,534,4,1200,662,358,176
6,BISTRIŢA-NĂSĂUD,TÂRLIŞUA,35152,BORLEASA,"ŞCOALA GENERALĂ BORLEASA",279,"Alegeri Prezidentiale",1,310,157,141,13,3,155,2,350,193,78,77
6,BISTRIŢA-NĂSĂUD,TÂRLIŞUA,35152,"LUNCA SĂTEASCĂ","ŞCOALA GENERALĂ LUNCA SĂTEASCĂ",280,"Alegeri Prezidentiale",1,454,197,175,22,0,197,0,500,303,113,84
6,BISTRIŢA-NĂSĂUD,TÂRLIŞUA,35152,AGRIEŞ,"ŞCOALA GENERALĂ AGRIEŞ",281,"Alegeri Prezidentiale",1,762,484,437,25,22,480,4,800,316,217,263
6,BISTRIŢA-NĂSĂUD,TÂRLIŞUA,35152,MOLIŞET,"ŞCOALA GENERALĂ MOLIŞET (COSTEASA)",282,"Alegeri Prezidentiale",1,174,124,113,8,3,122,2,200,76,69,53
6,BISTRIŢA-NĂSĂUD,TEACA,34985,ARCHIUD,"CĂMINUL CULTURAL ARCHIUD",283,"Alegeri Prezidentiale",1,449,224,195,29,0,222,2,500,276,133,89
6,BISTRIŢA-NĂSĂUD,TEACA,34985,BUDURLENI,"CĂMINUL CULTURAL BUDURLENI",284,"Alegeri Prezidentiale",1,75,69,49,20,0,69,0,100,31,29,40
6,BISTRIŢA-NĂSĂUD,TEACA,34985,OCNIŢA,"CĂMINUL CULTURAL OCNIŢA",285,"Alegeri Prezidentiale",1,829,369,336,33,0,368,1,900,531,269,99
6,BISTRIŢA-NĂSĂUD,TEACA,34985,PINTICU,"CĂMINUL CULTURAL PINTICU",286,"Alegeri Prezidentiale",1,629,257,231,26,0,253,4,650,393,154,99
6,BISTRIŢA-NĂSĂUD,TEACA,34985,TEACA,"CĂMINUL CULTURAL TEACA",287,"Alegeri Prezidentiale",1,885,378,342,36,0,376,2,950,572,290,86
6,BISTRIŢA-NĂSĂUD,TEACA,34985,TEACA,"PRIMĂRIA COMUNEI TEACA",288,"Alegeri Prezidentiale",1,764,390,351,39,0,382,8,850,460,281,101
6,BISTRIŢA-NĂSĂUD,TEACA,34985,"VIILE TECII","CĂMINUL CULTURAL VIILE TECII",289,"Alegeri Prezidentiale",1,850,335,305,30,0,329,6,950,615,218,111
6,BISTRIŢA-NĂSĂUD,TELCIU,35054,TELCIU,"LICEUL TEHNOLOGIC TELCIU",290,"Alegeri Prezidentiale",1,1171,457,435,22,0,456,1,1300,843,373,83
6,BISTRIŢA-NĂSĂUD,TELCIU,35054,TELCIU,"CENTRUL DE INFORMARE TURISTICĂ",291,"Alegeri Prezidentiale",1,992,485,443,42,0,479,6,1050,565,361,118
6,BISTRIŢA-NĂSĂUD,TELCIU,35054,TELCIU,"OCOLUL SILVIC TELCIU",292,"Alegeri Prezidentiale",1,963,386,374,12,0,385,1,1050,664,297,88
6,BISTRIŢA-NĂSĂUD,TELCIU,35054,TELCIŞOR,"ŞCOALA GIMNAZIALĂ TELCIŞOR",293,"Alegeri Prezidentiale",1,880,344,325,19,0,343,1,950,606,295,48
6,BISTRIŢA-NĂSĂUD,TELCIU,35054,FIAD,"CABANA STARSILVA FIAD",294,"Alegeri Prezidentiale",1,167,77,65,12,0,77,0,200,123,46,31
6,BISTRIŢA-NĂSĂUD,TELCIU,35054,BICHIGIU,"ŞCOALA GIMNAZIALĂ BICHIGIU",295,"Alegeri Prezidentiale",1,679,232,214,18,0,229,3,750,518,181,48
6,BISTRIŢA-NĂSĂUD,"TIHA BÂRGĂULUI",35090,"TIHA BÂRGĂULUI","ŞCOALA GIMNAZIALĂ TIHA BÎRGĂULUI",296,"Alegeri Prezidentiale",1,1360,657,615,40,2,654,3,1500,843,567,87
6,BISTRIŢA-NĂSĂUD,"TIHA BÂRGĂULUI",35090,TUREAC,"ȘCOALA GIMNAZIALĂ TUREAC",297,"Alegeri Prezidentiale",1,536,274,245,29,0,269,5,550,276,180,89
6,BISTRIŢA-NĂSĂUD,"TIHA BÂRGĂULUI",35090,TUREAC,"ȘCOALA GIMNAZIALĂ TUREAC",298,"Alegeri Prezidentiale",1,1579,736,692,44,0,728,8,1700,964,653,75
6,BISTRIŢA-NĂSĂUD,"TIHA BÂRGĂULUI",35090,"MUREŞENII BÂRGĂULUI","ŞCOALA GIMNAZIALĂ MUREŞENII BÎRGĂULUI",299,"Alegeri Prezidentiale",1,1349,725,675,50,0,724,1,1450,725,630,94
6,BISTRIŢA-NĂSĂUD,"TIHA BÂRGĂULUI",35090,"PIATRA FÂNTÂNELE","ŞCOALA GIMNAZIALĂ PIATRA FÎNTÎNELE",300,"Alegeri Prezidentiale",1,322,200,124,76,0,199,1,450,250,175,24
6,BISTRIŢA-NĂSĂUD,URIU,35269,URIU,"ŞCOALA GENERALĂ URIU",301,"Alegeri Prezidentiale",1,1234,675,636,36,3,673,2,1350,675,567,106
6,BISTRIŢA-NĂSĂUD,URIU,35269,"CRISTEŞTII CICEULUI","ŞCOALA GENERALĂ CRISTEŞTII CICEULUI",302,"Alegeri Prezidentiale",1,982,526,441,76,9,518,8,1050,524,320,198
6,BISTRIŢA-NĂSĂUD,URIU,35269,ILIŞUA,"ŞCOALA GENERALĂ ILIŞUA",303,"Alegeri Prezidentiale",1,592,306,268,38,0,304,2,650,344,209,95
6,BISTRIŢA-NĂSĂUD,URIU,35269,"HĂŞMAŞU CICEULUI","ŞCOALA GENERALĂ HĂŞMAŞU CICEULUI",304,"Alegeri Prezidentiale",1,192,128,105,23,0,126,2,200,72,75,51
6,BISTRIŢA-NĂSĂUD,URMENIŞ,35312,URMENIŞ,"SALA DE SPORT URMENIŞ",305,"Alegeri Prezidentiale",1,745,342,291,51,0,341,1,800,458,284,57
6,BISTRIŢA-NĂSĂUD,URMENIŞ,35312,ŞOPTERIU,"ŞCOALA GENERALĂ ŞOPTERIU",306,"Alegeri Prezidentiale",1,303,146,129,17,0,145,1,350,204,100,45
6,BISTRIŢA-NĂSĂUD,URMENIŞ,35312,DELURENI,"ŞCOALA GENERALĂ DELURENI",307,"Alegeri Prezidentiale",1,265,103,90,13,0,100,3,300,197,68,32
6,BISTRIŢA-NĂSĂUD,URMENIŞ,35312,FÂNAŢE,"CĂMINUL CULTURAL FÎNAŢE",308,"Alegeri Prezidentiale",1,151,92,73,19,0,92,0,200,108,74,18
6,BISTRIŢA-NĂSĂUD,ZAGRA,35429,ZAGRA,"ŞCOALA GENERALĂ ZAGRA",309,"Alegeri Prezidentiale",1,864,471,431,23,17,469,2,930,459,221,248
6,BISTRIŢA-NĂSĂUD,ZAGRA,35429,"POIENILE ZAGREI","ŞCOALA GENERALĂ POIENILE ZAGREI",310,"Alegeri Prezidentiale",1,696,366,334,16,16,363,3,740,374,131,232
6,BISTRIŢA-NĂSĂUD,ZAGRA,35429,SUPLAI,"ŞCOALA GENERALĂ SUPLAI",311,"Alegeri Prezidentiale",1,511,250,225,17,8,249,1,512,262,99,150
6,BISTRIŢA-NĂSĂUD,ZAGRA,35429,PERIŞOR,"ŞCOALA GENERALĂ PERIŞOR",312,"Alegeri Prezidentiale",1,429,233,217,7,9,233,0,450,217,100,133
6,BISTRIŢA-NĂSĂUD,ZAGRA,35429,ALUNIŞUL,"ŞCOALA GENERALĂ ALUNIŞUL",313,"Alegeri Prezidentiale",1,183,124,108,9,7,124,0,200,76,42,82
7,BOTOŞANI,"MUNICIPIUL BOTOŞANI",35731,BOTOŞANI,"LICEUL DE ARTĂ „ȘTEFAN LUCHIAN”",1,"Alegeri Prezidentiale",1,881,508,378,27,103,498,10,1200,692,207,291
7,BOTOŞANI,"MUNICIPIUL BOTOŞANI",35731,BOTOŞANI,"LICEUL DE ARTĂ „ȘTEFAN LUCHIAN”",2,"Alegeri Prezidentiale",1,1276,680,606,56,18,659,21,1500,820,360,299
7,BOTOŞANI,"MUNICIPIUL BOTOŞANI",35731,BOTOŞANI,"GRĂDINIȚA CU PROGRAM NORMAL „FLOARE DE COLȚ”",3,"Alegeri Prezidentiale",1,1527,724,681,43,0,707,17,1600,876,355,352
7,BOTOŞANI,"MUNICIPIUL BOTOŞANI",35731,BOTOŞANI,"GRĂDINIȚA CU PROGRAM NORMAL „FLOARE DE COLȚ”",4,"Alegeri Prezidentiale",1,1382,668,632,36,0,654,14,1400,732,338,316
7,BOTOŞANI,"MUNICIPIUL BOTOŞANI",35731,BOTOŞANI,"ŞCOALA GIMNAZIALĂ NR. 7",5,"Alegeri Prezidentiale",1,1121,523,483,40,0,509,14,1200,677,234,275
7,BOTOŞANI,"MUNICIPIUL BOTOŞANI",35731,BOTOŞANI,"ŞCOALA GIMNAZIALĂ NR. 7",6,"Alegeri Prezidentiale",1,1072,525,493,31,1,505,20,1100,575,269,236
7,BOTOŞANI,"MUNICIPIUL BOTOŞANI",35731,BOTOŞANI,"GRĂDINIŢA CU PROGRAM PRELUNGIT NR. 19",7,"Alegeri Prezidentiale",1,981,417,396,21,0,406,11,1100,683,218,188
7,BOTOŞANI,"MUNICIPIUL BOTOŞANI",35731,BOTOŞANI,"GRĂDINIŢA CU PROGRAM PRELUNGIT NR. 19",8,"Alegeri Prezidentiale",2,1094,462,434,28,0,451,11,1200,738,238,213
7,BOTOŞANI,"MUNICIPIUL BOTOŞANI",35731,BOTOŞANI,"ŞCOALA GIMNAZIALĂ NR. 17",9,"Alegeri Prezidentiale",1,1483,699,653,46,0,682,17,1500,801,357,325
7,BOTOŞANI,"MUNICIPIUL BOTOŞANI",35731,BOTOŞANI,"LICEUL TEORETIC „GRIGORE ANTIPA”",10,"Alegeri Prezidentiale",1,1611,769,745,24,0,744,25,1700,931,349,395
7,BOTOŞANI,"MUNICIPIUL BOTOŞANI",35731,BOTOŞANI,"LICEUL TEORETIC „GRIGORE ANTIPA”",11,"Alegeri Prezidentiale",1,1397,714,641,64,9,699,15,1500,786,338,361
7,BOTOŞANI,"MUNICIPIUL BOTOŞANI",35731,BOTOŞANI,"ŞCOALA GIMNAZIALĂ „SFÂNTA MARIA”",12,"Alegeri Prezidentiale",1,1449,652,623,29,0,631,21,1500,848,349,282
7,BOTOŞANI,"MUNICIPIUL BOTOŞANI",35731,BOTOŞANI,"ŞCOALA GIMNAZIALĂ „SFÂNTA MARIA”",13,"Alegeri Prezidentiale",1,1399,580,546,33,1,559,21,1500,920,298,261
7,BOTOŞANI,"MUNICIPIUL BOTOŞANI",35731,BOTOŞANI,"ŞCOALA GIMNAZIALĂ „SFÂNTA MARIA”",14,"Alegeri Prezidentiale",1,1270,520,503,15,2,505,15,1300,780,302,203
7,BOTOŞANI,"MUNICIPIUL BOTOŞANI",35731,BOTOŞANI,"ŞCOALA GIMNAZIALĂ NR. 13",15,"Alegeri Prezidentiale",1,1364,665,600,65,0,652,13,1400,735,365,287
7,BOTOŞANI,"MUNICIPIUL BOTOŞANI",35731,BOTOŞANI,"ŞCOALA GIMNAZIALĂ NR. 13",16,"Alegeri Prezidentiale",1,1489,649,603,46,0,623,26,1600,951,359,264
7,BOTOŞANI,"MUNICIPIUL BOTOŞANI",35731,BOTOŞANI,"COLEGIUL NAŢIONAL „MIHAI EMINESCU”",17,"Alegeri Prezidentiale",1,1328,589,561,27,1,575,14,1400,811,292,283
7,BOTOŞANI,"MUNICIPIUL BOTOŞANI",35731,BOTOŞANI,"COLEGIUL NAŢIONAL „MIHAI EMINESCU”",18,"Alegeri Prezidentiale",1,1084,580,551,29,0,560,20,1200,620,254,306
7,BOTOŞANI,"MUNICIPIUL BOTOŞANI",35731,BOTOŞANI,"COLEGIUL NAŢIONAL „MIHAI EMINESCU”",19,"Alegeri Prezidentiale",1,1502,709,661,48,0,687,22,1600,891,337,350
7,BOTOŞANI,"MUNICIPIUL BOTOŞANI",35731,BOTOŞANI,"COLEGIUL NAŢIONAL „MIHAI EMINESCU”",20,"Alegeri Prezidentiale",1,1174,496,476,20,0,477,19,1200,704,264,213
7,BOTOŞANI,"MUNICIPIUL BOTOŞANI",35731,BOTOŞANI,"ŞCOALA GIMNAZIALĂ NR. 12",21,"Alegeri Prezidentiale",1,987,420,391,29,0,416,4,1100,680,229,187
7,BOTOŞANI,"MUNICIPIUL BOTOŞANI",35731,BOTOŞANI,"ŞCOALA GIMNAZIALĂ NR. 12",22,"Alegeri Prezidentiale",1,853,368,347,21,0,356,12,900,532,192,164
7,BOTOŞANI,"MUNICIPIUL BOTOŞANI",35731,BOTOŞANI,"ŞCOALA GIMNAZIALĂ NR. 12",23,"Alegeri Prezidentiale",1,1302,599,572,26,1,583,16,1400,801,307,276
7,BOTOŞANI,"MUNICIPIUL BOTOŞANI",35731,BOTOŞANI,"GRĂDINIŢA CU PROGRAM PRELUNGIT NR. 23",24,"Alegeri Prezidentiale",1,1219,597,523,74,0,581,16,1300,703,299,282
7,BOTOŞANI,"MUNICIPIUL BOTOŞANI",35731,BOTOŞANI,"COLEGIUL TEHNIC „GHEORGHE ASACHI”",25,"Alegeri Prezidentiale",2,696,365,281,57,27,359,6,800,435,203,156
7,BOTOŞANI,"MUNICIPIUL BOTOŞANI",35731,BOTOŞANI,"COLEGIUL TEHNIC „GHEORGHE ASACHI”",26,"Alegeri Prezidentiale",1,959,487,447,40,0,462,25,1100,613,251,211
7,BOTOŞANI,"MUNICIPIUL BOTOŞANI",35731,BOTOŞANI,"COLEGIUL TEHNIC „GHEORGHE ASACHI”",27,"Alegeri Prezidentiale",1,1248,486,459,27,0,476,10,1400,914,292,184
7,BOTOŞANI,"MUNICIPIUL BOTOŞANI",35731,BOTOŞANI,"COLEGIUL TEHNIC „GHEORGHE ASACHI”",28,"Alegeri Prezidentiale",1,1121,479,453,26,0,470,9,1200,721,289,181
7,BOTOŞANI,"MUNICIPIUL BOTOŞANI",35731,BOTOŞANI,"COLEGIUL TEHNIC „GHEORGHE ASACHI”",29,"Alegeri Prezidentiale",1,836,375,349,26,0,364,11,900,525,218,146
7,BOTOŞANI,"MUNICIPIUL BOTOŞANI",35731,BOTOŞANI,"LICEUL „ALEXANDRU CEL BUN”",30,"Alegeri Prezidentiale",2,1411,610,558,52,0,594,16,1500,890,334,260
7,BOTOŞANI,"MUNICIPIUL BOTOŞANI",35731,BOTOŞANI,"LICEUL „ALEXANDRU CEL BUN”",31,"Alegeri Prezidentiale",1,793,519,383,31,105,504,15,900,381,261,243
7,BOTOŞANI,"MUNICIPIUL BOTOŞANI",35731,BOTOŞANI,"LICEUL „ALEXANDRU CEL BUN”",32,"Alegeri Prezidentiale",1,823,407,369,17,21,396,11,900,493,221,175
7,BOTOŞANI,"MUNICIPIUL BOTOŞANI",35731,BOTOŞANI,"ŞCOALA GIMNAZIALĂ „ȘTEFAN CEL MARE”",33,"Alegeri Prezidentiale",1,861,444,394,50,0,430,14,1000,556,242,188
7,BOTOŞANI,"MUNICIPIUL BOTOŞANI",35731,BOTOŞANI,"ŞCOALA GIMNAZIALĂ „ȘTEFAN CEL MARE”",34,"Alegeri Prezidentiale",1,1507,674,646,28,0,659,15,1600,926,335,324
7,BOTOŞANI,"MUNICIPIUL BOTOŞANI",35731,BOTOŞANI,"ŞCOALA GIMNAZIALĂ „ȘTEFAN CEL MARE”",35,"Alegeri Prezidentiale",1,594,282,265,17,0,275,7,700,418,148,127
7,BOTOŞANI,"MUNICIPIUL BOTOŞANI",35731,BOTOŞANI,"ŞCOALA GIMNAZIALĂ „ȘTEFAN CEL MARE”",36,"Alegeri Prezidentiale",1,1084,510,490,20,0,498,12,1200,690,297,201
7,BOTOŞANI,"MUNICIPIUL BOTOŞANI",35731,BOTOŞANI,"ŞCOALA GIMNAZIALĂ „ȘTEFAN CEL MARE”",37,"Alegeri Prezidentiale",1,1068,451,435,15,1,443,8,1200,749,258,185
7,BOTOŞANI,"MUNICIPIUL BOTOŞANI",35731,BOTOŞANI,"ŞCOALA GIMNAZIALĂ „ȘTEFAN CEL MARE”",38,"Alegeri Prezidentiale",1,1160,427,409,18,0,410,17,1200,773,245,165
7,BOTOŞANI,"MUNICIPIUL BOTOŞANI",35731,BOTOŞANI,"GRĂDINIŢA CU PROGRAM PRELUNGIT NR. 22",39,"Alegeri Prezidentiale",2,1151,462,448,14,0,449,13,1200,738,271,178
7,BOTOŞANI,"MUNICIPIUL BOTOŞANI",35731,BOTOŞANI,"GRĂDINIŢA CU PROGRAM PRELUNGIT NR. 22",40,"Alegeri Prezidentiale",2,848,369,350,19,0,358,11,882,513,210,148
7,BOTOŞANI,"MUNICIPIUL BOTOŞANI",35731,BOTOŞANI,"GRĂDINIŢA CU PROGRAM PRELUNGIT NR. 22",41,"Alegeri Prezidentiale",1,971,430,412,18,0,418,12,1000,570,250,168
7,BOTOŞANI,"MUNICIPIUL BOTOŞANI",35731,BOTOŞANI,"GRĂDINIŢA CU PROGRAM PRELUNGIT NR. 22",42,"Alegeri Prezidentiale",1,978,407,396,11,0,397,10,1100,693,230,167
7,BOTOŞANI,"MUNICIPIUL BOTOŞANI",35731,BOTOŞANI,"ŞCOALA GIMNAZIALĂ „ELENA RAREȘ”",43,"Alegeri Prezidentiale",1,1244,551,514,37,0,531,20,1400,849,318,213
7,BOTOŞANI,"MUNICIPIUL BOTOŞANI",35731,BOTOŞANI,"ŞCOALA GIMNAZIALĂ „ELENA RAREȘ”",44,"Alegeri Prezidentiale",1,1344,618,565,52,1,600,18,1500,882,327,273
7,BOTOŞANI,"MUNICIPIUL BOTOŞANI",35731,BOTOŞANI,"ŞCOALA GIMNAZIALĂ „ELENA RAREȘ”",45,"Alegeri Prezidentiale",1,1039,474,391,83,0,459,15,1200,726,272,187
7,BOTOŞANI,"MUNICIPIUL BOTOŞANI",35731,BOTOŞANI,"ŞCOALA GIMNAZIALĂ „ELENA RAREȘ”",46,"Alegeri Prezidentiale",1,1306,574,548,26,0,550,24,1400,826,323,227
7,BOTOŞANI,"MUNICIPIUL BOTOŞANI",35731,BOTOŞANI,"ŞCOALA GIMNAZIALĂ NR. 11",47,"Alegeri Prezidentiale",1,1100,579,514,65,0,563,16,1200,621,303,260
7,BOTOŞANI,"MUNICIPIUL BOTOŞANI",35731,BOTOŞANI,"ŞCOALA GIMNAZIALĂ NR. 11",48,"Alegeri Prezidentiale",1,827,422,386,36,0,418,4,900,478,226,192
7,BOTOŞANI,"MUNICIPIUL BOTOŞANI",35731,BOTOŞANI,"ŞCOALA GIMNAZIALĂ NR. 11",49,"Alegeri Prezidentiale",1,1201,601,561,40,0,584,17,1300,699,330,254
7,BOTOŞANI,"MUNICIPIUL BOTOŞANI",35731,BOTOŞANI,"ŞCOALA GIMNAZIALĂ NR. 11",50,"Alegeri Prezidentiale",1,975,423,405,18,0,411,12,1100,677,225,186
7,BOTOŞANI,"MUNICIPIUL BOTOŞANI",35731,BOTOŞANI,"ŞCOALA GIMNAZIALĂ NR. 11",51,"Alegeri Prezidentiale",1,610,302,286,16,0,291,11,800,498,157,134
7,BOTOŞANI,"MUNICIPIUL BOTOŞANI",35731,BOTOŞANI,"ŞCOALA GIMNAZIALĂ NR. 2",52,"Alegeri Prezidentiale",1,1113,399,367,32,0,389,10,1200,801,221,168
7,BOTOŞANI,"MUNICIPIUL BOTOŞANI",35731,BOTOŞANI,"ŞCOALA GIMNAZIALĂ NR. 2",53,"Alegeri Prezidentiale",1,610,270,252,18,0,261,9,800,530,145,116
7,BOTOŞANI,"MUNICIPIUL BOTOŞANI",35731,BOTOŞANI,"ŞCOALA GIMNAZIALĂ NR. 2",54,"Alegeri Prezidentiale",1,1277,498,480,18,0,494,4,1400,902,298,196
7,BOTOŞANI,"MUNICIPIUL BOTOŞANI",35731,BOTOŞANI,"ŞCOALA GIMNAZIALĂ NR. 2",55,"Alegeri Prezidentiale",1,1278,487,472,15,0,477,10,1400,913,310,167
7,BOTOŞANI,"MUNICIPIUL BOTOŞANI",35731,BOTOŞANI,"COLEGIUL ECONOMIC „OCTAV ONICESCU”",56,"Alegeri Prezidentiale",1,993,422,384,38,0,411,11,1100,678,235,176
7,BOTOŞANI,"MUNICIPIUL BOTOŞANI",35731,BOTOŞANI,"COLEGIUL ECONOMIC „OCTAV ONICESCU”",57,"Alegeri Prezidentiale",1,1112,576,540,36,0,559,17,1200,624,336,223
7,BOTOŞANI,"MUNICIPIUL BOTOŞANI",35731,BOTOŞANI,"COLEGIUL ECONOMIC „OCTAV ONICESCU”",58,"Alegeri Prezidentiale",2,1460,732,697,35,0,708,24,1600,868,403,305
7,BOTOŞANI,"MUNICIPIUL BOTOŞANI",35731,BOTOŞANI,"GRĂDINIȚA CU PROGRAM PRELUNGIT NR. 20",59,"Alegeri Prezidentiale",1,1364,702,678,24,0,676,26,1500,798,419,257
7,BOTOŞANI,"MUNICIPIUL BOTOŞANI",35731,BOTOŞANI,"ŞCOALA GIMNAZIALĂ NR. 10",60,"Alegeri Prezidentiale",1,1320,670,609,61,0,651,19,1400,730,388,263
7,BOTOŞANI,"MUNICIPIUL BOTOŞANI",35731,BOTOŞANI,"ŞCOALA GIMNAZIALĂ NR. 10",61,"Alegeri Prezidentiale",1,1399,651,617,33,1,640,11,1500,849,357,283
7,BOTOŞANI,"MUNICIPIUL BOTOŞANI",35731,BOTOŞANI,"ŞCOALA GIMNAZIALĂ NR. 10",62,"Alegeri Prezidentiale",1,1277,704,631,24,49,685,19,1400,696,388,297
7,BOTOŞANI,"MUNICIPIUL BOTOŞANI",35731,BOTOŞANI,"COLEGIUL NAŢIONAL „A.T. LAURIAN”",63,"Alegeri Prezidentiale",1,1265,624,576,48,0,608,16,1400,776,323,285
7,BOTOŞANI,"MUNICIPIUL BOTOŞANI",35731,BOTOŞANI,"COLEGIUL NAŢIONAL „A.T. LAURIAN”",64,"Alegeri Prezidentiale",1,1328,588,566,22,0,571,17,1400,812,315,256
7,BOTOŞANI,"MUNICIPIUL BOTOŞANI",35731,BOTOŞANI,"LOCAL CLUBUL PENSIONARILOR",65,"Alegeri Prezidentiale",1,1067,480,431,49,0,469,11,1200,720,248,221
7,BOTOŞANI,"MUNICIPIUL BOTOŞANI",35731,BOTOŞANI,"ŞCOALA GIMNAZIALĂ „SFÂNTUL NICOLAE”",66,"Alegeri Prezidentiale",1,1327,580,554,25,1,558,22,1400,820,313,245
7,BOTOŞANI,"MUNICIPIUL BOTOŞANI",35731,BOTOŞANI,"ŞCOALA GIMNAZIALĂ „SFÂNTUL NICOLAE”",67,"Alegeri Prezidentiale",1,992,444,421,23,0,432,12,1100,656,257,175
7,BOTOŞANI,"MUNICIPIUL BOTOŞANI",35731,BOTOŞANI,"ŞCOALA GIMNAZIALĂ „SFÂNTUL NICOLAE”",68,"Alegeri Prezidentiale",1,1335,619,602,17,0,599,20,1500,881,338,261
7,BOTOŞANI,"MUNICIPIUL BOTOŞANI",35731,BOTOŞANI,"LICEUL „DIMITRIE NEGREANU”",69,"Alegeri Prezidentiale",1,1281,624,597,27,0,607,17,1400,776,337,270
7,BOTOŞANI,"MUNICIPIUL BOTOŞANI",35731,BOTOŞANI,"LICEUL „DIMITRIE NEGREANU”",70,"Alegeri Prezidentiale",1,1268,589,550,39,0,573,16,1400,811,336,237
7,BOTOŞANI,"MUNICIPIUL BOTOŞANI",35731,BOTOŞANI,"LICEUL „DIMITRIE NEGREANU”",71,"Alegeri Prezidentiale",1,1112,514,494,20,0,497,17,1200,686,255,242
7,BOTOŞANI,"MUNICIPIUL BOTOŞANI",35731,BOTOŞANI,"ŞCOALA GIMNAZIALĂ „GRIGORE ANTIPA”",72,"Alegeri Prezidentiale",1,1014,464,415,49,0,451,13,1200,736,241,210
7,BOTOŞANI,"MUNICIPIUL BOTOŞANI",35731,BOTOŞANI,"ŞCOALA GIMNAZIALĂ „GRIGORE ANTIPA”",73,"Alegeri Prezidentiale",1,832,370,342,28,0,366,4,900,530,203,163
7,BOTOŞANI,"MUNICIPIUL BOTOŞANI",35731,BOTOŞANI,"ŞCOALA GIMNAZIALĂ „GRIGORE ANTIPA”",74,"Alegeri Prezidentiale",1,1207,528,508,20,0,503,25,1300,772,243,260
7,BOTOŞANI,"MUNICIPIUL BOTOŞANI",35731,BOTOŞANI,"ŞCOALA GIMNAZIALĂ „GRIGORE ANTIPA”",75,"Alegeri Prezidentiale",1,1132,520,491,29,0,503,17,1200,680,260,243
7,BOTOŞANI,"MUNICIPIUL BOTOŞANI",35731,BOTOŞANI,"ŞCOALA GIMNAZIALĂ „GRIGORE ANTIPA”",76,"Alegeri Prezidentiale",1,786,372,346,26,0,355,17,900,528,189,166
7,BOTOŞANI,"MUNICIPIUL BOTOŞANI",35731,BOTOŞANI,"LICEUL TEHNOLOGIC „PETRU RAREȘ”",77,"Alegeri Prezidentiale",1,1456,616,585,31,0,603,13,1600,984,317,286
7,BOTOŞANI,"MUNICIPIUL BOTOŞANI",35731,BOTOŞANI,"LICEUL TEHNOLOGIC „PETRU RAREȘ”",78,"Alegeri Prezidentiale",1,1062,504,459,20,25,493,11,1300,796,276,217
7,BOTOŞANI,"MUNICIPIUL BOTOŞANI",35731,BOTOŞANI,"LICEUL TEHNOLOGIC „PETRU RAREȘ”",79,"Alegeri Prezidentiale",1,1391,626,573,24,29,602,24,1600,974,320,282
7,BOTOŞANI,"MUNICIPIUL BOTOŞANI",35731,BOTOŞANI,"GRĂDINIŢA CU PROGRAM NORMAL NR. 8",80,"Alegeri Prezidentiale",1,1573,663,645,18,0,638,25,1700,1037,373,265
7,BOTOŞANI,"MUNICIPIUL BOTOŞANI",35731,BOTOŞANI,"GRĂDINIȚA CU PROGRAM NORMAL NR. 16",81,"Alegeri Prezidentiale",1,928,448,434,14,0,439,9,1000,552,262,177
7,BOTOŞANI,"MUNICIPIUL BOTOŞANI",35731,BOTOŞANI,"LICEUL PEDAGOGIC ”NICOLAE IORGA”",82,"Alegeri Prezidentiale",1,1277,790,577,23,190,767,23,1500,710,368,399
7,BOTOŞANI,"MUNICIPIUL BOTOŞANI",35731,BOTOŞANI,"LICEUL PEDAGOGIC ”NICOLAE IORGA”",83,"Alegeri Prezidentiale",1,1590,817,594,184,39,800,17,1790,973,360,440
7,BOTOŞANI,"MUNICIPIUL BOTOŞANI",35731,BOTOŞANI,"LICEUL PEDAGOGIC ”NICOLAE IORGA”",84,"Alegeri Prezidentiale",1,1132,670,456,15,199,659,11,1400,730,278,381
7,BOTOŞANI,"MUNICIPIUL BOTOŞANI",35731,BOTOŞANI,"LICEUL DE ARTĂ ŞTEFAN LUCHIAN",85,"Alegeri Prezidentiale",1,1291,799,641,57,101,772,27,1600,801,359,413
7,BOTOŞANI,"MUNICIPIUL DOROHOI",36006,DOROHOI,"COLEGIUL NAȚIONAL ”GRIGORE GHICA” DOROHOI",86,"Alegeri Prezidentiale",1,1340,565,541,23,1,558,7,1400,835,220,338
7,BOTOŞANI,"MUNICIPIUL DOROHOI",36006,DOROHOI,"COLEGIUL NAȚIONAL”GRIGORE GHICA”DOROHOI",87,"Alegeri Prezidentiale",1,1099,508,467,39,2,496,12,1192,684,206,290
7,BOTOŞANI,"MUNICIPIUL DOROHOI",36006,DOROHOI,"BIBLIOTECA MUNICIPALĂ DOROHOI",88,"Alegeri Prezidentiale",1,1663,778,746,31,1,764,14,1800,1022,338,426
7,BOTOŞANI,"MUNICIPIUL DOROHOI",36006,DOROHOI,"ȘCOALA GIMNAZIALĂ ”SPIRU HARET” DOROHOI",89,"Alegeri Prezidentiale",1,1391,646,599,47,0,633,13,1500,854,243,390
7,BOTOŞANI,"MUNICIPIUL DOROHOI",36006,DOROHOI,"ȘCOALA GIMNAZIALĂ”SPIRU HARET” DOROHOI",90,"Alegeri Prezidentiale",1,984,443,414,29,0,432,11,1100,657,200,232
7,BOTOŞANI,"MUNICIPIUL DOROHOI",36006,DOROHOI,"ȘCOALA GIMNAZIALĂ NR.1 DOROHOI",91,"Alegeri Prezidentiale",1,1221,574,509,65,0,564,10,1300,726,267,297
7,BOTOŞANI,"MUNICIPIUL DOROHOI",36006,DOROHOI,"CASA MUNICIPALĂ DE CULTURĂ DOROHOI",92,"Alegeri Prezidentiale",1,1155,510,478,30,2,498,12,1200,690,251,247
7,BOTOŞANI,"MUNICIPIUL DOROHOI",36006,DOROHOI,"ȘCOALA GIMNAZIALĂ ”ȘTEFAN CEL MARE” DOROHOI",93,"Alegeri Prezidentiale",1,1089,473,442,31,0,458,15,1200,727,187,271
7,BOTOŞANI,"MUNICIPIUL DOROHOI",36006,DOROHOI,"ȘCOALA GIMNAZIALĂ ” ȘTEFAN CEL MARE” DOROHOI",94,"Alegeri Prezidentiale",1,980,425,397,28,0,415,10,1100,675,188,227
7,BOTOŞANI,"MUNICIPIUL DOROHOI",36006,DOROHOI,"ȘCOALA GIMNAZIALĂ ”ALEXANDRU IOAN CUZA” DOROHOI",95,"Alegeri Prezidentiale",1,1116,445,392,9,44,441,4,1400,955,210,231
7,BOTOŞANI,"MUNICIPIUL DOROHOI",36006,DOROHOI,"ȘCOALA GIMNAZIALĂ ”ALEXANDRU IOAN CUZA” DOROHOI",96,"Alegeri Prezidentiale",1,1389,535,465,23,47,526,9,1600,1065,249,277
7,BOTOŞANI,"MUNICIPIUL DOROHOI",36006,DOROHOI,"LICEUL ”REGINA MARIA” DOROHOI",97,"Alegeri Prezidentiale",1,1309,514,493,21,0,510,4,1400,886,214,296
7,BOTOŞANI,"MUNICIPIUL DOROHOI",36006,DOROHOI,"LICEUL ”REGINA MARIA” DOROHOI",98,"Alegeri Prezidentiale",1,1238,507,482,25,0,492,15,1400,893,194,298
7,BOTOŞANI,"MUNICIPIUL DOROHOI",36006,DOROHOI,"ȘCOALA GIMNAZIALĂ ”MIHAIL KOGĂLNICEANU” DOROHOI",99,"Alegeri Prezidentiale",1,1318,545,514,31,0,532,13,1400,855,252,280
7,BOTOŞANI,"MUNICIPIUL DOROHOI",36006,DOROHOI,"ȘCOALA GIMNAZIALĂ ”MIHAIL KOGĂLNICEANU” DOROHOI",100,"Alegeri Prezidentiale",1,1201,491,470,21,0,481,10,1300,809,200,281
7,BOTOŞANI,"MUNICIPIUL DOROHOI",36006,DOROHOI,"GRĂDINIȚA CU PROGRAM PRELUNGIT ” ALBA CA ZĂPADA” DOROHOI",101,"Alegeri Prezidentiale",1,1085,414,384,30,0,400,14,1200,786,178,222
7,BOTOŞANI,"MUNICIPIUL DOROHOI",36006,DOROHOI,"GRĂDINIȚA CU PROGRAM PRELUNGIT”ALBA CA ZĂPADA” DOROHOI",102,"Alegeri Prezidentiale",1,1402,596,580,16,0,584,12,1600,1004,230,354
7,BOTOŞANI,"MUNICIPIUL DOROHOI",36006,DOROHOI,"SALA POLIVALENTĂ DOROHOI",103,"Alegeri Prezidentiale",1,820,398,367,31,0,383,15,900,502,143,240
7,BOTOŞANI,"MUNICIPIUL DOROHOI",36006,DOROHOI,"ȘCOALA GIMNAZIALĂ ” DIMITRIE ROMANESCU” DOROHOI",104,"Alegeri Prezidentiale",1,977,439,419,20,0,430,9,1000,561,186,244
7,BOTOŞANI,"MUNICIPIUL DOROHOI",36006,DOROHOI,"ȘCOALA GIMNAZIALĂ ”DIMITRIE ROMANESCU” DOROHOI",105,"Alegeri Prezidentiale",1,1088,445,422,23,0,438,7,1200,755,181,257
7,BOTOŞANI,"MUNICIPIUL DOROHOI",36006,DOROHOI,"CLĂDIRE ȘCOALĂ(GRĂDINIȚĂ) SATU NOU",106,"Alegeri Prezidentiale",1,734,305,286,19,0,295,10,800,495,115,180
7,BOTOŞANI,"MUNICIPIUL DOROHOI",36006,"LOTURI ENESCU","CLĂDIRE ȘCOALĂ LOTURI ENESCU",107,"Alegeri Prezidentiale",1,339,179,162,17,0,176,3,400,221,85,91
7,BOTOŞANI,"ORAŞ BUCECEA",36453,BUCECEA,"SCOALA NR.1 BUCECEA",108,"Alegeri Prezidentiale",1,715,341,282,55,4,335,6,800,459,180,155
7,BOTOŞANI,"ORAŞ BUCECEA",36453,BUCECEA,"CENTRUL CULTURAL BUCECEA",109,"Alegeri Prezidentiale",1,1622,750,679,67,4,733,17,1800,1050,342,391
7,BOTOŞANI,"ORAŞ BUCECEA",36453,BUCECEA,"SCOALA NR.2 BUCECEA",110,"Alegeri Prezidentiale",1,1526,587,534,33,20,579,8,1600,1013,242,337
7,BOTOŞANI,"ORAŞ BUCECEA",36453,CĂLINEŞTI,"SCOALA CALINESTI",111,"Alegeri Prezidentiale",1,541,225,205,18,2,219,6,600,375,91,128
7,BOTOŞANI,"ORAŞ DARABANI",35946,DARABANI,"LICEUL”DIMITRIE CANTEMIR",112,"Alegeri Prezidentiale",1,1467,539,513,20,6,527,12,1600,1061,274,253
7,BOTOŞANI,"ORAŞ DARABANI",35946,DARABANI,"ŞCOALA GIMNAZIALĂ”LEON DĂNĂILĂ”",113,"Alegeri Prezidentiale",1,1681,607,573,34,0,594,13,1800,1193,283,311
7,BOTOŞANI,"ORAŞ DARABANI",35946,DARABANI,"ŞCOALA GIMNAZIALĂ ”LEON DĂNĂILĂ”",114,"Alegeri Prezidentiale",1,1674,552,528,23,1,537,15,1800,1248,277,260
7,BOTOŞANI,"ORAŞ DARABANI",35946,DARABANI,"GRĂDINIŢA NR.2",115,"Alegeri Prezidentiale",1,1688,586,549,37,0,569,17,1800,1214,257,312
7,BOTOŞANI,"ORAŞ DARABANI",35946,DARABANI,"ŞCOALA GIMNAZIALĂ CU CLASELE I-VIII LEON DĂNĂILĂ DARABANI, ȘCOALA CORNEŞTI, CORP A",116,"Alegeri Prezidentiale",1,1025,385,370,15,0,378,7,1200,815,179,199
7,BOTOŞANI,"ORAŞ DARABANI",35946,BAJURA,"ŞCOALAL BAJURA",117,"Alegeri Prezidentiale",1,1554,522,501,21,0,510,12,1700,1178,272,238
7,BOTOŞANI,"ORAŞ DARABANI",35946,DARABANI,"ŞCOALA TEIOASA",118,"Alegeri Prezidentiale",1,1156,377,358,19,0,372,5,1200,823,148,224
7,BOTOŞANI,"ORAŞ DARABANI",35946,LIŞMĂNIŢA,"ŞCOALA LIŞMĂNIŢA",119,"Alegeri Prezidentiale",1,544,220,203,17,0,218,2,600,380,87,131
7,BOTOŞANI,"ORAŞ DARABANI",35946,EŞANCA,"ŞCOALA EŞANCA",120,"Alegeri Prezidentiale",1,254,93,76,17,0,91,2,300,207,36,55
7,BOTOŞANI,"ORAŞ FLĂMÂNZI",37280,FLĂMÂNZI,"ȘCOALA GIMNAZIALĂ ”MIHAIL STURZA”",121,"Alegeri Prezidentiale",1,642,250,226,24,0,249,1,800,550,168,81
7,BOTOŞANI,"ORAŞ FLĂMÂNZI",37280,FLĂMÂNZI,"ȘCOALA .GIMNAZIALĂ ”MIHAIL STURZA”",122,"Alegeri Prezidentiale",1,861,304,291,13,0,297,7,1000,696,197,100
7,BOTOŞANI,"ORAŞ FLĂMÂNZI",37280,FLĂMÂNZI,"ȘCOALA.GIMNAZIALĂ ”ION BOJOI”",123,"Alegeri Prezidentiale",1,1112,455,429,26,0,447,8,1200,745,298,149
7,BOTOŞANI,"ORAŞ FLĂMÂNZI",37280,FLĂMÂNZI,"CASA DE CULTURA ”NICOLAE SEVEREANU”",124,"Alegeri Prezidentiale",1,1133,357,330,27,0,349,8,1200,843,252,97
7,BOTOŞANI,"ORAŞ FLĂMÂNZI",37280,POIANA,"ȘCOALA GIMNAZIALĂ ”CONSTANTIN COMICESCU”",125,"Alegeri Prezidentiale",1,1441,629,582,42,5,623,6,1600,971,422,201
7,BOTOŞANI,"ORAŞ FLĂMÂNZI",37280,"NICOLAE BĂLCESCU","LICEUL TEHNOLOGIC ”NICOLAE BĂLCESCU”",126,"Alegeri Prezidentiale",1,1019,428,386,38,4,413,15,1216,788,273,140
7,BOTOŞANI,"ORAŞ FLĂMÂNZI",37280,"NICOLAE BĂLCESCU","LICEUL TEHNOLOGIC ”NICOLAE BĂLCESCU”",127,"Alegeri Prezidentiale",1,1213,515,477,12,26,506,9,1300,785,352,154
7,BOTOŞANI,"ORAŞ FLĂMÂNZI",37280,"NICOLAE BĂLCESCU","ŞCOALA TAMBA",128,"Alegeri Prezidentiale",1,1025,489,459,25,5,476,13,1200,711,362,114
7,BOTOŞANI,"ORAŞ FLĂMÂNZI",37280,CHIŢOVENI,"ȘCOALA PRIMARĂ ”GHEORGHE PRICOP”",129,"Alegeri Prezidentiale",1,472,216,193,23,0,215,1,500,284,155,60
7,BOTOŞANI,"ORAŞ FLĂMÂNZI",37280,PRISĂCANI,"ȘCOALA GIMNAZIALĂ ”PETRU ZAMFIRESCU”",130,"Alegeri Prezidentiale",1,505,191,175,16,0,190,1,600,409,141,49
7,BOTOŞANI,"ORAŞ SĂVENI",36060,SĂVENI,"LICEUL TEORETIC DR. M. CIUCA SAVENI",131,"Alegeri Prezidentiale",1,1200,587,481,103,3,578,9,1300,713,217,361
7,BOTOŞANI,"ORAŞ SĂVENI",36060,SĂVENI,"LICEUL TEORETIC DR. M.CIUCA SAVENI",132,"Alegeri Prezidentiale",1,890,484,343,103,38,475,9,1000,516,176,299
7,BOTOŞANI,"ORAŞ SĂVENI",36060,SĂVENI,"SCOALA GENERALA NR. 1 SAVENI",133,"Alegeri Prezidentiale",1,1518,706,599,101,6,692,14,1600,894,264,428
7,BOTOŞANI,"ORAŞ SĂVENI",36060,SĂVENI,"SCOALA GENERALA NR. 2 SAVENI",134,"Alegeri Prezidentiale",2,1482,704,598,93,13,693,11,1600,896,237,456
7,BOTOŞANI,"ORAŞ SĂVENI",36060,PETRICANI,"SCOALA GENERALA PETRICANI",135,"Alegeri Prezidentiale",1,1001,479,384,92,3,471,8,1100,621,161,310
7,BOTOŞANI,"ORAŞ SĂVENI",36060,BODEASA,"SCOALA GENERALA BODEASA",136,"Alegeri Prezidentiale",1,343,164,143,21,0,162,2,400,236,32,130
7,BOTOŞANI,"ORAŞ SĂVENI",36060,BOZIENI,"FOST MAGAZIN SĂTESC",137,"Alegeri Prezidentiale",1,228,126,82,44,0,125,1,300,174,30,95
7,BOTOŞANI,"ORAŞ ŞTEFĂNEŞTI",39168,BOBULEŞTI,"SCOALA GIMNAZIALA BOBULESTI",138,"Alegeri Prezidentiale",1,1186,436,407,29,0,430,6,1300,864,239,191
7,BOTOŞANI,"ORAŞ ŞTEFĂNEŞTI",39168,BĂDIUŢI,"SCOALA PRIMARA BADIUTI",139,"Alegeri Prezidentiale",1,835,346,322,24,0,341,5,900,554,189,152
7,BOTOŞANI,"ORAŞ ŞTEFĂNEŞTI",39168,ŞTEFĂNEŞTI,"LICEUL TEORETIC ”STEFAN D. LUCHIAN”",140,"Alegeri Prezidentiale",1,1237,468,414,32,22,461,7,1400,932,218,243
7,BOTOŞANI,"ORAŞ ŞTEFĂNEŞTI",39168,ŞTEFĂNEŞTI,"LICEUL TEORETIC ”STEFAN D. LUCHIAN”",141,"Alegeri Prezidentiale",1,928,348,299,49,0,342,6,1000,652,198,144
7,BOTOŞANI,"ORAŞ ŞTEFĂNEŞTI",39168,STÂNCA,"SCOALA PRIMARA STANCA",142,"Alegeri Prezidentiale",1,773,340,283,57,0,334,6,808,468,198,136
7,BOTOŞANI,ADĂŞENI,40035,ADĂŞENI,"CĂMINUL CULTURAL",143,"Alegeri Prezidentiale",2,794,315,297,18,0,307,8,899,584,94,213
7,BOTOŞANI,ADĂŞENI,40035,ZOIŢANI,"SCOALA ZOITANI",144,"Alegeri Prezidentiale",1,310,150,129,21,0,148,2,400,250,78,70
7,BOTOŞANI,ALBEŞTI,36131,ALBEŞTI,"CAMIN CULTURAL ALBESTI",145,"Alegeri Prezidentiale",1,914,400,365,34,1,397,3,1000,600,226,171
7,BOTOŞANI,ALBEŞTI,36131,ALBEŞTI,"SCOALA PRIMARA NR.1 ALBESTI",146,"Alegeri Prezidentiale",1,627,257,242,15,0,251,6,800,543,158,93
7,BOTOŞANI,ALBEŞTI,36131,BUIMĂCENI,"SCOALA PRIMARA NR.2 BUIMACENI",147,"Alegeri Prezidentiale",1,596,244,226,18,0,241,3,699,455,140,101
7,BOTOŞANI,ALBEŞTI,36131,COŞTIUGENI,"SCOALA PRIMARA NR.3 COSTIUGENI",148,"Alegeri Prezidentiale",1,441,170,144,26,0,167,3,499,329,98,69
7,BOTOŞANI,ALBEŞTI,36131,JIJIA,"SCOALA PRIMARA NR.4 JIJIA",149,"Alegeri Prezidentiale",1,502,202,175,27,0,202,0,600,398,105,97
7,BOTOŞANI,ALBEŞTI,36131,MĂŞCĂTENI,"SCOALA PRIMARA NR.5 MASCATENI",150,"Alegeri Prezidentiale",1,303,122,106,16,0,119,3,400,278,41,78
7,BOTOŞANI,ALBEŞTI,36131,"TUDOR VLADIMIRESCU","SCOALA GIMNAZIALA NR.2 TUDOR VLADIMIRESCU",151,"Alegeri Prezidentiale",1,670,217,201,16,0,214,3,800,583,143,71
7,BOTOŞANI,ALBEŞTI,36131,"TUDOR VLADIMIRESCU","SCOALA GIMNAZIALA NR.2 TUDOR VLADIMIRESCU",152,"Alegeri Prezidentiale",1,750,243,232,11,0,237,6,800,557,158,79
7,BOTOŞANI,AVRĂMENI,36202,AVRĂMENI,"SCOALA CU CLASELE 1 -8 AVRAMENI",153,"Alegeri Prezidentiale",1,1238,541,519,22,0,538,3,1300,759,269,269
7,BOTOŞANI,AVRĂMENI,36202,PANAITOAIA,"SCOALA PRIMARĂ NR.1 TIMUȘ SAT TIMUȘ",154,"Alegeri Prezidentiale",2,554,282,266,16,0,279,3,600,318,88,191
7,BOTOŞANI,AVRĂMENI,36202,"TUDOR VLADIMIRESCU","SCOALA CU CLASELE 1-8 TUDOR VLADIMIRESCU",155,"Alegeri Prezidentiale",1,584,300,279,21,0,297,3,600,300,114,183
7,BOTOŞANI,AVRĂMENI,36202,"AUREL VLAICU","SCOALA CU CLASELE 1-8 AUREL VLAICU",156,"Alegeri Prezidentiale",1,463,227,209,18,0,223,4,500,273,102,121
7,BOTOŞANI,AVRĂMENI,36202,ICHIMENI,"SCOALA CU CLASELE 1-4 ICHIMENI",157,"Alegeri Prezidentiale",1,105,56,44,12,0,56,0,200,144,17,39
7,BOTOŞANI,BĂLUŞENI,36300,BĂLUŞENI,"SCOALA BALUSENI",158,"Alegeri Prezidentiale",1,1113,513,420,56,37,509,4,1200,687,193,316
7,BOTOŞANI,BĂLUŞENI,36300,"BĂLUŞENII NOI","SCOALA BALUSENII NOI",159,"Alegeri Prezidentiale",1,267,124,116,8,0,122,2,300,176,49,73
7,BOTOŞANI,BĂLUŞENI,36300,BUZENI,"SCOALA BUZENI",160,"Alegeri Prezidentiale",1,551,262,236,21,5,258,4,600,338,175,83
7,BOTOŞANI,BĂLUŞENI,36300,DRAXINI,"SCOALA DRAXINI",161,"Alegeri Prezidentiale",1,1515,739,674,56,9,725,14,1600,861,343,382
7,BOTOŞANI,BĂLUŞENI,36300,ZĂICEŞTI,"SCOALA ZAICESTI",162,"Alegeri Prezidentiale",1,573,321,269,52,0,316,5,600,279,213,103
7,BOTOŞANI,BLÂNDEŞTI,39983,BLÂNDEŞTI,"SCOALA GIMNAZIALA NR. 1",163,"Alegeri Prezidentiale",1,625,286,248,38,0,285,1,800,514,145,140
7,BOTOŞANI,BLÂNDEŞTI,39983,CERCHEJENI,"SCOALA PRIMARA NR.2 CERCHEJENI",164,"Alegeri Prezidentiale",1,661,326,285,41,0,320,6,700,374,144,176
7,BOTOŞANI,BLÂNDEŞTI,39983,ŞOLDĂNEŞTI,"SCOLA PRIMARA NR. 3",165,"Alegeri Prezidentiale",3,326,210,184,26,0,209,1,400,190,129,80
7,BOTOŞANI,BRĂEŞTI,36373,BRĂEŞTI,"CĂMIN CULTURAL BRĂEŞTI",166,"Alegeri Prezidentiale",1,1112,407,366,41,0,404,3,1200,793,204,200
7,BOTOŞANI,BRĂEŞTI,36373,POIANA,"SCOALA POIANA 2",167,"Alegeri Prezidentiale",1,348,160,139,21,0,160,0,400,240,49,111
7,BOTOŞANI,BRĂEŞTI,36373,POPENI,"ŞCOALA POPENI",168,"Alegeri Prezidentiale",1,206,98,84,14,0,98,0,300,202,31,67
7,BOTOŞANI,BROSCĂUŢI,36426,BROSCĂUŢI,"SCOALA DIMITRIE POMPEIU BROSCAUTI",169,"Alegeri Prezidentiale",1,1479,645,581,64,0,635,10,1600,955,195,440
7,BOTOŞANI,BROSCĂUŢI,36426,BROSCĂUŢI,"ȘCOALA GIMNAZIALĂ ”DIMITRIE POMPEIU”",170,"Alegeri Prezidentiale",1,1297,563,540,23,0,556,7,1400,837,208,348
7,BOTOŞANI,CĂLĂRAŞI,36499,CĂLĂRAŞI,"CAMIN CULTURAL CALARASI",171,"Alegeri Prezidentiale",1,938,411,386,25,0,404,7,1000,589,257,147
7,BOTOŞANI,CĂLĂRAŞI,36499,CĂLĂRAŞI,"SCOALA CALARASI",172,"Alegeri Prezidentiale",1,910,420,392,28,0,414,6,1000,580,279,135
7,BOTOŞANI,CĂLĂRAŞI,36499,PLEŞANI,"SCOALA PLESANI",173,"Alegeri Prezidentiale",1,490,240,209,31,0,238,2,500,260,171,67
7,BOTOŞANI,CĂLĂRAŞI,36499,LIBERTATEA,"SCOALA LIBERTATEA",174,"Alegeri Prezidentiale",1,366,199,181,18,0,194,5,400,201,135,59
7,BOTOŞANI,CÂNDEŞTI,39967,CÂNDEŞTI,"ŞCOALA GIMNAZIALÃ, CÂNDEȘTI",175,"Alegeri Prezidentiale",1,854,442,376,66,0,433,9,900,458,189,244
7,BOTOŞANI,CÂNDEŞTI,39967,TALPA,"ŞCOALA PRIMARĂ TALPA",176,"Alegeri Prezidentiale",1,539,233,203,30,0,231,2,600,367,80,151
7,BOTOŞANI,CÂNDEŞTI,39967,VIŢCANI,"ŞCOLA PRIMARĂ VIŢCANI",177,"Alegeri Prezidentiale",1,265,150,131,19,0,148,2,300,150,63,85
7,BOTOŞANI,CONCEŞTI,36532,CONCEŞTI,"CĂMINUL CULTURAL CONCEȘTI",178,"Alegeri Prezidentiale",1,1225,470,439,31,0,456,14,1300,830,155,301
7,BOTOŞANI,CONCEŞTI,36532,MOVILENI,"CAMINUL CULTURAL MOVILENI",179,"Alegeri Prezidentiale",1,260,117,103,14,0,117,0,300,183,39,78
7,BOTOŞANI,COPĂLĂU,36569,COPĂLĂU,"ŞCOALA GIMNAZIALĂ NR.1 COPĂLĂU",180,"Alegeri Prezidentiale",1,1170,538,500,35,3,531,7,1200,662,304,227
7,BOTOŞANI,COPĂLĂU,36569,COPĂLĂU,"ŞCOALA GIMNAZIALĂ NR. 1 COPĂLĂU",181,"Alegeri Prezidentiale",1,1055,459,431,28,0,451,8,1200,741,278,173
7,BOTOŞANI,COPĂLĂU,36569,COTU,"ŞCOALA PRIMARĂ NR. 2 COTU",182,"Alegeri Prezidentiale",1,490,245,216,19,10,244,1,600,355,149,95
7,BOTOŞANI,COPĂLĂU,36569,CERBU,"ŞCOALA PRIMARĂ NR.3 CERBU",183,"Alegeri Prezidentiale",1,647,313,290,23,0,310,3,800,487,185,125
7,BOTOŞANI,CORDĂRENI,36649,CORDĂRENI,"CAMINUL CULTURAL CORDARENI",184,"Alegeri Prezidentiale",1,754,463,397,54,12,458,5,801,338,104,354
7,BOTOŞANI,CORDĂRENI,36649,GRIVIŢA,"SCOALA GRIVITA",185,"Alegeri Prezidentiale",2,390,234,196,27,11,230,4,400,166,81,149
7,BOTOŞANI,CORDĂRENI,36649,SLOBOZIA,"SCOALA SLOBOZIA",186,"Alegeri Prezidentiale",1,274,165,120,23,22,164,1,300,135,27,137
7,BOTOŞANI,CORLĂTENI,36676,CORLĂTENI,"PRIMARIA CORLATENI",187,"Alegeri Prezidentiale",1,520,203,189,14,0,202,1,600,397,98,104
7,BOTOŞANI,CORLĂTENI,36676,CARASA,"GRADINITA CARASA",188,"Alegeri Prezidentiale",1,429,188,139,49,0,188,0,500,312,61,127
7,BOTOŞANI,CORLĂTENI,36676,VLĂDENI,"SCOALA VLADENI",189,"Alegeri Prezidentiale",1,352,147,126,21,0,147,0,400,253,59,88
7,BOTOŞANI,CORLĂTENI,36676,PODENI,"SCOALA PODENI",190,"Alegeri Prezidentiale",1,321,162,141,21,0,157,5,400,238,94,63
7,BOTOŞANI,CORNI,36756,CORNI,"SCOALA O. BANCILA",191,"Alegeri Prezidentiale",1,1314,490,467,23,0,483,7,1400,910,244,239
7,BOTOŞANI,CORNI,36756,CORNI,"SCOALA O. BANCILA",192,"Alegeri Prezidentiale",1,868,316,300,16,0,312,4,900,584,183,129
7,BOTOŞANI,CORNI,36756,CORNI,"SCOALA O. BANCILA",193,"Alegeri Prezidentiale",1,1063,419,390,29,0,412,7,1100,681,186,226
7,BOTOŞANI,CORNI,36756,SARAFINEŞTI,"SCOALA CU CL I-VIII SARAFINESTI",194,"Alegeri Prezidentiale",1,1183,475,442,33,0,472,3,1200,725,258,214
7,BOTOŞANI,CORNI,36756,MESTEACĂN,"SCOALA CU CL I-IV MESTEACAN",195,"Alegeri Prezidentiale",1,349,156,134,22,0,150,6,366,210,98,52
7,BOTOŞANI,CORNI,36756,"BALTA ARSĂ","SCOALA CU CL I-IV BALTA ARSA",196,"Alegeri Prezidentiale",1,337,186,161,25,0,183,3,373,187,68,115
7,BOTOŞANI,COŞULA,39975,COŞULA,"GRĂDINIȚA *PRICHINDEL* COȘULA",197,"Alegeri Prezidentiale",1,1029,433,404,29,0,430,3,1200,767,136,294
7,BOTOŞANI,COŞULA,39975,BUDA,"ȘCOALA CU CLASELE I-IV BUDA",198,"Alegeri Prezidentiale",1,249,103,93,10,0,99,4,302,199,31,68
7,BOTOŞANI,COŞULA,39975,PĂDURENI,"ȘCOALA CU CLASELE I-IV PĂDURENI",199,"Alegeri Prezidentiale",1,480,245,228,17,0,243,2,500,255,107,136
7,BOTOŞANI,COŞULA,39975,ŞUPITCA,"ȘCOALA CU CLASELE I-IV ȘUPITCA",200,"Alegeri Prezidentiale",1,664,278,262,16,0,274,4,800,522,83,191
7,BOTOŞANI,COŢUŞCA,36809,COŢUŞCA,"LICEUL TEHNOLOGIC COȚUȘCA -CORP A",201,"Alegeri Prezidentiale",1,1696,508,454,54,0,501,7,1800,1292,236,265
7,BOTOŞANI,COŢUŞCA,36809,GHIRENI,"CĂMINUL CULTURAL GHIRENI",202,"Alegeri Prezidentiale",1,547,222,198,24,0,218,4,600,378,113,105
7,BOTOŞANI,COŢUŞCA,36809,"COTU MICULINŢI","ŞCOALA PRIMARĂ NR.4",203,"Alegeri Prezidentiale",1,312,170,147,23,0,169,1,400,230,76,93
7,BOTOŞANI,COŢUŞCA,36809,CRASNALEUCA,"GRĂDINIȚA CU PROGRAM NORMAL NR. 2 CRASNALEUCA",204,"Alegeri Prezidentiale",1,481,224,195,29,0,221,3,500,276,114,107
7,BOTOŞANI,COŢUŞCA,36809,PUŢURENI,"ŞCOALA PRIMARĂ NR.5",205,"Alegeri Prezidentiale",1,450,169,154,15,0,165,4,500,331,77,88
7,BOTOŞANI,COŢUŞCA,36809,NICHITENI,"ŞCOALA GIMNAZIALĂ NR.3",206,"Alegeri Prezidentiale",1,752,339,318,20,1,336,3,800,461,201,135
7,BOTOŞANI,CRISTEŞTI,36907,CRISTEŞTI,"SCOALA GIMNAZIALA NR. 1 CRISTESTI CORPUL II",207,"Alegeri Prezidentiale",1,1428,602,487,84,31,596,6,1500,898,255,341
7,BOTOŞANI,CRISTEŞTI,36907,CRISTEŞTI,"SCOALA PRIMARA NR. 1 SAT CRISTESTI , DENUMIRE UZUALA SCOALA DIN GHILANESTI",208,"Alegeri Prezidentiale",1,475,220,174,29,17,219,1,502,282,77,142
7,BOTOŞANI,CRISTEŞTI,36907,ONEAGA,"SCOALA GIMNAZIALA NR. 2 SAT ONEAGA",209,"Alegeri Prezidentiale",1,1132,458,412,31,15,451,7,1200,742,161,290
7,BOTOŞANI,CRISTEŞTI,36907,SCHIT-ORĂŞENI,"DISCOTECA ” DISCO-BAR ”",210,"Alegeri Prezidentiale",1,470,210,182,28,0,205,5,500,290,119,86
7,BOTOŞANI,CRISTEŞTI,36907,UNGUROAIA,"SCOALA PRIMARA NR. 4 UNGUROAIA",211,"Alegeri Prezidentiale",1,154,111,101,10,0,110,1,200,89,20,90
7,BOTOŞANI,CRISTINEŞTI,36952,CRISTINEŞTI,"CAMINUL CULTURAL CRISTINESTI",212,"Alegeri Prezidentiale",1,1195,532,473,59,0,523,9,1300,768,265,258
7,BOTOŞANI,CRISTINEŞTI,36952,DRAGALINA,"SCOALA DRAGALINA",213,"Alegeri Prezidentiale",1,515,327,196,131,0,321,6,600,273,171,150
7,BOTOŞANI,CRISTINEŞTI,36952,"FUNDU HERŢII","SCOALA FUNDU HERTII",214,"Alegeri Prezidentiale",1,612,332,294,38,0,330,2,800,468,152,178
7,BOTOŞANI,CRISTINEŞTI,36952,BARANCA,"SCOALA BARANCA",215,"Alegeri Prezidentiale",1,490,209,192,17,0,208,1,600,391,64,144
7,BOTOŞANI,CURTEŞTI,35759,CURTEŞTI,"GRADINITA CURTESTI",216,"Alegeri Prezidentiale",1,1106,584,485,99,0,568,16,1200,616,294,274
7,BOTOŞANI,CURTEŞTI,35759,AGAFTON,"SPATIU SCOALA AGAFTON",217,"Alegeri Prezidentiale",1,216,150,105,45,0,146,4,300,150,34,112
7,BOTOŞANI,CURTEŞTI,35759,BĂICENI,"SCOALA GENERALA.BAICENI",218,"Alegeri Prezidentiale",2,740,368,322,46,0,367,1,800,432,171,196
7,BOTOŞANI,CURTEŞTI,35759,"MĂNĂSTIREA DOAMNEI","SCOALA GENERALA MANASTIREA DOAMNEI",219,"Alegeri Prezidentiale",1,1015,588,507,81,0,574,14,1200,612,318,256
7,BOTOŞANI,CURTEŞTI,35759,ORĂŞENI-DEAL,"ȘCOALA GIMNAZIALĂ NR. 1 ORĂȘENI- DEAL, CORP B",220,"Alegeri Prezidentiale",1,947,513,440,65,8,505,8,1000,487,243,262
7,BOTOŞANI,CURTEŞTI,35759,ORĂŞENI-VALE,"SCOALA GENERALA ORASENI VALE",221,"Alegeri Prezidentiale",1,558,297,244,53,0,296,1,600,303,175,121
7,BOTOŞANI,DÂNGENI,37057,DÂNGENI,"CĂMINUL CULTURAL DÎNGENI",222,"Alegeri Prezidentiale",1,732,303,276,13,14,299,4,800,497,157,142
7,BOTOŞANI,DÂNGENI,37057,HULUB,"CĂMINUL CULTURAL HULUB",223,"Alegeri Prezidentiale",1,451,216,197,17,2,213,3,500,284,111,102
7,BOTOŞANI,DÂNGENI,37057,IACOBENI,"SCOALA GIMNAZIALA NR.2 IACOBENI",224,"Alegeri Prezidentiale",1,904,357,331,26,0,351,6,1000,643,158,193
7,BOTOŞANI,DÂNGENI,37057,STRAHOTIN,"SCOALA PRIMARA NR.2 STRAHOTIN",225,"Alegeri Prezidentiale",1,440,224,199,23,2,219,5,500,276,119,100
7,BOTOŞANI,DERSCA,37011,DERSCA,"SEDIUL PRIMĂRIEI DIN COMUNA DERSCA",226,"Alegeri Prezidentiale",1,1356,575,503,47,25,563,12,1400,825,289,274
7,BOTOŞANI,DERSCA,37011,DERSCA,"GRĂDINIȚA CU PROGRAM NORMAL, COMUNA DERSCA",227,"Alegeri Prezidentiale",1,1128,495,427,45,23,489,6,1200,705,267,222
7,BOTOŞANI,DIMĂCHENI,39959,MATEIENI,"CAMIN CULTURAL",228,"Alegeri Prezidentiale",1,193,105,90,15,0,103,2,200,95,31,72
7,BOTOŞANI,DIMĂCHENI,39959,DIMĂCHENI,PRIMARIA,229,"Alegeri Prezidentiale",1,816,351,315,36,0,346,5,900,549,96,250
7,BOTOŞANI,DOBÂRCENI,37100,DOBÂRCENI,"ȘCOALA DOBIRCENI",230,"Alegeri Prezidentiale",1,662,300,277,23,0,294,6,800,500,171,123
7,BOTOŞANI,DOBÂRCENI,37100,BIVOLARI,"SCOALA BIVOLARI",231,"Alegeri Prezidentiale",1,139,71,56,15,0,70,1,200,129,44,26
7,BOTOŞANI,DOBÂRCENI,37100,BRĂTENI,"ȘCOALA BRATENI",232,"Alegeri Prezidentiale",1,498,176,166,10,0,174,2,600,424,111,63
7,BOTOŞANI,DOBÂRCENI,37100,CIŞMĂNEŞTI,"SCOALA CISMANESTI",233,"Alegeri Prezidentiale",1,327,161,145,16,0,157,4,400,239,70,87
7,BOTOŞANI,DOBÂRCENI,37100,LIVADA,"SCOALA MURGUTA",234,"Alegeri Prezidentiale",1,389,183,171,12,0,183,0,400,217,133,50
7,BOTOŞANI,DRĂGUŞENI,37173,DRĂGUŞENI,"SCOALA GIMNAZIALA ARISTOTEL CRISMARU DRAGUSENI",235,"Alegeri Prezidentiale",1,1799,485,461,24,0,478,7,1800,1315,176,302
7,BOTOŞANI,DRĂGUŞENI,37173,PODRIGA,"SCOALA CU CLASELE I-IV PODRIGA",236,"Alegeri Prezidentiale",1,1538,362,332,30,0,355,7,1500,1138,104,251
7,BOTOŞANI,DRĂGUŞENI,37173,SARATA-DRĂGUŞENI,"SCOALA CU CLASELE I-IV SARATA",237,"Alegeri Prezidentiale",1,148,66,52,14,0,65,1,200,134,16,49
7,BOTOŞANI,DURNEŞTI,37217,DURNEŞTI,"CĂMINUL CULTURAL DIN SATUL DURNEȘTI",238,"Alegeri Prezidentiale",2,939,395,367,28,0,386,9,1000,605,253,133
7,BOTOŞANI,DURNEŞTI,37217,CUCUTENI,"ȘCOALA PRIMARĂ NR. 1 CUCUTENI",239,"Alegeri Prezidentiale",1,653,344,317,27,0,343,1,800,456,245,98
7,BOTOŞANI,DURNEŞTI,37217,GURANDA,"ȘCOALA GIMNAZIALĂ NR. 2 GURANDA",240,"Alegeri Prezidentiale",1,896,310,280,30,0,303,7,1000,690,195,108
7,BOTOŞANI,DURNEŞTI,37217,BĂBICENI,"GRĂDINIȚA CU PROGRAM NORMAL NR. 3 BĂBICENI",241,"Alegeri Prezidentiale",1,573,240,219,21,0,237,3,600,360,158,79
7,BOTOŞANI,FRUMUŞICA,37324,FRUMUŞICA,"SCOALA GIMNAZIALA NR. 2 FRUMUSICA",242,"Alegeri Prezidentiale",1,652,254,240,14,0,251,3,800,546,110,141
7,BOTOŞANI,FRUMUŞICA,37324,STOREŞTI,"SCOALA GIMNAZIALA NR.4 STORESTI",243,"Alegeri Prezidentiale",1,855,299,283,16,0,288,11,900,601,159,129
7,BOTOŞANI,FRUMUŞICA,37324,ŞENDRENI,"SCOALA GIMNAZIALA NR.5 SENDRENI",244,"Alegeri Prezidentiale",1,575,198,177,21,0,195,3,600,402,110,85
7,BOTOŞANI,FRUMUŞICA,37324,VLĂDENI-DEAL,"SCOALA GIMNAZIALA NR.1 VLADENI DEAL",245,"Alegeri Prezidentiale",1,1258,444,412,32,0,440,4,1300,856,259,181
7,BOTOŞANI,FRUMUŞICA,37324,BOSCOTENI,"SCOALA GIMNAZIALA NR.6 BOSCOTENI",246,"Alegeri Prezidentiale",1,513,189,169,20,0,187,2,600,411,115,72
7,BOTOŞANI,FRUMUŞICA,37324,RĂDENI,"SCOALA GIMNAZIALA NR.3 RADENI",247,"Alegeri Prezidentiale",1,789,258,230,28,0,256,2,800,542,132,124
7,BOTOŞANI,"GEORGE ENESCU",37397,DUMENI,"SEDIUL PRIMARIEI COMUNEI GEORGE ENESCU",248,"Alegeri Prezidentiale",1,545,303,248,55,0,299,4,600,297,151,148
7,BOTOŞANI,"GEORGE ENESCU",37397,DUMENI,"SCOALA GENERALA NR.2 DUMENI",249,"Alegeri Prezidentiale",1,852,492,431,61,0,482,10,900,408,263,219
7,BOTOŞANI,"GEORGE ENESCU",37397,ARBOREA,"SCOALA GENERALA ARBOREA",250,"Alegeri Prezidentiale",1,342,170,142,28,0,165,5,400,230,100,65
7,BOTOŞANI,"GEORGE ENESCU",37397,POPENI,"SCOALA GENERALA POPENI",251,"Alegeri Prezidentiale",3,409,218,177,41,0,218,0,500,282,104,114
7,BOTOŞANI,"GEORGE ENESCU",37397,STÂNCA,"SCOALA GENERALA STINCA",252,"Alegeri Prezidentiale",1,293,140,123,17,0,138,2,300,160,84,54
7,BOTOŞANI,GORBĂNEŞTI,37459,GORBĂNEŞTI,"SCOALA GORBANESTI",253,"Alegeri Prezidentiale",1,796,367,332,35,0,359,8,900,533,162,197
7,BOTOŞANI,GORBĂNEŞTI,37459,BĂTRÂNEŞTI,"ŞCOALA GENERALA BATRANESTI",254,"Alegeri Prezidentiale",1,210,82,71,11,0,80,2,300,218,24,56
7,BOTOŞANI,GORBĂNEŞTI,37459,"GEORGE COŞBUC","ŞCOALA GENERALĂ GEORGE COSBUC",255,"Alegeri Prezidentiale",1,195,94,82,12,0,92,2,200,106,42,50
7,BOTOŞANI,GORBĂNEŞTI,37459,SOCRUJENI,"SCOALA GENERALA SOCRUJENI",256,"Alegeri Prezidentiale",1,634,216,188,28,0,211,5,800,584,106,105
7,BOTOŞANI,GORBĂNEŞTI,37459,VÂNĂTORI,"CAMIN CULTURAL VANATORI",257,"Alegeri Prezidentiale",1,484,227,204,23,0,217,10,500,273,94,123
7,BOTOŞANI,GORBĂNEŞTI,37459,SILIŞCANI,"SCOALA GENERALA SILISCANI",258,"Alegeri Prezidentiale",1,269,134,107,27,0,133,1,300,166,80,53
7,BOTOŞANI,HAVÂRNA,37547,HAVÂRNA,"ȘCOALA GIMNAZIALĂ ” IOAN CERNAT” HAVÂRNA -CORPUL 2",259,"Alegeri Prezidentiale",1,894,358,336,22,0,352,6,1000,642,124,228
7,BOTOŞANI,HAVÂRNA,37547,HAVÂRNA,"GRADINITA CU PROGRAM NORMAL NR.2 HAVIRNA(CATUN BASEU)",260,"Alegeri Prezidentiale",1,667,238,225,13,0,233,5,800,562,109,124
7,BOTOŞANI,HAVÂRNA,37547,HAVÂRNA,"SCOALA GIMNAZIALA ” IOAN CERNAT” HAVIRNA -CORPUL NR.2",261,"Alegeri Prezidentiale",1,1037,340,325,15,0,334,6,1100,760,164,170
7,BOTOŞANI,HAVÂRNA,37547,BALINŢI,"SCOALA PRIMARA ”DUMITRU POMPAS” BALINTI",262,"Alegeri Prezidentiale",1,392,135,115,20,0,134,1,400,265,57,77
7,BOTOŞANI,HAVÂRNA,37547,TĂTĂRĂŞENI,"SCOALA GIMNAZIALA ” IANCU MUNTEANU” TATARASENI",263,"Alegeri Prezidentiale",1,622,276,253,23,0,274,2,800,524,122,152
7,BOTOŞANI,HĂNEŞTI,37618,HĂNEŞTI,"CAMIN CULTURAL HANESTI",264,"Alegeri Prezidentiale",1,1007,404,376,28,0,398,6,1100,696,240,158
7,BOTOŞANI,HĂNEŞTI,37618,SARATA-BASARAB,"ȘCOALA CU CLASELE I-IV SĂRATA BASARAB",265,"Alegeri Prezidentiale",1,324,165,155,10,0,163,2,400,235,94,69
7,BOTOŞANI,HĂNEŞTI,37618,BOROLEA,"SCOALA CU CL I-IV BOROLEA",266,"Alegeri Prezidentiale",1,297,144,130,14,0,142,2,400,256,96,46
7,BOTOŞANI,HILIŞEU-HORIA,37672,HILIŞEU-HORIA,"SCOALA GIMNAZIALA NR. 1 HILISEU HORIA",267,"Alegeri Prezidentiale",1,591,253,223,30,0,249,4,600,347,73,176
7,BOTOŞANI,HILIŞEU-HORIA,37672,HILIŞEU-CRIŞAN,"SCOALA GIMNAZIALA NR. 2 HILISEU CRISAN",268,"Alegeri Prezidentiale",1,1103,447,414,33,0,438,9,1200,753,159,279
7,BOTOŞANI,HILIŞEU-HORIA,37672,HILIŞEU-CLOŞCA,"SCOALA PRIMARA NR. 4 HILISEU CLOSCA",269,"Alegeri Prezidentiale",1,502,246,223,23,0,240,6,600,354,85,155
7,BOTOŞANI,HILIŞEU-HORIA,37672,IEZER,"SCOALA GIMNAZIALA NR. 3 IEZER",270,"Alegeri Prezidentiale",1,461,244,214,30,0,237,7,500,256,78,159
7,BOTOŞANI,HLIPICENI,37734,HLIPICENI,"SCOALA CU CL.I-VIII HLIPICENI",271,"Alegeri Prezidentiale",1,1345,550,482,68,0,542,8,1401,851,344,198
7,BOTOŞANI,HLIPICENI,37734,DRAGALINA,"SCOALA CU CL .I-IV DRAGALINA",272,"Alegeri Prezidentiale",1,308,155,145,10,0,153,2,400,245,100,53
7,BOTOŞANI,HLIPICENI,37734,VICTORIA,"SCOALA CU CL.I-VIII VICTORIA",273,"Alegeri Prezidentiale",1,1113,464,434,30,0,462,2,1200,736,251,211
7,BOTOŞANI,HUDEŞTI,37770,HUDEŞTI,"CĂMIN CULTURAL",274,"Alegeri Prezidentiale",1,931,435,395,32,8,431,4,1000,565,201,230
7,BOTOŞANI,HUDEŞTI,37770,VATRA,"CĂMIN CULTURAL",275,"Alegeri Prezidentiale",1,868,462,421,32,9,459,3,900,438,131,328
7,BOTOŞANI,HUDEŞTI,37770,ALBA,GRĂDINIȚA,276,"Alegeri Prezidentiale",1,1134,540,505,30,5,538,2,1200,660,195,343
7,BOTOŞANI,HUDEŞTI,37770,MLENĂUŢI,"ȘCOALA MLENĂUȚI",277,"Alegeri Prezidentiale",1,594,294,265,29,0,289,5,600,306,144,145
7,BOTOŞANI,HUDEŞTI,37770,BAŞEU,"ȘCOALĂ BAȘEU",278,"Alegeri Prezidentiale",1,400,198,170,28,0,196,2,500,302,66,130
7,BOTOŞANI,HUDEŞTI,37770,BARANCA,"ȘCOALA BARANCA",279,"Alegeri Prezidentiale",1,872,486,457,25,4,477,9,900,414,260,217
7,BOTOŞANI,IBĂNEŞTI,37823,DUMBRĂVIŢA,"SCOALA ”MIHAIL SADOVEANU”, CORP B",280,"Alegeri Prezidentiale",1,722,379,335,44,0,370,9,800,421,190,180
7,BOTOŞANI,IBĂNEŞTI,37823,DUMBRĂVIŢA,"SCOALA ”MIHAIL SADOVEANU”, CORP B",281,"Alegeri Prezidentiale",1,724,307,287,20,0,300,7,800,493,144,156
7,BOTOŞANI,IBĂNEŞTI,37823,IBĂNEŞTI,"GRADINITA CU 4 GRUPE IBANESTI",282,"Alegeri Prezidentiale",1,799,400,346,54,0,395,5,900,500,203,192
7,BOTOŞANI,IBĂNEŞTI,37823,IBĂNEŞTI,"GRADINITA CU 4 GRUPE IBANESTI",283,"Alegeri Prezidentiale",1,887,413,372,41,0,404,9,900,487,201,203
7,BOTOŞANI,LEORDA,37850,LEORDA,"SCOALA GENERALA NR. 1 LEORDA",284,"Alegeri Prezidentiale",1,1132,688,574,84,30,671,17,1200,512,337,334
7,BOTOŞANI,LEORDA,37850,COSTINEŞTI,"SCOALA GENERALA CU CLASELE I-IV COSTINESTI",285,"Alegeri Prezidentiale",1,172,122,99,23,0,121,1,200,78,60,61
7,BOTOŞANI,LEORDA,37850,DOLINA,"ȘCOALA PRIMARĂ NR. 3, DOLINA",286,"Alegeri Prezidentiale",1,836,389,351,38,0,383,6,900,511,246,137
7,BOTOŞANI,LOZNA,39942,LOZNA,"CAMIN CULTURAL",287,"Alegeri Prezidentiale",1,813,362,319,42,1,357,5,900,538,143,214
7,BOTOŞANI,LOZNA,39942,STRĂTENI,"CAMIN CULTURAL",288,"Alegeri Prezidentiale",1,724,266,248,18,0,258,8,800,534,118,140
7,BOTOŞANI,LUNCA,37912,LUNCA,"CAMINUL CULTURAL LUNCA",289,"Alegeri Prezidentiale",1,692,250,232,18,0,250,0,800,550,96,154
7,BOTOŞANI,LUNCA,37912,LUNCA,"CAMINUL CULTURAL BIZNOASA",290,"Alegeri Prezidentiale",1,570,281,247,34,0,278,3,600,319,87,191
7,BOTOŞANI,LUNCA,37912,STROIEŞTI,"CAMINUL CULTURAL STROIESTI",291,"Alegeri Prezidentiale",1,680,263,237,26,0,261,2,800,537,97,164
7,BOTOŞANI,LUNCA,37912,ZLĂTUNOAIA,"CĂMINUL CULTURAL ZLĂTUNOAIA",292,"Alegeri Prezidentiale",1,1296,491,460,31,0,486,5,1400,909,270,216
7,BOTOŞANI,LUNCA,37912,ZLĂTUNOAIA,"SCOALA GENERALA STANESTI",293,"Alegeri Prezidentiale",1,121,88,64,24,0,88,0,200,112,37,51
7,BOTOŞANI,MANOLEASA,37958,MANOLEASA,"SCOALA MANOLEASA",294,"Alegeri Prezidentiale",1,488,225,197,22,6,222,3,500,275,62,160
7,BOTOŞANI,MANOLEASA,37958,FLONDORA,"SCOALA FLONDORA",295,"Alegeri Prezidentiale",3,436,162,142,15,5,162,0,500,338,60,102
7,BOTOŞANI,MANOLEASA,37958,SADOVENI,"SCOALA SADOVENI",296,"Alegeri Prezidentiale",1,363,238,203,31,4,234,4,400,162,41,193
7,BOTOŞANI,MANOLEASA,37958,ZAHORENI,"SCOALA ZAHORENI",297,"Alegeri Prezidentiale",1,449,224,205,17,2,223,1,500,276,66,157
7,BOTOŞANI,MANOLEASA,37958,LIVENI,"SCOALA LIVENI",298,"Alegeri Prezidentiale",1,544,238,215,19,4,233,5,600,362,85,148
7,BOTOŞANI,MANOLEASA,37958,LOTURI,"SCOALA LOTURI",299,"Alegeri Prezidentiale",1,143,72,62,10,0,72,0,200,128,14,58
7,BOTOŞANI,MANOLEASA,37958,MANOLEASA-PRUT,"FOSTA SCOALA MANOLEASA PRUT",300,"Alegeri Prezidentiale",1,139,64,37,23,4,62,2,200,136,21,41
7,BOTOŞANI,"MIHAI EMINESCU",38063,IPOTEŞTI,"SCOALA IPOTEȘTI",301,"Alegeri Prezidentiale",1,510,332,303,29,0,324,8,600,268,216,108
7,BOTOŞANI,"MIHAI EMINESCU",38063,CUCORĂNI,"SCOALA CUCORĂNI",302,"Alegeri Prezidentiale",1,661,350,310,40,0,344,6,800,450,198,146
7,BOTOŞANI,"MIHAI EMINESCU",38063,CERVICEŞTI,"SCOALA CERVICEȘTI",303,"Alegeri Prezidentiale",1,718,392,362,30,0,379,13,800,408,210,169
7,BOTOŞANI,"MIHAI EMINESCU",38063,CĂTĂMĂREŞTI-DEAL,"SCOALA CĂTĂMĂREȘTI DEAL",304,"Alegeri Prezidentiale",1,1455,767,680,87,0,743,24,1500,733,476,267
7,BOTOŞANI,"MIHAI EMINESCU",38063,CĂTĂMĂREŞTI-DEAL,"SCOALA CĂTĂMĂREȘTI DEAL",305,"Alegeri Prezidentiale",1,1442,689,647,42,0,671,18,1500,811,401,270
7,BOTOŞANI,"MIHAI EMINESCU",38063,STÂNCEŞTI,"ȘCOALA STÎNCEȘTI",306,"Alegeri Prezidentiale",1,1355,637,581,56,0,615,22,1392,755,373,242
7,BOTOŞANI,"MIHAI EMINESCU",38063,CĂTĂMĂREŞTI,"ȘCOALA CĂTĂMĂREȘTI",307,"Alegeri Prezidentiale",1,521,283,249,34,0,279,4,600,317,157,122
7,BOTOŞANI,MIHĂILENI,38161,MIHĂILENI,"SCOALA CL I-IV MIHAILENI",308,"Alegeri Prezidentiale",1,1212,522,438,58,26,511,11,1300,778,201,310
7,BOTOŞANI,MIHĂILENI,38161,ROGOJEŞTI,"ŞCOALA GENERALĂ ROGOJESTI",309,"Alegeri Prezidentiale",1,455,231,188,30,13,228,3,500,269,128,100
7,BOTOŞANI,MIHĂILENI,38161,"PÂRÂU NEGRU","ŞCOALAGENERALĂ PARAU NEGRU",310,"Alegeri Prezidentiale",1,412,148,126,17,5,147,1,500,352,74,73
7,BOTOŞANI,MIHĂLĂŞENI,38241,MIHĂLĂŞENI,"SCOALA MIHALASENI",311,"Alegeri Prezidentiale",1,701,283,261,13,9,279,4,800,517,181,98
7,BOTOŞANI,MIHĂLĂŞENI,38241,SARATA,"SCOALA SARATA",312,"Alegeri Prezidentiale",1,422,176,159,17,0,175,1,500,324,89,86
7,BOTOŞANI,MIHĂLĂŞENI,38241,NEGREŞTI,"SCOALA NEGRESTI",313,"Alegeri Prezidentiale",1,369,176,155,16,5,172,4,400,224,102,70
7,BOTOŞANI,MIHĂLĂŞENI,38241,NĂSTASE,"SCOALA NASTASE",314,"Alegeri Prezidentiale",1,333,204,141,62,1,203,1,400,196,141,62
7,BOTOŞANI,MILEANCA,38321,MILEANCA,"SCOALA GIMNAZIALA NR.1 MILEANCA, CORP B, PARTER",315,"Alegeri Prezidentiale",1,1273,544,509,29,6,533,11,1400,856,233,300
7,BOTOŞANI,MILEANCA,38321,CODRENI,"SCOALA GIMNAZIALA NR.2 CODRENI",316,"Alegeri Prezidentiale",1,263,129,111,18,0,129,0,300,171,41,88
7,BOTOŞANI,MILEANCA,38321,SCUTARI,"SCOALA CU CLASELE I-IV SCUTARI",317,"Alegeri Prezidentiale",2,227,98,87,11,0,95,3,300,202,37,58
7,BOTOŞANI,MILEANCA,38321,SELIŞTEA,"SCOALA CU CLASELE I-IV SELIŞTEA",318,"Alegeri Prezidentiale",1,318,137,119,18,0,136,1,400,263,37,99
7,BOTOŞANI,MITOC,38376,MITOC,"ŞCOALA GIMNAZIALĂ ”FLORICĂ MURARIU” MITOC",319,"Alegeri Prezidentiale",1,975,402,364,37,1,400,2,1100,698,130,270
7,BOTOŞANI,MITOC,38376,HORIA,"ŞCOALA PRIMARĂ NR. 1 HORIA",320,"Alegeri Prezidentiale",1,388,189,171,18,0,188,1,400,211,86,102
7,BOTOŞANI,NICŞENI,38456,NICŞENI,CAMINCULTURALNICŞENI,321,"Alegeri Prezidentiale",1,744,341,311,30,0,339,2,800,459,188,151
7,BOTOŞANI,NICŞENI,38456,DOROBANŢI,"ȘCOALA GIMNAZIALĂ ”MIHAI CONSTANTINEANU” DOROBANȚI",322,"Alegeri Prezidentiale",1,1244,467,420,47,0,459,8,1400,933,208,251
7,BOTOŞANI,NICŞENI,38456,DACIA,"ŞCOALA DACIA",323,"Alegeri Prezidentiale",1,126,63,45,18,0,62,1,200,137,42,20
7,BOTOŞANI,PĂLTINIŞ,38492,PĂLTINIŞ,"CAMIN CULTURAL PALTINIS",324,"Alegeri Prezidentiale",1,1287,444,367,77,0,434,10,1400,956,223,211
7,BOTOŞANI,PĂLTINIŞ,38492,PĂLTINIŞ,"ȘCOALA GRIVIȚA",325,"Alegeri Prezidentiale",1,670,137,108,29,0,137,0,800,663,96,41
7,BOTOŞANI,PĂLTINIŞ,38492,PĂLTINIŞ,"CĂMIN CULTURAL IVANCĂUȚI",326,"Alegeri Prezidentiale",1,534,265,233,32,0,261,4,600,335,136,125
7,BOTOŞANI,PĂLTINIŞ,38492,CUZLĂU,"ȘCOALA CUZLĂU",327,"Alegeri Prezidentiale",1,378,187,168,19,0,183,4,400,213,98,85
7,BOTOŞANI,PĂLTINIŞ,38492,HORODIŞTEA,"ȘCOALA CU CL I-VIII HORODIȘTEA",328,"Alegeri Prezidentiale",1,656,313,239,74,0,304,9,800,487,159,145
7,BOTOŞANI,POMÂRLA,38544,POMÂRLA,"CENTRUL DE ZI DIN SAT POMÂRLA, COMUNA POMÂRLA",329,"Alegeri Prezidentiale",1,970,605,473,88,44,597,8,1100,495,308,289
7,BOTOŞANI,POMÂRLA,38544,POMÂRLA,"GRĂDINIȚA CU PROGRAM NORMAL NR.2 POMÂRLA, SAT POMÂRLA, COMUNA POMÂRLA",330,"Alegeri Prezidentiale",1,866,549,467,57,25,543,6,1000,451,282,261
7,BOTOŞANI,POMÂRLA,38544,RACOVĂŢ,"SOALA PRIMARA NR. 2 RACOVĂŢ",331,"Alegeri Prezidentiale",1,274,168,137,30,1,164,4,300,132,92,72
7,BOTOŞANI,PRĂJENI,38580,PRĂJENI,"ŞCOALA CU CLASELE I-IV SALA I",332,"Alegeri Prezidentiale",1,977,364,340,24,0,361,3,1100,736,202,159
7,BOTOŞANI,PRĂJENI,38580,CÂMPENI,"ŞCOALA CU CLASELE I-IV",333,"Alegeri Prezidentiale",1,510,222,199,23,0,216,6,600,378,111,105
7,BOTOŞANI,PRĂJENI,38580,LUPĂRIA,"ȘCOALA PRIMARĂ NR. 4 LUPĂRIA",334,"Alegeri Prezidentiale",1,577,273,258,15,0,273,0,600,327,151,122
7,BOTOŞANI,PRĂJENI,38580,MILETIN,"ŞCOALA GIMNAZIALA NR.2 MILETIN",335,"Alegeri Prezidentiale",1,468,222,208,14,0,216,6,500,278,130,86
7,BOTOŞANI,RĂCHIŢI,35839,RĂCHIŢI,"CĂMIN CULTURAL RĂCHIŢI",336,"Alegeri Prezidentiale",1,1010,600,475,116,9,589,11,1100,500,358,231
7,BOTOŞANI,RĂCHIŢI,35839,COSTEŞTI,"ŞCOALA GIMNAZIALĂ ”PETRE ŞUŞTER”",337,"Alegeri Prezidentiale",1,1276,687,617,70,0,676,11,1400,713,448,228
7,BOTOŞANI,RĂCHIŢI,35839,ROŞIORI,"CĂMIN CULTURAL ROŞIORI",338,"Alegeri Prezidentiale",1,1174,561,523,38,0,554,7,1200,639,347,207
7,BOTOŞANI,RĂCHIŢI,35839,CIŞMEA,"GRĂDINITA CU PROGRARM NORMAL NR.1 CISMEA",339,"Alegeri Prezidentiale",1,485,306,256,50,0,296,10,500,194,192,104
7,BOTOŞANI,RĂDĂUŢI-PRUT,38633,RĂDĂUŢI-PRUT,"CAMIN CULTURAL RADAUTI-PRUT",340,"Alegeri Prezidentiale",1,765,291,238,53,0,280,11,800,509,135,145
7,BOTOŞANI,RĂDĂUŢI-PRUT,38633,REDIU,"CAMINUL CULTURAL SAT REDIU",341,"Alegeri Prezidentiale",1,732,304,271,29,4,302,2,800,496,149,153
7,BOTOŞANI,RĂDĂUŢI-PRUT,38633,MIORCANI,"CAMINUL CULTURAL SAT MIORCANI",342,"Alegeri Prezidentiale",1,746,280,256,24,0,278,2,800,520,146,132
7,BOTOŞANI,RĂDĂUŢI-PRUT,38633,MIORCANI,"CAMINUL CULTURAL SAT MIORCANI",343,"Alegeri Prezidentiale",1,680,231,219,12,0,230,1,800,569,140,90
7,BOTOŞANI,RĂUSENI,38679,RĂUSENI,"SCOALA GIMNAZIALA NR. 1, CORP B",344,"Alegeri Prezidentiale",1,1060,387,335,52,0,382,5,1200,813,194,188
7,BOTOŞANI,RĂUSENI,38679,DOINA,"ŞCOALA GENERALA DOINA",345,"Alegeri Prezidentiale",1,419,171,160,11,0,169,2,500,329,70,99
7,BOTOŞANI,RĂUSENI,38679,REDIU,"GRADINITA REDIU",346,"Alegeri Prezidentiale",1,430,157,139,18,0,155,2,500,343,60,95
7,BOTOŞANI,RĂUSENI,38679,STOLNICENI,"GRĂDINIŢA STOLNICENI",347,"Alegeri Prezidentiale",1,152,82,66,16,0,79,3,200,118,33,46
7,BOTOŞANI,RIPICENI,38731,RIPICENI,"CĂMINUL CULTURAL",348,"Alegeri Prezidentiale",1,1399,159,142,17,0,155,4,1500,1341,68,87
7,BOTOŞANI,RIPICENI,38731,RIPICENI,"CĂMINUL CULTURAL",349,"Alegeri Prezidentiale",1,1039,216,198,16,2,212,4,1200,984,108,104
7,BOTOŞANI,RIPICENI,38731,RIPICENI,"GRĂDINIŢA DE COPII",350,"Alegeri Prezidentiale",1,1540,368,337,31,0,360,8,1600,1232,237,123
7,BOTOŞANI,ROMA,38811,ROMA,"SCOALA NR. 1 ROMA",351,"Alegeri Prezidentiale",1,1461,654,583,52,19,647,7,1600,946,305,342
7,BOTOŞANI,ROMA,38811,ROMA,"SCOALA NR.2 ROMA",352,"Alegeri Prezidentiale",1,941,500,397,81,22,495,5,1000,500,244,251
7,BOTOŞANI,ROMA,38811,COTÂRGACI,"SCOALA NR. 4 COTIRGACI",353,"Alegeri Prezidentiale",1,715,231,176,44,11,227,4,800,569,102,125
7,BOTOŞANI,ROMÂNEŞTI,38848,ROMÂNEŞTI,"CĂMINUL CULTURAL",354,"Alegeri Prezidentiale",1,1107,439,407,32,0,437,2,1200,761,247,190
7,BOTOŞANI,ROMÂNEŞTI,38848,DĂMIDENI,"SCOALA PRIMARĂ NR 1",355,"Alegeri Prezidentiale",1,477,180,160,20,0,178,2,500,320,93,85
7,BOTOŞANI,"SANTA MARE",38893,"SANTA MARE","CAMINUL CULTURAL SANTA MARE",356,"Alegeri Prezidentiale",1,1002,426,390,36,0,423,3,1100,674,263,160
7,BOTOŞANI,"SANTA MARE",38893,BERZA,"SCOALA GENERALA BERZA",357,"Alegeri Prezidentiale",1,172,99,82,17,0,99,0,200,101,64,35
7,BOTOŞANI,"SANTA MARE",38893,BOGDĂNEŞTI,"SCOALA GENERALA BOGDANESTI",358,"Alegeri Prezidentiale",1,312,158,148,10,0,155,3,400,242,93,62
7,BOTOŞANI,"SANTA MARE",38893,RÂNGHILEŞTI,"SCOALA GENERALA RINGHILESTI",359,"Alegeri Prezidentiale",1,286,129,112,17,0,127,2,300,171,90,37
7,BOTOŞANI,"SANTA MARE",38893,ILIŞENI,"SCOALA GENERALA ILISENI",360,"Alegeri Prezidentiale",1,324,174,154,20,0,169,5,400,226,93,76
7,BOTOŞANI,STĂUCENI,35884,STĂUCENI,"CAMIN CULTURAL",361,"Alegeri Prezidentiale",1,1112,439,402,37,0,431,8,1200,761,235,196
7,BOTOŞANI,STĂUCENI,35884,SILIŞTEA,"SCOALA GENERALA CU CLASELE I-IV",362,"Alegeri Prezidentiale",1,423,200,185,15,0,196,4,500,300,113,83
7,BOTOŞANI,STĂUCENI,35884,VICTORIA,"SCOALA GENERALA CU CLASELE I-IV",363,"Alegeri Prezidentiale",1,530,227,203,24,0,214,13,601,374,149,65
7,BOTOŞANI,STĂUCENI,35884,TOCILENI,"SCOALA GENERALA CU CLASELE I-VIII PATRIARH TEOCTIST ARAPASU",364,"Alegeri Prezidentiale",1,896,393,349,44,0,386,7,1000,607,198,188
7,BOTOŞANI,SUHARĂU,38982,SUHARĂU,"SCOALA PRIMARA NR. 3 SUHARAU",365,"Alegeri Prezidentiale",1,971,412,350,39,23,405,7,1000,588,139,266
7,BOTOŞANI,SUHARĂU,38982,SUHARĂU,"SCOALA GIMNAZIALA NR. 2 SUHARAU",366,"Alegeri Prezidentiale",1,557,251,225,26,0,250,1,600,349,110,140
7,BOTOŞANI,SUHARĂU,38982,LIŞNA,"ȘCOALA GIMNAZIALĂ CONSTATIN TINCU LIȘNA",367,"Alegeri Prezidentiale",1,716,334,308,26,0,330,4,800,466,170,160
7,BOTOŞANI,SUHARĂU,38982,OROFTIANA,"SCOALA GENERALA NR. 4 OROFTIANA",368,"Alegeri Prezidentiale",1,743,297,253,44,0,293,4,800,503,151,142
7,BOTOŞANI,SUHARĂU,38982,SMÂRDAN,"GRADINITA SMARDAN",369,"Alegeri Prezidentiale",1,601,274,247,27,0,266,8,800,526,110,156
7,BOTOŞANI,SULIŢA,39051,SULIŢA,"SCOALA CU CL I-VIII SULITA",370,"Alegeri Prezidentiale",1,1314,615,543,62,10,609,6,1400,785,339,270
7,BOTOŞANI,SULIŢA,39051,DRACŞANI,"SCOALA CU CL. I - VIII DRACSANI",371,"Alegeri Prezidentiale",1,1146,473,440,33,0,466,7,1200,727,222,244
7,BOTOŞANI,ŞENDRICENI,39122,ŞENDRICENI,"CENTRU DE ZI PENTRU COPII ”ZORI DE ZI”",372,"Alegeri Prezidentiale",1,1146,494,444,50,0,490,4,1200,706,202,288
7,BOTOŞANI,ŞENDRICENI,39122,ŞENDRICENI,"ŞCOALA GENERALĂ COBÎLA",373,"Alegeri Prezidentiale",1,734,299,262,37,0,296,3,800,501,117,179
7,BOTOŞANI,ŞENDRICENI,39122,HORLĂCENI,"ŞCOALA GENERALĂ",374,"Alegeri Prezidentiale",1,486,225,196,29,0,224,1,500,275,99,125
7,BOTOŞANI,ŞENDRICENI,39122,PĂDURENI,"ŞCOALA PRIMARĂ VICTOR ISĂCEANU,CORP VECHI",375,"Alegeri Prezidentiale",1,869,267,250,17,0,265,2,900,633,106,159
7,BOTOŞANI,ŞTIUBIENI,39220,ŞTIUBIENI,"CAMINUL CULTURAL ȘTIUBIENI",376,"Alegeri Prezidentiale",1,1417,652,600,48,4,645,7,1500,848,318,327
7,BOTOŞANI,ŞTIUBIENI,39220,NEGRENI,"CAMINUL CULTURAL NEGRENI",377,"Alegeri Prezidentiale",2,664,320,296,24,0,317,3,800,480,160,157
7,BOTOŞANI,TODIRENI,39266,TODIRENI,"LICEU TEHNOLOGIC TODIRENI, SALA P2, PARTER",378,"Alegeri Prezidentiale",1,1187,514,461,51,2,511,3,1200,686,237,274
7,BOTOŞANI,TODIRENI,39266,TODIRENI,"ŞCOALA CU CLASELE I-IV NR.2 TODIRENI",379,"Alegeri Prezidentiale",1,504,191,166,25,0,190,1,600,409,109,81
7,BOTOŞANI,TODIRENI,39266,CERNEŞTI,"ŞCOALA CU CLASELE I-VIII CERNEŞTI",380,"Alegeri Prezidentiale",1,663,253,224,28,1,250,3,800,547,120,130
7,BOTOŞANI,TODIRENI,39266,IUREŞTI,"ŞCOALA CU CLASELE I-IV IUREŞTI",381,"Alegeri Prezidentiale",1,442,173,154,19,0,172,1,500,327,74,98
7,BOTOŞANI,TRUŞEŞTI,39328,TRUŞEŞTI,"GRĂDINIŢA DE COPII TRUSESTI",382,"Alegeri Prezidentiale",1,1069,490,426,43,21,473,17,1100,610,246,227
7,BOTOŞANI,TRUŞEŞTI,39328,TRUŞEŞTI,"GRĂDINIŢA DE COPII TRUSESTI",383,"Alegeri Prezidentiale",1,1081,446,397,47,2,437,9,1200,754,198,239
7,BOTOŞANI,TRUŞEŞTI,39328,BUHĂCENI,"ŞCOALA GENERALĂ NR. 4 BUHĂCENI",384,"Alegeri Prezidentiale",1,639,342,318,23,1,338,4,800,458,131,207
7,BOTOŞANI,TRUŞEŞTI,39328,DRISLEA,"GRĂDINIŢA DRISLEA",385,"Alegeri Prezidentiale",1,843,406,372,31,3,404,2,900,494,213,191
7,BOTOŞANI,TRUŞEŞTI,39328,IONĂŞENI,"ŞCOALA GENERALĂ NR. 2 IONĂŞENI",386,"Alegeri Prezidentiale",1,758,379,312,47,20,373,6,800,421,191,182
7,BOTOŞANI,TUDORA,39391,TUDORA,"SCOALA TIBERIU CRUDU CORP B SALA 1",387,"Alegeri Prezidentiale",1,1384,601,551,49,1,584,17,1500,899,264,320
7,BOTOŞANI,TUDORA,39391,TUDORA,"SCOALA TIBERIU CRUDU CORP B SALA 2",388,"Alegeri Prezidentiale",1,1336,485,450,32,3,477,8,1400,915,248,229
7,BOTOŞANI,TUDORA,39391,TUDORA,"SCOALA CU CLASELE I-VIII ARINI",389,"Alegeri Prezidentiale",1,1253,446,411,31,4,436,10,1300,854,240,196
7,BOTOŞANI,UNGURENI,39417,UNGURENI,"ŞCOALA GIMNAZIALĂ NR. 1 UNGURENI",390,"Alegeri Prezidentiale",1,1154,389,335,54,0,383,6,1200,811,221,162
7,BOTOŞANI,UNGURENI,39417,UNGURENI,"CĂMIN CULTURAL",391,"Alegeri Prezidentiale",1,1076,389,369,20,0,386,3,1200,811,274,112
7,BOTOŞANI,UNGURENI,39417,"MIHAI VITEAZU","ŞCOALA PRIMARĂ NR. 5 MIHAI VITEAZU",392,"Alegeri Prezidentiale",1,390,213,198,14,1,209,4,400,187,131,78
7,BOTOŞANI,UNGURENI,39417,BORZEŞTI,"ŞCOALA GIMNAZIALĂ NR. 3 BORZEŞTI",393,"Alegeri Prezidentiale",1,1095,463,427,36,0,460,3,1200,737,172,288
7,BOTOŞANI,UNGURENI,39417,"PLOPENII MARI","LICEUL TEHNOLOGIC PLOPENII MARI",394,"Alegeri Prezidentiale",1,799,299,280,19,0,297,2,1000,701,181,116
7,BOTOŞANI,UNGURENI,39417,CĂLUGĂRENI,"ŞCOALA GIMNAZIALĂ NR. 8 CĂLUGĂRENII VECHI",395,"Alegeri Prezidentiale",1,582,217,190,27,0,213,4,600,383,81,132
7,BOTOŞANI,UNŢENI,39532,UNŢENI,"ŞCOALA GIMNAZIALĂ NR.1 UNŢENI",396,"Alegeri Prezidentiale",1,978,377,349,28,0,371,6,1100,723,166,205
7,BOTOŞANI,UNŢENI,39532,MÂNĂSTIRENI,"ŞCOALA PRIMARĂ NR.2 MÂNĂSTIRENI",397,"Alegeri Prezidentiale",1,648,269,245,24,0,267,2,700,431,148,119
7,BOTOŞANI,UNŢENI,39532,BURLEŞTI,"ŞCOALA PRIMARĂ NR.3 BURLEŞTI",398,"Alegeri Prezidentiale",1,535,265,228,37,0,264,1,600,335,117,147
7,BOTOŞANI,VĂCULEŞTI,39612,VĂCULEŞTI,"SCOALA VACULESTI, CORP A",399,"Alegeri Prezidentiale",1,880,484,391,65,28,478,6,900,416,168,310
7,BOTOŞANI,VĂCULEŞTI,39612,SAUCENIŢA,"BAZA SPORTIVĂ",400,"Alegeri Prezidentiale",1,769,373,320,42,11,371,2,800,427,170,201
7,BOTOŞANI,VĂCULEŞTI,39612,GOROVEI,"SCOALA GOROVEI",401,"Alegeri Prezidentiale",1,28,44,20,24,0,44,0,100,56,8,36
7,BOTOŞANI,"VÂRFU CÂMPULUI",39694,MAGHERA,"ŞC.CU CLASELE I-VIII NR.1",402,"Alegeri Prezidentiale",1,663,374,306,68,0,371,3,700,326,190,181
7,BOTOŞANI,"VÂRFU CÂMPULUI",39694,"VÂRFU CÂMPULUI","ȘC.CU CLASELE I-VIII GEORGE HAZGAN",403,"Alegeri Prezidentiale",1,1455,221,189,29,3,218,3,1400,1179,89,129
7,BOTOŞANI,"VÂRFU CÂMPULUI",39694,"VÂRFU CÂMPULUI","ŞC.CU CLASELE I-VIII GEORGE HAZGAN",404,"Alegeri Prezidentiale",1,1616,323,284,33,6,318,5,1600,1277,129,189
7,BOTOŞANI,"VÂRFU CÂMPULUI",39694,IONĂŞENI,"ŞC.CU CLASELE I-VIII IONĂŞENI",405,"Alegeri Prezidentiale",1,718,304,275,29,0,296,8,800,496,142,154
7,BOTOŞANI,"VÂRFU CÂMPULUI",39694,LUNCA,"ŞC.CU CLASELE I-IV LUNCA",406,"Alegeri Prezidentiale",1,540,307,249,56,2,296,11,600,293,150,146
7,BOTOŞANI,VIIŞOARA,39658,VIIŞOARA,"CĂMINUL CULTURAL VIIŞOARA",407,"Alegeri Prezidentiale",1,692,266,236,30,0,263,3,800,534,96,167
7,BOTOŞANI,VIIŞOARA,39658,"CUZA VODĂ","ŞCOLA CU CLASELE I-IV CUZA VODĂ",408,"Alegeri Prezidentiale",1,441,170,155,15,0,169,1,500,330,73,96
7,BOTOŞANI,VIIŞOARA,39658,"VIIŞOARA MICĂ","ŞCOLA CU CLASELE I-IV VIIŞOARA MICĂ",409,"Alegeri Prezidentiale",2,392,177,161,16,0,176,1,400,223,72,104
7,BOTOŞANI,VLĂDENI,39738,VLĂDENI,"SCOALA CU CLASELE I-VIII VLADENI(CORP NOU)",410,"Alegeri Prezidentiale",1,1482,621,551,69,1,611,10,1600,979,241,370
7,BOTOŞANI,VLĂDENI,39738,BREHUIEŞTI,"SCOALA CU CLASELE I-VIII BREHUIESTI(CORPUL B)",411,"Alegeri Prezidentiale",1,1364,495,459,36,0,488,7,1600,1105,249,239
7,BOTOŞANI,VLĂDENI,39738,MÂNDREŞTI,"SCOALA CU CLASELE I-VIII MANDRESTI",412,"Alegeri Prezidentiale",1,1107,430,390,40,0,418,12,1200,770,194,224
7,BOTOŞANI,VLĂSINEŞTI,39792,VLĂSINEŞTI,"ŞCOALA CU CLASELE I-VIII GHEORGHE BURAC",413,"Alegeri Prezidentiale",1,1269,667,557,70,40,653,14,1300,633,220,433
7,BOTOŞANI,VLĂSINEŞTI,39792,SÂRBI,"ŞCOALA CU CLASELE I-IV",414,"Alegeri Prezidentiale",1,829,492,442,25,25,486,6,900,408,150,336
7,BOTOŞANI,VLĂSINEŞTI,39792,"MIRON COSTIN","ŞCOALA CU CLASELE I-IV",415,"Alegeri Prezidentiale",1,324,232,197,31,4,230,2,400,168,81,149
7,BOTOŞANI,VORNICENI,39836,VORNICENI,"ȘCOALA GIMNAZIALĂ PROF. OCTAVIAN IONESCU VORNICENI",416,"Alegeri Prezidentiale",1,1269,441,414,27,0,438,3,1400,959,179,259
7,BOTOŞANI,VORNICENI,39836,VORNICENI,"GRĂDINIȚA NR. 2 VORNICENI",417,"Alegeri Prezidentiale",1,936,270,251,19,0,268,2,1000,730,121,147
7,BOTOŞANI,VORNICENI,39836,VORNICENI,"ȘCOALA GIMNAZIALĂ NR.1 VORNICENI",418,"Alegeri Prezidentiale",1,904,307,289,18,0,301,6,1000,693,112,189
7,BOTOŞANI,VORNICENI,39836,"DEALU CRUCII","ȘCOALA PRIMARĂ NR. 2 DEALU CRUCII",419,"Alegeri Prezidentiale",1,299,133,118,15,0,131,2,400,267,40,91
7,BOTOŞANI,VORONA,39872,VORONA,"”SOCIETATEA COOPERATIVA DE CONSUM VORONA - MAGAZIN MIXT VORONA NOUA”",420,"Alegeri Prezidentiale",1,766,311,294,15,2,303,8,792,481,138,165
7,BOTOŞANI,VORONA,39872,VORONA,"LICEUL TEHNOLOGIC STEFAN CEL MARE VORONA",421,"Alegeri Prezidentiale",1,817,382,337,44,1,374,8,900,518,151,223
7,BOTOŞANI,VORONA,39872,VORONA,"SCOALA CU CLASELE I-VIII IONITA PANCUL VORONA",422,"Alegeri Prezidentiale",1,502,226,194,28,4,226,0,600,374,117,109
7,BOTOŞANI,VORONA,39872,"VORONA MARE","SCOALA CU CLASELE I-VIII LUCA ARBORE VORONA MARE",423,"Alegeri Prezidentiale",1,1017,458,397,44,17,447,11,1100,642,141,306
7,BOTOŞANI,VORONA,39872,JOLDEŞTI,"SCOALA CU CLASELE I-VIII RALUCA IURASCU JOLDESTI",424,"Alegeri Prezidentiale",1,1037,388,353,30,5,385,3,1100,712,193,192
7,BOTOŞANI,VORONA,39872,ICUŞENI,"GRADINITA NUMARUL 2 ICUSENI",425,"Alegeri Prezidentiale",1,233,101,81,20,0,97,4,300,199,40,57
7,BOTOŞANI,VORONA,39872,ICUŞENI,"SCOALA CU CLASELE I-VIII ALEXANDRU CEL BUN ICUSENI",426,"Alegeri Prezidentiale",1,814,309,281,27,1,308,1,900,591,168,140
7,BOTOŞANI,VORONA,39872,POIANA,"SCOALA CU CLASELE I-VIII NICOLAE IORGA POIANA",427,"Alegeri Prezidentiale",3,987,378,350,23,5,370,8,1100,722,146,224
8,BRAŞOV,"MUNICIPIUL BRAŞOV",40198,BRAŞOV,"SEMINARUL TEOLOGIC LICEAL ORTODOX ”DUMITRU STĂNILOAIE”",1,"Alegeri Prezidentiale",1,1524,890,808,82,0,862,28,1600,710,647,215
8,BRAŞOV,"MUNICIPIUL BRAŞOV",40198,BRAŞOV,"SEMINARUL TEOLOGIC LICEAL ORTODOX ”DUMITRU STĂNILOAIE”",2,"Alegeri Prezidentiale",1,1192,709,652,57,0,692,17,1300,591,517,175
8,BRAŞOV,"MUNICIPIUL BRAŞOV",40198,BRAŞOV,"GRĂDINIŢA CU PROGRAM PRELUNGIT NR. 2",3,"Alegeri Prezidentiale",1,986,573,520,50,3,561,12,1100,527,426,135
8,BRAŞOV,"MUNICIPIUL BRAŞOV",40198,BRAŞOV,"GRĂDINIŢA CU PROGRAM PRELUNGIT NR. 2",4,"Alegeri Prezidentiale",1,1123,720,576,102,42,697,23,1200,480,554,143
8,BRAŞOV,"MUNICIPIUL BRAŞOV",40198,BRAŞOV,"LICEUL ”ANDREI MUREŞANU”",5,"Alegeri Prezidentiale",1,1402,1034,734,229,71,1004,30,1500,466,749,255
8,BRAŞOV,"MUNICIPIUL BRAŞOV",40198,BRAŞOV,"LICEUL ”ANDREI MUREŞANU”",6,"Alegeri Prezidentiale",1,1368,895,624,214,57,872,23,1800,905,675,197
8,BRAŞOV,"MUNICIPIUL BRAŞOV",40198,BRAŞOV,"COLEGIUL TEHNIC ”MARIA BAIULESCU”",7,"Alegeri Prezidentiale",1,1303,690,550,137,3,677,13,1400,710,545,132
8,BRAŞOV,"MUNICIPIUL BRAŞOV",40198,BRAŞOV,"COLEGIUL TEHNIC ”MARIA BAIULESCU”",8,"Alegeri Prezidentiale",1,1453,731,631,100,0,712,19,1600,869,532,180
8,BRAŞOV,"MUNICIPIUL BRAŞOV",40198,BRAŞOV,"COLEGIUL NAŢIONAL ”APRILY LAJOS”",9,"Alegeri Prezidentiale",1,950,696,444,252,0,676,20,1100,404,530,146
8,BRAŞOV,"MUNICIPIUL BRAŞOV",40198,BRAŞOV,"COLEGIUL NAŢIONAL ”APRILY LAJOS”",10,"Alegeri Prezidentiale",1,944,686,493,191,2,673,13,1000,314,511,162
8,BRAŞOV,"MUNICIPIUL BRAŞOV",40198,BRAŞOV,"COLEGIUL NAŢIONAL ”APRILY LAJOS”",11,"Alegeri Prezidentiale",1,717,462,336,126,0,454,8,800,338,344,110
8,BRAŞOV,"MUNICIPIUL BRAŞOV",40198,BRAŞOV,"COLEGIUL NAŢIONAL ”UNIREA”",12,"Alegeri Prezidentiale",1,1247,1120,628,483,9,1088,32,1900,780,869,219
8,BRAŞOV,"MUNICIPIUL BRAŞOV",40198,BRAŞOV,"COLEGIUL NAŢIONAL ”UNIREA”",13,"Alegeri Prezidentiale",1,1247,1119,562,556,1,1095,24,1900,781,861,234
8,BRAŞOV,"MUNICIPIUL BRAŞOV",40198,BRAŞOV,"ŞCOALA GIMNAZIALĂ NR. 8",14,"Alegeri Prezidentiale",1,953,598,526,72,0,588,10,1100,502,453,135
8,BRAŞOV,"MUNICIPIUL BRAŞOV",40198,BRAŞOV,"ŞCOALA GIMNAZIALĂ NR. 8",15,"Alegeri Prezidentiale",1,1031,717,531,157,29,689,28,1100,383,514,175
8,BRAŞOV,"MUNICIPIUL BRAŞOV",40198,BRAŞOV,"ŞCOALA GIMNAZIALĂ NR. 8",16,"Alegeri Prezidentiale",1,1164,724,651,72,1,711,13,1300,576,522,189
8,BRAŞOV,"MUNICIPIUL BRAŞOV",40198,BRAŞOV,"ŞCOALA GIMNAZIALĂ NR. 8",17,"Alegeri Prezidentiale",1,1663,934,885,49,0,901,33,1700,766,664,237
8,BRAŞOV,"MUNICIPIUL BRAŞOV",40198,BRAŞOV,"ŞCOALA GIMNAZIALĂ NR.5",18,"Alegeri Prezidentiale",1,1429,977,748,219,10,958,19,1600,623,752,206
8,BRAŞOV,"MUNICIPIUL BRAŞOV",40198,BRAŞOV,"ŞCOALA GIMNAZIALĂ NR.5",19,"Alegeri Prezidentiale",1,1553,935,728,153,54,911,24,1700,765,651,260
8,BRAŞOV,"MUNICIPIUL BRAŞOV",40198,BRAŞOV,"ŞCOALA GIMNAZIALĂ NR. 15",20,"Alegeri Prezidentiale",1,1635,1192,883,275,34,1170,22,1900,708,856,314
8,BRAŞOV,"MUNICIPIUL BRAŞOV",40198,BRAŞOV,"ŞCOALA GIMNAZIALĂ NR. 15",21,"Alegeri Prezidentiale",1,1545,1169,821,347,1,1145,24,1800,631,864,281
8,BRAŞOV,"MUNICIPIUL BRAŞOV",40198,BRAŞOV,"ŞCOALA GIMNAZIALĂ NR. 15",22,"Alegeri Prezidentiale",1,1451,1088,807,281,0,1065,23,1700,612,822,243
8,BRAŞOV,"MUNICIPIUL BRAŞOV",40198,BRAŞOV,"ŞCOALA GIMNAZIALĂ NR. 15",23,"Alegeri Prezidentiale",1,1417,837,762,74,1,813,24,1500,663,619,194
8,BRAŞOV,"MUNICIPIUL BRAŞOV",40198,BRAŞOV,"ŞCOALA GIMNAZIALĂ NR. 15",24,"Alegeri Prezidentiale",1,1283,732,681,51,0,712,20,1300,568,483,229
8,BRAŞOV,"MUNICIPIUL BRAŞOV",40198,BRAŞOV,"ŞCOALA GIMNAZIALĂ NR. 15",25,"Alegeri Prezidentiale",1,1198,645,615,29,1,634,11,1200,555,470,164
8,BRAŞOV,"MUNICIPIUL BRAŞOV",40198,BRAŞOV,"ŞCOALA GIMNAZIALĂ NR. 15",26,"Alegeri Prezidentiale",1,1178,873,610,263,0,851,22,1500,627,700,151
8,BRAŞOV,"MUNICIPIUL BRAŞOV",40198,BRAŞOV,"LICEUL DE MUZICĂ ”TUDOR CIORTEA”",27,"Alegeri Prezidentiale",1,1338,1078,680,274,124,1047,31,1500,422,781,266
8,BRAŞOV,"MUNICIPIUL BRAŞOV",40198,BRAŞOV,"ŞCOALA GIMNAZIALĂ NR. 12",28,"Alegeri Prezidentiale",2,1593,968,831,135,2,942,26,1700,732,737,205
8,BRAŞOV,"MUNICIPIUL BRAŞOV",40198,BRAŞOV,"ŞCOALA GIMNAZIALĂ NR. 12",29,"Alegeri Prezidentiale",1,1445,910,715,195,0,877,33,1600,690,691,186
8,BRAŞOV,"MUNICIPIUL BRAŞOV",40198,BRAŞOV,"GRĂDINIŢA CU PROGRAM PRELUNGIT ”CASUTA BUCURIEI” NR. 11",30,"Alegeri Prezidentiale",1,875,488,422,66,0,481,7,992,504,347,134
8,BRAŞOV,"MUNICIPIUL BRAŞOV",40198,BRAŞOV,"GRĂDINIŢA CU PROGRAM PRELUNGIT ”CASUTA BUCURIEI” NR. 11",31,"Alegeri Prezidentiale",1,865,569,508,61,0,555,14,992,423,390,165
8,BRAŞOV,"MUNICIPIUL BRAŞOV",40198,BRAŞOV,"COLEGIUL ”EMIL RACOVIŢĂ”",32,"Alegeri Prezidentiale",1,1551,966,818,147,1,942,24,1600,634,697,245
8,BRAŞOV,"MUNICIPIUL BRAŞOV",40198,BRAŞOV,"COLEGIUL ”EMIL RACOVIŢĂ”",33,"Alegeri Prezidentiale",1,1357,780,718,62,0,763,17,1500,720,537,226
8,BRAŞOV,"MUNICIPIUL BRAŞOV",40198,BRAŞOV,"COLEGIUL ”EMIL RACOVIŢĂ”",34,"Alegeri Prezidentiale",1,1299,779,673,106,0,764,15,1400,621,556,208
8,BRAŞOV,"MUNICIPIUL BRAŞOV",40198,BRAŞOV,"COLEGIUL ”EMIL RACOVIŢĂ”",35,"Alegeri Prezidentiale",1,851,527,481,46,0,518,9,900,373,415,103
8,BRAŞOV,"MUNICIPIUL BRAŞOV",40198,BRAŞOV,"COLEGIUL NAŢIONAL ”DR. I. MEŞOTĂ”",36,"Alegeri Prezidentiale",1,1651,950,870,80,0,930,20,1696,746,669,261
8,BRAŞOV,"MUNICIPIUL BRAŞOV",40198,BRAŞOV,"COLEGIUL NAŢIONAL ”DR. I. MEŞOTĂ”",37,"Alegeri Prezidentiale",1,940,729,529,200,0,712,17,998,269,550,162
8,BRAŞOV,"MUNICIPIUL BRAŞOV",40198,BRAŞOV,"COLEGIUL NAŢIONAL ”DR. I. MEŞOTĂ”",38,"Alegeri Prezidentiale",1,1495,932,776,156,0,918,14,1600,668,706,212
8,BRAŞOV,"MUNICIPIUL BRAŞOV",40198,BRAŞOV,"ŞCOALA GIMNAZIALĂ NR. 19",39,"Alegeri Prezidentiale",1,1107,710,623,86,1,691,19,1200,490,465,226
8,BRAŞOV,"MUNICIPIUL BRAŞOV",40198,BRAŞOV,"ŞCOALA GIMNAZIALĂ NR. 19",40,"Alegeri Prezidentiale",1,1333,956,736,219,1,930,26,1500,544,655,275
8,BRAŞOV,"MUNICIPIUL BRAŞOV",40198,BRAŞOV,"ŞCOALA GIMNAZIALĂ NR. 19",41,"Alegeri Prezidentiale",1,977,627,507,120,0,610,17,1100,473,434,176
8,BRAŞOV,"MUNICIPIUL BRAŞOV",40198,BRAŞOV,"ŞCOALA GIMNAZIALĂ NR. 19",42,"Alegeri Prezidentiale",1,1548,915,817,98,0,892,23,1600,685,633,259
8,BRAŞOV,"MUNICIPIUL BRAŞOV",40198,BRAŞOV,"ŞCOALA GIMNAZIALĂ NR. 19",43,"Alegeri Prezidentiale",1,1419,1009,817,192,0,981,28,1600,591,694,287
8,BRAŞOV,"MUNICIPIUL BRAŞOV",40198,BRAŞOV,"VILA ORIZONT",44,"Alegeri Prezidentiale",1,329,740,143,597,0,719,21,1200,460,566,153
8,BRAŞOV,"MUNICIPIUL BRAŞOV",40198,BRAŞOV,"ŞCOALA GIMNAZIALĂ NR. 27 ”ANATOL GHERMANSCHI”",45,"Alegeri Prezidentiale",1,1454,866,771,95,0,847,19,1500,634,605,242
8,BRAŞOV,"MUNICIPIUL BRAŞOV",40198,BRAŞOV,"ŞCOALA GIMNAZIALĂ NR. 27 ”ANATOL GHERMANSCHI”",46,"Alegeri Prezidentiale",2,1446,858,782,76,0,836,22,1500,642,589,247
8,BRAŞOV,"MUNICIPIUL BRAŞOV",40198,BRAŞOV,"ŞCOALA GIMNAZIALĂ NR. 27 ”ANATOL GHERMANSCHI”",47,"Alegeri Prezidentiale",1,633,578,380,198,0,568,10,700,122,429,139
8,BRAŞOV,"MUNICIPIUL BRAŞOV",40198,BRAŞOV,"ŞCOALA GIMNAZIALĂ NR. 27 ”ANATOL GHERMANSCHI”",48,"Alegeri Prezidentiale",1,1580,922,851,71,0,898,24,1600,678,626,272
8,BRAŞOV,"MUNICIPIUL BRAŞOV",40198,BRAŞOV,"ŞCOALA GIMNAZIALĂ NR. 27 ”ANATOL GHERMANSCHI”",49,"Alegeri Prezidentiale",1,1428,873,775,98,0,849,24,1600,727,594,255
8,BRAŞOV,"MUNICIPIUL BRAŞOV",40198,BRAŞOV,"ŞCOALA GIMNAZIALĂ NR. 27 ”ANATOL GHERMANSCHI”",50,"Alegeri Prezidentiale",1,1517,944,827,116,1,919,25,1600,656,645,274
8,BRAŞOV,"MUNICIPIUL BRAŞOV",40198,BRAŞOV,"ŞCOALA GIMNAZIALĂ NR. 27 ”ANATOL GHERMANSCHI”",51,"Alegeri Prezidentiale",1,1551,928,854,74,0,913,15,1600,672,627,286
8,BRAŞOV,"MUNICIPIUL BRAŞOV",40198,BRAŞOV,"ŞCOALA GIMNAZIALĂ NR. 11 „ST.O.IOSIF”",52,"Alegeri Prezidentiale",1,1171,735,647,88,0,717,18,1300,565,526,191
8,BRAŞOV,"MUNICIPIUL BRAŞOV",40198,BRAŞOV,"ŞCOALA GIMNAZIALĂ NR. 11 „ST.O.IOSIF”",53,"Alegeri Prezidentiale",1,1486,822,761,61,0,795,27,1500,678,574,221
8,BRAŞOV,"MUNICIPIUL BRAŞOV",40198,BRAŞOV,"ŞCOALA GIMNAZIALĂ NR. 11 „ST.O.IOSIF”",54,"Alegeri Prezidentiale",1,1066,562,528,34,0,553,9,1200,638,381,172
8,BRAŞOV,"MUNICIPIUL BRAŞOV",40198,BRAŞOV,"ŞCOALA GIMNAZIALĂ NR. 11 „ST.O.IOSIF”",55,"Alegeri Prezidentiale",1,914,401,373,28,0,388,13,1000,599,286,102
8,BRAŞOV,"MUNICIPIUL BRAŞOV",40198,BRAŞOV,"ŞCOALA GIMNAZIALĂ NR. 11 „ST.O.IOSIF”",56,"Alegeri Prezidentiale",1,1426,725,680,45,0,703,22,1500,775,504,199
8,BRAŞOV,"MUNICIPIUL BRAŞOV",40198,BRAŞOV,"ŞCOALA GIMNAZIALĂ NR. 11 „ST.O.IOSIF”",57,"Alegeri Prezidentiale",1,1362,717,672,45,0,705,12,1400,683,502,203
8,BRAŞOV,"MUNICIPIUL BRAŞOV",40198,BRAŞOV,"ȘCOALĂ GENERALĂ NR. 11 ȘTEFAN OCTAVIAN IOSIF",58,"Alegeri Prezidentiale",1,1391,723,688,35,0,701,22,1400,677,499,202
8,BRAŞOV,"MUNICIPIUL BRAŞOV",40198,BRAŞOV,"ȘCOALĂ GENERALĂ NR. 11 ȘTEFAN OCTAVIAN IOSIF",59,"Alegeri Prezidentiale",1,961,544,522,21,1,525,19,1100,556,376,149
8,BRAŞOV,"MUNICIPIUL BRAŞOV",40198,BRAŞOV,"ŞCOALA GIMNAZIALĂ NR. 11",60,"Alegeri Prezidentiale",1,1218,804,660,144,0,786,18,1300,496,555,231
8,BRAŞOV,"MUNICIPIUL BRAŞOV",40198,BRAŞOV,"ŞCOALA GIMNAZIALĂ NR. 11",61,"Alegeri Prezidentiale",1,1317,770,726,44,0,749,21,1400,630,496,253
8,BRAŞOV,"MUNICIPIUL BRAŞOV",40198,BRAŞOV,"ŞCOALA GIMNAZIALĂ NR. 11",62,"Alegeri Prezidentiale",1,1226,661,632,29,0,645,16,1300,639,436,209
8,BRAŞOV,"MUNICIPIUL BRAŞOV",40198,BRAŞOV,"ŞCOALA GIMNAZIALĂ NR. 11",63,"Alegeri Prezidentiale",1,1251,665,628,37,0,649,16,1400,735,474,175
8,BRAŞOV,"MUNICIPIUL BRAŞOV",40198,BRAŞOV,"ŞCOALA GIMNAZIALĂ NR. 11",64,"Alegeri Prezidentiale",1,1558,894,860,34,0,869,25,1600,706,649,220
8,BRAŞOV,"MUNICIPIUL BRAŞOV",40198,BRAŞOV,"ŞCOALA GIMNAZIALĂ NR. 11",65,"Alegeri Prezidentiale",1,1493,757,737,20,0,743,14,1500,743,517,226
8,BRAŞOV,"MUNICIPIUL BRAŞOV",40198,BRAŞOV,"ŞCOALA GIMNAZIALĂ NR. 25",66,"Alegeri Prezidentiale",1,1505,953,840,111,2,934,19,1600,647,663,271
8,BRAŞOV,"MUNICIPIUL BRAŞOV",40198,BRAŞOV,"ŞCOALA GIMNAZIALĂ NR. 25",67,"Alegeri Prezidentiale",1,1655,895,807,88,0,865,30,1700,805,637,228
8,BRAŞOV,"MUNICIPIUL BRAŞOV",40198,BRAŞOV,"ŞCOALA GIMNAZIALĂ NR. 25",68,"Alegeri Prezidentiale",1,855,606,475,131,0,592,14,900,294,440,152
8,BRAŞOV,"MUNICIPIUL BRAŞOV",40198,BRAŞOV,"ŞCOALA GIMNAZIALĂ NR. 25",69,"Alegeri Prezidentiale",1,1560,911,814,97,0,891,20,1600,689,656,235
8,BRAŞOV,"MUNICIPIUL BRAŞOV",40198,BRAŞOV,"LICEUL DE ARTE PLASTICE „HANS MATTIS-TEUTSCH”",70,"Alegeri Prezidentiale",1,1287,965,721,244,0,939,26,1400,435,720,219
8,BRAŞOV,"MUNICIPIUL BRAŞOV",40198,BRAŞOV,"LICEUL DE ARTE PLASTICE „HANS MATTIS-TEUTSCH”",71,"Alegeri Prezidentiale",1,1213,678,635,43,0,662,16,1300,622,480,182
8,BRAŞOV,"MUNICIPIUL BRAŞOV",40198,BRAŞOV,"LICEUL DE ARTE PLASTICE „HANS MATTIS-TEUTSCH”",72,"Alegeri Prezidentiale",1,1533,868,823,45,0,848,20,1600,732,598,250
8,BRAŞOV,"MUNICIPIUL BRAŞOV",40198,BRAŞOV,"ȘCOALA GIMNAZIALĂ NR. 4",73,"Alegeri Prezidentiale",1,1403,837,704,133,0,813,24,1600,763,612,201
8,BRAŞOV,"MUNICIPIUL BRAŞOV",40198,BRAŞOV,"ȘCOALA GIMNAZIALĂ NR. 4",74,"Alegeri Prezidentiale",1,1145,696,573,123,0,681,15,1300,604,518,163
8,BRAŞOV,"MUNICIPIUL BRAŞOV",40198,BRAŞOV,"ȘCOALA GIMNAZIALĂ NR. 4",75,"Alegeri Prezidentiale",1,1253,710,681,29,0,682,28,1300,590,498,184
8,BRAŞOV,"MUNICIPIUL BRAŞOV",40198,BRAŞOV,"ȘCOALA GIMNAZIALĂ NR. 4",76,"Alegeri Prezidentiale",1,1316,674,652,21,1,657,17,1400,726,453,204
8,BRAŞOV,"MUNICIPIUL BRAŞOV",40198,BRAŞOV,"ȘCOALA GIMNAZIALĂ NR. 4",77,"Alegeri Prezidentiale",1,1583,918,865,52,1,907,11,1600,682,673,234
8,BRAŞOV,"MUNICIPIUL BRAŞOV",40198,BRAŞOV,"ȘCOALA GIMNAZIALĂ NR. 4",78,"Alegeri Prezidentiale",1,1128,633,588,44,1,621,12,1200,567,482,139
8,BRAŞOV,"MUNICIPIUL BRAŞOV",40198,BRAŞOV,"ŞCOALA GIMNAZIALĂ NR. 9 ”NICOLAE ORGHIDAN”",79,"Alegeri Prezidentiale",1,1561,805,724,81,0,789,16,1600,795,594,195
8,BRAŞOV,"MUNICIPIUL BRAŞOV",40198,BRAŞOV,"ŞCOALA GIMNAZIALĂ NR. 9 ”NICOLAE ORGHIDAN”",80,"Alegeri Prezidentiale",1,1642,850,767,83,0,839,11,1700,850,630,209
8,BRAŞOV,"MUNICIPIUL BRAŞOV",40198,BRAŞOV,"ŞCOALA GIMNAZIALĂ NR. 9 ”NICOLAE ORGHIDAN”",81,"Alegeri Prezidentiale",1,1397,785,733,49,3,767,18,1400,615,548,219
8,BRAŞOV,"MUNICIPIUL BRAŞOV",40198,BRAŞOV,"ŞCOALA GIMNAZIALĂ NR. 9",82,"Alegeri Prezidentiale",1,1457,894,729,165,0,873,21,1600,706,621,252
8,BRAŞOV,"MUNICIPIUL BRAŞOV",40198,BRAŞOV,"ŞCOALA GIMNAZIALĂ NR. 9",83,"Alegeri Prezidentiale",1,1034,643,520,123,0,624,19,1100,457,430,194
8,BRAŞOV,"MUNICIPIUL BRAŞOV",40198,BRAŞOV,"ŞCOALA GIMNAZIALĂ NR. 9",84,"Alegeri Prezidentiale",1,1150,633,589,43,1,622,11,1300,667,449,173
8,BRAŞOV,"MUNICIPIUL BRAŞOV",40198,BRAŞOV,"ŞCOALA GIMNAZIALĂ NR. 9",85,"Alegeri Prezidentiale",1,1411,674,642,32,0,662,12,1500,826,444,218
8,BRAŞOV,"MUNICIPIUL BRAŞOV",40198,BRAŞOV,"ŞCOALA GIMNAZIALĂ NR. 9",86,"Alegeri Prezidentiale",1,1575,828,797,31,0,808,20,1600,772,572,236
8,BRAŞOV,"MUNICIPIUL BRAŞOV",40198,BRAŞOV,"ŞCOALA GIMNAZIALĂ NR. 9",87,"Alegeri Prezidentiale",1,1548,829,788,38,3,811,18,1600,771,589,222
8,BRAŞOV,"MUNICIPIUL BRAŞOV",40198,BRAŞOV,"ŞCOALA GIMNAZIALĂ NR. 9",88,"Alegeri Prezidentiale",1,1478,785,715,70,0,769,16,1500,715,536,233
8,BRAŞOV,"MUNICIPIUL BRAŞOV",40198,BRAŞOV,"ȘCOALĂ GENERALĂ NR. 9",89,"Alegeri Prezidentiale",1,1440,744,699,45,0,736,8,1500,756,565,171
8,BRAŞOV,"MUNICIPIUL BRAŞOV",40198,BRAŞOV,"ŞCOALA GIMNAZIALĂ NR. 3 ”GHEORGHE LAZĂR”",90,"Alegeri Prezidentiale",1,1570,1032,857,175,0,1005,27,1600,568,738,267
8,BRAŞOV,"MUNICIPIUL BRAŞOV",40198,BRAŞOV,"ŞCOALA GIMNAZIALĂ NR. 3 ”GHEORGHE LAZĂR”",91,"Alegeri Prezidentiale",1,1573,943,798,145,0,918,25,1700,757,673,245
8,BRAŞOV,"MUNICIPIUL BRAŞOV",40198,BRAŞOV,"ŞCOALA GIMNAZIALĂ NR. 3 ”GHEORGHE LAZĂR”",92,"Alegeri Prezidentiale",1,1667,997,903,92,2,975,22,1700,703,693,282
8,BRAŞOV,"MUNICIPIUL BRAŞOV",40198,BRAŞOV,"ŞCOALA GIMNAZIALĂ NR. 3 ”GHEORGHE LAZĂR”",93,"Alegeri Prezidentiale",1,1252,762,689,73,0,750,12,1400,638,530,220
8,BRAŞOV,"MUNICIPIUL BRAŞOV",40198,BRAŞOV,"ŞCOALA GIMNAZIALĂ NR. 3 ”GHEORGHE LAZĂR”",94,"Alegeri Prezidentiale",1,1546,829,786,42,1,807,22,1600,771,575,232
8,BRAŞOV,"MUNICIPIUL BRAŞOV",40198,BRAŞOV,"ŞCOALA GIMNAZIALĂ NR. 3 ”GHEORGHE LAZĂR”",95,"Alegeri Prezidentiale",1,1471,804,768,36,0,789,15,1500,696,581,208
8,BRAŞOV,"MUNICIPIUL BRAŞOV",40198,BRAŞOV,"ŞCOALA GIMNAZIALĂ NR. 3 ”GHEORGHE LAZĂR”",96,"Alegeri Prezidentiale",1,1651,917,872,43,2,899,18,1700,783,655,244
8,BRAŞOV,"MUNICIPIUL BRAŞOV",40198,BRAŞOV,"LICEUL TEHNOLOGIC SILVIC ”DOCTOR NICOLAE RUCĂREANU”",97,"Alegeri Prezidentiale",1,1089,674,557,117,0,670,4,1200,526,501,169
8,BRAŞOV,"MUNICIPIUL BRAŞOV",40198,BRAŞOV,"LICEUL TEHNOLOGIC SILVIC ”DOCTOR NICOLAE RUCĂREANU”",98,"Alegeri Prezidentiale",1,1392,803,736,67,0,791,12,1400,597,564,227
8,BRAŞOV,"MUNICIPIUL BRAŞOV",40198,BRAŞOV,"LICEUL TEHNOLOGIC SILVIC ”DOCTOR NICOLAE RUCĂREANU”",99,"Alegeri Prezidentiale",1,870,478,456,22,0,472,6,1000,522,333,139
8,BRAŞOV,"MUNICIPIUL BRAŞOV",40198,BRAŞOV,"LICEUL TEHNOLOGIC SILVIC ”DOCTOR NICOLAE RUCĂREANU”",100,"Alegeri Prezidentiale",1,1442,741,710,31,0,730,11,1500,759,506,224
8,BRAŞOV,"MUNICIPIUL BRAŞOV",40198,BRAŞOV,"ŞCOALA GIMNAZIALĂ NR. 2",101,"Alegeri Prezidentiale",1,1512,838,754,82,2,816,22,1600,762,565,251
8,BRAŞOV,"MUNICIPIUL BRAŞOV",40198,BRAŞOV,"ŞCOALA GIMNAZIALĂ NR. 2",102,"Alegeri Prezidentiale",1,1455,918,830,87,1,896,22,1500,582,646,250
8,BRAŞOV,"MUNICIPIUL BRAŞOV",40198,BRAŞOV,"ŞCOALA GIMNAZIALĂ NR. 2",103,"Alegeri Prezidentiale",1,1461,890,785,104,1,870,20,1500,610,604,266
8,BRAŞOV,"MUNICIPIUL BRAŞOV",40198,BRAŞOV,"ŞCOALA GIMNAZIALĂ NR. 2",104,"Alegeri Prezidentiale",1,1601,853,766,86,1,828,25,1700,847,585,243
8,BRAŞOV,"MUNICIPIUL BRAŞOV",40198,BRAŞOV,"ŞCOALA GIMNAZIALĂ NR. 2",105,"Alegeri Prezidentiale",1,1448,814,701,113,0,799,15,1600,786,551,248
8,BRAŞOV,"MUNICIPIUL BRAŞOV",40198,BRAŞOV,"ȘCOALA GIMNAZIALĂ NR. 2",106,"Alegeri Prezidentiale",1,1777,1027,910,117,0,1011,16,1900,873,753,258
8,BRAŞOV,"MUNICIPIUL BRAŞOV",40198,BRAŞOV,"COLEGIUL DE ŞTIINŢE ”GRIGORE ANTIPA”",107,"Alegeri Prezidentiale",1,1447,948,765,183,0,937,11,1600,652,703,234
8,BRAŞOV,"MUNICIPIUL BRAŞOV",40198,BRAŞOV,"COLEGIUL DE ŞTIINŢE ”GRIGORE ANTIPA”",108,"Alegeri Prezidentiale",1,1475,869,755,114,0,853,16,1500,631,659,194
8,BRAŞOV,"MUNICIPIUL BRAŞOV",40198,BRAŞOV,"COLEGIUL DE ŞTIINŢE ”GRIGORE ANTIPA”",109,"Alegeri Prezidentiale",1,1413,797,712,85,0,781,16,1600,803,621,160
8,BRAŞOV,"MUNICIPIUL BRAŞOV",40198,BRAŞOV,"COLEGIUL DE ŞTIINŢE ”GRIGORE ANTIPA”",110,"Alegeri Prezidentiale",1,1193,837,687,60,90,819,18,1600,763,592,227
8,BRAŞOV,"MUNICIPIUL BRAŞOV",40198,BRAŞOV,"COLEGIUL NAŢIONAL DE INFORMATICĂ ”GRIGORE MOISIL”",111,"Alegeri Prezidentiale",1,1190,869,627,241,1,851,18,1300,431,601,250
8,BRAŞOV,"MUNICIPIUL BRAŞOV",40198,BRAŞOV,"COLEGIUL NAŢIONAL DE INFORMATICĂ ”GRIGORE MOISIL”",112,"Alegeri Prezidentiale",1,1375,985,680,220,85,959,26,1500,515,685,274
8,BRAŞOV,"MUNICIPIUL BRAŞOV",40198,BRAŞOV,"COLEGIUL NAŢIONAL DE INFORMATICĂ ”GRIGORE MOISIL”",113,"Alegeri Prezidentiale",1,1564,827,687,139,1,805,22,1600,773,591,214
8,BRAŞOV,"MUNICIPIUL BRAŞOV",40198,BRAŞOV,"COLEGIUL NAŢIONAL DE INFORMATICĂ ”GRIGORE MOISIL”",114,"Alegeri Prezidentiale",1,1348,770,720,50,0,758,12,1400,630,528,230
8,BRAŞOV,"MUNICIPIUL BRAŞOV",40198,BRAŞOV,"COLEGIUL NAŢIONAL DE INFORMATICĂ ”GRIGORE MOISIL”",115,"Alegeri Prezidentiale",1,1579,962,887,75,0,931,31,1600,638,671,260
8,BRAŞOV,"MUNICIPIUL BRAŞOV",40198,BRAŞOV,"COLEGIUL NAŢIONAL DE INFORMATICĂ ”GRIGORE MOISIL”",116,"Alegeri Prezidentiale",1,971,558,447,111,0,547,11,1100,542,395,152
8,BRAŞOV,"MUNICIPIUL BRAŞOV",40198,BRAŞOV,"COLEGIUL NAŢIONAL DE INFORMATICĂ ”GRIGORE MOISIL”",117,"Alegeri Prezidentiale",1,1284,752,677,75,0,739,13,1400,648,534,205
8,BRAŞOV,"MUNICIPIUL BRAŞOV",40198,BRAŞOV,"COLEGIUL NAŢIONAL DE INFORMATICĂ ”GRIGORE MOISIL”",118,"Alegeri Prezidentiale",1,1664,950,898,51,1,921,29,1700,750,661,260
8,BRAŞOV,"MUNICIPIUL BRAŞOV",40198,BRAŞOV,"LICEUL CU PROGRAM SPORTIV",119,"Alegeri Prezidentiale",1,1542,971,867,104,0,947,24,1600,629,670,277
8,BRAŞOV,"MUNICIPIUL BRAŞOV",40198,BRAŞOV,"LICEUL CU PROGRAM SPORTIV",120,"Alegeri Prezidentiale",1,1100,650,544,105,1,635,15,1200,550,487,148
8,BRAŞOV,"MUNICIPIUL BRAŞOV",40198,BRAŞOV,"LICEUL CU PROGRAM SPORTIV",121,"Alegeri Prezidentiale",1,1234,695,645,50,0,678,17,1400,705,467,211
8,BRAŞOV,"MUNICIPIUL BRAŞOV",40198,BRAŞOV,"LICEUL CU PROGRAM SPORTIV",122,"Alegeri Prezidentiale",1,1444,798,756,42,0,788,10,1500,702,524,264
8,BRAŞOV,"MUNICIPIUL BRAŞOV",40198,BRAŞOV,"LICEUL CU PROGRAM SPORTIV",123,"Alegeri Prezidentiale",1,1387,736,702,34,0,720,16,1400,664,495,225
8,BRAŞOV,"MUNICIPIUL BRAŞOV",40198,BRAŞOV,"ŞCOALA GIMNAZIALĂ NR. 1",124,"Alegeri Prezidentiale",1,1445,912,760,150,2,896,16,1600,688,630,266
8,BRAŞOV,"MUNICIPIUL BRAŞOV",40198,BRAŞOV,"ŞCOALA GIMNAZIALĂ NR. 1",125,"Alegeri Prezidentiale",1,1381,827,738,89,0,812,15,1400,573,557,255
8,BRAŞOV,"MUNICIPIUL BRAŞOV",40198,BRAŞOV,"ŞCOALA GIMNAZIALĂ NR. 1",126,"Alegeri Prezidentiale",1,1322,764,710,54,0,745,19,1500,736,510,235
8,BRAŞOV,"MUNICIPIUL BRAŞOV",40198,BRAŞOV,"ŞCOALA GIMNAZIALĂ NR. 1",127,"Alegeri Prezidentiale",1,1629,927,876,45,6,910,17,1700,773,655,255
8,BRAŞOV,"MUNICIPIUL BRAŞOV",40198,BRAŞOV,"ŞCOALA GIMNAZIALĂ NR. 1",128,"Alegeri Prezidentiale",1,1458,750,690,60,0,734,16,1500,750,481,253
8,BRAŞOV,"MUNICIPIUL BRAŞOV",40198,BRAŞOV,"ŞCOALA GIMNAZIALĂ NR. 1",129,"Alegeri Prezidentiale",1,928,525,466,56,3,521,4,1000,475,364,157
8,BRAŞOV,"MUNICIPIUL BRAŞOV",40198,BRAŞOV,"ŞCOALA GIMNAZIALĂ NR. 1",130,"Alegeri Prezidentiale",1,1036,529,507,22,0,517,12,1108,579,339,178
8,BRAŞOV,"MUNICIPIUL BRAŞOV",40198,BRAŞOV,"ŞCOALA GIMNAZIALĂ NR. 1",131,"Alegeri Prezidentiale",1,1563,841,812,27,2,821,20,1600,759,587,234
8,BRAŞOV,"MUNICIPIUL BRAŞOV",40198,BRAŞOV,"CENTRUL REGIONAL DE FORMARE PROFESIONALĂ BRAŞOV",132,"Alegeri Prezidentiale",1,980,523,448,75,0,507,16,1100,577,359,148
8,BRAŞOV,"MUNICIPIUL BRAŞOV",40198,BRAŞOV,"CENTRUL REGIONAL DE FORMARE PROFESIONALĂ BRAŞOV",133,"Alegeri Prezidentiale",1,1267,712,633,77,2,687,25,1400,688,463,224
8,BRAŞOV,"MUNICIPIUL BRAŞOV",40198,BRAŞOV,"CANTINA STUDENŢEASCĂ",134,"Alegeri Prezidentiale",1,1600,1949,807,1142,0,1893,56,2600,651,1611,282
8,BRAŞOV,"MUNICIPIUL BRAŞOV",40198,BRAŞOV,"COLEGIUL NAŢIONAL ECONOMIC ”ANDREI BÂRSEANU”",135,"Alegeri Prezidentiale",1,920,513,468,45,0,502,11,992,479,390,112
8,BRAŞOV,"MUNICIPIUL BRAŞOV",40198,BRAŞOV,"COLEGIUL NAŢIONAL ECONOMIC ”ANDREI BÂRSEANU”",136,"Alegeri Prezidentiale",1,1172,651,592,59,0,631,20,1300,649,473,158
8,BRAŞOV,"MUNICIPIUL BRAŞOV",40198,BRAŞOV,"COLEGIUL NAŢIONAL ECONOMIC ”ANDREI BÂRSEANU”",137,"Alegeri Prezidentiale",1,1190,780,625,103,52,762,18,1300,520,607,155
8,BRAŞOV,"MUNICIPIUL BRAŞOV",40198,BRAŞOV,"ŞCOALA GIMNAZIALĂ NR. 14",138,"Alegeri Prezidentiale",1,1304,679,587,92,0,662,17,1400,721,518,144
8,BRAŞOV,"MUNICIPIUL BRAŞOV",40198,BRAŞOV,"ŞCOALA GIMNAZIALĂ NR. 14",139,"Alegeri Prezidentiale",1,1425,701,613,88,0,689,12,1500,799,525,164
8,BRAŞOV,"MUNICIPIUL BRAŞOV",40198,BRAŞOV,"ŞCOALA GIMNAZIALĂ NR. 14",140,"Alegeri Prezidentiale",1,1611,852,775,77,0,838,14,1700,848,644,194
8,BRAŞOV,"MUNICIPIUL BRAŞOV",40198,BRAŞOV,"ŞCOALA GIMNAZIALĂ NR. 14",141,"Alegeri Prezidentiale",1,1516,793,683,110,0,781,12,1600,807,613,168
8,BRAŞOV,"MUNICIPIUL BRAŞOV",40198,BRAŞOV,"ŞCOALA GIMNAZIALĂ NR. 14",142,"Alegeri Prezidentiale",1,1450,917,752,165,0,907,10,1600,683,745,162
8,BRAŞOV,"MUNICIPIUL BRAŞOV",40198,BRAŞOV,"ŞCOALA GIMNAZIALĂ NR. 14",143,"Alegeri Prezidentiale",1,1659,956,794,162,0,937,19,1700,744,761,176
8,BRAŞOV,"MUNICIPIUL BRAŞOV",40198,BRAŞOV,"ŞCOALA GIMNAZIALĂ NR. 14",144,"Alegeri Prezidentiale",1,1226,695,612,83,0,683,12,1400,705,541,142
8,BRAŞOV,"MUNICIPIUL BRAŞOV",40198,BRAŞOV,"ŞCOALA GIMNAZIALĂ NR. 14",145,"Alegeri Prezidentiale",1,899,466,433,33,0,453,13,1000,534,341,112
8,BRAŞOV,"MUNICIPIUL BRAŞOV",40198,BRAŞOV,"ŞCOALA GIMNAZIALĂ NR. 14",146,"Alegeri Prezidentiale",1,1194,633,602,30,1,614,19,1300,667,448,166
8,BRAŞOV,"MUNICIPIUL BRAŞOV",40198,BRAŞOV,"ŞCOALA GIMNAZIALĂ NR. 14",147,"Alegeri Prezidentiale",1,1397,742,677,64,1,727,15,1500,758,559,168
8,BRAŞOV,"MUNICIPIUL BRAŞOV",40198,BRAŞOV,"ŞCOALA GIMNAZIALĂ NR. 14",148,"Alegeri Prezidentiale",1,1342,663,622,41,0,649,14,1400,737,518,131
8,BRAŞOV,"MUNICIPIUL BRAŞOV",40198,BRAŞOV,"ŞCOALA GIMNAZIALĂ NR. 14",149,"Alegeri Prezidentiale",1,1890,1238,1151,87,0,1215,23,2000,762,1003,212
8,BRAŞOV,"MUNICIPIUL BRAŞOV",40198,BRAŞOV,"ŞCOALA GIMNAZIALĂ NR. 14",150,"Alegeri Prezidentiale",1,1777,1123,1007,116,0,1104,19,1800,677,894,210
8,BRAŞOV,"MUNICIPIUL BRAŞOV",40198,BRAŞOV,"CARTIER AVANTGARDEN",151,"Alegeri Prezidentiale",1,1761,1381,947,434,0,1359,22,2100,719,1196,163
8,BRAŞOV,"MUNICIPIUL BRAŞOV",40198,BRAŞOV,"CARTIER AVANTGARDEN",152,"Alegeri Prezidentiale",1,1679,1357,864,492,1,1332,25,2000,643,1178,154
8,BRAŞOV,"MUNICIPIUL BRAŞOV",40198,BRAŞOV,"ŞCOALA GIMNAZIALĂ NR. 30",153,"Alegeri Prezidentiale",1,1499,945,829,115,1,932,13,1600,655,683,249
8,BRAŞOV,"MUNICIPIUL BRAŞOV",40198,BRAŞOV,"ŞCOALA GIMNAZIALĂ NR. 30",154,"Alegeri Prezidentiale",1,1629,1148,985,163,0,1123,25,1800,652,862,261
8,BRAŞOV,"MUNICIPIUL BRAŞOV",40198,BRAŞOV,"ŞCOALA GIMNAZIALĂ NR. 30",155,"Alegeri Prezidentiale",1,1635,1004,922,82,0,982,22,1700,696,698,284
8,BRAŞOV,"MUNICIPIUL BRAŞOV",40198,BRAŞOV,"ŞCOALA GIMNAZIALĂ NR. 30",156,"Alegeri Prezidentiale",1,1498,824,790,34,0,808,16,1500,676,582,226
8,BRAŞOV,"MUNICIPIUL BRAŞOV",40198,BRAŞOV,"ȘCOALA GIMNAZIALĂ NR. 30",157,"Alegeri Prezidentiale",1,1376,942,880,62,0,923,19,1400,458,770,153
8,BRAŞOV,"MUNICIPIUL BRAŞOV",40198,BRAŞOV,"ŞCOALA GIMNAZIALĂ NR. 30",158,"Alegeri Prezidentiale",1,1581,972,892,80,0,954,18,1600,628,807,147
8,BRAŞOV,"MUNICIPIUL BRAŞOV",40198,BRAŞOV,"ŞCOALA GIMNAZIALĂ NR. 13",159,"Alegeri Prezidentiale",1,1673,1076,869,199,8,1049,27,1800,724,780,269
8,BRAŞOV,"MUNICIPIUL BRAŞOV",40198,BRAŞOV,"ŞCOALA GIMNAZIALĂ NR. 13",160,"Alegeri Prezidentiale",1,1250,855,690,77,88,823,32,1400,545,582,241
8,BRAŞOV,"MUNICIPIUL BRAŞOV",40198,BRAŞOV,"ŞCOALA GIMNAZIALĂ NR. 13",161,"Alegeri Prezidentiale",1,1536,912,832,80,0,881,31,1600,688,627,254
8,BRAŞOV,"MUNICIPIUL BRAŞOV",40198,BRAŞOV,"ŞCOALA GIMNAZIALĂ NR. 13",162,"Alegeri Prezidentiale",1,1511,855,794,61,0,839,16,1600,745,596,243
8,BRAŞOV,"MUNICIPIUL BRAŞOV",40198,BRAŞOV,"ŞCOALA GIMNAZIALĂ NR. 13",163,"Alegeri Prezidentiale",1,1622,864,813,51,0,844,20,1700,836,579,265
8,BRAŞOV,"MUNICIPIUL BRAŞOV",40198,BRAŞOV,"COLEGIUL ”NICOLAE TITULESCU”",164,"Alegeri Prezidentiale",1,1542,1328,658,670,0,1309,19,1900,572,1055,254
8,BRAŞOV,"MUNICIPIUL BRAŞOV",40198,BRAŞOV,"COLEGIUL ”NICOLAE TITULESCU”",165,"Alegeri Prezidentiale",1,1419,901,658,243,0,885,16,1800,899,646,239
8,BRAŞOV,"MUNICIPIUL BRAŞOV",40198,BRAŞOV,"COLEGIUL ”NICOLAE TITULESCU”",166,"Alegeri Prezidentiale",1,1416,1010,729,281,0,996,14,1800,790,729,267
8,BRAŞOV,"MUNICIPIUL BRAŞOV",40198,BRAŞOV,"COLEGIUL ”NICOLAE TITULESCU”",167,"Alegeri Prezidentiale",1,1430,853,699,153,1,839,14,1800,947,584,255
8,BRAŞOV,"MUNICIPIUL BRAŞOV",40198,BRAŞOV,"COLEGIUL ”NICOLAE TITULESCU”",168,"Alegeri Prezidentiale",1,1599,882,798,84,0,843,39,2000,1118,629,214
8,BRAŞOV,"MUNICIPIUL BRAŞOV",40198,BRAŞOV,"COLEGIUL ”NICOLAE TITULESCU”",169,"Alegeri Prezidentiale",1,1435,741,622,119,0,735,6,1800,1059,555,180
8,BRAŞOV,"MUNICIPIUL BRAŞOV",40198,BRAŞOV,"ŞCOALA PROFESIONALĂ GERMANĂ „KRONSTADT”",170,"Alegeri Prezidentiale",1,1820,1438,1186,252,0,1395,43,1900,462,1209,186
8,BRAŞOV,"MUNICIPIUL BRAŞOV",40198,BRAŞOV,"ŞCOALA PROFESIONALĂ GERMANĂ „KRONSTADT”",171,"Alegeri Prezidentiale",1,1232,887,707,180,0,866,21,1300,413,739,127
8,BRAŞOV,"MUNICIPIUL BRAŞOV",40198,BRAŞOV,"COLEGIUL TEHNIC DE TRANSPORTURI",172,"Alegeri Prezidentiale",1,746,422,346,76,0,414,8,800,378,321,93
8,BRAŞOV,"MUNICIPIUL BRAŞOV",40198,BRAŞOV,"COLEGIUL TEHNIC DE TRANSPORTURI",173,"Alegeri Prezidentiale",1,1171,674,610,64,0,656,18,1300,626,455,201
8,BRAŞOV,"MUNICIPIUL BRAŞOV",40198,BRAŞOV,"COLEGIUL TEHNIC DE TRANSPORTURI",174,"Alegeri Prezidentiale",1,1612,790,762,28,0,778,12,1700,910,579,199
8,BRAŞOV,"MUNICIPIUL BRAŞOV",40198,BRAŞOV,"ŞCOALA GIMNAZIALĂ NR. 31",175,"Alegeri Prezidentiale",1,1367,758,716,42,0,734,24,1400,642,501,233
8,BRAŞOV,"MUNICIPIUL BRAŞOV",40198,BRAŞOV,"ŞCOALA GIMNAZIALĂ NR. 31",176,"Alegeri Prezidentiale",1,1395,808,727,81,0,790,18,1400,592,545,245
8,BRAŞOV,"MUNICIPIUL BRAŞOV",40198,BRAŞOV,"ŞCOALA GIMNAZIALĂ NR. 31",177,"Alegeri Prezidentiale",1,1138,637,592,45,0,618,19,1300,663,381,237
8,BRAŞOV,"MUNICIPIUL BRAŞOV",40198,BRAŞOV,"COLEGIUL TEHNIC ”REMUS RĂDULEŢ”",178,"Alegeri Prezidentiale",1,536,269,246,23,0,263,6,600,331,204,59
8,BRAŞOV,"MUNICIPIUL BRAŞOV",40198,BRAŞOV,"COLEGIUL TEHNIC ”REMUS RĂDULEŢ”",179,"Alegeri Prezidentiale",1,983,499,464,35,0,488,11,1100,601,371,117
8,BRAŞOV,"MUNICIPIUL BRAŞOV",40198,BRAŞOV,"COLEGIUL TEHNIC ”REMUS RĂDULEŢ”",180,"Alegeri Prezidentiale",1,1110,538,454,84,0,530,8,1200,662,403,127
8,BRAŞOV,"MUNICIPIUL BRAŞOV",40198,BRAŞOV,"COLEGIUL TEHNIC ”REMUS RĂDULEŢ”",181,"Alegeri Prezidentiale",1,1079,546,507,39,0,531,15,1200,654,382,149
8,BRAŞOV,"MUNICIPIUL BRAŞOV",40198,BRAŞOV,"COLEGIUL TEHNIC ”REMUS RĂDULEŢ”",182,"Alegeri Prezidentiale",1,1035,562,527,35,0,551,11,1100,538,360,191
8,BRAŞOV,"MUNICIPIUL CODLEA",40241,CODLEA,"COLEGIUL TEHNIC SIMION MEHEDINŢI",183,"Alegeri Prezidentiale",1,962,467,423,44,0,462,5,1100,633,348,114
8,BRAŞOV,"MUNICIPIUL CODLEA",40241,CODLEA,"COLEGIUL TEHNIC SIMION MEHEDINŢI",184,"Alegeri Prezidentiale",1,1155,587,561,26,0,575,12,1300,713,383,192
8,BRAŞOV,"MUNICIPIUL CODLEA",40241,CODLEA,"COLEGIUL TEHNIC SIMION MEHEDINŢI",185,"Alegeri Prezidentiale",1,1116,621,577,43,1,612,9,1200,579,414,198
8,BRAŞOV,"MUNICIPIUL CODLEA",40241,CODLEA,"COLEGIUL TEHNIC SIMION MEHEDINTI",186,"Alegeri Prezidentiale",1,1082,550,505,45,0,534,16,1200,650,451,83
8,BRAŞOV,"MUNICIPIUL CODLEA",40241,CODLEA,"ŞCOALA GENERALA NR.2",187,"Alegeri Prezidentiale",1,1074,579,523,56,0,566,13,1200,621,415,151
8,BRAŞOV,"MUNICIPIUL CODLEA",40241,CODLEA,"GRADINITA NR.1",188,"Alegeri Prezidentiale",1,1212,824,550,74,200,801,23,1500,676,459,342
8,BRAŞOV,"MUNICIPIUL CODLEA",40241,CODLEA,"GRADINITA NR.1",189,"Alegeri Prezidentiale",1,1274,902,612,49,241,884,18,1600,698,534,350
8,BRAŞOV,"MUNICIPIUL CODLEA",40241,CODLEA,"GRUP SCOLAR FORESTIER",190,"Alegeri Prezidentiale",1,1556,840,751,89,0,823,17,1608,768,599,224
8,BRAŞOV,"MUNICIPIUL CODLEA",40241,CODLEA,"ŞCOALA GENERALA NR.1",191,"Alegeri Prezidentiale",1,1344,719,616,69,34,705,14,1500,781,495,210
8,BRAŞOV,"MUNICIPIUL CODLEA",40241,CODLEA,"GRADINITA NR.4",192,"Alegeri Prezidentiale",1,1267,547,516,31,0,538,9,1400,853,413,125
8,BRAŞOV,"MUNICIPIUL CODLEA",40241,CODLEA,"GRADINITA NR.4",193,"Alegeri Prezidentiale",1,1741,938,914,24,0,921,17,1800,862,626,295
8,BRAŞOV,"MUNICIPIUL CODLEA",40241,CODLEA,"ŞCOALA GENERALA NR. 3",194,"Alegeri Prezidentiale",1,938,514,461,53,0,508,6,1000,486,341,167
8,BRAŞOV,"MUNICIPIUL CODLEA",40241,CODLEA,"ŞCOALA GENERALA NR. 3",195,"Alegeri Prezidentiale",1,1379,701,678,23,0,686,15,1400,699,460,226
8,BRAŞOV,"MUNICIPIUL CODLEA",40241,CODLEA,"ŞCOALA GENERALA NR. 3",196,"Alegeri Prezidentiale",1,1017,500,479,21,0,491,9,1100,600,344,147
8,BRAŞOV,"MUNICIPIUL CODLEA",40241,CODLEA,"LICEUL TEORETIC",197,"Alegeri Prezidentiale",1,1281,649,611,37,1,637,12,1300,651,435,202
8,BRAŞOV,"MUNICIPIUL CODLEA",40241,CODLEA,"ŞCOALA DE ARTE SI MESERII",198,"Alegeri Prezidentiale",1,1033,551,528,23,0,542,9,1100,549,381,161
8,BRAŞOV,"MUNICIPIUL CODLEA",40241,CODLEA,"ŞCOALA DE ARTE SI MESERII",199,"Alegeri Prezidentiale",1,1436,471,450,21,0,450,21,1500,1029,324,126
8,BRAŞOV,"MUNICIPIUL FĂGĂRAŞ",40278,FĂGĂRAŞ,"SERVICIUL PUBLIC DE ASISTENTA SOCIALA, STR. T. VLADIMIRESCU NR.8",200,"Alegeri Prezidentiale",1,1600,615,578,37,0,607,8,1700,1085,404,203
8,BRAŞOV,"MUNICIPIUL FĂGĂRAŞ",40278,FĂGĂRAŞ,"GRADINITA CU PROGRAM NORMAL „VOINICELUL”",201,"Alegeri Prezidentiale",1,1687,654,614,40,0,644,10,1800,1146,419,225
8,BRAŞOV,"MUNICIPIUL FĂGĂRAŞ",40278,FĂGĂRAŞ,"CASA MUNICIPALĂ DE CULTURĂ",202,"Alegeri Prezidentiale",1,1491,733,637,78,18,716,17,1500,767,533,183
8,BRAŞOV,"MUNICIPIUL FĂGĂRAŞ",40278,FĂGĂRAŞ,"CASA MUNICIPALĂ DE CULTURĂ",203,"Alegeri Prezidentiale",1,1312,583,508,75,0,567,16,1400,817,412,155
8,BRAŞOV,"MUNICIPIUL FĂGĂRAŞ",40278,FĂGĂRAŞ,"ŞCOALA GIMNAZIALĂ ” OVID DENSUŞIANU” - ŞCOALA GENERALĂ NR.4",204,"Alegeri Prezidentiale",1,1151,480,458,22,0,475,5,1300,820,325,150
8,BRAŞOV,"MUNICIPIUL FĂGĂRAŞ",40278,FĂGĂRAŞ,"FUNDAŢIA CULTURALĂ ”NEGRU VODA”",205,"Alegeri Prezidentiale",1,986,530,454,76,0,512,18,1100,570,368,144
8,BRAŞOV,"MUNICIPIUL FĂGĂRAŞ",40278,FĂGĂRAŞ,"COLEGIUL NAŢIONAL ”D-NA STANCA”",206,"Alegeri Prezidentiale",1,1476,645,598,46,1,629,16,1500,855,430,199
8,BRAŞOV,"MUNICIPIUL FĂGĂRAŞ",40278,FĂGĂRAŞ,"COLEGIUL NAŢIONAL ”D-NA STANCA”",207,"Alegeri Prezidentiale",1,1349,632,573,59,0,618,14,1400,768,444,174
8,BRAŞOV,"MUNICIPIUL FĂGĂRAŞ",40278,FĂGĂRAŞ,"COLEGIUL NAŢIONAL ”RADU NEGRU” - ŞCOALA GENERALĂ NR.1",208,"Alegeri Prezidentiale",1,1145,541,486,55,0,528,13,1300,759,384,144
8,BRAŞOV,"MUNICIPIUL FĂGĂRAŞ",40278,FĂGĂRAŞ,"COLEGIUL NAŢIONAL ”RADU NEGRU” - ŞCOALA GENERALĂ NR.1",209,"Alegeri Prezidentiale",1,1321,664,542,54,68,650,14,1900,1236,454,196
8,BRAŞOV,"MUNICIPIUL FĂGĂRAŞ",40278,FĂGĂRAŞ,"COLEGIUL NAŢIONAL „RADU NEGRU”",210,"Alegeri Prezidentiale",1,1172,547,465,82,0,539,8,1300,753,371,168
8,BRAŞOV,"MUNICIPIUL FĂGĂRAŞ",40278,FĂGĂRAŞ,"COLEGIUL NAŢIONAL „RADU NEGRU”",211,"Alegeri Prezidentiale",1,1393,586,551,35,0,576,10,1500,914,397,179
8,BRAŞOV,"MUNICIPIUL FĂGĂRAŞ",40278,FĂGĂRAŞ,"COLEGIUL NAŢIONAL ”D-NA STANCA”-ŞCOALA GIMNAZIALĂ NR.7",212,"Alegeri Prezidentiale",1,1505,531,501,30,0,516,15,1600,1069,349,167
8,BRAŞOV,"MUNICIPIUL FĂGĂRAŞ",40278,FĂGĂRAŞ,"COLEGIUL NAŢIONAL ”D-NA STANCA”-ŞCOALA GIMNAZIALĂ NR.7",213,"Alegeri Prezidentiale",1,1606,580,533,47,0,566,14,1700,1120,398,168
8,BRAŞOV,"MUNICIPIUL FĂGĂRAŞ",40278,FĂGĂRAŞ,"COLEGIUL NAŢIONAL ”D-NA STANCA”-ŞCOALA GIMNAZIALĂ NR. 7",214,"Alegeri Prezidentiale",1,1652,692,645,47,0,685,7,1700,1008,471,214
8,BRAŞOV,"MUNICIPIUL FĂGĂRAŞ",40278,FĂGĂRAŞ,"COLEGIUL „AUREL VIJOLI”",215,"Alegeri Prezidentiale",1,1400,437,407,30,0,430,7,1502,1065,248,182
8,BRAŞOV,"MUNICIPIUL FĂGĂRAŞ",40278,FĂGĂRAŞ,"COLEGIUL „AUREL VIJOLI”",216,"Alegeri Prezidentiale",1,1155,329,307,22,0,327,2,1300,971,207,120
8,BRAŞOV,"MUNICIPIUL FĂGĂRAŞ",40278,FĂGĂRAŞ,"LICEUL TEOLOGIC ORTODOX ”CONSTANTIN BRÂNCOVEANU”",217,"Alegeri Prezidentiale",1,1852,753,705,48,0,743,10,1900,1147,500,243
8,BRAŞOV,"MUNICIPIUL FĂGĂRAŞ",40278,FĂGĂRAŞ,"GRĂDINIȚA CU PROGRAM PRELUNGIT ALBINUȚA",218,"Alegeri Prezidentiale",1,1065,536,498,38,0,528,8,1200,664,403,125
8,BRAŞOV,"MUNICIPIUL FĂGĂRAŞ",40278,FĂGĂRAŞ,"GRĂDINIȚA CU PROGRAM PRELUNGIT ALBINUȚA",219,"Alegeri Prezidentiale",1,1196,482,448,34,0,477,5,1300,818,348,129
8,BRAŞOV,"MUNICIPIUL FĂGĂRAŞ",40278,FĂGĂRAŞ,"LICEUL TEOLOGIC ORTODOX ” SF.. CONSTANTIN BRÂNCOVEANU”",220,"Alegeri Prezidentiale",1,1692,563,525,38,0,546,17,1800,1237,383,163
8,BRAŞOV,"MUNICIPIUL FĂGĂRAŞ",40278,FĂGĂRAŞ,"LICEUL TEOLOGIC ORTODOX ” SF.. CONSTANTIN BRÂNCOVEANU” -GRĂDINIŢA CU PROGRAM NORMAL „MATEIAŞ BRÂNCOVEANU”,",221,"Alegeri Prezidentiale",1,1089,443,398,45,0,435,8,1200,757,302,133
8,BRAŞOV,"MUNICIPIUL FĂGĂRAŞ",40278,FĂGĂRAŞ,"ŞCOALA GIMNAZIALĂ ” OVID DENSUŞIANU”",222,"Alegeri Prezidentiale",1,1108,514,465,49,0,504,10,1200,686,339,165
8,BRAŞOV,"MUNICIPIUL SĂCELE",40438,SĂCELE,"ŞCOALA GIMNAZIALĂ NR. 1, CORPUL A (LÂNGĂ GRĂDINIŢĂ)",223,"Alegeri Prezidentiale",1,1191,684,593,91,0,671,13,1300,616,523,148
8,BRAŞOV,"MUNICIPIUL SĂCELE",40438,SĂCELE,"ŞCOALA GIMNAZIALĂ NR. 1 CORPUL B",224,"Alegeri Prezidentiale",1,1281,700,480,220,0,685,15,1400,700,520,165
8,BRAŞOV,"MUNICIPIUL SĂCELE",40438,SĂCELE,"ŞCOALA GIMNAZIALĂ NR. 1 CORPUL F",225,"Alegeri Prezidentiale",1,1840,1002,932,70,0,967,35,1900,898,763,204
8,BRAŞOV,"MUNICIPIUL SĂCELE",40438,SĂCELE,"LICEU ZAJZONI RAB ISTVAN",226,"Alegeri Prezidentiale",1,1605,854,754,100,0,830,24,1700,846,679,151
8,BRAŞOV,"MUNICIPIUL SĂCELE",40438,SĂCELE,"LICEUL GEORGE MOROIANU CORPUL C",227,"Alegeri Prezidentiale",1,1656,1047,918,129,0,1025,22,1700,653,830,195
8,BRAŞOV,"MUNICIPIUL SĂCELE",40438,SĂCELE,"LICEUL GEORGE MOROIANU CORPUL C",228,"Alegeri Prezidentiale",1,1481,780,745,35,0,763,17,1500,720,608,155
8,BRAŞOV,"MUNICIPIUL SĂCELE",40438,SĂCELE,"SALA DE SPORT",229,"Alegeri Prezidentiale",1,1475,791,737,54,0,770,21,1500,709,528,242
8,BRAŞOV,"MUNICIPIUL SĂCELE",40438,SĂCELE,"SALA DE SPORT",230,"Alegeri Prezidentiale",1,1388,783,735,48,0,766,17,1400,617,548,218
8,BRAŞOV,"MUNICIPIUL SĂCELE",40438,SĂCELE,"LICEUL GEORGE MOROIANU",231,"Alegeri Prezidentiale",1,1706,1047,884,163,0,1017,30,1800,753,827,190
8,BRAŞOV,"MUNICIPIUL SĂCELE",40438,SĂCELE,"ŞCOALA GIMNAZIALĂ NR.4 FRAŢII POPEEA",232,"Alegeri Prezidentiale",1,1630,1022,917,91,14,993,29,1700,678,716,277
8,BRAŞOV,"MUNICIPIUL SĂCELE",40438,SĂCELE,"ŞCOALA GIMNAZIALĂ NR.4 FRAŢII POPEEA",233,"Alegeri Prezidentiale",1,1341,753,695,58,0,738,15,1400,647,498,240
8,BRAŞOV,"MUNICIPIUL SĂCELE",40438,SĂCELE,"ŞCOALA GIMNAZIALĂ NR.4 FRAŢII POPEEA",234,"Alegeri Prezidentiale",1,1132,611,580,31,0,600,11,1200,589,408,192
8,BRAŞOV,"MUNICIPIUL SĂCELE",40438,SĂCELE,"ŞCOALA GIMNAZIALĂ NR.4 FRAŢII POPEEA",235,"Alegeri Prezidentiale",1,1438,726,701,25,0,717,9,1500,774,480,237
8,BRAŞOV,"MUNICIPIUL SĂCELE",40438,SĂCELE,"GRUP ŞCOLAR INDUSTRIAL VICTOR JINGA",236,"Alegeri Prezidentiale",1,1036,483,450,33,0,473,10,1100,617,319,154
8,BRAŞOV,"MUNICIPIUL SĂCELE",40438,SĂCELE,"GRUP ŞCOLAR INDUSTRIAL VICTOR JINGA",237,"Alegeri Prezidentiale",1,1123,532,508,24,0,525,7,1200,668,346,179
8,BRAŞOV,"MUNICIPIUL SĂCELE",40438,SĂCELE,"ŞCOALA GIMNAZIALĂ NR.5 CORPUL B",238,"Alegeri Prezidentiale",1,1120,528,484,44,0,521,7,1200,672,412,109
8,BRAŞOV,"MUNICIPIUL SĂCELE",40438,SĂCELE,"ŞCOALA GIMNAZIALĂ NR.5 CORPUL B",239,"Alegeri Prezidentiale",1,1247,410,384,26,0,391,19,1300,890,238,153
8,BRAŞOV,"MUNICIPIUL SĂCELE",40438,SĂCELE,"ŞCOALA GIMNAZIALĂ NR.5 CORPUL A",240,"Alegeri Prezidentiale",1,1121,414,399,15,0,393,21,1200,786,143,250
8,BRAŞOV,"MUNICIPIUL SĂCELE",40438,SĂCELE,"ŞCOALA GIMNAZIALĂ NR.5 CORPUL A",241,"Alegeri Prezidentiale",1,1336,578,564,14,0,548,30,1400,822,227,321
8,BRAŞOV,"MUNICIPIUL SĂCELE",40438,SĂCELE,"ȘCOALA GIMNAZIALĂ NR.1 , CORPUL B",242,"Alegeri Prezidentiale",1,1249,833,639,194,0,816,17,1400,567,622,194
8,BRAŞOV,"ORAŞ GHIMBAV",40214,GHIMBAV,"PRIMĂRIA GHIMBAV",243,"Alegeri Prezidentiale",1,1957,1270,1092,178,0,1250,20,1989,719,927,323
8,BRAŞOV,"ORAŞ GHIMBAV",40214,GHIMBAV,"ŞCOALA GENERALĂ GHIMBAV CLASELE V-VIII",244,"Alegeri Prezidentiale",1,1841,1203,970,232,1,1182,21,1900,697,915,267
8,BRAŞOV,"ORAŞ GHIMBAV",40214,GHIMBAV,"ŞCOALA GENERALĂ GHIMBAV CLASELE I-IV",245,"Alegeri Prezidentiale",1,1909,1118,985,132,1,1104,14,2000,882,864,240
8,BRAŞOV,"ORAŞ PREDEAL",40303,PREDEAL,"CENTRUL DE CULTURĂ MIHAIL SAULESCU",246,"Alegeri Prezidentiale",1,1230,1426,581,845,0,1389,37,1800,374,948,441
8,BRAŞOV,"ORAŞ PREDEAL",40303,PREDEAL,"LICEUL TEORETIC MIHAIL SAULESCU",247,"Alegeri Prezidentiale",1,978,605,465,140,0,587,18,1300,695,376,211
8,BRAŞOV,"ORAŞ PREDEAL",40303,PREDEAL,"LICEUL TEORETIC MIHAIL SĂULESCU",248,"Alegeri Prezidentiale",1,1132,858,577,281,0,835,23,1400,542,603,232
8,BRAŞOV,"ORAŞ PREDEAL",40303,"TIMIŞU DE SUS","AGENȚIA POȘTALĂ",249,"Alegeri Prezidentiale",1,301,167,129,36,2,163,4,400,233,116,47
8,BRAŞOV,"ORAŞ PREDEAL",40303,"TIMIŞU DE JOS","GRADINITA CU PROGRAM NORMAL TIMISUL DE JOS",250,"Alegeri Prezidentiale",1,338,177,138,39,0,171,6,400,223,134,37
8,BRAŞOV,"ORAŞ PREDEAL",40303,PREDEAL,"OFICIUL POSTAL DAMBUL MORII",251,"Alegeri Prezidentiale",1,181,179,100,79,0,174,5,200,21,138,36
8,BRAŞOV,"ORAŞ RÂŞNOV",40367,RÂŞNOV,"ȘCOALA GENERALĂ NR. 1 RÂȘNOV",252,"Alegeri Prezidentiale",1,1549,871,816,54,1,855,16,1600,729,636,219
8,BRAŞOV,"ORAŞ RÂŞNOV",40367,RÂŞNOV,"ȘCOALA GENERALĂ NR. 1 RÂȘNOV",253,"Alegeri Prezidentiale",1,1261,589,521,68,0,580,9,1400,811,402,178
8,BRAŞOV,"ORAŞ RÂŞNOV",40367,RÂŞNOV,"ȘCOALA GENERALĂ NR. 3 RÂȘNOV",254,"Alegeri Prezidentiale",1,1252,785,680,105,0,763,22,1400,615,520,243
8,BRAŞOV,"ORAŞ RÂŞNOV",40367,RÂŞNOV,"ȘCOALA GENERALĂ NR. 3 RÂȘNOV",255,"Alegeri Prezidentiale",1,1622,933,849,84,0,907,26,1700,767,651,256
8,BRAŞOV,"ORAŞ RÂŞNOV",40367,RÂŞNOV,"GRĂDINIŢA NR.1",256,"Alegeri Prezidentiale",1,917,463,429,33,1,455,8,1000,537,334,121
8,BRAŞOV,"ORAŞ RÂŞNOV",40367,RÂŞNOV,"ȘCOALA GENERALĂ NR. 2 RÂȘNOV",257,"Alegeri Prezidentiale",1,1641,861,791,70,0,835,26,1800,939,596,239
8,BRAŞOV,"ORAŞ RÂŞNOV",40367,RÂŞNOV,"ȘCOALA GENERALĂ NR. 2 RÂȘNOV",258,"Alegeri Prezidentiale",1,1426,861,736,124,1,845,16,1600,739,636,209
8,BRAŞOV,"ORAŞ RÂŞNOV",40367,RÂŞNOV,"ȘCOALA GENERALĂ NR. 2 RÂȘNOV",259,"Alegeri Prezidentiale",1,1237,723,645,77,1,708,15,1400,677,516,192
8,BRAŞOV,"ORAŞ RÂŞNOV",40367,RÂŞNOV,"GRUP ȘCOLAR INDUSTRIAL RÂȘNOV",260,"Alegeri Prezidentiale",1,1022,754,541,213,0,735,19,1100,346,520,215
8,BRAŞOV,"ORAŞ RÂŞNOV",40367,RÂŞNOV,"GRUP ȘCOLAR INDUSTRIAL RÂȘNOV",261,"Alegeri Prezidentiale",1,1439,891,790,101,0,875,16,1600,709,684,191
8,BRAŞOV,"ORAŞ RÂŞNOV",40367,RÂŞNOV,"GRUP ȘCOLAR INDUSTRIAL RÂȘNOV",262,"Alegeri Prezidentiale",1,1485,770,721,48,1,758,12,1600,830,530,228
8,BRAŞOV,"ORAŞ RUPEA",40394,RUPEA,"ŞCOALA GENERALA I",263,"Alegeri Prezidentiale",1,1115,449,416,33,0,440,9,1200,751,324,116
8,BRAŞOV,"ORAŞ RUPEA",40394,RUPEA,"CASA ORASENEASCA DE CULTURA",264,"Alegeri Prezidentiale",1,1211,570,469,79,22,555,15,1500,930,401,154
8,BRAŞOV,"ORAŞ RUPEA",40394,RUPEA,"SCOALA GENERALA II",265,"Alegeri Prezidentiale",1,1536,693,635,57,1,675,18,1700,1007,498,177
8,BRAŞOV,"ORAŞ RUPEA",40394,RUPEA,"CLUB MUNCITORESC BRAFOR GARA RUPEA",266,"Alegeri Prezidentiale",1,559,247,226,21,0,243,4,600,353,176,67
8,BRAŞOV,"ORAŞ RUPEA",40394,FIŞER,"SCOALA PRIMARA FISER",267,"Alegeri Prezidentiale",1,388,173,154,19,0,171,2,400,227,125,46
8,BRAŞOV,"ORAŞ VICTORIA",40465,VICTORIA,"PRIMARIA VICTORIA",268,"Alegeri Prezidentiale",1,1250,500,454,46,0,494,6,1400,900,365,129
8,BRAŞOV,"ORAŞ VICTORIA",40465,VICTORIA,"LICEUL TEORETIC I.C. DRĂGUȘANU",269,"Alegeri Prezidentiale",1,1601,644,573,71,0,638,6,1800,1156,504,134
8,BRAŞOV,"ORAŞ VICTORIA",40465,VICTORIA,"ŞCOALA GIMNAZIALA VICTORIA",270,"Alegeri Prezidentiale",1,1638,724,655,68,1,712,12,1800,1076,579,133
8,BRAŞOV,"ORAŞ VICTORIA",40465,VICTORIA,"COLEGIUL TEHNIC DR. ALEXANDRU BĂRBAT",271,"Alegeri Prezidentiale",1,1038,502,440,45,17,498,4,1200,698,375,123
8,BRAŞOV,"ORAŞ VICTORIA",40465,VICTORIA,"GRĂDINIŢA NR. 1",272,"Alegeri Prezidentiale",1,1474,574,525,49,0,566,8,1600,1026,453,113
8,BRAŞOV,"ORAŞ ZĂRNEŞTI",40492,ZĂRNEŞTI,"GRĂDINIŢA BOBOCEL",273,"Alegeri Prezidentiale",1,1401,735,704,31,0,718,17,1500,765,493,225
8,BRAŞOV,"ORAŞ ZĂRNEŞTI",40492,ZĂRNEŞTI,"LICEUL TEORETIC M.I.MEŢIANU - CORP A",274,"Alegeri Prezidentiale",1,1327,801,689,112,0,795,6,1500,699,548,247
8,BRAŞOV,"ORAŞ ZĂRNEŞTI",40492,ZĂRNEŞTI,"LICEUL TEORETIC M.I.MEŢIANU - CORP B",275,"Alegeri Prezidentiale",1,1363,862,769,93,0,847,15,1500,638,596,251
8,BRAŞOV,"ORAŞ ZĂRNEŞTI",40492,ZĂRNEŞTI,"LICEUL TEORETIC M.I.MEŢIANU - CORP B",276,"Alegeri Prezidentiale",1,1618,883,826,57,0,863,20,1800,917,614,249
8,BRAŞOV,"ORAŞ ZĂRNEŞTI",40492,ZĂRNEŞTI,"CASA DE CULTURĂ",277,"Alegeri Prezidentiale",1,1296,728,652,76,0,714,14,1400,672,528,186
8,BRAŞOV,"ORAŞ ZĂRNEŞTI",40492,ZĂRNEŞTI,"GRĂDINIŢA VOINICELUL NR. 2",278,"Alegeri Prezidentiale",1,1202,692,615,77,0,680,12,1300,608,478,202
8,BRAŞOV,"ORAŞ ZĂRNEŞTI",40492,ZĂRNEŞTI,"CLUBUL PENSIONARILOR - CARAIMAN",279,"Alegeri Prezidentiale",1,1431,759,726,33,0,746,13,1600,841,489,257
8,BRAŞOV,"ORAŞ ZĂRNEŞTI",40492,ZĂRNEŞTI,"CLUBUL PENSIONARILOR",280,"Alegeri Prezidentiale",1,1251,727,681,46,0,716,11,1400,673,454,262
8,BRAŞOV,"ORAŞ ZĂRNEŞTI",40492,ZĂRNEŞTI,"ŞCOALA GIMNAZIALĂ NR. 3 POMPILIU DAN-CORP A",281,"Alegeri Prezidentiale",1,979,609,519,90,0,593,16,1100,491,453,140
8,BRAŞOV,"ORAŞ ZĂRNEŞTI",40492,ZĂRNEŞTI,"SPITALUL ORĂŞENESC DR. CAIUS TIBERIU SPÂRCHEZ",282,"Alegeri Prezidentiale",1,1299,822,734,77,11,803,19,1400,578,470,333
8,BRAŞOV,"ORAŞ ZĂRNEŞTI",40492,ZĂRNEŞTI,"ŞCOALA GIMNAZIALĂ NR. 1 GHEORGHE CRĂCIUN CORP B",283,"Alegeri Prezidentiale",1,1338,756,699,57,0,730,26,1500,744,446,284
8,BRAŞOV,"ORAŞ ZĂRNEŞTI",40492,ZĂRNEŞTI,"ŞCOALA GIMNAZIALĂ NR. 1 GHEORGHE CRĂCIUN",284,"Alegeri Prezidentiale",1,1370,799,747,30,22,782,17,1500,701,515,267
8,BRAŞOV,"ORAŞ ZĂRNEŞTI",40492,ZĂRNEŞTI,"LICEUL TEHNOLOGIC MALAXA",285,"Alegeri Prezidentiale",1,1014,407,367,40,0,398,9,1100,693,264,134
8,BRAŞOV,"ORAŞ ZĂRNEŞTI",40492,ZĂRNEŞTI,"SCOALA GIMNAZIALA NR. 2",286,"Alegeri Prezidentiale",1,1617,424,379,45,0,408,16,1800,1376,246,162
8,BRAŞOV,"ORAŞ ZĂRNEŞTI",40492,"TOHANU NOU","CĂMINUL CULTURAL TOHANUL NOU",287,"Alegeri Prezidentiale",1,1182,799,692,107,0,774,25,1300,501,556,218
8,BRAŞOV,"ORAŞ ZĂRNEŞTI",40492,ZĂRNEŞTI,"CAMINUL CULTURAL TOHANUL VECHI",288,"Alegeri Prezidentiale",1,1711,908,855,53,0,896,12,1900,992,628,268
8,BRAŞOV,APAŢA,40526,APAŢA,"PRIMĂRIA COMUNEI APAȚA",289,"Alegeri Prezidentiale",1,1261,373,346,27,0,366,7,1350,977,319,47
8,BRAŞOV,APAŢA,40526,APAŢA,"PRIMĂRIA COMUNEI APAȚA",290,"Alegeri Prezidentiale",1,1163,356,338,17,1,352,4,1350,994,283,69
8,BRAŞOV,AUGUSTIN,42498,AUGUSTIN,"GRĂDINIȚA DE COPII",291,"Alegeri Prezidentiale",1,1306,440,384,54,2,434,6,1400,960,261,173
8,BRAŞOV,BECLEAN,40544,BECLEAN,"SCOALA GENERALA BECLEAN",292,"Alegeri Prezidentiale",1,651,302,237,65,0,296,6,697,395,223,73
8,BRAŞOV,BECLEAN,40544,HUREZ,"CLADIRE FOST SEDIU PRIMARIE",293,"Alegeri Prezidentiale",1,374,241,190,51,0,238,3,396,155,173,65
8,BRAŞOV,BECLEAN,40544,BOHOLŢ,"CAMIN CULTURAL BOHOLT",294,"Alegeri Prezidentiale",1,154,100,78,22,0,97,3,200,100,71,26
8,BRAŞOV,BECLEAN,40544,CALBOR,"SCOALA GENERALA CALBOR",295,"Alegeri Prezidentiale",1,189,130,91,39,0,129,1,200,70,115,14
8,BRAŞOV,BECLEAN,40544,LUŢA,"CAMIN CULTURAL LUTA",296,"Alegeri Prezidentiale",1,57,65,34,31,0,61,4,100,35,43,18
8,BRAŞOV,BOD,40606,BOD,"ȘCOALA GIMNAZIALĂ BOD SAT",297,"Alegeri Prezidentiale",1,1238,738,606,132,0,733,5,1300,562,535,198
8,BRAŞOV,BOD,40606,BOD,"CĂMINUL CULTURAL",298,"Alegeri Prezidentiale",1,1150,626,524,102,0,615,11,1300,674,459,156
8,BRAŞOV,BOD,40606,"COLONIA BOD","GRĂDINIŢA BOD COLONIE",299,"Alegeri Prezidentiale",1,903,526,412,114,0,521,5,1000,474,414,107
8,BRAŞOV,BOD,40606,"COLONIA BOD","ȘCOALA GENERALĂ COLONIA BOD",300,"Alegeri Prezidentiale",1,955,478,430,48,0,472,6,1000,522,380,92
8,BRAŞOV,BRAN,40633,BRAN,"PRIMĂRIA COMUNEI BRAN",301,"Alegeri Prezidentiale",1,802,941,365,575,1,926,15,1099,158,751,175
8,BRAŞOV,BRAN,40633,BRAN,"CĂMINUL CULTURAL POARTA",302,"Alegeri Prezidentiale",1,897,603,447,156,0,594,9,1192,589,420,174
8,BRAŞOV,BRAN,40633,PREDELUŢ,"ŞCOALA GENERALĂ PREDELUŢ",303,"Alegeri Prezidentiale",1,877,773,489,284,0,760,13,1200,427,584,176
8,BRAŞOV,BRAN,40633,SOHODOL,"CĂMINUL CULTURAL SOHODOL",304,"Alegeri Prezidentiale",1,914,462,364,98,0,454,8,1200,738,360,94
8,BRAŞOV,BRAN,40633,ŞIMON,"CĂMINUL CULTURAL ŞIMON",305,"Alegeri Prezidentiale",1,1022,675,471,204,0,663,12,1300,625,513,150
8,BRAŞOV,BUDILA,40688,BUDILA,"ȘCOALA GIMNAZIALĂ BUDILA",306,"Alegeri Prezidentiale",1,1046,687,656,23,8,667,20,1100,413,542,125
8,BRAŞOV,BUDILA,40688,BUDILA,"ȘCOALA GIMNAZIALĂ BUDILA",307,"Alegeri Prezidentiale",1,1111,514,486,28,0,509,5,1200,686,421,88
8,BRAŞOV,BUDILA,40688,BUDILA,"PRIMĂRIA COMUNEI BUDILA",308,"Alegeri Prezidentiale",1,934,573,539,30,4,555,18,1000,427,409,146
8,BRAŞOV,BUNEŞTI,40704,BUNEŞTI,"PRIMĂRIA BUNEŞTI",309,"Alegeri Prezidentiale",1,612,237,196,41,0,237,0,700,463,166,71
8,BRAŞOV,BUNEŞTI,40704,CRIŢ,"ŞCOALA PRIMARĂ CRIȚ",310,"Alegeri Prezidentiale",1,552,236,199,37,0,229,7,600,364,182,47
8,BRAŞOV,BUNEŞTI,40704,MEŞENDORF,"CĂMINUL CULTURAL MEŞENDORF",311,"Alegeri Prezidentiale",1,303,109,78,31,0,108,1,299,190,75,33
8,BRAŞOV,BUNEŞTI,40704,ROADEŞ,"ŞCOALA PRIMARĂ ROADEŞ",312,"Alegeri Prezidentiale",1,262,136,105,31,0,135,1,300,164,110,25
8,BRAŞOV,BUNEŞTI,40704,VISCRI,"ŞCOALA PRIMARĂ VISCRI",313,"Alegeri Prezidentiale",1,368,179,99,80,0,176,3,400,221,140,36
8,BRAŞOV,CAŢA,40768,CAŢA,"CĂMINUL CULTURAL CAŢA",314,"Alegeri Prezidentiale",1,1041,455,414,41,0,450,5,1100,645,329,121
8,BRAŞOV,CAŢA,40768,BEIA,"ŞCOALA GENERALĂ BEIA",315,"Alegeri Prezidentiale",1,319,147,129,18,0,146,1,400,253,108,38
8,BRAŞOV,CAŢA,40768,DRĂUŞENI,"GRĂDINIŢA DRĂUŞENI",316,"Alegeri Prezidentiale",1,404,188,177,11,0,186,2,500,312,162,24
8,BRAŞOV,CAŢA,40768,IONEŞTI,"CĂMINUL CULTURAL IONEŞTI",317,"Alegeri Prezidentiale",1,101,54,45,9,0,54,0,200,146,50,4
8,BRAŞOV,CAŢA,40768,PALOŞ,"ŞCOALA GENERALĂ PALOŞ",318,"Alegeri Prezidentiale",1,189,117,77,40,0,113,4,200,83,82,31
8,BRAŞOV,CINCU,40820,CINCU,"GRĂDINIȚA CU PROGRAM PRELUNGIT CINCU",319,"Alegeri Prezidentiale",1,1286,702,579,120,3,694,8,2192,1490,564,130
8,BRAŞOV,CINCU,40820,TOARCLA,"ȘCOALA GENERALĂ TOARCLA",320,"Alegeri Prezidentiale",1,281,149,127,19,3,149,0,301,152,118,31
8,BRAŞOV,COMANA,40857,"COMANA DE JOS","CĂMINUL CULTURAL COMĂNA DE JOS",321,"Alegeri Prezidentiale",1,846,336,292,44,0,328,8,900,564,241,87
8,BRAŞOV,COMANA,40857,"COMANA DE SUS","CĂMINUL CULTURAL COMĂNA DE SUS",322,"Alegeri Prezidentiale",1,288,151,111,39,1,149,2,300,149,91,58
8,BRAŞOV,COMANA,40857,CRIHALMA,"CĂMINUL CULTURAL CRIHALMA",323,"Alegeri Prezidentiale",1,563,258,240,18,0,256,2,600,342,196,60
8,BRAŞOV,COMANA,40857,"TICUŞU NOU","CĂMINUL CULTURAL TICUŞU NOU",324,"Alegeri Prezidentiale",1,460,228,211,17,0,226,2,500,272,158,68
8,BRAŞOV,CRISTIAN,40900,CRISTIAN,"GRADINITA DE COPII CRISTIAN",325,"Alegeri Prezidentiale",1,1664,1296,947,349,0,1272,24,1800,504,1031,241
8,BRAŞOV,CRISTIAN,40900,CRISTIAN,"CAMINUL CULTURAL NR. 1",326,"Alegeri Prezidentiale",1,1262,805,661,143,1,790,15,1400,595,613,177
8,BRAŞOV,CRISTIAN,40900,CRISTIAN,"SCOALA GENERALA, CORP B",327,"Alegeri Prezidentiale",1,1650,1135,953,182,0,1123,12,1808,673,853,270
8,BRAŞOV,CRIZBAV,42456,CRIZBAV,"CĂMINUL CULTURAL",328,"Alegeri Prezidentiale",1,1366,662,579,83,0,648,14,1500,838,414,234
8,BRAŞOV,CRIZBAV,42456,CUTUŞ,"ŞCOALA PRIMARĂ CUTUŞ",329,"Alegeri Prezidentiale",1,576,234,211,23,0,226,8,600,366,72,154
8,BRAŞOV,DRĂGUŞ,42480,DRĂGUŞ,"PRIMĂRIA DRĂGUŞ",330,"Alegeri Prezidentiale",1,910,636,495,122,19,628,8,1000,364,555,73
8,BRAŞOV,DUMBRĂVIŢA,40928,DUMBRĂVIŢA,"PRIMĂRIA COMUNEI DUMBRĂVIŢA",331,"Alegeri Prezidentiale",1,1601,722,649,73,0,714,8,1800,1078,568,146
8,BRAŞOV,DUMBRĂVIŢA,40928,DUMBRĂVIŢA,"GRĂDINIŢA CU PROGRAM NORMAL DUMBRĂVIŢA",332,"Alegeri Prezidentiale",1,1769,849,795,54,0,839,10,1900,1051,642,197
8,BRAŞOV,DUMBRĂVIŢA,40928,VLĂDENI,"ŞCOALA GENERALĂ SAT VLĂDENI",333,"Alegeri Prezidentiale",1,713,435,321,114,0,427,8,800,365,317,110
8,BRAŞOV,FELDIOARA,40955,FELDIOARA,"CĂMINUL CULTURAL FELDIOARA",334,"Alegeri Prezidentiale",1,1804,867,799,68,0,857,10,2000,1133,607,250
8,BRAŞOV,FELDIOARA,40955,FELDIOARA,"LICEUL TEORETIC PETRU RAREȘ FELDIOARA",335,"Alegeri Prezidentiale",1,1315,744,674,70,0,733,11,1400,656,540,193
8,BRAŞOV,FELDIOARA,40955,FELDIOARA,"LICEUL TEORETIC PETRU RAREȘ FELDIOARA",336,"Alegeri Prezidentiale",1,1193,489,472,17,0,485,4,1300,811,324,161
8,BRAŞOV,FELDIOARA,40955,ROTBAV,"CĂMINUL CULTURAL ROTBAV",337,"Alegeri Prezidentiale",1,1077,615,504,111,0,604,11,1200,585,439,165
8,BRAŞOV,FELDIOARA,40955,"COLONIA RECONSTRUCŢIA","CĂMINUL CULTURAL RECONSTRUCŢIA",338,"Alegeri Prezidentiale",1,592,309,294,15,0,304,5,706,397,228,76
8,BRAŞOV,FUNDATA,40991,FUNDATA,"ŞCOALA GENERALĂ FUNDATA",339,"Alegeri Prezidentiale",1,456,443,233,200,10,433,10,503,60,325,108
8,BRAŞOV,FUNDATA,40991,ŞIRNEA,"ŞCOALA GENERALĂ ŞIRNEA",340,"Alegeri Prezidentiale",1,211,150,86,61,3,149,1,500,350,122,27
8,BRAŞOV,HĂLCHIU,41033,HĂLCHIU,"CĂMINUL CULTURAL",341,"Alegeri Prezidentiale",1,1520,820,715,105,0,809,11,1700,880,619,190
8,BRAŞOV,HĂLCHIU,41033,HĂLCHIU,"LOCAȚIA KREDENT",342,"Alegeri Prezidentiale",2,1484,868,755,113,0,850,18,1600,732,646,204
8,BRAŞOV,HĂLCHIU,41033,"SATU NOU","CAMIN CULTURAL",343,"Alegeri Prezidentiale",1,999,416,367,49,0,403,13,1100,684,317,86
8,BRAŞOV,HĂRMAN,41088,"PODU OLTULUI","CĂMINUL CULTURAL",344,"Alegeri Prezidentiale",1,648,510,369,141,0,498,12,700,190,391,107
8,BRAŞOV,HĂRMAN,41088,HĂRMAN,"SCOALA GIMNAZIALA HARMAN",345,"Alegeri Prezidentiale",1,1703,968,832,135,1,948,20,1900,932,746,202
8,BRAŞOV,HĂRMAN,41088,HĂRMAN,"SCOALA GIMNAZIALA HARMAN",346,"Alegeri Prezidentiale",1,1637,944,775,169,0,931,13,1800,856,727,204
8,BRAŞOV,HĂRMAN,41088,HĂRMAN,"SCOALA GIMNAZIALA HARMAN",347,"Alegeri Prezidentiale",1,1529,911,794,117,0,894,17,1700,789,682,212
8,BRAŞOV,HÂRSENI,41113,HÂRSENI,"ŞCOALA GIMNAZIALĂ PROF.DR. IOAN CERGHIT HÂRSENI",348,"Alegeri Prezidentiale",1,481,257,229,28,0,255,2,500,243,159,96
8,BRAŞOV,HÂRSENI,41113,SEBEŞ,"GRĂDINIȚA SEBEȘ",349,"Alegeri Prezidentiale",1,659,342,269,71,2,338,4,700,358,246,92
8,BRAŞOV,HÂRSENI,41113,MĂRGINENI,"GRĂDINIȚA MĂRGINENI",350,"Alegeri Prezidentiale",1,249,170,115,55,0,169,1,300,130,115,54
8,BRAŞOV,HÂRSENI,41113,COPĂCEL,"GRĂDINIȚA COPĂCEL",351,"Alegeri Prezidentiale",1,512,312,258,54,0,306,6,600,288,225,81
8,BRAŞOV,HOGHIZ,41177,HOGHIZ,"CĂMINUL CULTURAL HOGHIZ",352,"Alegeri Prezidentiale",1,1006,429,381,48,0,422,7,1100,671,345,77
8,BRAŞOV,HOGHIZ,41177,HOGHIZ,"CĂMINUL CULTURAL HOGHIZ",353,"Alegeri Prezidentiale",1,793,310,294,16,0,306,4,900,590,241,65
8,BRAŞOV,HOGHIZ,41177,"BOGATA OLTEANĂ","CĂMINUL CULTURAL BOGATA",354,"Alegeri Prezidentiale",1,331,159,139,20,0,157,2,400,241,88,69
8,BRAŞOV,HOGHIZ,41177,CUCIULATA,"ȘCOALA GIMNAZIALĂ ”ARON PUMNU” CUCIULATA",355,"Alegeri Prezidentiale",1,1150,429,379,50,0,424,5,1300,871,231,193
8,BRAŞOV,HOGHIZ,41177,DOPCA,"CĂMINUL CULTURAL DOPCA",356,"Alegeri Prezidentiale",1,400,182,170,12,0,180,2,500,318,148,32
8,BRAŞOV,HOGHIZ,41177,FÂNTÂNA,"CĂMUNUL CULTURAL FÂNTÂNA",357,"Alegeri Prezidentiale",1,211,151,124,27,0,150,1,300,149,117,33
8,BRAŞOV,HOGHIZ,41177,LUPŞA,"CĂMINUL CULTURAL LUPŞA",358,"Alegeri Prezidentiale",1,81,67,43,24,0,67,0,100,33,43,24
8,BRAŞOV,HOLBAV,42472,HOLBAV,"PRIMARIA COMUNEI HOLBAV",359,"Alegeri Prezidentiale",1,1014,500,472,28,0,495,5,1100,600,369,126
8,BRAŞOV,HOMOROD,41248,HOMOROD,"CAMIN CULTURAL HOMOROD",360,"Alegeri Prezidentiale",1,1200,375,357,18,0,368,7,1300,925,266,102
8,BRAŞOV,HOMOROD,41248,MERCHEAŞA,"CAMIN CULTURAL MERCHEASA",361,"Alegeri Prezidentiale",1,408,169,142,27,0,168,1,500,331,128,40
8,BRAŞOV,HOMOROD,41248,JIMBOR,"CAMIN CULTURAL JIMBOR",362,"Alegeri Prezidentiale",1,379,113,90,23,0,105,8,400,287,84,21
8,BRAŞOV,JIBERT,41284,JIBERT,"ŞCOALA GENERALĂ JIBERT",363,"Alegeri Prezidentiale",1,632,205,182,23,0,201,4,700,495,171,30
8,BRAŞOV,JIBERT,41284,DACIA,"ŞCOALA GENERALĂ DACIA",364,"Alegeri Prezidentiale",1,607,225,195,30,0,222,3,700,475,142,80
8,BRAŞOV,JIBERT,41284,LOVNIC,"ŞCOALA GENERALĂ LOVNIC",365,"Alegeri Prezidentiale",1,437,139,112,27,0,138,1,500,361,104,34
8,BRAŞOV,JIBERT,41284,GRÂNARI,"ŞCOALA GENERALĂ GRÎNARI",366,"Alegeri Prezidentiale",1,290,135,118,17,0,135,0,300,165,127,8
8,BRAŞOV,JIBERT,41284,VĂLENI,"ŞCOALA GENERALĂ VĂLENI",367,"Alegeri Prezidentiale",1,133,95,64,31,0,94,1,200,105,54,40
8,BRAŞOV,LISA,41346,LISA,"CĂMINUL CULTURAL LISA",368,"Alegeri Prezidentiale",1,875,530,426,100,4,522,8,1000,470,294,228
8,BRAŞOV,LISA,41346,BREAZA,"CĂMINUL CULTURAL BREAZA",369,"Alegeri Prezidentiale",1,560,369,272,97,0,366,3,600,231,234,132
8,BRAŞOV,MĂIERUŞ,41382,MĂIERUŞ,"CAMINUL CULTURAL MAIERUS",370,"Alegeri Prezidentiale",1,1464,820,759,61,0,813,7,1600,780,664,149
8,BRAŞOV,MĂIERUŞ,41382,ARINI,"CAMINUL CULTURAL ARINI",371,"Alegeri Prezidentiale",1,780,489,431,58,0,480,9,900,411,387,93
8,BRAŞOV,MÂNDRA,41417,MÂNDRA,"SCOALA GENERALA MÂNDRA",372,"Alegeri Prezidentiale",1,946,514,399,115,0,506,8,1000,486,306,200
8,BRAŞOV,MÂNDRA,41417,ILENI,"AŞEZAMÂNT CULTURAL",373,"Alegeri Prezidentiale",1,650,352,274,78,0,346,6,700,348,244,102
8,BRAŞOV,MÂNDRA,41417,RÂUŞOR,"AŞEZAMÂNT CULTURAL",374,"Alegeri Prezidentiale",1,435,289,220,69,0,288,1,500,211,209,79
8,BRAŞOV,MÂNDRA,41417,TODERIŢA,"AŞEZAMÂNT CULTURAL",375,"Alegeri Prezidentiale",1,234,156,105,51,0,154,2,300,144,94,60
8,BRAŞOV,MÂNDRA,41417,ŞONA,"AŞEZAMÂNT CULTURAL",376,"Alegeri Prezidentiale",1,196,161,93,68,0,157,4,200,39,100,57
8,BRAŞOV,MOIECIU,41471,"MOIECIU DE JOS","PRIMĂRIA COMUNEI MOIECIU",377,"Alegeri Prezidentiale",1,1077,823,535,287,1,816,7,1499,676,609,207
8,BRAŞOV,MOIECIU,41471,"MOIECIU DE JOS","PRIMĂRIA COMUNEI MOIECIU",378,"Alegeri Prezidentiale",1,1234,1007,712,295,0,986,21,1400,393,765,221
8,BRAŞOV,MOIECIU,41471,"MOIECIU DE SUS","ŞCOALA GIMNAZIALĂ MOIECIU DE SUS",379,"Alegeri Prezidentiale",1,771,680,378,302,0,676,4,1100,420,480,196
8,BRAŞOV,MOIECIU,41471,PEŞTERA,"ŞCOALA GIMNAZIALĂ PEȘTERA",380,"Alegeri Prezidentiale",1,355,296,171,125,0,282,14,400,104,205,77
8,BRAŞOV,MOIECIU,41471,MĂGURA,"ŞCOALA GIMNAZIALĂ MĂGURA",381,"Alegeri Prezidentiale",1,421,254,197,57,0,253,1,500,246,181,72
8,BRAŞOV,ORMENIŞ,41541,ORMENIŞ,"DISPENSAR MEDICAL ORMENIŞ",382,"Alegeri Prezidentiale",1,1579,579,538,41,0,554,25,1700,1121,353,201
8,BRAŞOV,PĂRĂU,41578,PĂRĂU,"CĂMINUL CULTURAL PĂRĂU",383,"Alegeri Prezidentiale",1,505,258,195,63,0,255,3,600,342,152,103
8,BRAŞOV,PĂRĂU,41578,GRID,"ŞCOALA PRIMARĂ GRID",384,"Alegeri Prezidentiale",1,241,168,104,64,0,166,2,300,132,127,39
8,BRAŞOV,PĂRĂU,41578,"VENEŢIA DE JOS","CLĂDIREA FOSTEI PRIMĂRII",385,"Alegeri Prezidentiale",1,578,269,222,47,0,266,3,600,331,195,71
8,BRAŞOV,PĂRĂU,41578,"VENEŢIA DE SUS","CLĂDIREA FOSTEI PRIMĂRII",386,"Alegeri Prezidentiale",1,370,180,143,37,0,176,4,400,220,134,42
8,BRAŞOV,"POIANA MĂRULUI",41621,"POIANA MĂRULUI","ȘCOALA GIMNAZIALĂ NR.1 CORP A2",387,"Alegeri Prezidentiale",1,1252,852,725,126,1,841,11,1400,548,579,262
8,BRAŞOV,"POIANA MĂRULUI",41621,"POIANA MĂRULUI","ȘCOALĂ GIMNAZIALĂ NR.1 CORP B",388,"Alegeri Prezidentiale",1,984,462,413,49,0,443,19,1100,638,316,127
8,BRAŞOV,"POIANA MĂRULUI",41621,"POIANA MĂRULUI","ȘCOALĂ GIMNAZIALĂ NR. 2 ÎNTRE-VAI",389,"Alegeri Prezidentiale",1,388,151,118,32,1,149,2,400,249,70,79
8,BRAŞOV,PREJMER,41667,PREJMER,"ȘCOALA GIMNAZIALĂ PREJMER, STR.ȘCOLII, NR.1, CORP A, PARTER",390,"Alegeri Prezidentiale",1,1590,922,761,161,0,902,20,1800,878,729,173
8,BRAŞOV,PREJMER,41667,PREJMER,"ȘCOALA GIMNAZIALĂ PREJMER, STR.ȘCOLII, NR.1, CORP A, PARTER",391,"Alegeri Prezidentiale",1,1832,888,800,88,0,873,15,2000,1112,683,190
8,BRAŞOV,PREJMER,41667,PREJMER,"ȘCOALA GIMNAZIALĂ PREJMER, STR.ȘCOLII, NR.1, CORP A, PARTER",392,"Alegeri Prezidentiale",1,1733,933,842,91,0,923,10,1900,967,734,189
8,BRAŞOV,PREJMER,41667,"LUNCA CALNICULUI","SCOALA GIMNAZIALA LUNCA CALNICULUI SAT",393,"Alegeri Prezidentiale",1,1283,645,577,67,1,638,7,1400,755,498,140
8,BRAŞOV,PREJMER,41667,"LUNCA CALNICULUI","SCOALA GIMNAZIALA LUNCA CALNICULUI COLONIE",394,"Alegeri Prezidentiale",1,1316,684,607,77,0,675,9,1500,816,511,164
8,BRAŞOV,RACOŞ,41701,MATEIAŞ,"CAMIN CULTURAL",395,"Alegeri Prezidentiale",1,398,170,141,29,0,168,2,400,230,112,56
8,BRAŞOV,RACOŞ,41701,RACOŞ,"SCOALA GENERALA „BETHLEN SAMUEL”",396,"Alegeri Prezidentiale",1,1114,259,244,15,0,253,6,1200,941,143,110
8,BRAŞOV,RACOŞ,41701,RACOŞ,"PRIMĂRIA COMUNEI RACOS",397,"Alegeri Prezidentiale",1,1025,307,291,16,0,297,10,1100,793,226,71
8,BRAŞOV,RECEA,41738,RECEA,"CĂMINUL CULTURAL RECEA",398,"Alegeri Prezidentiale",1,1586,825,617,207,1,813,12,1700,875,626,187
8,BRAŞOV,RECEA,41738,BERIVOI,"GRĂDINIŢA BERIVOI",399,"Alegeri Prezidentiale",1,478,274,182,92,0,268,6,500,226,201,67
8,BRAŞOV,RECEA,41738,SĂVĂSTRENI,"CĂMINUL CULTURAL SĂVĂSTRENI",400,"Alegeri Prezidentiale",1,563,294,229,65,0,290,4,600,306,204,86
8,BRAŞOV,"SÂMBĂTA DE SUS",42464,"SÂMBĂTA DE SUS","SCOALA GENERALA",401,"Alegeri Prezidentiale",1,1293,828,638,190,0,813,15,1600,772,635,178
8,BRAŞOV,SÂNPETRU,41925,SÂNPETRU,"ŞCOALA GIMNAZIALĂ SÂNPETRU",402,"Alegeri Prezidentiale",1,1817,1150,979,170,1,1131,19,1900,750,906,225
8,BRAŞOV,SÂNPETRU,41925,SÂNPETRU,"GRADINITA CU PROGRAM NORMAL 4ORE SANPETRU",403,"Alegeri Prezidentiale",1,1578,1169,910,259,0,1140,29,1700,531,898,242
8,BRAŞOV,SÂNPETRU,41925,SÂNPETRU,"CĂMINUL CULTURAL AL BISERICII ORTODOXE",404,"Alegeri Prezidentiale",1,1475,909,706,157,46,888,21,1600,691,651,237
8,BRAŞOV,SÂNPETRU,41925,SÂNPETRU,"GRADINITA CU PROGRAM NORMAL 8 ORE SÎNPETRU",405,"Alegeri Prezidentiale",1,1805,1429,1113,316,0,1399,30,1900,471,1194,205
8,BRAŞOV,ŞERCAIA,41818,ŞERCAIA,"CĂMIN CULTURAL ŞERCAIA",406,"Alegeri Prezidentiale",1,1410,576,506,70,0,572,4,1600,1024,484,88
8,BRAŞOV,ŞERCAIA,41818,VAD,"CĂMIN CULTURAL VAD",407,"Alegeri Prezidentiale",1,447,245,189,55,1,243,2,500,255,175,68
8,BRAŞOV,ŞERCAIA,41818,HĂLMEAG,"FOSTUL SEDIU CAP",408,"Alegeri Prezidentiale",1,397,159,123,32,4,154,5,400,241,134,20
8,BRAŞOV,ŞINCA,41854,VÂLCEA,"ȘCOALĂ GENERALĂ",409,"Alegeri Prezidentiale",1,187,82,70,12,0,79,3,200,118,61,18
8,BRAŞOV,ŞINCA,41854,BUCIUM,"CĂMINUL CULTURAL",410,"Alegeri Prezidentiale",1,225,165,111,54,0,165,0,300,135,129,36
8,BRAŞOV,ŞINCA,41854,OHABA,"CĂMINUL CULTURAL",411,"Alegeri Prezidentiale",1,266,128,87,41,0,127,1,298,170,95,32
8,BRAŞOV,ŞINCA,41854,PERŞANI,"CĂMINUL CULTURAL",412,"Alegeri Prezidentiale",1,889,409,328,81,0,399,10,1000,591,300,99
8,BRAŞOV,ŞINCA,41854,ŞERCĂIŢA,"CĂMINUL CULTURAL",413,"Alegeri Prezidentiale",1,573,335,237,98,0,330,5,600,265,250,80
8,BRAŞOV,ŞINCA,41854,"ŞINCA VECHE",PRIMĂRIE,414,"Alegeri Prezidentiale",1,712,410,334,76,0,406,4,800,390,319,87
8,BRAŞOV,"ŞINCA NOUĂ",42449,"ŞINCA NOUĂ","CĂMINUL CULTURAL",415,"Alegeri Prezidentiale",1,957,624,571,53,0,607,17,1100,476,469,138
8,BRAŞOV,"ŞINCA NOUĂ",42449,"ŞINCA NOUĂ","ȘCOALĂ GENERALĂ",416,"Alegeri Prezidentiale",1,189,115,95,20,0,114,1,200,85,96,18
8,BRAŞOV,"ŞINCA NOUĂ",42449,PALTIN,"ȘCOALA PRIMARĂ PALTIN",417,"Alegeri Prezidentiale",1,143,130,70,60,0,130,0,200,70,94,36
8,BRAŞOV,ŞOARŞ,41943,ŞOARŞ,"PRIMĂRIA COMUNEI ȘOARȘ",418,"Alegeri Prezidentiale",1,501,217,197,20,0,212,5,600,383,167,45
8,BRAŞOV,ŞOARŞ,41943,FELMER,"ȘCOALA GENERALĂ FELMER",419,"Alegeri Prezidentiale",1,367,186,148,38,0,178,8,400,214,138,40
8,BRAŞOV,ŞOARŞ,41943,BĂRCUT,"ȘCOALA GENERALĂ BĂRCUT",420,"Alegeri Prezidentiale",1,350,148,130,18,0,145,3,400,252,119,26
8,BRAŞOV,ŞOARŞ,41943,RODBAV,"ȘCOALA GENERALĂ RODBAV",421,"Alegeri Prezidentiale",1,257,144,127,17,0,142,2,300,156,116,26
8,BRAŞOV,ŞOARŞ,41943,SELIŞTAT,"CĂMINUL CULTURAL ORTODOX SELIȘTAT",422,"Alegeri Prezidentiale",1,163,69,58,11,0,68,1,199,130,61,7
8,BRAŞOV,TĂRLUNGENI,42003,TĂRLUNGENI,"CAMIN CULTURAL",423,"Alegeri Prezidentiale",2,1878,999,883,116,0,981,18,2100,1101,798,183
8,BRAŞOV,TĂRLUNGENI,42003,TĂRLUNGENI,"GRADINITA PROGRAM PRELUNGIT",424,"Alegeri Prezidentiale",1,1974,1024,899,125,0,1014,10,2100,1076,854,160
8,BRAŞOV,TĂRLUNGENI,42003,PURCĂRENI,"SCOALA GENERALA PURCARENI",425,"Alegeri Prezidentiale",1,1220,734,653,81,0,726,8,1300,566,590,136
8,BRAŞOV,TĂRLUNGENI,42003,ZIZIN,"SCOALA GENERALA ZIZIN",426,"Alegeri Prezidentiale",1,1035,618,585,33,0,604,14,1100,482,310,294
8,BRAŞOV,TĂRLUNGENI,42003,ZIZIN,"SCOALA GENERALA ZIZIN",427,"Alegeri Prezidentiale",1,1116,668,635,33,0,657,11,1200,532,305,352
8,BRAŞOV,TĂRLUNGENI,42003,CĂRPINIŞ,"SCOALA GENERALA CARPINIS",428,"Alegeri Prezidentiale",1,404,289,227,62,0,282,7,500,211,206,76
8,BRAŞOV,TELIU,42058,TELIU,"ȘCOALĂ GENERALĂ TELIU",429,"Alegeri Prezidentiale",1,1352,604,574,30,0,589,15,1500,896,304,285
8,BRAŞOV,TELIU,42058,TELIU,"CĂMINUL CULTURAL TELIU",430,"Alegeri Prezidentiale",1,1062,505,437,68,0,500,5,1200,695,417,83
8,BRAŞOV,TELIU,42058,TELIU,"ȘCOALĂ GENERALĂ TELIU VALE",431,"Alegeri Prezidentiale",1,792,445,398,47,0,445,0,900,455,329,116
8,BRAŞOV,TICUŞU,42076,"TICUŞU VECHI","CĂMINUL CULTURAL TICUŞU VECHI",432,"Alegeri Prezidentiale",1,592,257,231,26,0,245,12,600,343,174,71
8,BRAŞOV,TICUŞU,42076,COBOR,"ŞCOALA PRIMARĂ COBOR",433,"Alegeri Prezidentiale",1,183,97,80,16,1,95,2,200,103,73,22
8,BRAŞOV,UCEA,42101,"UCEA DE JOS","SEDIUL PRIMARIEI COMUNEI UCEA",434,"Alegeri Prezidentiale",1,690,315,270,43,2,312,3,800,485,265,47
8,BRAŞOV,UCEA,42101,"UCEA DE SUS","CAMINUL CULTURAL UCEA DE SUS",435,"Alegeri Prezidentiale",1,822,480,413,67,0,478,2,900,420,404,74
8,BRAŞOV,UCEA,42101,FELDIOARA,"CAMINUL CULTURAL FELDIOARA",436,"Alegeri Prezidentiale",1,179,110,76,34,0,107,3,200,90,80,27
8,BRAŞOV,UCEA,42101,CORBI,"CAMINUL CULTURAL CORBI",437,"Alegeri Prezidentiale",1,171,116,88,28,0,116,0,200,84,97,19
8,BRAŞOV,UNGRA,42156,UNGRA,"ŞCOALA GENERALĂ UNGRA",438,"Alegeri Prezidentiale",1,1107,348,326,22,0,344,4,1200,852,224,120
8,BRAŞOV,UNGRA,42156,DĂIŞOARA,"GRĂDINIŢA DĂIŞOARA",439,"Alegeri Prezidentiale",1,583,346,318,28,0,340,6,600,254,98,242
8,BRAŞOV,"VAMA BUZĂULUI",42183,"VAMA BUZĂULUI","ANEXĂ PRIMARIE",440,"Alegeri Prezidentiale",1,1363,673,610,62,1,669,4,1500,827,457,212
8,BRAŞOV,"VAMA BUZĂULUI",42183,ACRIŞ,"CENTRUL LOCAL DE INFORMARE ȘI PROMOVARE TURISTICĂ VAMA BUZĂULUI",441,"Alegeri Prezidentiale",1,989,459,394,65,0,449,10,1100,641,335,114
8,BRAŞOV,"VAMA BUZĂULUI",42183,BUZĂIEL,"ŞCOALA PRIMARĂ BUZĂIEL",442,"Alegeri Prezidentiale",1,454,187,174,13,0,186,1,502,315,142,44
8,BRAŞOV,VIŞTEA,42236,"VIŞTEA DE JOS","PRIMĂRIA COMUNEI VIŞTEA",443,"Alegeri Prezidentiale",1,645,265,211,54,0,261,4,700,435,225,36
8,BRAŞOV,VIŞTEA,42236,"VIŞTEA DE SUS","GRĂDINIŢA VIŞTEA DE SUS",444,"Alegeri Prezidentiale",1,487,281,221,60,0,276,5,500,219,226,50
8,BRAŞOV,VIŞTEA,42236,OLTEŢ,"ŞCOALA GENERALĂ OLTEŢ",445,"Alegeri Prezidentiale",1,290,184,87,97,0,181,3,300,116,143,38
8,BRAŞOV,VIŞTEA,42236,RUCĂR,"GRADINIŢA RUCĂR",446,"Alegeri Prezidentiale",1,333,205,154,51,0,205,0,400,195,175,30
8,BRAŞOV,VOILA,42307,VOILA,"CĂMINUL CULTURAL VOILA",447,"Alegeri Prezidentiale",1,621,270,202,67,1,268,2,700,430,189,79
8,BRAŞOV,VOILA,42307,CINCŞOR,"CAMINUL CULTURAL CINCSOR",448,"Alegeri Prezidentiale",1,654,330,243,86,1,322,8,700,370,240,82
8,BRAŞOV,VOILA,42307,DRIDIF,"CAMINUL CULTURAL DRIDIF",449,"Alegeri Prezidentiale",1,351,202,160,42,0,199,3,400,198,139,60
8,BRAŞOV,VOILA,42307,LUDIŞOR,"CAMINUL CULTURAL LUDISOR",450,"Alegeri Prezidentiale",1,157,141,79,61,1,141,0,200,59,110,31
8,BRAŞOV,VOILA,42307,"SÂMBĂTA DE JOS","CAMINUL CULTURAL SAMBATA DE JOS",451,"Alegeri Prezidentiale",1,430,237,167,69,1,236,1,500,263,189,47
8,BRAŞOV,VOILA,42307,VOIVODENI,"CAMINUL CULTURAL VOIVODENII MARI",452,"Alegeri Prezidentiale",1,347,267,175,92,0,263,4,400,133,176,87
8,BRAŞOV,VULCAN,42398,VULCAN,"CAMINUL CULTURAL VULCAN",453,"Alegeri Prezidentiale",1,1670,989,867,122,0,963,26,1800,811,728,235
8,BRAŞOV,VULCAN,42398,VULCAN,"CAMINUL CULTURAL VULCAN",454,"Alegeri Prezidentiale",1,1630,708,627,81,0,696,12,1800,1092,530,166
8,BRAŞOV,VULCAN,42398,"COLONIA 1 MAI","CAMINUL CULTURAL 1 MAI",455,"Alegeri Prezidentiale",1,686,378,327,51,0,374,4,800,422,325,49
9,BRĂILA,"MUNICIPIUL BRĂILA",42682,BRĂILA,"ŞCOALA GIMNAZIALĂ NR. 31 „MIHAI VITEAZUL”",1,"Alegeri Prezidentiale",1,1341,608,578,30,0,596,12,1500,892,344,252
9,BRĂILA,"MUNICIPIUL BRĂILA",42682,BRĂILA,"ŞCOALA GIMNAZIALĂ NR. 31 „MIHAI VITEAZUL”",2,"Alegeri Prezidentiale",1,1221,607,567,40,0,597,10,1308,701,313,284
9,BRĂILA,"MUNICIPIUL BRĂILA",42682,BRĂILA,"ŞCOALA GIMNAZIALĂ NR. 31 „MIHAI VITEAZUL”",3,"Alegeri Prezidentiale",1,1050,519,499,20,0,508,11,1100,581,247,261
9,BRĂILA,"MUNICIPIUL BRĂILA",42682,BRĂILA,"ŞCOALA GIMNAZIALĂ NR. 31 „MIHAI VITEAZUL”",4,"Alegeri Prezidentiale",1,1162,603,584,19,0,591,12,1300,697,305,286
9,BRĂILA,"MUNICIPIUL BRĂILA",42682,BRĂILA,"GRĂDINIŢA NR. 61 „BOBOCEL”",5,"Alegeri Prezidentiale",1,1168,601,587,14,0,585,16,1300,699,311,274
9,BRĂILA,"MUNICIPIUL BRĂILA",42682,BRĂILA,"GRĂDINIŢA NR. 61 „BOBOCEL”",6,"Alegeri Prezidentiale",1,1211,657,646,11,0,642,15,1308,651,317,325
9,BRĂILA,"MUNICIPIUL BRĂILA",42682,BRĂILA,"ȘCOALA GIMNAZIALĂ NR. 1 „VLAICU VODĂ”",7,"Alegeri Prezidentiale",1,1364,762,723,39,0,752,10,1500,738,395,357
9,BRĂILA,"MUNICIPIUL BRĂILA",42682,BRĂILA,"ȘCOALA GIMNAZIALĂ NR. 1 „VLAICU VODĂ”",8,"Alegeri Prezidentiale",1,1470,790,737,53,0,781,9,1600,810,423,358
9,BRĂILA,"MUNICIPIUL BRĂILA",42682,BRĂILA,"GRĂDINIŢA NR. 12 „SFÂNTUL NICOLAE”",9,"Alegeri Prezidentiale",1,1677,841,810,31,0,826,15,1800,959,445,381
9,BRĂILA,"MUNICIPIUL BRĂILA",42682,BRĂILA,"GRĂDINIŢA NR. 12 „SFÂNTUL NICOLAE”",10,"Alegeri Prezidentiale",1,1533,773,751,22,0,752,21,1700,927,411,341
9,BRĂILA,"MUNICIPIUL BRĂILA",42682,BRĂILA,"ȘCOALA GIMNAZIALĂ NR. 27 „AUREL VLAICU”",11,"Alegeri Prezidentiale",1,1356,679,654,24,1,661,18,1500,821,432,229
9,BRĂILA,"MUNICIPIUL BRĂILA",42682,BRĂILA,"ȘCOALA GIMNAZIALĂ NR. 27 „AUREL VLAICU”",12,"Alegeri Prezidentiale",1,1496,723,711,12,0,711,12,1600,877,374,337
9,BRĂILA,"MUNICIPIUL BRĂILA",42682,BRĂILA,"ŞCOALA GIMNAZIALĂ NR. 27 „AUREL VLAICU”",13,"Alegeri Prezidentiale",1,1283,675,657,18,0,664,11,1400,725,402,262
9,BRĂILA,"MUNICIPIUL BRĂILA",42682,BRĂILA,"ŞCOALA GIMNAZIALĂ NR. 27 „AUREL VLAICU”",14,"Alegeri Prezidentiale",2,1391,626,613,13,0,618,8,1508,882,381,237
9,BRĂILA,"MUNICIPIUL BRĂILA",42682,BRĂILA,"ȘCOALA GIMNAZIALĂ NR. 2 „FĂNUȘ NEAGU”",15,"Alegeri Prezidentiale",1,915,476,362,47,67,467,9,1000,524,247,220
9,BRĂILA,"MUNICIPIUL BRĂILA",42682,BRĂILA,"ȘCOALA GIMNAZIALĂ NR. 2 „FĂNUȘ NEAGU”",16,"Alegeri Prezidentiale",1,1079,627,517,30,80,618,9,1200,573,335,283
9,BRĂILA,"MUNICIPIUL BRĂILA",42682,BRĂILA,"ŞCOALA GIMNAZIALĂ NR. 2 „FĂNUŞ NEAGU”",17,"Alegeri Prezidentiale",1,1074,547,525,22,0,540,7,1200,653,307,233
9,BRĂILA,"MUNICIPIUL BRĂILA",42682,BRĂILA,"ŞCOALA GIMNAZIALĂ NR. 2 „FĂNUŞ NEAGU”",18,"Alegeri Prezidentiale",1,1364,697,687,10,0,678,19,1500,803,391,287
9,BRĂILA,"MUNICIPIUL BRĂILA",42682,BRĂILA,"ŞCOALA GIMNAZIALĂ NR. 2 „FĂNUŞ NEAGU”",19,"Alegeri Prezidentiale",1,1121,595,553,42,0,582,13,1200,605,368,214
9,BRĂILA,"MUNICIPIUL BRĂILA",42682,BRĂILA,"GRĂDINIŢA NR. 39 „CĂSUȚA FERMECATĂ”",20,"Alegeri Prezidentiale",1,1247,603,590,13,0,595,8,1400,797,305,290
9,BRĂILA,"MUNICIPIUL BRĂILA",42682,BRĂILA,"GRĂDINIŢA NR. 39 „CĂSUȚA FERMECATĂ”",21,"Alegeri Prezidentiale",1,1126,540,513,27,0,527,13,1192,652,286,241
9,BRĂILA,"MUNICIPIUL BRĂILA",42682,BRĂILA,"GRĂDINIŢA NR. 39 „CĂSUȚA FERMECATĂ”",22,"Alegeri Prezidentiale",1,1120,501,484,17,0,488,13,1200,699,271,217
9,BRĂILA,"MUNICIPIUL BRĂILA",42682,BRĂILA,"GRĂDINIŢA NR. 39 „CĂSUȚA FERMECATĂ”",23,"Alegeri Prezidentiale",1,1085,509,497,12,0,503,6,1200,691,266,237
9,BRĂILA,"MUNICIPIUL BRĂILA",42682,BRĂILA,"ȘCOALA GIMNAZIALĂ NR. 28 „VASILE ALECSANDRI”",24,"Alegeri Prezidentiale",1,1049,578,531,47,0,566,12,1100,522,331,235
9,BRĂILA,"MUNICIPIUL BRĂILA",42682,BRĂILA,"ȘCOALA GIMNAZIALĂ NR. 28 „VASILE ALECSANDRI”",25,"Alegeri Prezidentiale",1,971,414,399,15,0,404,10,1100,686,213,191
9,BRĂILA,"MUNICIPIUL BRĂILA",42682,BRĂILA,"ȘCOALA GIMNAZIALĂ NR. 28 „VASILE ALECSANDRI”",26,"Alegeri Prezidentiale",1,955,458,442,16,0,445,13,1000,542,224,221
9,BRĂILA,"MUNICIPIUL BRĂILA",42682,BRĂILA,"ŞCOALA GIMNAZIALĂ NR. 28 „VASILE ALECSANDRI”",27,"Alegeri Prezidentiale",1,1271,671,648,23,0,659,12,1400,729,354,305
9,BRĂILA,"MUNICIPIUL BRĂILA",42682,BRĂILA,"ŞCOALA GIMNAZIALĂ NR. 28 „VASILE ALECSANDRI”",28,"Alegeri Prezidentiale",1,872,381,373,7,1,374,7,1000,619,216,158
9,BRĂILA,"MUNICIPIUL BRĂILA",42682,BRĂILA,"GRĂDINIŢA NR. 38 „IZVORAȘUL”",29,"Alegeri Prezidentiale",1,1265,657,614,43,0,647,10,1400,743,350,297
9,BRĂILA,"MUNICIPIUL BRĂILA",42682,BRĂILA,"ŞCOALA GIMNAZIALĂ NR. 29 „MIHAIL SADOVEANU”",30,"Alegeri Prezidentiale",1,641,350,306,42,2,340,10,700,350,173,167
9,BRĂILA,"MUNICIPIUL BRĂILA",42682,BRĂILA,"ȘCOALA GIMNAZIALĂ NR. 29 „MIHAIL SADOVEANU”",31,"Alegeri Prezidentiale",1,1201,551,538,13,0,544,7,1300,749,315,229
9,BRĂILA,"MUNICIPIUL BRĂILA",42682,BRĂILA,"ȘCOALA GIMNAZIALĂ NR. 29 „MIHAIL SADOVEANU”",32,"Alegeri Prezidentiale",1,1356,590,579,11,0,580,10,1500,910,303,277
9,BRĂILA,"MUNICIPIUL BRĂILA",42682,BRĂILA,"GRĂDINIŢA NR. 11 „BRÂNDUȘA”",33,"Alegeri Prezidentiale",1,1515,719,701,17,1,708,11,1700,981,392,316
9,BRĂILA,"MUNICIPIUL BRĂILA",42682,BRĂILA,"COLEGIUL NAȚIONAL „ANA ASLAN”",34,"Alegeri Prezidentiale",1,877,373,322,50,1,370,3,1000,627,238,132
9,BRĂILA,"MUNICIPIUL BRĂILA",42682,BRĂILA,"COLEGIUL NAȚIONAL „ANA ASLAN”",35,"Alegeri Prezidentiale",1,1325,597,577,20,0,586,11,1400,803,257,329
9,BRĂILA,"MUNICIPIUL BRĂILA",42682,BRĂILA,"COLEGIUL NAȚIONAL „ANA ASLAN”",36,"Alegeri Prezidentiale",1,1022,510,495,15,0,496,14,1100,590,302,194
9,BRĂILA,"MUNICIPIUL BRĂILA",42682,BRĂILA,"COLEGIUL NAȚIONAL „ANA ASLAN”",37,"Alegeri Prezidentiale",1,1403,701,678,23,0,686,15,1500,799,407,279
9,BRĂILA,"MUNICIPIUL BRĂILA",42682,BRĂILA,"COLEGIUL NAȚIONAL „ANA ASLAN”",38,"Alegeri Prezidentiale",1,1484,578,552,26,0,566,12,1600,1022,302,264
9,BRĂILA,"MUNICIPIUL BRĂILA",42682,BRĂILA,"COLEGIUL TEHNIC „EDMOND NICOLAU”",39,"Alegeri Prezidentiale",1,1489,700,641,42,17,689,11,1600,900,344,345
9,BRĂILA,"MUNICIPIUL BRĂILA",42682,BRĂILA,"COLEGIUL TEHNIC „EDMOND NICOLAU”",40,"Alegeri Prezidentiale",1,1236,617,590,27,0,606,11,1300,683,345,261
9,BRĂILA,"MUNICIPIUL BRĂILA",42682,BRĂILA,"COMPANIA DE UTILITĂȚI PUBLICE „DUNĂREA” SA BRĂILA",41,"Alegeri Prezidentiale",1,1405,690,656,34,0,680,10,1500,810,364,316
9,BRĂILA,"MUNICIPIUL BRĂILA",42682,BRĂILA,"ŞCOALA GIMNAZIALĂ NR. 4 „ALEXANDRU IOAN CUZA”",42,"Alegeri Prezidentiale",1,1158,646,586,60,0,631,15,1300,654,355,276
9,BRĂILA,"MUNICIPIUL BRĂILA",42682,BRĂILA,"ŞCOALA GIMNAZIALĂ NR. 4 „ALEXANDRU IOAN CUZA”",43,"Alegeri Prezidentiale",1,1306,737,684,53,0,716,21,1400,663,388,328
9,BRĂILA,"MUNICIPIUL BRĂILA",42682,BRĂILA,"ȘCOALA GIMNAZIALĂ NR. 4 „ALEXANDRU IOAN CUZA”",44,"Alegeri Prezidentiale",1,1090,609,598,11,0,597,12,1200,591,342,255
9,BRĂILA,"MUNICIPIUL BRĂILA",42682,BRĂILA,"GRĂDINIȚA CU PROGRAM NORMAL WALDORF",45,"Alegeri Prezidentiale",1,1362,739,695,44,0,720,19,1500,761,402,318
9,BRĂILA,"MUNICIPIUL BRĂILA",42682,BRĂILA,"GRĂDINIȚA CU PROGRAM NORMAL WALDORF",46,"Alegeri Prezidentiale",1,854,566,477,33,56,559,7,900,334,310,249
9,BRĂILA,"MUNICIPIUL BRĂILA",42682,BRĂILA,"ŞCOALA GIMNAZIALĂ NR. 8 „ION BĂNCILĂ”",47,"Alegeri Prezidentiale",1,1401,672,646,25,1,659,13,1492,820,372,287
9,BRĂILA,"MUNICIPIUL BRĂILA",42682,BRĂILA,"ŞCOALA GIMNAZIALĂ NR. 8 „ION BĂNCILĂ”",48,"Alegeri Prezidentiale",1,1113,559,529,30,0,547,12,1200,641,314,233
9,BRĂILA,"MUNICIPIUL BRĂILA",42682,BRĂILA,"ŞCOALA GIMNAZIALĂ NR. 8 „ION BĂNCILĂ”",49,"Alegeri Prezidentiale",1,712,413,384,29,0,411,2,800,387,222,189
9,BRĂILA,"MUNICIPIUL BRĂILA",42682,BRĂILA,"ŞCOALA GIMNAZIALĂ NR. 8 „ION BĂNCILĂ”",50,"Alegeri Prezidentiale",1,681,350,333,17,0,340,10,800,450,196,144
9,BRĂILA,"MUNICIPIUL BRĂILA",42682,BRĂILA,"ŞCOALA GIMNAZIALĂ NR. 8 „ION BĂNCILĂ”",51,"Alegeri Prezidentiale",1,734,356,345,11,0,350,6,800,444,200,150
9,BRĂILA,"MUNICIPIUL BRĂILA",42682,BRĂILA,"LICEUL TEORETIC „PANAIT CERNA”",52,"Alegeri Prezidentiale",1,1556,796,756,40,0,770,26,1700,904,403,367
9,BRĂILA,"MUNICIPIUL BRĂILA",42682,BRĂILA,"LICEUL TEORETIC „PANAIT CERNA”",53,"Alegeri Prezidentiale",1,1359,705,667,37,1,694,11,1500,795,364,330
9,BRĂILA,"MUNICIPIUL BRĂILA",42682,BRĂILA,"LICEUL TEORETIC „PANAIT CERNA”",54,"Alegeri Prezidentiale",1,1316,598,571,27,0,590,8,1400,802,321,269
9,BRĂILA,"MUNICIPIUL BRĂILA",42682,BRĂILA,"LICEUL TEORETIC „PANAIT CERNA”",55,"Alegeri Prezidentiale",1,993,491,468,23,0,485,6,1100,609,254,231
9,BRĂILA,"MUNICIPIUL BRĂILA",42682,BRĂILA,"COLEGIUL NAȚIONAL „GHEORGHE MUNTEANU MURGOCI”",56,"Alegeri Prezidentiale",1,1198,701,657,44,0,685,16,1300,599,391,294
9,BRĂILA,"MUNICIPIUL BRĂILA",42682,BRĂILA,"COLEGIUL NAȚIONAL „GHEORGHE MUNTEANU MURGOCI”",57,"Alegeri Prezidentiale",1,1207,624,574,50,0,614,10,1300,676,335,279
9,BRĂILA,"MUNICIPIUL BRĂILA",42682,BRĂILA,"ŞCOALA GIMNAZIALĂ NR. 7 „ION CREANGĂ”",58,"Alegeri Prezidentiale",1,1172,586,542,44,0,570,16,1300,714,345,225
9,BRĂILA,"MUNICIPIUL BRĂILA",42682,BRĂILA,"ȘCOALA GIMNAZIALĂ NR. 7 „ION CREANGĂ”",59,"Alegeri Prezidentiale",1,977,509,486,22,1,489,20,1100,591,273,216
9,BRĂILA,"MUNICIPIUL BRĂILA",42682,BRĂILA,"ȘCOALA GIMNAZIALĂ NR. 7 „ION CREANGĂ”",60,"Alegeri Prezidentiale",1,917,509,443,20,46,501,8,1000,491,257,244
9,BRĂILA,"MUNICIPIUL BRĂILA",42682,BRĂILA,"LICEUL TEORETIC „NICOLAE IORGA”",61,"Alegeri Prezidentiale",1,831,380,337,28,15,368,12,900,520,187,181
9,BRĂILA,"MUNICIPIUL BRĂILA",42682,BRĂILA,"ŞCOALA GIMNAZIALĂ NR. 5 „NIKOS KAZANTZAKIS”",62,"Alegeri Prezidentiale",2,1013,437,414,23,0,425,12,1100,663,248,177
9,BRĂILA,"MUNICIPIUL BRĂILA",42682,BRĂILA,"COLEGIUL NAŢIONAL „NICOLAE BĂLCESCU”",63,"Alegeri Prezidentiale",1,1356,625,579,46,0,609,16,1492,867,318,291
9,BRĂILA,"MUNICIPIUL BRĂILA",42682,BRĂILA,"LICEUL DE ARTĂ „HARICLEA DARCLEE”",64,"Alegeri Prezidentiale",1,1446,692,655,36,1,681,11,1592,900,402,279
9,BRĂILA,"MUNICIPIUL BRĂILA",42682,BRĂILA,"LICEUL DE ARTĂ „HARICLEA DARCLEE”",65,"Alegeri Prezidentiale",2,1400,696,622,34,40,687,9,1500,804,435,252
9,BRĂILA,"MUNICIPIUL BRĂILA",42682,BRĂILA,"LICEUL TEHNOLOGIC „GRIGORE MOISIL”",66,"Alegeri Prezidentiale",1,1518,879,658,38,183,850,29,1700,821,404,446
9,BRĂILA,"MUNICIPIUL BRĂILA",42682,BRĂILA,"ȘCOALA GIMNAZIALĂ NR. 17 „ECATERINA TEODOROIU”",67,"Alegeri Prezidentiale",1,1265,751,580,23,148,745,6,1400,649,369,376
9,BRĂILA,"MUNICIPIUL BRĂILA",42682,BRĂILA,"ȘCOALA GIMNAZIALĂ NR. 17 „ECATERINA TEODOROIU”",68,"Alegeri Prezidentiale",1,1464,738,700,37,1,726,12,1600,862,408,318
9,BRĂILA,"MUNICIPIUL BRĂILA",42682,BRĂILA,"COLEGIUL TEHNIC „PANAIT ISTRATI”",69,"Alegeri Prezidentiale",1,1334,711,684,27,0,693,18,1500,789,370,323
9,BRĂILA,"MUNICIPIUL BRĂILA",42682,BRĂILA,"COLEGIUL TEHNIC „PANAIT ISTRATI”",70,"Alegeri Prezidentiale",1,877,435,420,15,0,431,4,1008,573,209,222
9,BRĂILA,"MUNICIPIUL BRĂILA",42682,BRĂILA,"COLEGIUL TEHNIC „PANAIT ISTRATI”",71,"Alegeri Prezidentiale",2,1273,607,593,14,0,593,14,1400,793,388,205
9,BRĂILA,"MUNICIPIUL BRĂILA",42682,BRĂILA,"ŞCOALA GIMNAZIALĂ NR. 18 „MIHU DRAGOMIR”",72,"Alegeri Prezidentiale",1,1024,480,441,38,1,472,8,1100,620,264,208
9,BRĂILA,"MUNICIPIUL BRĂILA",42682,BRĂILA,"ȘCOALA GIMNAZIALĂ NR. 18 „MIHU DRAGOMIR”",73,"Alegeri Prezidentiale",1,1269,572,544,27,1,560,12,1400,828,295,265
9,BRĂILA,"MUNICIPIUL BRĂILA",42682,BRĂILA,"GRĂDINIŢA NR. 21 „PESCĂRUȘUL”",74,"Alegeri Prezidentiale",2,1269,581,573,7,1,559,22,1400,819,312,247
9,BRĂILA,"MUNICIPIUL BRĂILA",42682,BRĂILA,"GRĂDINIŢA NR. 21 „PESCĂRUȘUL”",75,"Alegeri Prezidentiale",1,997,456,436,20,0,446,10,1100,644,236,210
9,BRĂILA,"MUNICIPIUL BRĂILA",42682,BRĂILA,"GRĂDINIŢA NR. 21 „PESCĂRUȘUL”",76,"Alegeri Prezidentiale",1,1280,551,541,10,0,540,11,1400,849,329,211
9,BRĂILA,"MUNICIPIUL BRĂILA",42682,BRĂILA,"ŞCOALA GIMNAZIALĂ NR. 6 „CONSTANTIN SANDU ALDEA”",77,"Alegeri Prezidentiale",1,1244,693,645,48,0,678,15,1400,707,404,274
9,BRĂILA,"MUNICIPIUL BRĂILA",42682,BRĂILA,"ŞCOALA GIMNAZIALĂ NR. 6 „CONSTANTIN SANDU ALDEA”",78,"Alegeri Prezidentiale",1,1246,648,634,14,0,637,11,1400,752,333,304
9,BRĂILA,"MUNICIPIUL BRĂILA",42682,BRĂILA,"ŞCOALA GIMNAZIALĂ NR. 6 „CONSTANTIN SANDU ALDEA”",79,"Alegeri Prezidentiale",1,1165,616,595,21,0,609,7,1300,684,359,250
9,BRĂILA,"MUNICIPIUL BRĂILA",42682,BRĂILA,"ŞCOALA GIMNAZIALĂ NR. 6 „CONSTANTIN SANDU ALDEA”",80,"Alegeri Prezidentiale",1,1259,704,687,17,0,692,12,1399,695,427,265
9,BRĂILA,"MUNICIPIUL BRĂILA",42682,BRĂILA,"LICEUL TEHNOLOGIC „ANGHEL SALIGNY”",81,"Alegeri Prezidentiale",1,1226,665,619,45,1,651,14,1300,635,376,275
9,BRĂILA,"MUNICIPIUL BRĂILA",42682,BRĂILA,"LICEUL TEHNOLOGIC „ANGHEL SALIGNY”",82,"Alegeri Prezidentiale",1,1046,532,509,23,0,523,9,1100,568,302,221
9,BRĂILA,"MUNICIPIUL BRĂILA",42682,BRĂILA,"LICEUL TEHNOLOGIC „ANGHEL SALIGNY”",83,"Alegeri Prezidentiale",1,1220,645,606,38,1,639,6,1300,655,397,242
9,BRĂILA,"MUNICIPIUL BRĂILA",42682,BRĂILA,"COLEGIUL ECONOMIC „ION GHICA”",84,"Alegeri Prezidentiale",1,1100,582,549,32,1,572,10,1200,618,344,228
9,BRĂILA,"MUNICIPIUL BRĂILA",42682,BRĂILA,"COLEGIUL ECONOMIC „ION GHICA”",85,"Alegeri Prezidentiale",1,1388,694,671,23,0,675,19,1500,806,387,288
9,BRĂILA,"MUNICIPIUL BRĂILA",42682,BRĂILA,"CASA CORPULUI DIDACTIC",86,"Alegeri Prezidentiale",1,1173,564,545,19,0,554,10,1300,736,303,251
9,BRĂILA,"MUNICIPIUL BRĂILA",42682,BRĂILA,"ŞCOALA GIMNAZIALĂ NR. 32 „DIMITRIE CANTEMIR”",87,"Alegeri Prezidentiale",1,1189,521,494,27,0,511,10,1300,779,270,241
9,BRĂILA,"MUNICIPIUL BRĂILA",42682,BRĂILA,"ŞCOALA GIMNAZIALĂ NR. 32 „DIMITRIE CANTEMIR”",88,"Alegeri Prezidentiale",1,1407,699,677,22,0,681,18,1500,801,360,321
9,BRĂILA,"MUNICIPIUL BRĂILA",42682,BRĂILA,"ȘCOALA GIMNAZIALĂ NR. 32 „DIMITRIE CANTEMIR”",89,"Alegeri Prezidentiale",1,841,413,399,14,0,403,10,900,487,209,194
9,BRĂILA,"MUNICIPIUL BRĂILA",42682,BRĂILA,"ȘCOALA GIMNAZIALĂ NR. 32 „DIMITRIE CANTEMIR”",90,"Alegeri Prezidentiale",1,1231,572,560,12,0,568,4,1300,728,276,292
9,BRĂILA,"MUNICIPIUL BRĂILA",42682,BRĂILA,"ȘCOALA GIMNAZIALĂ NR. 32 „DIMITRIE CANTEMIR”",91,"Alegeri Prezidentiale",2,1397,710,695,15,0,690,20,1500,790,356,334
9,BRĂILA,"MUNICIPIUL BRĂILA",42682,BRĂILA,"GRĂDINIŢA NR. 36 „FURNICUŢA”",92,"Alegeri Prezidentiale",1,1356,694,669,25,0,683,11,1500,806,381,302
9,BRĂILA,"MUNICIPIUL BRĂILA",42682,BRĂILA,"GRĂDINIŢA NR. 48 „LUCEAFĂRUL”",93,"Alegeri Prezidentiale",1,1215,635,620,15,0,624,11,1292,657,326,298
9,BRĂILA,"MUNICIPIUL BRĂILA",42682,BRĂILA,"GRĂDINIŢA NR. 48 „LUCEAFĂRUL”",94,"Alegeri Prezidentiale",1,1179,639,611,28,0,625,14,1300,661,305,320
9,BRĂILA,"MUNICIPIUL BRĂILA",42682,BRĂILA,"GRĂDINIŢA NR. 37 „DUMBRAVA MINUNATĂ”",95,"Alegeri Prezidentiale",1,1142,681,571,19,91,663,18,1200,519,336,327
9,BRĂILA,"MUNICIPIUL BRĂILA",42682,BRĂILA,"GRĂDINIŢA NR. 37 „DUMBRAVA MINUNATĂ”",96,"Alegeri Prezidentiale",1,1716,840,814,26,0,815,25,1900,1060,453,362
9,BRĂILA,"MUNICIPIUL BRĂILA",42682,BRĂILA,"GRĂDINIŢA NR. 37 „DUMBRAVA MINUNATĂ”",97,"Alegeri Prezidentiale",1,1243,721,617,27,77,711,10,1400,679,388,323
9,BRĂILA,"MUNICIPIUL BRĂILA",42682,BRĂILA,"LICEUL PEDAGOGIC „D.P. PERPESSICIUS”",98,"Alegeri Prezidentiale",1,1062,547,503,43,1,539,8,1200,653,288,251
9,BRĂILA,"MUNICIPIUL BRĂILA",42682,BRĂILA,"LICEUL PEDAGOGIC „D.P. PERPESSICIUS”",99,"Alegeri Prezidentiale",1,1426,736,723,13,0,721,15,1600,864,375,346
9,BRĂILA,"MUNICIPIUL BRĂILA",42682,BRĂILA,"LICEUL PEDAGOGIC „D.P. PERPESSICIUS”",100,"Alegeri Prezidentiale",1,1454,790,770,20,0,776,14,1600,810,399,377
9,BRĂILA,"MUNICIPIUL BRĂILA",42682,BRĂILA,"ȘCOALA GIMNAZIALĂ NR. 23 „MIHAI EMINESCU”",101,"Alegeri Prezidentiale",1,1003,411,371,40,0,404,7,1100,689,219,185
9,BRĂILA,"MUNICIPIUL BRĂILA",42682,BRĂILA,"ȘCOALA GIMNAZIALĂ NR. 23 „MIHAI EMINESCU”",102,"Alegeri Prezidentiale",1,1221,500,470,30,0,493,7,1300,800,258,235
9,BRĂILA,"MUNICIPIUL BRĂILA",42682,BRĂILA,"ȘCOALA GIMNAZIALĂ NR. 23 „MIHAI EMINESCU”",103,"Alegeri Prezidentiale",3,1152,602,574,28,0,589,13,1300,698,308,281
9,BRĂILA,"MUNICIPIUL BRĂILA",42682,BRĂILA,"ŞCOALA GIMNAZIALĂ NR. 9 „ANTON PANN”",104,"Alegeri Prezidentiale",1,1162,445,427,18,0,436,9,1300,855,223,213
9,BRĂILA,"MUNICIPIUL BRĂILA",42682,BRĂILA,"ŞCOALA GIMNAZIALĂ NR. 9 „ANTON PANN”",105,"Alegeri Prezidentiale",1,1231,486,469,17,0,482,4,1300,814,284,198
9,BRĂILA,"MUNICIPIUL BRĂILA",42682,BRĂILA,"ŞCOALA GIMNAZIALĂ NR. 9 „ANTON PANN”",106,"Alegeri Prezidentiale",1,1350,528,518,10,0,517,11,1500,972,304,213
9,BRĂILA,"MUNICIPIUL BRĂILA",42682,BRĂILA,"ŞCOALA GIMNAZIALĂ NR. 9 „ANTON PANN”",107,"Alegeri Prezidentiale",1,1255,530,523,7,0,517,13,1400,870,295,222
9,BRĂILA,"MUNICIPIUL BRĂILA",42682,BRĂILA,"ŞCOALA GIMNAZIALĂ NR. 13 „NEDELCU CHERCEA”",108,"Alegeri Prezidentiale",1,1289,586,543,40,3,570,16,1400,814,336,234
9,BRĂILA,"MUNICIPIUL BRĂILA",42682,BRĂILA,"ŞCOALA GIMNAZIALĂ NR. 13 „NEDELCU CHERCEA”",109,"Alegeri Prezidentiale",1,1272,634,609,25,0,619,15,1400,766,329,290
9,BRĂILA,"MUNICIPIUL BRĂILA",42682,BRĂILA,"ȘCOALA GIMNAZIALĂ NR. 22 „RADU TUDORAN”",110,"Alegeri Prezidentiale",1,1365,645,624,21,0,627,18,1500,855,359,268
9,BRĂILA,"MUNICIPIUL BRĂILA",42682,BRĂILA,"ȘCOALA GIMNAZIALĂ NR. 22 „RADU TUDORAN”",111,"Alegeri Prezidentiale",1,1396,596,583,13,0,578,18,1500,904,303,275
9,BRĂILA,"MUNICIPIUL BRĂILA",42682,BRĂILA,"ȘCOALA GIMNAZIALĂ NR. 22 „RADU TUDORAN”",112,"Alegeri Prezidentiale",1,1239,577,569,8,0,561,16,1400,823,343,218
9,BRĂILA,"MUNICIPIUL BRĂILA",42682,BRĂILA,"ȘCOALA GIMNAZIALĂ NR. 22 „RADU TUDORAN”",113,"Alegeri Prezidentiale",1,1178,565,550,15,0,554,11,1300,735,294,260
9,BRĂILA,"MUNICIPIUL BRĂILA",42682,BRĂILA,"ȘCOALA GIMNAZIALĂ NR. 22 „RADU TUDORAN”",114,"Alegeri Prezidentiale",1,1161,514,502,12,0,508,6,1300,786,298,210
9,BRĂILA,"MUNICIPIUL BRĂILA",42682,BRĂILA,"CǍMINUL CULTURAL „NEDELCU CHERCEA”",115,"Alegeri Prezidentiale",1,1403,578,549,29,0,568,10,1500,922,340,228
9,BRĂILA,"MUNICIPIUL BRĂILA",42682,BRĂILA,"ȘCOALA GIMNAZIALĂ NR. 24 „GHEORGHE NAUM”",116,"Alegeri Prezidentiale",1,1367,587,564,23,0,573,14,1500,913,319,254
9,BRĂILA,"MUNICIPIUL BRĂILA",42682,BRĂILA,"ȘCOALA GIMNAZIALĂ NR. 24 „GHEORGHE NAUM”",117,"Alegeri Prezidentiale",1,1498,671,654,17,0,663,8,1600,929,398,265
9,BRĂILA,"MUNICIPIUL BRĂILA",42682,BRĂILA,"ȘCOALA GIMNAZIALĂ NR. 24 „GHEORGHE NAUM”",118,"Alegeri Prezidentiale",1,1308,652,632,20,0,639,13,1400,748,384,255
9,BRĂILA,"MUNICIPIUL BRĂILA",42682,BRĂILA,"ȘCOALA GIMNAZIALĂ NR. 24 „GHEORGHE NAUM”",119,"Alegeri Prezidentiale",1,1465,561,524,27,10,555,6,1600,1039,334,221
9,BRĂILA,"MUNICIPIUL BRĂILA",42682,BRĂILA,"GRĂDINIŢA NR. 8 „SCUFIȚA ROȘIE”",120,"Alegeri Prezidentiale",1,1207,610,588,21,1,598,12,1300,690,342,256
9,BRĂILA,"MUNICIPIUL BRĂILA",42682,BRĂILA,"GRĂDINIŢA NR. 8 „SCUFIȚA ROȘIE”",121,"Alegeri Prezidentiale",2,1192,556,535,20,1,539,17,1300,744,287,252
9,BRĂILA,"MUNICIPIUL BRĂILA",42682,BRĂILA,"ȘCOALA GIMNAZIALĂ NR. 11 „ION LUCA CARAGIALE”",122,"Alegeri Prezidentiale",1,1170,514,482,31,1,499,15,1300,786,287,212
9,BRĂILA,"MUNICIPIUL BRĂILA",42682,BRĂILA,"ȘCOALA GIMNAZIALĂ NR. 11 „ION LUCA CARAGIALE”",123,"Alegeri Prezidentiale",1,1246,545,522,23,0,533,12,1400,855,299,234
9,BRĂILA,"MUNICIPIUL BRĂILA",42682,BRĂILA,"ȘCOALA GIMNAZIALĂ NR. 19 „MIHAIL KOGĂLNICEANU”",124,"Alegeri Prezidentiale",1,1396,633,620,13,0,621,12,1492,859,335,286
9,BRĂILA,"MUNICIPIUL BRĂILA",42682,BRĂILA,"ȘCOALA GIMNAZIALĂ NR. 19 „MIHAIL KOGĂLNICEANU”",125,"Alegeri Prezidentiale",1,1248,517,504,13,0,509,8,1400,883,280,229
9,BRĂILA,"MUNICIPIUL BRĂILA",42682,BRĂILA,"ȘCOALA GIMNAZIALĂ NR. 19 „MIHAIL KOGĂLNICEANU”",126,"Alegeri Prezidentiale",1,1385,624,607,17,0,610,14,1492,868,369,241
9,BRĂILA,"MUNICIPIUL BRĂILA",42682,BRĂILA,"ȘCOALA GIMNAZIALĂ NR. 19 „MIHAIL KOGĂLNICEANU”",127,"Alegeri Prezidentiale",1,1652,804,783,21,0,778,26,1800,996,528,250
9,BRĂILA,"MUNICIPIUL BRĂILA",42682,BRĂILA,"ȘCOALA GIMNAZIALĂ NR. 21 „ALEXANDR SERGHEEVICI PUȘKIN”",128,"Alegeri Prezidentiale",1,1245,513,492,21,0,505,8,1400,887,338,167
9,BRĂILA,"MUNICIPIUL BRĂILA",42682,BRĂILA,"ȘCOALA GIMNAZIALĂ NR. 21 „ALEXANDR SERGHEEVICI PUȘKIN”",129,"Alegeri Prezidentiale",1,1281,542,527,15,0,533,9,1400,858,326,207
9,BRĂILA,"MUNICIPIUL BRĂILA",42682,BRĂILA,"ŞCOALA GIMNAZIALĂ NR. 20 „GEORGE COŞBUC”",130,"Alegeri Prezidentiale",1,1338,641,614,27,0,629,12,1500,859,391,238
9,BRĂILA,"MUNICIPIUL BRĂILA",42682,BRĂILA,"ŞCOALA GIMNAZIALĂ NR. 20 „GEORGE COŞBUC”",131,"Alegeri Prezidentiale",1,1186,609,583,26,0,603,6,1300,691,326,277
9,BRĂILA,"MUNICIPIUL BRĂILA",42682,BRĂILA,"ŞCOALA GIMNAZIALĂ NR. 20 „GEORGE COŞBUC”",132,"Alegeri Prezidentiale",1,1324,669,655,14,0,655,14,1500,831,330,325
9,BRĂILA,"MUNICIPIUL BRĂILA",42682,BRĂILA,"LICEUL TEHNOLOGIC „CONSTANTIN BRÂNCOVEANU”",133,"Alegeri Prezidentiale",1,1045,533,502,31,0,522,11,1100,567,279,243
9,BRĂILA,"MUNICIPIUL BRĂILA",42682,BRĂILA,"LICEUL TEHNOLOGIC „CONSTANTIN BRÂNCOVEANU”",134,"Alegeri Prezidentiale",1,1597,615,591,24,0,598,17,1700,1085,345,253
9,BRĂILA,"MUNICIPIUL BRĂILA",42682,BRĂILA,"LICEUL TEHNOLOGIC „CONSTANTIN BRÂNCOVEANU”",135,"Alegeri Prezidentiale",1,1354,644,627,17,0,636,8,1508,864,342,294
9,BRĂILA,"MUNICIPIUL BRĂILA",42682,BRĂILA,"LICEUL TEHNOLOGIC „CONSTANTIN BRÂNCOVEANU”",136,"Alegeri Prezidentiale",1,1184,588,577,11,0,579,9,1300,712,287,292
9,BRĂILA,"MUNICIPIUL BRĂILA",42682,BRĂILA,"LICEUL TEHNOLOGIC „CONSTANTIN BRÂNCOVEANU”",137,"Alegeri Prezidentiale",1,1153,493,477,16,0,484,9,1300,807,264,220
9,BRĂILA,"MUNICIPIUL BRĂILA",42682,BRĂILA,"ȘCOALA GIMNAZIALĂ NR. 33 „SFÂNTUL ANDREI”",138,"Alegeri Prezidentiale",1,1102,529,511,18,0,518,11,1200,671,351,167
9,BRĂILA,"MUNICIPIUL BRĂILA",42682,BRĂILA,"ȘCOALA GIMNAZIALĂ NR. 33 „SFÂNTUL ANDREI”",139,"Alegeri Prezidentiale",1,1420,646,629,17,0,634,12,1600,954,391,243
9,BRĂILA,"MUNICIPIUL BRĂILA",42682,BRĂILA,"ȘCOALA GIMNAZIALĂ NR. 33 „SFÂNTUL ANDREI”",140,"Alegeri Prezidentiale",1,1089,521,514,7,0,508,13,1200,679,244,264
9,BRĂILA,"ORAŞ FĂUREI",42753,FĂUREI,"CASA DE CULTURĂ FĂUREI, SALA MICĂ",141,"Alegeri Prezidentiale",1,1432,679,620,57,2,664,15,1600,921,334,330
9,BRĂILA,"ORAŞ FĂUREI",42753,FĂUREI,"ŞCOALA GIMNAZIALĂ CU CLASELE I-IV FĂUREI, SALA NR.2",142,"Alegeri Prezidentiale",1,1327,619,573,29,17,609,10,1500,881,335,274
9,BRĂILA,"ORAŞ FĂUREI",42753,FĂUREI,"FOSTA ŞCOALA GENERALĂ NR.2 FĂUREI, SALA NR.1",143,"Alegeri Prezidentiale",1,543,239,221,17,1,236,3,582,343,124,112
9,BRĂILA,"ORAŞ IANCA",43331,IANCA,"ȘCOALA GIMNAZIALĂ IANCA",144,"Alegeri Prezidentiale",1,1054,446,406,40,0,438,8,1200,754,188,250
9,BRĂILA,"ORAŞ IANCA",43331,IANCA,"ȘCOALA GIMNAZIALĂ IANCA",145,"Alegeri Prezidentiale",1,1164,500,475,25,0,493,7,1300,800,259,234
9,BRĂILA,"ORAŞ IANCA",43331,IANCA,"CASA DE CULTURĂ ”ION THEODORESCU SION”",146,"Alegeri Prezidentiale",1,1183,546,462,84,0,534,12,1292,746,285,249
9,BRĂILA,"ORAŞ IANCA",43331,IANCA,"LICEUL TEORETIC ”CONSTANTIN ANGELESCU”",147,"Alegeri Prezidentiale",1,1039,450,420,30,0,448,2,1100,650,251,197
9,BRĂILA,"ORAŞ IANCA",43331,IANCA,"LICEUL TEORETIC ”CONSTANTIN ANGELESCU”",148,"Alegeri Prezidentiale",1,1014,483,444,26,13,474,9,1100,617,217,257
9,BRĂILA,"ORAŞ IANCA",43331,PLOPU,"ȘCOALA GIMNAZIALĂ PLOPU",149,"Alegeri Prezidentiale",1,1221,554,517,37,0,549,5,1300,746,239,310
9,BRĂILA,"ORAŞ IANCA",43331,OPRIŞENEŞTI,"ȘCOALA PRIMARĂ OPRIȘENEȘTI",150,"Alegeri Prezidentiale",1,632,339,310,29,0,332,7,700,361,198,134
9,BRĂILA,"ORAŞ IANCA",43331,PERIŞORU,"ȘCOALA GIMNAZIALĂ PERIȘORU",151,"Alegeri Prezidentiale",1,871,393,364,29,0,388,5,1000,607,185,203
9,BRĂILA,"ORAŞ IANCA",43331,"TÂRLELE FILIU","ȘCOALA PRIMARĂ TÎRLELE FILIU",152,"Alegeri Prezidentiale",1,450,230,199,31,0,229,1,500,270,115,114
9,BRĂILA,"ORAŞ IANCA",43331,BERLEŞTI,"ȘCOALA PRIMARĂ BERLEȘTI",153,"Alegeri Prezidentiale",1,259,149,129,20,0,147,2,300,151,74,73
9,BRĂILA,"ORAŞ ÎNSURĂŢEI",43411,ÎNSURĂŢEI,"ȘCOALA GIMNAZIALĂ ”SPIRU HARET” ÎNSURĂȚEI - LOCAȚIA 1",154,"Alegeri Prezidentiale",1,1136,320,303,17,0,314,6,1200,880,142,172
9,BRĂILA,"ORAŞ ÎNSURĂŢEI",43411,ÎNSURĂŢEI,"ȘCOALA GIMNAZIALĂ ”SPIRU HARET” ÎNSURĂȚEI - LOCAȚIA 1",155,"Alegeri Prezidentiale",2,1078,390,356,34,0,384,6,1200,810,173,211
9,BRĂILA,"ORAŞ ÎNSURĂŢEI",43411,ÎNSURĂŢEI,"LICEUL TEHNOLOGIC ” NICOLAE TITULESCU ” ÎNSURĂȚEI - ȘCOALA ANEXĂ",156,"Alegeri Prezidentiale",1,997,378,345,33,0,370,8,1100,722,146,224
9,BRĂILA,"ORAŞ ÎNSURĂŢEI",43411,ÎNSURĂŢEI,"LICEUL TEHNOLOGIC ” NICOLAE TITULESCU ” ÎNSURĂȚEI - ȘCOALA ANEXĂ",157,"Alegeri Prezidentiale",1,865,300,276,24,0,294,6,1000,700,108,186
9,BRĂILA,"ORAŞ ÎNSURĂŢEI",43411,ÎNSURĂŢEI,"ȘCOALA GIMNAZIALĂ ” SPIRU HARET ” ÎNSURĂȚEI - LOCAȚIA 2",158,"Alegeri Prezidentiale",1,1280,505,476,29,0,500,5,1400,895,212,288
9,BRĂILA,"ORAŞ ÎNSURĂŢEI",43411,"LACU REZII","ȘCOALA GIMNAZIALĂ ” SPIRU HARET ” ÎNSURĂȚEI - LOCAȚIA DIN SATUL LACU REZII",159,"Alegeri Prezidentiale",1,382,148,132,16,0,147,1,400,252,64,83
9,BRĂILA,BĂRĂGANUL,42824,BĂRĂGANUL,"ŞCOALA CU CLASELE I - VIII BĂRĂGANUL",160,"Alegeri Prezidentiale",1,1208,478,404,74,0,472,6,1300,822,236,236
9,BRĂILA,BĂRĂGANUL,42824,BĂRĂGANUL,"SCOALA CU CLS. I - VIII BĂRĂGANUL - SALA DE CLASĂ NR. 1",161,"Alegeri Prezidentiale",1,1294,524,463,61,0,517,7,1400,876,247,270
9,BRĂILA,"BERTEŞTII DE JOS",42842,"BERTEŞTII DE JOS","CĂMINUL CULTURAL BERTEȘTII DE JOS",162,"Alegeri Prezidentiale",1,677,363,326,37,0,359,4,700,337,221,138
9,BRĂILA,"BERTEŞTII DE JOS",42842,"SPIRU HARET","CĂMINUL CULTURAL SPIRU HARET",163,"Alegeri Prezidentiale",1,1231,479,454,25,0,476,3,1300,821,279,197
9,BRĂILA,"BERTEŞTII DE JOS",42842,"BERTEŞTII DE SUS","CĂMINUL CULTURAL BERTEȘTII DE SUS",164,"Alegeri Prezidentiale",1,272,145,118,27,0,145,0,300,155,92,53
9,BRĂILA,"BERTEŞTII DE JOS",42842,"GURA CĂLMĂŢUI","SEDIU MULTIFUNCȚIONAL GURA CĂLMĂȚUI",165,"Alegeri Prezidentiale",1,256,146,127,19,0,145,1,300,154,74,71
9,BRĂILA,"BORDEI VERDE",42913,"BORDEI VERDE","ȘCOALA CU CLASELE I-VIII BORDEI VERDE",166,"Alegeri Prezidentiale",1,1100,581,535,46,0,574,7,1200,619,232,342
9,BRĂILA,"BORDEI VERDE",42913,"CONSTANTIN GABRIELESCU","CAMINUL CULTURAL DIN LOCALITATEA CONSTANTIN GABRIELESCU",167,"Alegeri Prezidentiale",1,523,284,255,29,0,280,4,600,316,102,178
9,BRĂILA,"BORDEI VERDE",42913,LIŞCOTEANCA,"CĂMINUL CULTURAL LIȘCOTEANCA",168,"Alegeri Prezidentiale",1,436,251,228,23,0,249,2,500,249,90,159
9,BRĂILA,CAZASU,44560,CAZASU,"ȘCOALA CU CLASELE I-IV CAZASU (SATUC)",169,"Alegeri Prezidentiale",1,1322,680,623,57,0,666,14,1400,720,454,212
9,BRĂILA,CAZASU,44560,CAZASU,"ȘCOALA GIMNAZIALĂ CAZASU",170,"Alegeri Prezidentiale",1,1681,793,733,60,0,789,4,1800,1007,524,265
9,BRĂILA,CHISCANI,42708,CHISCANI,"SCOALA GIMNAZIALA CHISCANI - CENTRU",171,"Alegeri Prezidentiale",1,1457,586,559,27,0,578,8,1600,1014,361,217
9,BRĂILA,CHISCANI,42708,CHISCANI,"SCOALA GIMNAZIALA- CHISCANI - CARTIER",172,"Alegeri Prezidentiale",1,1904,724,676,48,0,714,10,2100,1376,462,252
9,BRĂILA,CHISCANI,42708,"LACU SĂRAT","GRADINITA CU PROGRAM NORMAL -LACU SARAT",173,"Alegeri Prezidentiale",1,1822,886,769,112,5,872,14,2000,1114,523,349
9,BRĂILA,CIOCILE,42968,CIOCILE,"CAMINUL CULTURAL CIOCILE",174,"Alegeri Prezidentiale",1,773,316,283,33,0,313,3,800,484,121,192
9,BRĂILA,CIOCILE,42968,CIOCILE,"CAMINUL CULTURAL CIOCILE",175,"Alegeri Prezidentiale",1,800,372,345,27,0,365,7,900,528,150,215
9,BRĂILA,CIOCILE,42968,CHICHINEŢU,"ȘCOALA PRIMARA PRI CHICHINEȚU",176,"Alegeri Prezidentiale",1,442,187,161,26,0,184,3,500,313,68,116
9,BRĂILA,CIREŞU,43019,CIREŞU,"ȘCOALA CU CLASELE I-VIII CIREȘU",177,"Alegeri Prezidentiale",1,725,293,258,35,0,289,4,800,507,198,91
9,BRĂILA,CIREŞU,43019,BATOGU,"ȘCOALA CU CLASELE I-VIII BATOGU",178,"Alegeri Prezidentiale",1,532,247,221,26,0,246,1,600,353,154,92
9,BRĂILA,CIREŞU,43019,SCĂRLĂTEŞTI,"ȘCOALA CU CLASELE I-VIII SCĂRLĂTEȘTI",179,"Alegeri Prezidentiale",1,658,295,279,16,0,295,0,709,414,194,101
9,BRĂILA,CIREŞU,43019,VULTURENI,"ȘCOALA CU CLASELE I-VIII VULTURENI",180,"Alegeri Prezidentiale",1,461,250,227,23,0,248,2,500,250,150,98
9,BRĂILA,DUDEŞTI,43073,DUDEŞTI,"ȘCOALA GIMNAZIALĂ DUDEȘTI",181,"Alegeri Prezidentiale",1,1333,553,504,49,0,544,9,1500,947,197,347
9,BRĂILA,DUDEŞTI,43073,TĂTARU,"ȘCOALA CU CLASELE V-VIII TĂTARU",182,"Alegeri Prezidentiale",1,1111,506,454,52,0,498,8,1200,694,179,319
9,BRĂILA,DUDEŞTI,43073,TĂTARU,"ŞCOALA CU CLASELE I-IV TATARU",183,"Alegeri Prezidentiale",1,421,204,171,33,0,201,3,500,296,66,135
9,BRĂILA,FRECĂŢEI,43117,AGAUA,"CĂMIN CULTURAL AGAUA",184,"Alegeri Prezidentiale",1,428,203,178,25,0,201,2,500,297,107,94
9,BRĂILA,FRECĂŢEI,43117,FRECĂŢEI,"ȘCOALA CU CLASELE I-VIII FRECĂȚEI",185,"Alegeri Prezidentiale",1,291,147,133,14,0,147,0,300,153,100,47
9,BRĂILA,FRECĂŢEI,43117,TITCOV,"ȘCOALA CU CLASELE I-IV TITCOV",186,"Alegeri Prezidentiale",1,379,172,158,14,0,169,3,400,228,115,54
9,BRĂILA,GALBENU,43180,GALBENU,"ȘCOALA GIMNAZIALA ”TOMA TAMPEANU” GALBENU",187,"Alegeri Prezidentiale",1,751,338,290,48,0,334,4,800,462,129,205
9,BRĂILA,GALBENU,43180,SĂTUC,"ȘCOALA GIMNAZIALĂ SĂTUC",188,"Alegeri Prezidentiale",1,567,281,250,31,0,277,4,600,319,107,170
9,BRĂILA,GALBENU,43180,ZAMFIREŞTI,"ȘCOALA GIMNAZIALĂ ZAMFIREȘTI",189,"Alegeri Prezidentiale",1,292,155,134,21,0,155,0,300,145,49,106
9,BRĂILA,GALBENU,43180,DROGU,"ȘCOALA GIMNAZIALĂ DROGU",190,"Alegeri Prezidentiale",1,671,271,231,40,0,268,3,700,429,60,208
9,BRĂILA,GALBENU,43180,PÂNTECANI,"ȘCOALA GIMNAZIALĂ PÂNTECANI",191,"Alegeri Prezidentiale",1,138,80,63,17,0,80,0,200,120,33,47
9,BRĂILA,GEMENELE,43242,GEMENELE,"ȘCOALA GIMNAZIALĂ CU CLASELE I-VIII",192,"Alegeri Prezidentiale",1,1441,663,610,53,0,656,7,1600,937,282,374
9,BRĂILA,GRĂDIŞTEA,43279,GRĂDIŞTEA,"CAMIN CULTURAL GRADISTEA",193,"Alegeri Prezidentiale",1,993,565,496,69,0,559,6,1100,535,425,134
9,BRĂILA,GRĂDIŞTEA,43279,IBRIANU,"SCOALA IBRIANU - CORPUL NOU",194,"Alegeri Prezidentiale",1,502,275,244,31,0,271,4,600,325,211,60
9,BRĂILA,GRĂDIŞTEA,43279,MARALOIU,"SCOALA MARALOIU",195,"Alegeri Prezidentiale",1,225,163,123,40,0,163,0,300,137,118,45
9,BRĂILA,GROPENI,43313,GROPENI,"CĂMIN CULTURAL",196,"Alegeri Prezidentiale",1,1434,634,569,65,0,623,11,1600,966,405,218
9,BRĂILA,GROPENI,43313,GROPENI,"ȘCOALA GIMNAZIALĂ GROPENI",197,"Alegeri Prezidentiale",2,1332,591,552,39,0,585,6,1500,909,339,246
9,BRĂILA,JIRLĂU,43466,JIRLĂU,"ŞCOALA GIMNAZIALĂ NR.2",198,"Alegeri Prezidentiale",1,1371,504,465,38,1,500,4,1500,996,160,340
9,BRĂILA,JIRLĂU,43466,JIRLĂU,"SCOALA GIMNAZIALĂ NR.1",199,"Alegeri Prezidentiale",1,1127,433,387,44,2,428,5,1208,775,135,293
9,BRĂILA,MĂRAŞU,43493,MĂRAŞU,"CĂMINUL CULTURAL MĂRAȘU",200,"Alegeri Prezidentiale",1,751,241,217,24,0,236,5,800,559,135,101
9,BRĂILA,MĂRAŞU,43493,BĂNDOIU,"ȘCOALA PRIMARA BĂNDOIU",201,"Alegeri Prezidentiale",1,342,157,135,22,0,157,0,400,243,97,60
9,BRĂILA,MĂRAŞU,43493,ŢĂCĂU,"ȘCOALA GIMNAZIALĂ ȚĂCĂU",202,"Alegeri Prezidentiale",1,560,211,199,12,0,209,2,600,389,141,68
9,BRĂILA,MĂRAŞU,43493,MĂGURENI,"CĂMINUL CULTURAL MĂGURENI",203,"Alegeri Prezidentiale",1,421,182,153,29,0,181,1,500,318,96,85
9,BRĂILA,MĂRAŞU,43493,PLOPI,"ȘCOALA PRIMARA PLOPI",204,"Alegeri Prezidentiale",1,144,47,40,7,0,47,0,200,153,26,21
9,BRĂILA,MĂXINENI,43563,MĂXINENI,"ȘCOALA GENERALĂ CU CLASELE I-VIII MĂXINENI",205,"Alegeri Prezidentiale",1,1198,494,457,37,0,488,6,1300,806,331,157
9,BRĂILA,MĂXINENI,43563,"CORBU NOU","CĂMINUL CULTURAL CORBU NOU",206,"Alegeri Prezidentiale",1,676,254,226,28,0,252,2,700,446,156,96
9,BRĂILA,MĂXINENI,43563,"CORBU VECHI","CĂMINUL CULTURAL CORBU VECHI",207,"Alegeri Prezidentiale",1,228,100,89,11,0,98,2,300,200,71,27
9,BRĂILA,MĂXINENI,43563,LATINU,"CAMIN CULTURAL LATINU",208,"Alegeri Prezidentiale",1,600,223,191,31,1,220,3,700,477,117,103
9,BRĂILA,"MIRCEA VODĂ",43625,"MIRCEA VODĂ","SCOALA GIMNAZIALA MIRCEA VODA, JUDEȚUL BRAILA",209,"Alegeri Prezidentiale",1,914,312,279,33,0,306,6,1000,688,204,102
9,BRĂILA,"MIRCEA VODĂ",43625,"MIRCEA VODĂ","SCOALA GIMNAZIALA MIRCEA VODA, JUDETUL BRAILA",210,"Alegeri Prezidentiale",1,1008,339,307,32,0,334,5,1100,761,238,96
9,BRĂILA,"MIRCEA VODĂ",43625,DEDULEŞTI,"SCOALA GIMNAZIALA SAT DEDULESTI",211,"Alegeri Prezidentiale",1,689,244,209,35,0,242,2,800,556,157,85
9,BRĂILA,"MOVILA MIRESII",43652,"MOVILA MIRESII","SCOALA VECHE",212,"Alegeri Prezidentiale",1,1130,557,507,50,0,550,7,1200,643,166,384
9,BRĂILA,"MOVILA MIRESII",43652,"MOVILA MIRESII","CAMIN CULTURAL M.MIRESII",213,"Alegeri Prezidentiale",1,1171,538,490,48,0,530,8,1300,762,190,340
9,BRĂILA,"MOVILA MIRESII",43652,"ŢEPEŞ VODĂ","SCOALA TEPES VODA",214,"Alegeri Prezidentiale",1,764,373,338,35,0,369,4,800,427,154,215
9,BRĂILA,"MOVILA MIRESII",43652,ESNA,"SCOALA ESNA",215,"Alegeri Prezidentiale",1,260,135,121,14,0,133,2,300,165,29,104
9,BRĂILA,RACOVIŢA,43698,RACOVIŢA,"CĂMINUL CULTURAL RACOVIȚA",216,"Alegeri Prezidentiale",1,856,436,382,54,0,433,3,1000,564,204,229
9,BRĂILA,RÂMNICELU,43732,RÂMNICELU,"ȘCOALA GIMNAZIALĂ RÎMNICELU",217,"Alegeri Prezidentiale",1,1113,508,452,56,0,503,5,1200,692,215,288
9,BRĂILA,RÂMNICELU,43732,CONSTANTINEŞTI,"ȘCOALA PRIMARĂ CONSTANTINEȘTI",218,"Alegeri Prezidentiale",1,260,154,119,35,0,152,2,300,146,69,83
9,BRĂILA,RÂMNICELU,43732,"MIHAIL KOGĂLNICEANU","ȘCOALA PRIMARĂ MIHAIL KOGĂLNICEANU",219,"Alegeri Prezidentiale",1,209,141,113,28,0,139,2,300,159,92,47
9,BRĂILA,ROMANU,43787,ROMANU,"ȘCOALA GIMNAZIALA ROMANU",220,"Alegeri Prezidentiale",1,1140,473,416,56,1,465,8,1200,727,243,222
9,BRĂILA,ROMANU,43787,OANCEA,"ȘCOALA GIMNAZIALA OANCEA",221,"Alegeri Prezidentiale",1,321,151,118,33,0,151,0,400,249,87,64
9,BRĂILA,ROŞIORI,43812,ROŞIORI,"CASA DE CULTURĂ ROȘIORI",222,"Alegeri Prezidentiale",1,1237,450,390,60,0,442,8,1400,950,137,305
9,BRĂILA,ROŞIORI,43812,COLŢEA,"ȘCOALA CU CLASELE I-VIII COLȚEA",223,"Alegeri Prezidentiale",1,834,315,273,42,0,314,1,900,585,109,205
9,BRĂILA,"SALCIA TUDOR",43867,"SALCIA TUDOR","CĂMINUL CULTURAL SALCIA TUDOR",224,"Alegeri Prezidentiale",1,591,288,252,35,1,286,2,700,412,188,98
9,BRĂILA,"SALCIA TUDOR",43867,"CUZA VODĂ","ȘCOALA GIMNAZIALĂ CUZA VODĂ",225,"Alegeri Prezidentiale",2,686,302,278,24,0,297,5,700,398,175,122
9,BRĂILA,"SALCIA TUDOR",43867,GULIANCA,"CĂMINUL CULTURAL GULIANCA",226,"Alegeri Prezidentiale",1,330,139,118,21,0,138,1,400,261,81,57
9,BRĂILA,"SALCIA TUDOR",43867,OLĂNEASCA,"CĂMINUL CULTURAL OLĂNEASCA",227,"Alegeri Prezidentiale",1,343,138,123,15,0,135,3,400,262,84,51
9,BRĂILA,"SALCIA TUDOR",43867,ARICIU,"CĂMINUL CULTURAL ARICIU",228,"Alegeri Prezidentiale",1,132,65,52,13,0,64,1,200,135,39,25
9,BRĂILA,"SCORŢARU NOU",43929,"SCORŢARU NOU","ȘCOALA GIMNAZIALĂ SCORȚARU NOU",229,"Alegeri Prezidentiale",1,683,319,277,42,0,316,3,808,489,190,126
9,BRĂILA,"SCORŢARU NOU",43929,SIHLEANU,"GRĂDINIȚA CU PROGRAM NORMAL SIHLEANU",230,"Alegeri Prezidentiale",1,380,203,173,30,0,200,3,392,189,94,106
9,BRĂILA,SILIŞTEA,43992,SILIŞTEA,"CĂMINUL CULTURAL SILIȘTEA",231,"Alegeri Prezidentiale",1,860,363,314,49,0,362,1,900,537,178,184
9,BRĂILA,SILIŞTEA,43992,MUCHEA,"ȘCOALA PRIMARĂ MUCHEA",232,"Alegeri Prezidentiale",1,342,176,152,24,0,175,1,400,224,74,101
9,BRĂILA,SILIŞTEA,43992,"COTU LUNG","GRĂDINIŢA CU PROGRAM NORMAL COTU-LUNG",233,"Alegeri Prezidentiale",1,265,159,113,46,0,154,5,300,141,72,82
9,BRĂILA,STĂNCUŢA,44060,STĂNCUŢA,"ȘCOALA GIMNAZIALA STĂNCUȚA",234,"Alegeri Prezidentiale",1,1256,668,625,43,0,660,8,1400,732,259,401
9,BRĂILA,STĂNCUŢA,44060,"CUZA VODĂ","CĂMINUL CULTURAL CUZA VODĂ",235,"Alegeri Prezidentiale",1,1208,499,479,20,0,488,11,1300,801,273,215
9,BRĂILA,STĂNCUŢA,44060,STANCA,"ȘCOALA STANCA",236,"Alegeri Prezidentiale",1,348,208,164,44,0,206,2,400,192,84,122
9,BRĂILA,SURDILA-GĂISEANCA,44113,SURDILA-GĂISEANCA,"CĂMINUL CULTURAL SURDILA GĂISEANCA",237,"Alegeri Prezidentiale",1,1333,745,689,56,0,736,9,1392,647,354,382
9,BRĂILA,SURDILA-GĂISEANCA,44113,FILIPEŞTI,"FOSTA ȘCOALA GIMNAZIALA FILIPESTI",238,"Alegeri Prezidentiale",1,645,343,251,92,0,338,5,700,357,208,130
9,BRĂILA,SURDILA-GRECI,42771,SURDILA-GRECI,"ȘCOALA CU CLASELE I-VIII SURDILA GRECI",239,"Alegeri Prezidentiale",1,587,288,250,38,0,287,1,600,312,186,101
9,BRĂILA,SURDILA-GRECI,42771,FĂUREI-SAT,"ȘCOALA CU CLASELE I-IV FĂUREI - SAT",240,"Alegeri Prezidentiale",1,284,164,133,31,0,164,0,300,136,107,57
9,BRĂILA,SURDILA-GRECI,42771,HORIA,"ȘCOALA CU CLASELE I-IV HORIA",241,"Alegeri Prezidentiale",1,327,199,176,23,0,198,1,410,211,154,44
9,BRĂILA,ŞUŢEŞTI,44140,ŞUŢEŞTI,"CĂMINUL CULTURAL ŞUŢEŞTI",242,"Alegeri Prezidentiale",1,1099,453,395,58,0,449,4,1200,747,241,208
9,BRĂILA,ŞUŢEŞTI,44140,ŞUŢEŞTI,"ŞCOALA GIMNAZIALĂ ŞUŢEŞTI (ŞCOALA DE ARTE ŞI MESERII)",243,"Alegeri Prezidentiale",1,1218,430,404,26,0,427,3,1281,851,243,184
9,BRĂILA,ŞUŢEŞTI,44140,ŞUŢEŞTI,"ŞCOALA GIMNAZIALĂ ŞUŢEŞTI (ŞCOALA DE ARTE ŞI MESERII)",244,"Alegeri Prezidentiale",1,948,317,302,15,0,312,5,1053,736,159,153
9,BRĂILA,ŞUŢEŞTI,44140,"MIHAIL KOGĂLNICEANU","ŞCOALA CU CLASELE I-IV MIHAIL KOGĂLNICEANU",245,"Alegeri Prezidentiale",1,292,143,112,31,0,142,1,400,257,61,81
9,BRĂILA,TICHILEŞTI,44177,TICHILEŞTI,"SCOALA GIMNAZIALA TICHILESTI",246,"Alegeri Prezidentiale",1,1417,674,526,48,100,665,9,1600,926,380,285
9,BRĂILA,TICHILEŞTI,44177,TICHILEŞTI,"SCOALA GIMNAZIALA TICHILESTI",247,"Alegeri Prezidentiale",1,1369,537,507,30,0,533,4,1500,963,354,179
9,BRĂILA,TICHILEŞTI,44177,ALBINA,"SCOALA PRIMARA ALBINA",248,"Alegeri Prezidentiale",1,254,163,113,50,0,163,0,300,137,86,77
9,BRĂILA,TRAIAN,44202,TRAIAN,"ȘCOALA CU CLASELE I-VIII TRAIAN",249,"Alegeri Prezidentiale",1,920,443,388,55,0,438,5,1000,557,200,238
9,BRĂILA,TRAIAN,44202,SILISTRARU,"GRĂDINIȚA SILISTRARU",250,"Alegeri Prezidentiale",1,600,290,249,41,0,289,1,700,410,109,180
9,BRĂILA,TRAIAN,44202,URLEASCA,"GRĂDINIȚA URLEASCA",251,"Alegeri Prezidentiale",1,999,368,339,29,0,362,6,1111,743,177,185
9,BRĂILA,TRAIAN,44202,CĂLDĂRUŞA,"FOSTA ȘCOALĂ CĂLDĂRUȘA",252,"Alegeri Prezidentiale",1,158,90,74,16,0,86,4,200,110,38,48
9,BRĂILA,"TUDOR VLADIMIRESCU",44257,"TUDOR VLADIMIRESCU","ȘCOALA GIMNAZIALĂ TUDOR VLADIMIRESCU",253,"Alegeri Prezidentiale",1,804,386,309,77,0,379,7,900,514,210,169
9,BRĂILA,"TUDOR VLADIMIRESCU",44257,"SCORŢARU VECHI","CĂMINUL CULTURAL SCORȚARU VECHI",254,"Alegeri Prezidentiale",1,774,465,406,59,0,460,5,900,435,194,266
9,BRĂILA,"TUDOR VLADIMIRESCU",44257,COMĂNEASCA,"CĂMINUL CULTURAL COMĂNEASCA",255,"Alegeri Prezidentiale",1,175,121,88,33,0,119,2,200,79,45,74
9,BRĂILA,TUFEŞTI,44300,TUFEŞTI,"SCOALA PETRE CARP TUFESTI",256,"Alegeri Prezidentiale",1,865,362,326,36,0,356,6,1000,638,168,188
9,BRĂILA,TUFEŞTI,44300,TUFEŞTI,"CLADIREA FOSTEI GRADINITE TUFESTI",257,"Alegeri Prezidentiale",1,871,387,348,39,0,383,4,1000,613,209,174
9,BRĂILA,TUFEŞTI,44300,TUFEŞTI,"CAMIN CULTURAL DIN FOSTUL SAT TIBANESTI",258,"Alegeri Prezidentiale",1,1109,423,391,32,0,421,2,1200,777,217,204
9,BRĂILA,TUFEŞTI,44300,TUFEŞTI,"SCOALA PETRE CARP DIN FOSTUL SAT TIBANESTI",259,"Alegeri Prezidentiale",1,1338,593,552,41,0,588,5,1500,907,303,285
9,BRĂILA,ULMU,44328,ULMU,"CAMINUL CULTURAL ULMU",260,"Alegeri Prezidentiale",1,1240,697,613,84,0,697,0,1400,703,447,250
9,BRĂILA,ULMU,44328,ULMU,"CAMINUL CULTURAL MOHREANU",261,"Alegeri Prezidentiale",1,994,542,508,34,0,534,8,1100,558,219,315
9,BRĂILA,ULMU,44328,JUGUREANU,"CAMINUL CULTURAL JUGUREANU",262,"Alegeri Prezidentiale",1,783,405,366,39,0,397,8,900,495,202,195
9,BRĂILA,UNIREA,44355,UNIREA,"SCOALA GIMNAZIALA UNIREA",263,"Alegeri Prezidentiale",1,863,423,368,55,0,416,7,1000,577,227,189
9,BRĂILA,UNIREA,44355,"VALEA CÂNEPII","STRUCTURA SCOALA GIMNAZIALA VALEA CINEPII,",264,"Alegeri Prezidentiale",1,1047,441,385,56,0,434,7,1100,659,249,185
9,BRĂILA,VĂDENI,44391,VĂDENI,"SCOALA GIMNAZIALA CU CLASELE I-VIII VADENI -SALA A",265,"Alegeri Prezidentiale",1,937,439,400,39,0,429,10,1008,569,265,164
9,BRĂILA,VĂDENI,44391,VĂDENI,"SCOALA GIMNAZIALA CU CLASELE I-VIII-VADENI-SALA B",266,"Alegeri Prezidentiale",1,981,448,412,36,0,443,5,1100,652,251,192
9,BRĂILA,VĂDENI,44391,BALDOVINEŞTI,"SCOALA GIMNAZIALA CU CLASELE I-VIII BALDOVINESTI",267,"Alegeri Prezidentiale",1,964,417,375,42,0,402,15,1100,683,226,176
9,BRĂILA,VĂDENI,44391,PIETROIU,"SCOALA CU CLASELE I-IV PIETROIU",268,"Alegeri Prezidentiale",1,437,232,206,26,0,228,4,500,268,120,108
9,BRĂILA,VICTORIA,44435,VICTORIA,"SCOALA GIMNAZIALA VICTORIA",269,"Alegeri Prezidentiale",1,890,432,412,20,0,427,5,1000,568,247,180
9,BRĂILA,VICTORIA,44435,VICTORIA,"SCOALA GIMNAZIALA VICTORIA",270,"Alegeri Prezidentiale",1,824,436,414,22,0,434,2,900,464,233,201
9,BRĂILA,VICTORIA,44435,"MIHAI BRAVU","SCOALA GIMNAZIALA VICTORIA STRUCTURA SCOLARA GIMNAZIALA MIHAI BRAVU",271,"Alegeri Prezidentiale",1,1213,443,420,23,0,441,2,1300,857,199,242
9,BRĂILA,VIŞANI,44462,VIŞANI,"ȘCOALA GIMNAZIALĂ VIȘANI",272,"Alegeri Prezidentiale",1,1401,660,616,44,0,655,5,1600,940,202,453
9,BRĂILA,VIŞANI,44462,CÂINENI-BĂI,"ȘCOALA PRIMARĂ CÂINENI-BĂI",273,"Alegeri Prezidentiale",1,478,237,201,36,0,237,0,500,263,105,132
9,BRĂILA,VIZIRU,44505,VIZIRU,"SCOALA CU CLASELE I-VIII VIZIRU",274,"Alegeri Prezidentiale",1,1425,700,608,92,0,696,4,1600,900,362,334
9,BRĂILA,VIZIRU,44505,VIZIRU,"CENTRU EDUCATIONAL VIZIRU",275,"Alegeri Prezidentiale",1,1681,714,640,74,0,708,6,1900,1186,299,409
9,BRĂILA,VIZIRU,44505,LANURILE,"ȘCOALA LANURILE",276,"Alegeri Prezidentiale",1,889,370,325,45,0,366,4,1000,630,222,144
9,BRĂILA,VIZIRU,44505,LANURILE,"ȘCOALA LANURILE",277,"Alegeri Prezidentiale",1,899,386,358,28,0,380,6,1000,614,219,161
9,BRĂILA,ZĂVOAIA,44532,ZĂVOAIA,"CAMIN CULTURAL ZAVOAIA",278,"Alegeri Prezidentiale",1,966,434,403,31,0,430,4,1092,658,256,174
9,BRĂILA,ZĂVOAIA,44532,ZĂVOAIA,"CĂMINUL CULTURAL ZĂVOAIA",279,"Alegeri Prezidentiale",1,906,403,377,26,0,399,4,1000,597,228,171
9,BRĂILA,ZĂVOAIA,44532,DUDESCU,"CĂMINUL CULTURAL DUDESCU",280,"Alegeri Prezidentiale",2,619,357,315,42,0,352,5,700,343,180,172
10,BUZĂU,"MUNICIPIUL BUZĂU",44818,BUZĂU,"ŞCOALA GIMNAZIALĂ ”EP.DIONISIE ROMANO”",1,"Alegeri Prezidentiale",1,1525,866,781,85,0,850,16,1670,804,470,380
10,BUZĂU,"MUNICIPIUL BUZĂU",44818,BUZĂU,"ŞCOALA GIMNAZIALĂ NR.11",2,"Alegeri Prezidentiale",1,1379,668,603,65,0,660,8,1510,842,360,300
10,BUZĂU,"MUNICIPIUL BUZĂU",44818,BUZĂU,"ŞCOALA GIMNAZIALĂ NR.11",3,"Alegeri Prezidentiale",1,1575,875,831,44,0,855,20,1730,855,480,375
10,BUZĂU,"MUNICIPIUL BUZĂU",44818,BUZĂU,"ŞCOALA GIMNAZIALĂ NR.11",4,"Alegeri Prezidentiale",1,1649,913,842,71,0,900,13,1810,897,502,398
10,BUZĂU,"MUNICIPIUL BUZĂU",44818,BUZĂU,"ŞCOALA GIMNAZIALĂ NR.11",5,"Alegeri Prezidentiale",1,1463,772,652,100,20,750,22,1636,864,422,328
10,BUZĂU,"MUNICIPIUL BUZĂU",44818,BUZĂU,"DIRECŢIA DE ASISTENŢĂ SOCIALĂ",6,"Alegeri Prezidentiale",1,1043,537,506,31,0,524,13,1140,603,322,202
10,BUZĂU,"MUNICIPIUL BUZĂU",44818,BUZĂU,"DIRECŢIA DE ASISTENŢĂ SOCIALĂ",7,"Alegeri Prezidentiale",1,1111,516,495,21,0,507,9,1220,704,295,212
10,BUZĂU,"MUNICIPIUL BUZĂU",44818,BUZĂU,"LICEUL TEHNOLOGIC ”GRIGORE MOISIL”",8,"Alegeri Prezidentiale",1,1629,814,782,32,0,793,21,1790,976,425,368
10,BUZĂU,"MUNICIPIUL BUZĂU",44818,BUZĂU,"LICEUL TEHNOLOGIC ”GRIGORE MOISIL”",9,"Alegeri Prezidentiale",1,1433,717,664,51,2,697,20,1570,853,394,303
10,BUZĂU,"MUNICIPIUL BUZĂU",44818,BUZĂU,"LICEUL TEHNOLOGIC ”GRIGORE MOISIL”",10,"Alegeri Prezidentiale",1,1295,647,618,29,0,637,10,1420,773,352,285
10,BUZĂU,"MUNICIPIUL BUZĂU",44818,BUZĂU,"LICEUL TEHNOLOGIC ”GRIGORE MOISIL”",11,"Alegeri Prezidentiale",1,1460,655,635,20,0,634,21,1600,945,350,284
10,BUZĂU,"MUNICIPIUL BUZĂU",44818,BUZĂU,"COLEGIUL UNIVERSITAR ECONOMIC",12,"Alegeri Prezidentiale",1,1603,877,785,92,0,862,15,1760,883,481,381
10,BUZĂU,"MUNICIPIUL BUZĂU",44818,BUZĂU,"ŞCOALA GIMNAZIALĂ NR. 7",13,"Alegeri Prezidentiale",1,1760,851,781,70,0,838,13,1930,1079,509,329
10,BUZĂU,"MUNICIPIUL BUZĂU",44818,BUZĂU,"ŞCOALA GIMNAZIALĂ NR. 7",14,"Alegeri Prezidentiale",1,1774,946,892,54,0,923,23,1940,994,525,398
10,BUZĂU,"MUNICIPIUL BUZĂU",44818,BUZĂU,"ŞCOALA GIMNAZIALĂ ”GENERAL GRIGORE BAŞTAN”",15,"Alegeri Prezidentiale",1,957,455,422,33,0,450,5,1050,595,258,192
10,BUZĂU,"MUNICIPIUL BUZĂU",44818,BUZĂU,"ŞCOALA GIMNAZIALĂ ”GENERAL GRIGORE BAŞTAN”",16,"Alegeri Prezidentiale",1,954,479,444,35,0,467,12,1040,561,283,184
10,BUZĂU,"MUNICIPIUL BUZĂU",44818,BUZĂU,"ŞCOALA GIMNAZIALĂ ”GENERAL GRIGORE BAŞTAN”",17,"Alegeri Prezidentiale",1,1743,830,816,14,0,813,17,1910,1080,464,349
10,BUZĂU,"MUNICIPIUL BUZĂU",44818,BUZĂU,"ŞCOALA GIMNAZIALĂ ”GENERAL GRIGORE BAŞTAN”",18,"Alegeri Prezidentiale",1,1250,594,579,15,0,581,13,1370,776,351,230
10,BUZĂU,"MUNICIPIUL BUZĂU",44818,BUZĂU,"LICEUL TEORETIC ”ALEXANDRU MARGHILOMAN”",19,"Alegeri Prezidentiale",1,1389,720,686,34,0,704,16,1520,800,420,284
10,BUZĂU,"MUNICIPIUL BUZĂU",44818,BUZĂU,"LICEUL TEORETIC ”ALEXANDRU MARGHILOMAN”",20,"Alegeri Prezidentiale",1,1292,637,582,55,0,622,15,1420,783,365,257
10,BUZĂU,"MUNICIPIUL BUZĂU",44818,BUZĂU,"LICEUL TEORETIC ”ALEXANDRU MARGHILOMAN”",21,"Alegeri Prezidentiale",1,1399,720,651,69,0,706,14,1530,810,434,272
10,BUZĂU,"MUNICIPIUL BUZĂU",44818,BUZĂU,"LICEUL TEHNOLOGIC ”HENRI COANDĂ”",22,"Alegeri Prezidentiale",1,1392,538,505,33,0,530,8,1530,992,288,242
10,BUZĂU,"MUNICIPIUL BUZĂU",44818,BUZĂU,"LICEUL TEHNOLOGIC ”HENRI COANDĂ”",23,"Alegeri Prezidentiale",1,1319,363,343,20,0,360,3,1440,1077,166,194
10,BUZĂU,"MUNICIPIUL BUZĂU",44818,BUZĂU,"LICEUL TEHNOLOGIC ”HENRI COANDĂ” - SALA DE SPORT",24,"Alegeri Prezidentiale",1,1146,561,525,23,13,550,11,1286,725,302,248
10,BUZĂU,"MUNICIPIUL BUZĂU",44818,BUZĂU,"LICEUL TEHNOLOGIC ”HENRI COANDĂ” - SALA DE SPORT",25,"Alegeri Prezidentiale",1,1345,587,566,21,0,575,12,1470,883,360,215
10,BUZĂU,"MUNICIPIUL BUZĂU",44818,BUZĂU,"ŞCOALA GIMNAZIALĂ ”ION CREANGĂ”",26,"Alegeri Prezidentiale",1,1604,735,705,30,0,720,15,1760,1025,403,317
10,BUZĂU,"MUNICIPIUL BUZĂU",44818,BUZĂU,"ŞCOALA GIMNAZIALĂ ”ION CREANGĂ”",27,"Alegeri Prezidentiale",1,1396,747,681,66,0,735,12,1530,783,416,319
10,BUZĂU,"MUNICIPIUL BUZĂU",44818,BUZĂU,"ŞCOALA GIMNAZIALĂ ”ION CREANGĂ”",28,"Alegeri Prezidentiale",2,1622,798,767,31,0,785,13,1780,982,435,350
10,BUZĂU,"MUNICIPIUL BUZĂU",44818,BUZĂU,"ŞCOALA GIMNAZIALĂ ”ION CREANGĂ”",29,"Alegeri Prezidentiale",1,1362,708,676,32,0,688,20,1490,782,344,344
10,BUZĂU,"MUNICIPIUL BUZĂU",44818,BUZĂU,"COLEGIUL TEHNIC",30,"Alegeri Prezidentiale",1,872,456,434,22,0,451,5,950,494,244,207
10,BUZĂU,"MUNICIPIUL BUZĂU",44818,BUZĂU,"COLEGIUL TEHNIC",31,"Alegeri Prezidentiale",1,915,488,428,25,35,480,8,1036,548,236,244
10,BUZĂU,"MUNICIPIUL BUZĂU",44818,BUZĂU,"LICEUL DE ARTE ”MARGARETA STERIAN”",32,"Alegeri Prezidentiale",1,1488,724,676,48,0,711,13,1630,906,420,291
10,BUZĂU,"MUNICIPIUL BUZĂU",44818,BUZĂU,"COLEGIUL NAŢIONAL ”B.P. HAŞDEU”",33,"Alegeri Prezidentiale",1,1379,794,640,81,73,768,26,1566,772,443,325
10,BUZĂU,"MUNICIPIUL BUZĂU",44818,BUZĂU,"ŞCOALA GIMNAZIALĂ ”P.H. ZANGOPOL”",34,"Alegeri Prezidentiale",1,993,461,410,51,0,451,10,1090,629,270,181
10,BUZĂU,"MUNICIPIUL BUZĂU",44818,BUZĂU,"ŞCOALA GIMNAZIALĂ ”P.H. ZANGOPOL”",35,"Alegeri Prezidentiale",1,1243,562,542,20,0,543,19,1360,798,308,235
10,BUZĂU,"MUNICIPIUL BUZĂU",44818,BUZĂU,"ŞCOALA GIMNAZIALĂ ”P.H. ZANGOPOL”",36,"Alegeri Prezidentiale",1,1572,744,714,29,1,728,16,1720,976,396,332
10,BUZĂU,"MUNICIPIUL BUZĂU",44818,BUZĂU,"LICEUL TEHNOLOGIC ”DIMITRIE FILIPESCU”",37,"Alegeri Prezidentiale",1,1435,729,669,60,0,721,8,1570,841,374,347
10,BUZĂU,"MUNICIPIUL BUZĂU",44818,BUZĂU,"LICEUL TEHNOLOGIC ”DIMITRIE FILIPESCU”",38,"Alegeri Prezidentiale",1,1519,652,598,54,0,638,14,1660,1008,389,249
10,BUZĂU,"MUNICIPIUL BUZĂU",44818,BUZĂU,"COLEGIUL AGRICOL ”DR. C. ANGELESCU”",39,"Alegeri Prezidentiale",1,1330,733,671,61,1,725,8,1486,753,434,291
10,BUZĂU,"MUNICIPIUL BUZĂU",44818,BUZĂU,"ŞCOALA GIMNAZIALĂ ”N.CONSTANTINESCU”",40,"Alegeri Prezidentiale",1,1063,570,506,64,0,555,15,1160,590,339,216
10,BUZĂU,"MUNICIPIUL BUZĂU",44818,BUZĂU,"ŞCOALA GIMNAZIALĂ ”N.CONSTANTINESCU”",41,"Alegeri Prezidentiale",1,981,560,505,55,0,551,9,1070,510,307,244
10,BUZĂU,"MUNICIPIUL BUZĂU",44818,BUZĂU,"ŞCOALA GIMNAZIALĂ ”N.CONSTANTINESCU”",42,"Alegeri Prezidentiale",1,1668,824,781,42,1,807,17,1830,1006,450,357
10,BUZĂU,"MUNICIPIUL BUZĂU",44818,BUZĂU,"GRĂDINIŢA CU PROGRAM PRELUNGIT NR. 8",43,"Alegeri Prezidentiale",1,991,503,477,26,0,497,6,1090,587,273,224
10,BUZĂU,"MUNICIPIUL BUZĂU",44818,BUZĂU,"GRĂDINIŢA CU PROGRAM PRELUNGIT NR. 8",44,"Alegeri Prezidentiale",1,832,471,433,38,0,458,13,910,439,272,186
10,BUZĂU,"MUNICIPIUL BUZĂU",44818,BUZĂU,"GRĂDINIŢA CU PROGRAM PRELUNGIT NR. 8",45,"Alegeri Prezidentiale",1,1627,901,831,70,0,883,18,1780,879,460,423
10,BUZĂU,"MUNICIPIUL BUZĂU",44818,BUZĂU,"COLEGIUL NAŢIONAL PEDAGOGIC ”SPIRU HARET”",46,"Alegeri Prezidentiale",1,1616,760,727,32,1,737,23,1770,1010,421,316
10,BUZĂU,"MUNICIPIUL BUZĂU",44818,BUZĂU,"COLEGIUL NAŢIONAL PEDAGOGIC ”SPIRU HARET”",47,"Alegeri Prezidentiale",1,1690,910,814,96,0,886,24,1850,940,498,388
10,BUZĂU,"MUNICIPIUL BUZĂU",44818,BUZĂU,"COLEGIUL NAŢIONAL PEDAGOGIC ”SPIRU HARET”",48,"Alegeri Prezidentiale",1,1379,722,637,85,0,709,13,1510,788,367,342
10,BUZĂU,"MUNICIPIUL BUZĂU",44818,BUZĂU,"COLEGIUL NAŢIONAL PEDAGOGIC ”SPIRU HARET”",49,"Alegeri Prezidentiale",1,1190,660,615,45,0,646,14,1300,640,346,300
10,BUZĂU,"MUNICIPIUL BUZĂU",44818,BUZĂU,"ŞCOALA GIMNAZIALĂ ”EPISCOP DIONISIE ROMANO”",50,"Alegeri Prezidentiale",1,1506,837,751,86,0,822,15,1650,813,527,295
10,BUZĂU,"MUNICIPIUL BUZĂU",44818,BUZĂU,"GRĂDINIŢA CU PROGRAM PRELUNGIT NR. 1",51,"Alegeri Prezidentiale",1,1092,688,597,91,0,663,25,1200,512,433,230
10,BUZĂU,"MUNICIPIUL BUZĂU",44818,BUZĂU,"ŞCOALA GIMNAZIALĂ ”DR. GEORGE EMIL PALADE”",52,"Alegeri Prezidentiale",1,1517,770,738,32,0,744,26,1660,890,404,340
10,BUZĂU,"MUNICIPIUL BUZĂU",44818,BUZĂU,"ŞCOALA GIMNAZIALĂ ”DR. GEORGE EMIL PALADE”",53,"Alegeri Prezidentiale",1,1286,687,668,19,0,678,9,1410,723,391,287
10,BUZĂU,"MUNICIPIUL BUZĂU",44818,BUZĂU,"ŞCOALA GIMNAZIALĂ ”DR. GEORGE EMIL PALADE”",54,"Alegeri Prezidentiale",1,1545,785,742,43,0,770,15,1690,905,439,331
10,BUZĂU,"MUNICIPIUL BUZĂU",44818,BUZĂU,"ŞCOALA GIMNAZIALĂ ”DR. GEORGE EMIL PALADE”",55,"Alegeri Prezidentiale",1,1132,696,571,125,0,676,20,1240,544,398,278
10,BUZĂU,"MUNICIPIUL BUZĂU",44818,BUZĂU,"ŞCOALA GIMNAZIALĂ ”DR. GEORGE EMIL PALADE”",56,"Alegeri Prezidentiale",1,1197,596,566,30,0,587,9,1310,714,329,258
10,BUZĂU,"MUNICIPIUL BUZĂU",44818,BUZĂU,"COLEGIUL ECONOMIC",57,"Alegeri Prezidentiale",1,1154,598,528,70,0,590,8,1260,662,322,268
10,BUZĂU,"MUNICIPIUL BUZĂU",44818,BUZĂU,"ŞCOALA GIMNAZIALĂ ”CPT. AV. MIRCEA T. BĂDULESCU”",58,"Alegeri Prezidentiale",1,1296,738,684,53,1,724,14,1420,682,433,291
10,BUZĂU,"MUNICIPIUL BUZĂU",44818,BUZĂU,"ŞCOALA GIMNAZIALĂ ”CPT. AV. MIRCEA T. BĂDULESCU”",59,"Alegeri Prezidentiale",1,1414,828,710,118,0,804,24,1550,722,461,343
10,BUZĂU,"MUNICIPIUL BUZĂU",44818,BUZĂU,"ŞCOALA GIMNAZIALĂ ”CPT. AV. MIRCEA T. BĂDULESCU”",60,"Alegeri Prezidentiale",1,1327,644,601,42,1,633,11,1450,806,352,281
10,BUZĂU,"MUNICIPIUL BUZĂU",44818,BUZĂU,"ŞCOALA GIMNAZIALĂ ”CPT. AV. MIRCEA T. BĂDULESCU”",61,"Alegeri Prezidentiale",1,1204,653,598,53,2,636,17,1320,667,367,269
10,BUZĂU,"MUNICIPIUL BUZĂU",44818,BUZĂU,"GRĂDINIŢA CU PROGRAM PRELUNGIT NR.4",62,"Alegeri Prezidentiale",1,1354,708,667,41,0,692,16,1479,771,382,310
10,BUZĂU,"MUNICIPIUL BUZĂU",44818,BUZĂU,"ŞCOALA GIMNAZIALĂ ”N.TITULESCU”",63,"Alegeri Prezidentiale",1,1283,695,647,48,0,682,13,1410,715,422,260
10,BUZĂU,"MUNICIPIUL BUZĂU",44818,BUZĂU,"ŞCOALA GIMNAZIALĂ ”N.TITULESCU”",64,"Alegeri Prezidentiale",1,1453,747,704,43,0,732,15,1590,843,420,312
10,BUZĂU,"MUNICIPIUL BUZĂU",44818,BUZĂU,"ŞCOALA GIMNAZIALĂ ”SF.APOSTOL ANDREI”",65,"Alegeri Prezidentiale",1,1331,720,579,96,45,708,12,1620,900,406,302
10,BUZĂU,"MUNICIPIUL BUZĂU",44818,BUZĂU,"ŞCOALA GIMNAZIALĂ ”SF.APOSTOL ANDREI”",66,"Alegeri Prezidentiale",1,1442,715,620,50,45,696,19,1740,1025,357,339
10,BUZĂU,"MUNICIPIUL BUZĂU",44818,BUZĂU,"ŞCOALA GIMNAZIALĂ ”SF.APOSTOL ANDREI”",67,"Alegeri Prezidentiale",1,1524,800,746,22,32,781,19,1830,1030,429,352
10,BUZĂU,"MUNICIPIUL BUZĂU",44818,BUZĂU,"ŞCOALA GIMNAZIALĂ ”SF.APOSTOL ANDREI”",68,"Alegeri Prezidentiale",1,1718,938,893,45,0,926,12,1880,942,513,413
10,BUZĂU,"MUNICIPIUL BUZĂU",44818,BUZĂU,"LICEUL CU PROGRAM SPORTIV ”I.BALAŞ-SÖTER”",69,"Alegeri Prezidentiale",1,925,434,405,29,0,422,12,1010,576,217,205
10,BUZĂU,"MUNICIPIUL BUZĂU",44818,BUZĂU,"LICEUL CU PROGRAM SPORTIV ”I.BALAŞ- SÖTER ”",70,"Alegeri Prezidentiale",1,1302,670,633,37,0,657,13,1430,760,362,295
10,BUZĂU,"MUNICIPIUL BUZĂU",44818,BUZĂU,"LICEUL CU PROGRAM SPORTIV ”I.BALAŞ- SÖTER ”",71,"Alegeri Prezidentiale",1,1081,518,474,44,0,506,12,1180,662,272,234
10,BUZĂU,"MUNICIPIUL BUZĂU",44818,BUZĂU,"GRĂDINIŢA CU PROGRAM PRELUNGIT ”BOBOCEII DIN MICRO III”",72,"Alegeri Prezidentiale",1,1405,786,685,101,0,761,25,1540,754,415,346
10,BUZĂU,"MUNICIPIUL BUZĂU",44818,BUZĂU,"SEMINARUL TEOLOGIC ORTODOX ”CHESARIE EPISCOPUL”",73,"Alegeri Prezidentiale",1,1473,788,748,40,0,765,23,1610,822,433,332
10,BUZĂU,"MUNICIPIUL BUZĂU",44818,BUZĂU,"SEMINARUL TEOLOGIC ORTODOX ”CHESARIE EPISCOPUL”",74,"Alegeri Prezidentiale",1,1680,793,725,68,0,775,18,1840,1047,458,317
10,BUZĂU,"MUNICIPIUL BUZĂU",44818,BUZĂU,"LICEUL TEHNOLOGIC ”COSTIN NENIŢESCU”",75,"Alegeri Prezidentiale",1,1833,691,630,61,0,679,12,2010,1319,423,256
10,BUZĂU,"MUNICIPIUL BUZĂU",44818,BUZĂU,"LICEUL TEHNOLOGIC MESERII ŞI SERVICII",76,"Alegeri Prezidentiale",1,1470,535,499,36,0,520,15,1610,1075,318,202
10,BUZĂU,"MUNICIPIUL BUZĂU",44818,BUZĂU,"LICEUL TEHNOLOGIC MESERII ŞI SERVICII",77,"Alegeri Prezidentiale",1,1159,401,374,27,0,393,8,1270,869,232,161
10,BUZĂU,"MUNICIPIUL BUZĂU",44818,BUZĂU,"ŞCOALA GIMNAZIALĂ ” M. KOGĂLNICEANU”",78,"Alegeri Prezidentiale",1,1614,690,638,52,0,685,5,1770,1080,371,314
10,BUZĂU,"MUNICIPIUL BUZĂU",44818,BUZĂU,"ŞCOALA GIMNAZIALĂ ” M. KOGĂLNICEANU”",79,"Alegeri Prezidentiale",1,1727,559,540,19,0,541,18,1890,1331,297,244
10,BUZĂU,"MUNICIPIUL BUZĂU",44818,BUZĂU,"ŞCOALA GIMNAZIALĂ ” M. KOGĂLNICEANU”",80,"Alegeri Prezidentiale",1,1654,424,401,23,0,406,18,1810,1386,169,237
10,BUZĂU,"MUNICIPIUL RÂMNICU SĂRAT",44845,"RÂMNICU SĂRAT","CENTRUL DE RECUPERARE PENTRU COPII CU DIZABILITĂŢI",81,"Alegeri Prezidentiale",1,1938,814,786,28,0,794,20,2120,1306,340,454
10,BUZĂU,"MUNICIPIUL RÂMNICU SĂRAT",44845,"RÂMNICU SĂRAT","ŞCOALA GIMNAZIALĂ VASILE CRISTOFOREANU",82,"Alegeri Prezidentiale",1,1762,432,412,20,0,424,8,1930,1498,126,298
10,BUZĂU,"MUNICIPIUL RÂMNICU SĂRAT",44845,"RÂMNICU SĂRAT","ŞCOALA GIMNAZIALĂ ”VASILE CRISTOFOREANU”",83,"Alegeri Prezidentiale",2,1591,742,692,49,1,731,11,1741,999,299,432
10,BUZĂU,"MUNICIPIUL RÂMNICU SĂRAT",44845,"RÂMNICU SĂRAT","ŞCOALA GIMNAZIALĂ ”VASILE CRISTOFOREANU”",84,"Alegeri Prezidentiale",1,1586,719,655,64,0,715,4,1740,1021,306,409
10,BUZĂU,"MUNICIPIUL RÂMNICU SĂRAT",44845,"RÂMNICU SĂRAT","ŞCOALA GIMNAZIALĂ ”VASILE CRISTOFOREANU”",85,"Alegeri Prezidentiale",1,1462,767,700,67,0,754,13,1600,833,334,420
10,BUZĂU,"MUNICIPIUL RÂMNICU SĂRAT",44845,"RÂMNICU SĂRAT","GRĂDINIŢA CU PROGRAM NORMAL ”ORIZONT”",86,"Alegeri Prezidentiale",1,1489,712,668,44,0,699,13,1630,918,297,402
10,BUZĂU,"MUNICIPIUL RÂMNICU SĂRAT",44845,"RÂMNICU SĂRAT","LICEUL TEHNOLOGIC ”VICTOR FRUNZĂ”",87,"Alegeri Prezidentiale",1,1645,617,578,39,0,602,15,1800,1183,265,337
10,BUZĂU,"MUNICIPIUL RÂMNICU SĂRAT",44845,"RÂMNICU SĂRAT","LICEUL TEHNOLOGIC ”VICTOR FRUNZĂ”",88,"Alegeri Prezidentiale",1,1365,783,651,47,85,766,17,1089,306,348,418
10,BUZĂU,"MUNICIPIUL RÂMNICU SĂRAT",44845,"RÂMNICU SĂRAT","COLEGIUL NAŢIONAL ”ALEXANDRU VLAHUŢĂ”",89,"Alegeri Prezidentiale",1,1141,530,492,37,1,519,11,1250,720,214,305
10,BUZĂU,"MUNICIPIUL RÂMNICU SĂRAT",44845,"RÂMNICU SĂRAT","COLEGIUL NAŢIONAL ”ALEXANDRU VLAHUŢĂ”",90,"Alegeri Prezidentiale",1,1303,612,579,33,0,598,14,1430,818,277,321
10,BUZĂU,"MUNICIPIUL RÂMNICU SĂRAT",44845,"RÂMNICU SĂRAT","GRĂDINIŢA CU PROGRAM PRELUNGIT ”MUGURAŞII”",91,"Alegeri Prezidentiale",1,1456,635,592,43,0,619,16,1600,965,263,356
10,BUZĂU,"MUNICIPIUL RÂMNICU SĂRAT",44845,"RÂMNICU SĂRAT","GRĂDINIŢA CU PROGRAM PRELUNGIT ”LUMEA COPILĂRIEI”",92,"Alegeri Prezidentiale",1,1672,749,724,25,0,733,16,1830,1081,326,407
10,BUZĂU,"MUNICIPIUL RÂMNICU SĂRAT",44845,"RÂMNICU SĂRAT","GRĂDINIŢA CU PROGRAM PRELUNGIT ”LUMEA COPILĂRIEI”",93,"Alegeri Prezidentiale",1,1771,797,753,44,0,774,23,1940,1143,398,376
10,BUZĂU,"MUNICIPIUL RÂMNICU SĂRAT",44845,"RÂMNICU SĂRAT","ŞCOALA GIMNAZIALĂ NR. 6",94,"Alegeri Prezidentiale",1,1929,875,808,67,0,859,16,2110,1235,386,473
10,BUZĂU,"MUNICIPIUL RÂMNICU SĂRAT",44845,"RÂMNICU SĂRAT","LICEUL TEORETIC ”ŞTEFAN CEL MARE”",95,"Alegeri Prezidentiale",1,1198,585,554,31,0,568,17,1310,725,261,307
10,BUZĂU,"MUNICIPIUL RÂMNICU SĂRAT",44845,"RÂMNICU SĂRAT","CANTINA DE AJUTOR SOCIAL",96,"Alegeri Prezidentiale",1,1320,611,580,30,1,599,12,1450,839,245,354
10,BUZĂU,"MUNICIPIUL RÂMNICU SĂRAT",44845,"RÂMNICU SĂRAT","ŞCOALA GIMNAZIALĂ NR. 1",97,"Alegeri Prezidentiale",1,1165,582,522,43,17,568,14,1280,698,224,344
10,BUZĂU,"MUNICIPIUL RÂMNICU SĂRAT",44845,"RÂMNICU SĂRAT","ŞCOALA GIMNAZIALĂ NR. 2",98,"Alegeri Prezidentiale",1,1777,782,728,37,17,772,10,1976,1194,336,436
10,BUZĂU,"MUNICIPIUL RÂMNICU SĂRAT",44845,"RÂMNICU SĂRAT","S.C. RAFINĂRIA VENUS OILREG S.A.",99,"Alegeri Prezidentiale",1,1882,791,752,39,0,772,19,2060,1269,340,432
10,BUZĂU,"MUNICIPIUL RÂMNICU SĂRAT",44845,"RÂMNICU SĂRAT","GRĂDINIŢA CU PROGRAM PRELUNGIT NR.2",100,"Alegeri Prezidentiale",1,1479,683,652,31,0,665,18,1620,937,332,333
10,BUZĂU,"MUNICIPIUL RÂMNICU SĂRAT",44845,"RÂMNICU SĂRAT","LICEUL ECONOMIC ”ELINA MATEI BASARAB”",101,"Alegeri Prezidentiale",1,1525,694,643,51,0,667,27,1670,976,333,334
10,BUZĂU,"ORAŞ NEHOIU",47916,NEHOIU,"CASA DE CULTURĂ GEORGE BĂICULESCU NEHOIU",102,"Alegeri Prezidentiale",1,1123,665,560,101,4,653,12,1230,565,388,265
10,BUZĂU,"ORAŞ NEHOIU",47916,NEHOIU,"GRUP SCOLAR TEHNIC NEHOIU STR. SCOLII",103,"Alegeri Prezidentiale",1,1032,610,516,51,43,596,14,1166,556,382,214
10,BUZĂU,"ORAŞ NEHOIU",47916,NEHOIU,"SALA DE SPORT A ORASULUI",104,"Alegeri Prezidentiale",1,671,388,361,25,2,383,5,730,342,226,157
10,BUZĂU,"ORAŞ NEHOIU",47916,NEHOIU,"CĂMIN CULTURAL BĂDÂRLEGI",105,"Alegeri Prezidentiale",1,100,69,55,14,0,68,1,110,41,38,30
10,BUZĂU,"ORAŞ NEHOIU",47916,NEHOIU,"CLĂDIREA FOSTA SECŢIE CONFECŢIONAT ÎNCĂLŢĂMINTE DÂMBOVIŢA (LÂNGĂ BISERICA ORTODOXĂ) STR. VALEA NEHOIULUI",106,"Alegeri Prezidentiale",1,554,294,278,16,0,288,6,610,316,175,113
10,BUZĂU,"ORAŞ NEHOIU",47916,NEHOIU,"CĂMIN CULTURAL VALEA NEHOIULUI",107,"Alegeri Prezidentiale",1,820,446,423,20,3,438,8,900,454,284,154
10,BUZĂU,"ORAŞ NEHOIU",47916,NEHOIU,"ŞCOALA PRIMARĂ NEHOIAŞU",108,"Alegeri Prezidentiale",1,341,221,196,24,1,219,2,370,149,121,98
10,BUZĂU,"ORAŞ NEHOIU",47916,NEHOIU,"ŞCOALA GIMNAZIALĂ LUNCA PRIPORULUI",109,"Alegeri Prezidentiale",1,625,384,345,31,8,379,5,680,296,257,122
10,BUZĂU,"ORAŞ NEHOIU",47916,"LUNCA PRIPORULUI","SCOALA CU CLASELE I-IV PRUND",110,"Alegeri Prezidentiale",1,357,266,229,37,0,262,4,390,124,195,67
10,BUZĂU,"ORAŞ NEHOIU",47916,"BÂSCA ROZILEI","CĂMIN CULTURAL BÎSCA ROZILEI",111,"Alegeri Prezidentiale",1,591,348,315,33,0,341,7,650,302,224,117
10,BUZĂU,"ORAŞ NEHOIU",47916,"BÂSCA ROZILEI","GRĂDINITA POD VINETIS - VECHE",112,"Alegeri Prezidentiale",1,499,306,284,22,0,303,3,550,244,144,159
10,BUZĂU,"ORAŞ NEHOIU",47916,VINEŢIŞU,"CĂMIN CULTURAL VINETIS",113,"Alegeri Prezidentiale",1,119,96,80,16,0,96,0,140,44,70,26
10,BUZĂU,"ORAŞ NEHOIU",47916,PĂLTINENI,"CĂMIN CULTURAL PĂLTINENI",114,"Alegeri Prezidentiale",1,680,378,336,41,1,370,8,740,362,233,137
10,BUZĂU,"ORAŞ NEHOIU",47916,MLĂJET,"CĂMIN CULTURAL MLĂJET",115,"Alegeri Prezidentiale",1,703,400,365,32,3,392,8,770,370,232,160
10,BUZĂU,"ORAŞ NEHOIU",47916,CHIRLEŞTI,"SCOALA CU CLASELE I-IV CHIRLESTI",116,"Alegeri Prezidentiale",1,651,425,360,65,0,417,8,710,285,284,133
10,BUZĂU,"ORAŞ NEHOIU",47916,CURMĂTURA,"CĂMIN CULTURAL CURMĂTURA",117,"Alegeri Prezidentiale",1,133,99,81,10,8,98,1,150,51,40,58
10,BUZĂU,"ORAŞ PĂTÂRLAGELE",48325,PĂTÂRLAGELE,"LICEUL TEHNOLOGIC PĂTÂRLAGELE",118,"Alegeri Prezidentiale",1,949,446,399,46,1,441,5,1076,630,250,191
10,BUZĂU,"ORAŞ PĂTÂRLAGELE",48325,PĂTÂRLAGELE,"LICEUL TEHNOLOGIC PĂTÂRLAGELE",119,"Alegeri Prezidentiale",1,1112,551,506,45,0,544,7,1219,668,284,260
10,BUZĂU,"ORAŞ PĂTÂRLAGELE",48325,POIENILE,"ŞCOALĂ PRIMARĂ",120,"Alegeri Prezidentiale",1,242,136,105,31,0,136,0,260,124,62,74
10,BUZĂU,"ORAŞ PĂTÂRLAGELE",48325,MĂRUNŢIŞU,"ŞCOALA GENERALĂ",121,"Alegeri Prezidentiale",1,1217,556,506,50,0,546,10,1330,774,292,254
10,BUZĂU,"ORAŞ PĂTÂRLAGELE",48325,MUŞCEL,"ŞCOALA GENERALĂ",122,"Alegeri Prezidentiale",1,588,284,262,22,0,281,3,640,356,131,150
10,BUZĂU,"ORAŞ PĂTÂRLAGELE",48325,"VALEA LUPULUI","ŞCOALA PRIMARĂ",123,"Alegeri Prezidentiale",1,376,194,169,25,0,189,5,410,216,92,97
10,BUZĂU,"ORAŞ PĂTÂRLAGELE",48325,"VALEA VIEI","ŞCOALA PRIMARĂ",124,"Alegeri Prezidentiale",1,394,191,165,26,0,189,2,430,239,109,80
10,BUZĂU,"ORAŞ PĂTÂRLAGELE",48325,CRÂNG,"ŞCOALA PRIMARĂ",125,"Alegeri Prezidentiale",1,529,270,247,23,0,268,2,580,310,116,152
10,BUZĂU,"ORAŞ PĂTÂRLAGELE",48325,"SIBICIU DE SUS","ŞCOALA PRIMARĂ",126,"Alegeri Prezidentiale",1,705,392,346,46,0,388,4,770,378,193,195
10,BUZĂU,"ORAŞ PĂTÂRLAGELE",48325,"VALEA SIBICIULUI","ŞCOALA PRIMARĂ",127,"Alegeri Prezidentiale",1,186,104,91,13,0,103,1,200,96,53,50
10,BUZĂU,"ORAŞ POGOANELE",48744,POGOANELE,"LICEUL TEORETIC POGOANELE",128,"Alegeri Prezidentiale",1,1472,675,586,57,32,661,14,1646,971,292,369
10,BUZĂU,"ORAŞ POGOANELE",48744,POGOANELE,"CLUBUL COPIILOR POGOANELE",129,"Alegeri Prezidentiale",1,1410,627,568,52,7,609,18,1540,913,268,341
10,BUZĂU,"ORAŞ POGOANELE",48744,POGOANELE,"ŞCOALA GENERALĂ NR.2 POGOANELE",130,"Alegeri Prezidentiale",1,1488,567,533,30,4,555,12,1630,1063,262,293
10,BUZĂU,"ORAŞ POGOANELE",48744,CĂLDĂRĂŞTI,"ŞCOALA GENERALĂ CĂLDĂRĂŞTI",131,"Alegeri Prezidentiale",1,1509,785,701,51,33,771,14,1650,865,255,516
10,BUZĂU,AMARU,44863,AMARU,"ŞCOALA GENERALA AMARU",132,"Alegeri Prezidentiale",1,937,443,388,55,0,436,7,1030,587,214,222
10,BUZĂU,AMARU,44863,DULBANU,"CĂMINUL CULTURAL",133,"Alegeri Prezidentiale",1,403,162,136,26,0,162,0,440,278,58,104
10,BUZĂU,AMARU,44863,"LACU SINAIA","CĂMINUL CULTURAL",134,"Alegeri Prezidentiale",1,195,84,69,15,0,81,3,210,126,29,52
10,BUZĂU,AMARU,44863,LUNCA,"CAMINUL CULTURAL LUNCA",135,"Alegeri Prezidentiale",1,308,152,115,37,0,150,2,366,214,42,108
10,BUZĂU,"BALTA ALBĂ",44934,"BALTA ALBĂ","GRĂDINIŢA CU PROGRAM NORMAL SAT BALTA ALBĂ",136,"Alegeri Prezidentiale",1,429,276,209,67,0,272,4,470,194,154,118
10,BUZĂU,"BALTA ALBĂ",44934,BĂILE,"CAMINUL CULTURAL BAILE",137,"Alegeri Prezidentiale",1,354,241,173,68,0,239,2,390,149,149,90
10,BUZĂU,"BALTA ALBĂ",44934,AMARA,"ŞCOALA GIMNAZIALĂ SAT AMARA",138,"Alegeri Prezidentiale",2,1203,823,658,148,17,817,6,1320,497,404,413
10,BUZĂU,BĂLĂCEANU,44989,BĂLĂCEANU,"PRIMARIA COMUNEI BĂLĂCEANU",139,"Alegeri Prezidentiale",1,1258,816,630,116,70,804,12,1380,564,458,346
10,BUZĂU,BECENI,45003,BECENI,"ŞCOALA PRIMARĂ BECENI",140,"Alegeri Prezidentiale",1,796,393,334,59,0,388,5,870,477,190,198
10,BUZĂU,BECENI,45003,"GURA DIMIENII","ŞCOALA GIMNAZIALĂ GURA DIMIENII",141,"Alegeri Prezidentiale",1,767,391,342,49,0,386,5,840,449,189,197
10,BUZĂU,BECENI,45003,"VALEA PĂRULUI","ŞCOALA GIMNAZIALĂ VALEA PĂRULUI",142,"Alegeri Prezidentiale",1,1142,527,463,64,0,524,3,1250,723,267,257
10,BUZĂU,BECENI,45003,"IZVORU DULCE","ŞCOALA PRIMARĂ IZVORU DULCE",143,"Alegeri Prezidentiale",1,680,352,303,49,0,348,4,740,388,205,143
10,BUZĂU,BECENI,45003,FLOREŞTI,"ŞCOALA PRIMARĂ FLOREŞTI",144,"Alegeri Prezidentiale",1,204,86,67,19,0,86,0,220,134,26,60
10,BUZĂU,BERCA,45101,BERCA,"CASA DE CULTURĂ BERCA-PARTER",145,"Alegeri Prezidentiale",1,1207,674,591,83,0,667,7,1356,682,389,278
10,BUZĂU,BERCA,45101,BERCA,"CASA DE CULTURĂ BERCA-ETAJ 1",146,"Alegeri Prezidentiale",1,1111,537,496,41,0,522,15,1220,683,330,192
10,BUZĂU,BERCA,45101,BERCA,"LICEUL TEHNOLOGIC SF.MUCENIC SAVA, BERCA",147,"Alegeri Prezidentiale",1,625,370,326,44,0,365,5,680,310,228,137
10,BUZĂU,BERCA,45101,SĂTUC,"GRĂDINIŢA SĂTUC",148,"Alegeri Prezidentiale",1,542,329,268,61,0,316,13,590,261,184,132
10,BUZĂU,BERCA,45101,RĂTEŞTI,"GRĂDINIȚA CU PROGRAM NORMAL RĂTEŞTI",149,"Alegeri Prezidentiale",1,791,356,318,32,6,340,16,870,514,166,174
10,BUZĂU,BERCA,45101,PÂCLELE,"CĂMIN CULTURAL PÎCLE",150,"Alegeri Prezidentiale",1,127,68,50,18,0,66,2,140,72,42,24
10,BUZĂU,BERCA,45101,JOSENI,"CĂMIN CULTURAL JOSENI",151,"Alegeri Prezidentiale",1,763,377,312,65,0,372,5,840,463,217,155
10,BUZĂU,BERCA,45101,PLEŞEŞTI,"ŞCOALA GIMNAZIALĂ PLEȘCOI",152,"Alegeri Prezidentiale",1,807,418,376,41,1,413,5,880,462,266,147
10,BUZĂU,BERCA,45101,PLEŞEŞTI,"CĂMIN CULTURAL PLEŞCOI",153,"Alegeri Prezidentiale",1,746,398,337,61,0,395,3,820,422,233,162
10,BUZĂU,BERCA,45101,"VALEA NUCULUI","ŞCOALA PRIMARĂ VALEA NUCULUI",154,"Alegeri Prezidentiale",1,568,265,216,49,0,260,5,620,355,149,111
10,BUZĂU,BISOCA,45245,BISOCA,"SALA DE FESTIVITATI A PRIMARIEI BISOCA",155,"Alegeri Prezidentiale",1,464,184,166,18,0,181,3,510,326,64,117
10,BUZĂU,BISOCA,45245,RECEA,"CAMPUS PENTRU COPII SF.SAVA - RECEA",156,"Alegeri Prezidentiale",1,793,243,225,18,0,243,0,870,627,82,161
10,BUZĂU,BISOCA,45245,PLEŞI,"ŞCOALA GENERALĂ PLEŞI",157,"Alegeri Prezidentiale",1,349,148,144,4,0,145,3,380,232,37,108
10,BUZĂU,BISOCA,45245,SĂRILE,"ŞCOALA GENERALĂ SĂRILE",158,"Alegeri Prezidentiale",1,396,178,169,9,0,178,0,430,252,55,123
10,BUZĂU,BLĂJANI,45334,BLĂJANI,"CĂMINUL CULTURAL BLĂJANI",159,"Alegeri Prezidentiale",1,589,430,340,64,26,421,9,640,210,119,302
10,BUZĂU,BLĂJANI,45334,SOREŞTI,"CĂMINUL CULTURAL SOREŞTI",160,"Alegeri Prezidentiale",1,237,198,152,31,15,194,4,260,62,63,131
10,BUZĂU,BOLDU,45361,BOLDU,"CLUBUL PRIMĂRIEI BOLDU",161,"Alegeri Prezidentiale",1,953,595,490,64,41,590,5,1040,445,177,413
10,BUZĂU,BOLDU,45361,BOLDU,"GRĂDINIŢA DE COPII BOLDU",162,"Alegeri Prezidentiale",1,820,501,423,40,38,494,7,900,399,157,337
10,BUZĂU,BOZIORU,45389,BOZIORU,"ŞCOALA GIMNAZIALĂ BOZIORU",163,"Alegeri Prezidentiale",1,493,298,240,42,16,290,8,540,242,131,159
10,BUZĂU,BOZIORU,45389,FIŞICI,"ŞCOALA PRIMARĂ FIŞICI",164,"Alegeri Prezidentiale",1,311,189,159,27,3,185,4,340,151,96,89
10,BUZĂU,BRĂDEANU,45496,BRĂDEANU,"ŞCOALA GIMNAZIALĂ BRĂDEANU",165,"Alegeri Prezidentiale",1,884,412,345,67,0,409,3,970,558,226,183
10,BUZĂU,BRĂDEANU,45496,SMÂRDAN,"ŞCOALA GIMNAZIALĂ SMÎRDAN",166,"Alegeri Prezidentiale",1,719,383,337,46,0,378,5,790,407,151,227
10,BUZĂU,BRĂDEANU,45496,MITROPOLIA,"ŞCOALA PRIMARĂ MITROPOLIA",167,"Alegeri Prezidentiale",1,347,208,173,35,0,205,3,380,172,96,109
10,BUZĂU,BRĂEŞTI,45539,BRĂEŞTI,"ŞCOALA GIMNAZIALĂ COMUNA BRĂEŞTI",168,"Alegeri Prezidentiale",1,372,192,171,20,1,191,1,410,218,79,112
10,BUZĂU,BRĂEŞTI,45539,BRĂTILEŞTI,"ŞCOALA GIMNAZIALĂ BRĂTILEŞTI",169,"Alegeri Prezidentiale",1,1085,417,400,17,0,414,3,1190,773,195,219
10,BUZĂU,BRĂEŞTI,45539,PINU,"CAMINUL CULTURAL PINU",170,"Alegeri Prezidentiale",1,282,156,128,17,11,154,2,310,154,73,81
10,BUZĂU,BREAZA,45619,BREAZA,"GRADINITA CU PROGRAM NORMAL BREAZA",171,"Alegeri Prezidentiale",1,780,393,339,54,0,390,3,850,457,201,189
10,BUZĂU,BREAZA,45619,GRECEANCA,"ŞCOALA GENERALĂ GRECEANCA",172,"Alegeri Prezidentiale",1,750,340,273,67,0,334,6,856,516,210,124
10,BUZĂU,BREAZA,45619,VISPEŞTI,"ŞCOALA PRIMARĂ VISPEŞTI",173,"Alegeri Prezidentiale",1,569,305,228,77,0,302,3,620,315,141,161
10,BUZĂU,BUDA,45673,BUDA,"GRĂDINIŢA CU PROGRAM NORMAL BUDA",174,"Alegeri Prezidentiale",1,896,462,396,59,7,461,1,980,518,235,226
10,BUZĂU,BUDA,45673,MUCEŞTI-DĂNULEŞTI,"ŞCOALA PRIMARĂ MUCEŞTI DĂNULEŞTI",175,"Alegeri Prezidentiale",1,936,388,348,38,2,382,6,1020,632,131,251
10,BUZĂU,BUDA,45673,TOROPĂLEŞTI,"GRADINITA PN PIETROIU",176,"Alegeri Prezidentiale",2,520,197,181,16,0,194,3,570,373,62,132
10,BUZĂU,"C.A. ROSETTI",45815,"C.A. ROSETTI","ȘCOALA GIMNAZIALĂ C.A.ROSETTI",177,"Alegeri Prezidentiale",1,709,337,306,31,0,332,5,780,443,185,147
10,BUZĂU,"C.A. ROSETTI",45815,BĂLTENI,"ŞCOALA PRIMARĂ BĂLTENI",178,"Alegeri Prezidentiale",1,361,180,141,39,0,177,3,390,210,115,62
10,BUZĂU,"C.A. ROSETTI",45815,BÂLHACU,"CĂMINUL CULTURAL BÎLHACU",179,"Alegeri Prezidentiale",1,174,90,65,25,0,90,0,200,110,55,35
10,BUZĂU,"C.A. ROSETTI",45815,"COTU CIORII","ŞCOALA PRIMARĂ COTU CIORII",180,"Alegeri Prezidentiale",1,479,198,157,41,0,197,1,520,322,109,88
10,BUZĂU,"C.A. ROSETTI",45815,LUNCA,"ȘCOALA GIMNAZIALĂ LUNCA",181,"Alegeri Prezidentiale",1,817,391,349,42,0,384,7,890,499,137,247
10,BUZĂU,"C.A. ROSETTI",45815,VIZIRENI,"ŞCOALA PRIMARĂ VIZIRENI",182,"Alegeri Prezidentiale",1,360,200,176,24,0,198,2,390,190,141,57
10,BUZĂU,CALVINI,45753,CALVINI,"CAMIN CULTURAL CALVINI",183,"Alegeri Prezidentiale",1,784,391,326,58,7,384,7,860,469,201,183
10,BUZĂU,CALVINI,45753,"BÂSCENII DE JOS","SCOALA GIMNAZIALA ”DUMITRU I. IONESCU” CALVINI",184,"Alegeri Prezidentiale",1,1517,446,413,27,6,435,11,1660,1214,125,310
10,BUZĂU,CALVINI,45753,"BÂSCENII DE JOS","SCOALA PRIMARA BÎSCENII DE JOS",185,"Alegeri Prezidentiale",1,474,255,222,26,7,251,4,520,265,101,150
10,BUZĂU,CALVINI,45753,"BÂSCENII DE SUS","SCOALA GIMNAZIALA BÎSCENII DE SUS",186,"Alegeri Prezidentiale",1,726,376,312,55,9,372,4,790,414,210,162
10,BUZĂU,CĂNEŞTI,45888,CĂNEŞTI,"SCOALA GIMNAZIALA CANESTI",187,"Alegeri Prezidentiale",1,449,265,195,34,36,257,8,490,225,89,168
10,BUZĂU,CĂNEŞTI,45888,NEGOŞINA,"SCOALA PRIMARA NEGOSINA",188,"Alegeri Prezidentiale",1,156,110,91,19,0,107,3,180,70,37,70
10,BUZĂU,CĂTINA,45959,CĂTINA,"ŞCOALA GIMNAZIALĂ NR.1 CĂTINA",189,"Alegeri Prezidentiale",1,615,307,254,49,4,301,6,670,363,212,89
10,BUZĂU,CĂTINA,45959,CORBU,"ŞCOALA GIMNAZIALĂ NR.2 CORBU",190,"Alegeri Prezidentiale",1,644,380,327,45,8,377,3,700,320,173,204
10,BUZĂU,CĂTINA,45959,"VALEA CĂTINEI","ŞCOALA PRIMARĂ NR.1 VALEA CĂTINEI",191,"Alegeri Prezidentiale",1,376,185,163,19,3,182,3,410,225,126,56
10,BUZĂU,CĂTINA,45959,SLOBOZIA,"ŞCOALA CU CLS.I-IV SLOBOZIA",192,"Alegeri Prezidentiale",1,159,87,76,11,0,85,2,180,93,61,24
10,BUZĂU,CĂTINA,45959,ZELETIN,"ŞCOALA PRIMARĂ NR.2 ZELETIN",193,"Alegeri Prezidentiale",1,163,40,29,11,0,39,1,180,140,29,10
10,BUZĂU,CERNĂTEŞTI,46019,CERNĂTEŞTI,"GRADINITA CU PROGRAM NORMAL CERNATESTI",194,"Alegeri Prezidentiale",1,916,421,368,53,0,418,3,1000,579,226,192
10,BUZĂU,CERNĂTEŞTI,46019,"ZĂRNEŞTII DE SLĂNIC","CĂMINUL CULTURAL DIN SATUL ZĂRNEŞTI SLĂNIC",195,"Alegeri Prezidentiale",1,1102,555,508,47,0,551,4,1210,655,281,270
10,BUZĂU,CERNĂTEŞTI,46019,ALDENI,"CĂMINUL CULTURAL DIN SATUL ALDENI",196,"Alegeri Prezidentiale",1,677,401,319,82,0,399,2,740,339,191,208
10,BUZĂU,CERNĂTEŞTI,46019,FULGA,"ŞCOALA PRIMARA DIN SATUL FULGA",197,"Alegeri Prezidentiale",1,388,205,165,40,0,199,6,420,215,85,114
10,BUZĂU,CHILIILE,46108,CHILIILE,"CAMINUL CULTURAL CHILIILE",198,"Alegeri Prezidentiale",1,264,201,150,35,16,200,1,290,89,68,132
10,BUZĂU,CHILIILE,46108,TRESTIOARA,"ŞCOALA TRESTIOARA",199,"Alegeri Prezidentiale",1,174,123,86,21,16,121,2,200,77,19,102
10,BUZĂU,CHIOJDU,46180,CHIOJDU,"GRADINITA CU PROGRAM NORMAL CHIOJDU",200,"Alegeri Prezidentiale",1,787,433,347,84,2,428,5,860,427,231,197
10,BUZĂU,CHIOJDU,46180,"BÂSCA CHIOJDULUI","ŞCOALA GIMNAZIALA BISCA-CHIOJDULUI",201,"Alegeri Prezidentiale",1,936,425,387,32,6,421,4,1020,595,237,184
10,BUZĂU,CHIOJDU,46180,PLESCIOARA,"ŞCOALA PRIMARA PLESCIOARA",202,"Alegeri Prezidentiale",1,126,76,62,12,2,75,1,140,64,40,35
10,BUZĂU,CHIOJDU,46180,CĂTIAŞU,"ŞCOALA PRIMARA CATIASU",203,"Alegeri Prezidentiale",1,284,145,118,25,2,142,3,310,165,51,91
10,BUZĂU,CHIOJDU,46180,LERA,"ŞCOALA PRIMARA LERA",204,"Alegeri Prezidentiale",1,362,173,150,23,0,173,0,400,227,102,71
10,BUZĂU,CHIOJDU,46180,POENIŢELE,"ŞCOALA PRIMARA POENITELE",205,"Alegeri Prezidentiale",1,173,88,71,17,0,88,0,190,102,35,53
10,BUZĂU,CILIBIA,46251,CILIBIA,"PRIMĂRIA COMUNA CILIBIA – LA PARTER",206,"Alegeri Prezidentiale",2,1184,520,444,71,5,513,7,1300,780,302,211
10,BUZĂU,CILIBIA,46251,"MOVILA OII","ŞCOALA PRIMARĂ DIN SATUL MOVILA OII",207,"Alegeri Prezidentiale",1,291,183,140,34,9,180,3,320,137,82,98
10,BUZĂU,CISLĂU,46313,CISLĂU,"GRĂDINIŢA CU PROGRAM NORMAL NR. 1 COMUNA CISLĂU",208,"Alegeri Prezidentiale",1,1812,945,880,64,1,934,11,1990,1045,383,551
10,BUZĂU,CISLĂU,46313,SCĂRIŞOARA,"ŞCOALA GIMNAZIALĂ SAT SCĂRIŞOARA, COMUNA CISLĂU",209,"Alegeri Prezidentiale",1,1028,611,549,59,3,604,7,1130,519,331,273
10,BUZĂU,CISLĂU,46313,"BUDA CRĂCIUNEŞTI","CENTRUL DE ZI « DOAMNA NEAGA » PENTRU COPII CU VÂRSTE CUPRINSE ÎNTRE 3-6 ANI",210,"Alegeri Prezidentiale",1,626,319,289,30,0,317,2,680,361,197,120
10,BUZĂU,CISLĂU,46313,"GURA BÂSCEI","ŞCOALA PRIMARĂ SAT GURA BÂSCEI, COMUNA CISLĂU",211,"Alegeri Prezidentiale",1,300,153,122,28,3,150,3,330,177,60,90
10,BUZĂU,COCHIRLEANCA,46377,COCHIRLEANCA,"SCOALA GIMNAZIALA COCHIRLEANCA NR.1",212,"Alegeri Prezidentiale",1,1267,462,434,28,0,461,1,1390,928,249,212
10,BUZĂU,COCHIRLEANCA,46377,COCHIRLEANCA,"SCOALA GIMNAZIALA COCHIRLEANCA NR.2",213,"Alegeri Prezidentiale",1,817,321,302,19,0,319,2,890,569,144,175
10,BUZĂU,COCHIRLEANCA,46377,BOBOC,"CLĂDIRE PUNCT SANITAR UMAN SAT BOBOC",214,"Alegeri Prezidentiale",1,1352,496,451,45,0,488,8,1480,984,208,280
10,BUZĂU,COCHIRLEANCA,46377,ROŞIORU,"SCOALA PRIMARA ROSIORU",215,"Alegeri Prezidentiale",1,563,247,217,30,0,244,3,620,373,139,105
10,BUZĂU,COCHIRLEANCA,46377,"GARA BOBOCU","SCOALA PRIMARA GARA BOBOCU",216,"Alegeri Prezidentiale",1,293,152,111,41,0,149,3,320,168,101,48
10,BUZĂU,COCHIRLEANCA,46377,TÂRLELE,"SCOALA PRIMARA TARLELE",217,"Alegeri Prezidentiale",1,39,32,16,16,0,32,0,50,18,18,14
10,BUZĂU,COLŢI,46439,COLŢI,"ȘCOALA GIMNAZIALĂ COLȚI",218,"Alegeri Prezidentiale",1,398,202,168,34,0,201,1,430,228,115,86
10,BUZĂU,COLŢI,46439,ALUNIŞ,"ȘCOALA GIMNAZIALĂ ALUNIȘ",219,"Alegeri Prezidentiale",1,118,79,62,17,0,79,0,130,51,50,29
10,BUZĂU,COLŢI,46439,"MUSCELU CĂRĂMĂNEŞTI","CĂMINUL CULTURAL MUSCELUL CĂRĂMĂNEŞTI",220,"Alegeri Prezidentiale",1,79,50,31,19,0,50,0,90,40,15,35
10,BUZĂU,COLŢI,46439,"COLŢII DE JOS","ŞCOALA GIMNAZIALĂ COLȚII DE JOS",221,"Alegeri Prezidentiale",1,249,146,129,14,3,145,1,270,124,58,87
10,BUZĂU,COSTEŞTI,46484,COSTEŞTI,"ȘCOALA GIMNAZIALĂ COSTEȘTI",222,"Alegeri Prezidentiale",1,1270,648,551,97,0,639,9,1426,778,337,302
10,BUZĂU,COSTEŞTI,46484,PIETROSU,"GRĂDINIŢA CU PROGRAM NORMAL PIETROSU",223,"Alegeri Prezidentiale",1,1096,400,360,40,0,393,7,1200,800,170,223
10,BUZĂU,COSTEŞTI,46484,BUDIŞTENI,"GRĂDINIȚA CU PROGRAM NORMAL BUDIȘTENI",224,"Alegeri Prezidentiale",2,398,194,170,24,0,189,5,430,236,101,88
10,BUZĂU,COSTEŞTI,46484,SPĂTARU,"ŞCOALA GIMNAZIALĂ ”GENERAL ȘTEFAN GUȘĂ” SPĂTARU",225,"Alegeri Prezidentiale",1,1068,608,519,89,0,601,7,1170,562,371,230
10,BUZĂU,COSTEŞTI,46484,GOMOEŞTI,"ŞCOALA PRIMARĂ GOMOEȘTI",226,"Alegeri Prezidentiale",1,180,112,75,37,0,112,0,200,88,62,50
10,BUZĂU,COZIENI,46554,COZIENI,"ŞCOALA COZIENI",227,"Alegeri Prezidentiale",1,517,283,226,57,0,278,5,570,287,92,186
10,BUZĂU,COZIENI,46554,BĂLĂNEŞTI,"ŞCOALA BĂLĂNEŞTI",228,"Alegeri Prezidentiale",1,599,309,249,60,0,305,4,660,351,119,186
10,BUZĂU,COZIENI,46554,TRESTIA,"CĂMINUL CULTURAL TRESTIA",229,"Alegeri Prezidentiale",2,323,151,124,27,0,150,1,350,199,57,93
10,BUZĂU,COZIENI,46554,PIETRARU,"ŞCOALA PIETRARU",230,"Alegeri Prezidentiale",1,175,86,61,25,0,84,2,200,114,31,53
10,BUZĂU,FLORICA,50564,FLORICA,"ŞCOALA GIMNAZIALA FLORICA",231,"Alegeri Prezidentiale",1,1046,610,500,85,25,603,7,1150,540,255,348
10,BUZĂU,GĂLBINAŞI,46769,GĂLBINAŞI,"ŞCOALA GIMNAZIALĂ GĂLBINAŞI",232,"Alegeri Prezidentiale",1,1081,527,444,83,0,517,10,1180,653,274,243
10,BUZĂU,GĂLBINAŞI,46769,BENTU,"GRĂDINIȚA CU PROGRAM NORMAL BENTU",233,"Alegeri Prezidentiale",1,748,404,342,62,0,399,5,820,416,248,151
10,BUZĂU,GĂLBINAŞI,46769,TĂBĂRĂŞTI,"ȘCOALA PRIMARĂ NR.1 TĂBĂRĂȘTI",234,"Alegeri Prezidentiale",2,712,375,332,43,0,373,2,780,405,179,194
10,BUZĂU,GĂLBINAŞI,46769,TĂBĂRĂŞTI,"GRĂDINIȚA CU PROGRAM NORMAL NR. 2 TĂBĂRĂȘTI",235,"Alegeri Prezidentiale",1,946,493,431,62,0,487,6,1040,547,270,217
10,BUZĂU,GHERĂSENI,46803,GHERĂSENI,"GRADINITA CU PROGRAM NORMAL GHERASENI",236,"Alegeri Prezidentiale",1,1457,788,695,91,2,781,7,1600,812,432,349
10,BUZĂU,GHERĂSENI,46803,GHERĂSENI,"ŞCOALA CU CLASELE I-IV GHERASENI",237,"Alegeri Prezidentiale",1,856,452,420,32,0,446,6,940,488,220,226
10,BUZĂU,GHERĂSENI,46803,SUDIŢI,"ŞCOALA CU CLS.I-IV SUDITI",238,"Alegeri Prezidentiale",1,440,232,205,27,0,230,2,480,248,104,126
10,BUZĂU,GHERGHEASA,46830,GHERGHEASA,"ŞCOALA GIMNAZIALA GHERGHEASA",239,"Alegeri Prezidentiale",1,968,467,396,71,0,464,3,1060,593,232,232
10,BUZĂU,GHERGHEASA,46830,SĂLCIOARA,"CĂMINUL CULTURAL SĂLCIOARA",240,"Alegeri Prezidentiale",1,826,395,337,58,0,394,1,900,505,197,197
10,BUZĂU,"GLODEANU SĂRAT",46867,"GLODEANU SĂRAT","SCOALA GIMNAZIALA GLODEANU SARAT",241,"Alegeri Prezidentiale",1,1704,744,657,73,14,734,10,1870,1126,267,467
10,BUZĂU,"GLODEANU SĂRAT",46867,ILEANA,"GRADINITA CU PROGRAM NORMAL ILEANA",242,"Alegeri Prezidentiale",1,345,203,168,34,1,200,3,380,177,87,113
10,BUZĂU,"GLODEANU SĂRAT",46867,PITULICEA,"ŞCOALA GIMNAZIALA PITULICEA",243,"Alegeri Prezidentiale",1,750,375,316,59,0,371,4,820,445,172,199
10,BUZĂU,"GLODEANU SĂRAT",46867,CĂLDĂRUŞEANCA,"GRĂDINIȚA CU PROGRAM NORMAL",244,"Alegeri Prezidentiale",1,466,280,226,48,6,277,3,510,230,104,173
10,BUZĂU,GLODEANU-SILIŞTEA,46910,GLODEANU-SILIŞTEA,"ȘCOALA GIMNAZIALĂ GLODEANU-SILIȘTEA",245,"Alegeri Prezidentiale",1,1074,608,517,91,0,597,11,1180,572,202,395
10,BUZĂU,GLODEANU-SILIŞTEA,46910,COTORCA,"ȘCOALA PRIMARĂ COTORCA",246,"Alegeri Prezidentiale",1,783,394,333,61,0,390,4,860,466,192,198
10,BUZĂU,GLODEANU-SILIŞTEA,46910,"CÂRLIGU MARE","ŞCOALA CÎRLIGU MARE",247,"Alegeri Prezidentiale",1,347,164,118,46,0,162,2,380,216,74,88
10,BUZĂU,GLODEANU-SILIŞTEA,46910,VĂCĂREASCA,"ŞCOALA GIMNAZIALĂ VĂCĂREASCA",248,"Alegeri Prezidentiale",1,384,226,156,70,0,224,2,420,194,95,129
10,BUZĂU,GLODEANU-SILIŞTEA,46910,CASOTA,"GRĂDINIŢA CAŞOTA",249,"Alegeri Prezidentiale",1,263,154,123,31,0,154,0,290,136,91,63
10,BUZĂU,GREBĂNU,47006,GREBĂNU,"ŞCOALA GIMNAZIALĂ GREBĂNU",250,"Alegeri Prezidentiale",1,1788,713,665,48,0,702,11,1960,1247,318,384
10,BUZĂU,GREBĂNU,47006,HOMEŞTI,"ŞCOALA PRIMARĂ HOMEŞTI",251,"Alegeri Prezidentiale",1,812,349,286,63,0,344,5,891,542,125,219
10,BUZĂU,GREBĂNU,47006,LIVADA,"ŞCOALA PRIMARĂ LIVADA",252,"Alegeri Prezidentiale",1,587,345,265,80,0,342,3,640,295,111,231
10,BUZĂU,GREBĂNU,47006,PLEVNA,"ŞCOALA GIMNAZIALĂ PLEVNA",253,"Alegeri Prezidentiale",1,1130,600,539,61,0,594,6,1240,640,258,336
10,BUZĂU,"GURA TEGHII",47079,PĂLTINIŞ,"ŞCOALA GIMNAZIALĂ PĂLTINIŞ",254,"Alegeri Prezidentiale",1,497,254,218,35,1,253,1,540,286,162,91
10,BUZĂU,"GURA TEGHII",47079,FURTUNEŞTI,"CĂMINUL CULTURAL SAT FURTUNEŞTI",255,"Alegeri Prezidentiale",1,755,375,357,15,3,368,7,830,455,246,122
10,BUZĂU,"GURA TEGHII",47079,"GURA TEGHII","CAMINUL CULTURAL SATUL GURA TEGHII",256,"Alegeri Prezidentiale",1,1107,687,586,84,17,676,11,1210,523,434,242
10,BUZĂU,"GURA TEGHII",47079,VARLAAM,"ŞCOALA PRIMARĂ VARLAAM",257,"Alegeri Prezidentiale",1,453,241,212,23,6,237,4,490,249,136,101
10,BUZĂU,LARGU,47159,LARGU,"PRIMARIA LARGU",258,"Alegeri Prezidentiale",1,1240,517,456,61,0,515,2,1360,843,222,293
10,BUZĂU,LOPĂTARI,47186,LOPĂTARI,"PRIMARIA LOPĂTARI",259,"Alegeri Prezidentiale",1,962,518,445,73,0,512,6,1050,532,286,226
10,BUZĂU,LOPĂTARI,47186,LUNCILE,"ŞCOALA PRIMARĂ SAT LUNCILE",260,"Alegeri Prezidentiale",1,657,248,218,30,0,248,0,720,472,165,83
10,BUZĂU,LOPĂTARI,47186,TERCA,"CĂMINUL CULTURAL TERCA",261,"Alegeri Prezidentiale",1,341,139,123,16,0,139,0,370,231,85,54
10,BUZĂU,LOPĂTARI,47186,PLOŞTINA,"ŞCOALA PRIMARĂ SAT PLOŞTINA",262,"Alegeri Prezidentiale",1,399,171,151,20,0,168,3,440,269,98,70
10,BUZĂU,LOPĂTARI,47186,"PLAIU NUCULUI","CĂMINUL CULTURAL DIN SATUL PLAIU NUCULUI",263,"Alegeri Prezidentiale",1,575,249,224,25,0,248,1,638,389,122,126
10,BUZĂU,LUCIU,47300,LUCIU,"FOSTA ŞCOALĂ GIMNAZIALĂ ”PROF. DR. ION ANGHEL”",264,"Alegeri Prezidentiale",2,1514,657,603,54,0,645,12,1660,1003,248,397
10,BUZĂU,LUCIU,47300,CARAGELE,"ŞCOALA CARAGELE",265,"Alegeri Prezidentiale",1,677,285,253,32,0,281,4,740,455,80,201
10,BUZĂU,MĂGURA,47337,MĂGURA,"ȘCOALA GIMNAZIALĂ MĂGURA",266,"Alegeri Prezidentiale",1,1069,656,517,86,53,643,13,1206,550,281,362
10,BUZĂU,MĂGURA,47337,CIUTA,"ŞCOALA GIMNAZIALĂ CIUTA",267,"Alegeri Prezidentiale",1,638,330,305,24,1,329,1,700,370,81,248
10,BUZĂU,MĂRĂCINENI,47373,MĂRĂCINENI,"SCOALA GENERALA MARACINENI",268,"Alegeri Prezidentiale",1,1390,728,674,54,0,719,9,1556,828,351,368
10,BUZĂU,MĂRĂCINENI,47373,MĂRĂCINENI,"ŞCOALA GENERALĂ MĂRĂCINENI",269,"Alegeri Prezidentiale",1,1208,621,550,71,0,614,7,1320,699,359,255
10,BUZĂU,MĂRĂCINENI,47373,CĂPĂŢÂNEŞTI,"ŞCOALA GENERALĂ CĂPĂŢÎNEŞTI",270,"Alegeri Prezidentiale",1,1508,751,704,47,0,742,9,1650,899,422,320
10,BUZĂU,MĂRĂCINENI,47373,CĂPĂŢÂNEŞTI,"GRĂDINIŢA CU PROGRAM NORMAL CĂPĂŢÂNEŞTI",271,"Alegeri Prezidentiale",1,1519,806,723,83,0,791,15,1660,854,458,333
10,BUZĂU,MĂRĂCINENI,47373,POTOCENI,"ŞCOALA GENERALĂ POTOCENI",272,"Alegeri Prezidentiale",1,1709,893,807,86,0,876,17,1870,977,501,375
10,BUZĂU,MĂRGĂRITEŞTI,47417,MĂRGĂRITEŞTI,"PRIMARIA MĂRGĂRITEŞTI",273,"Alegeri Prezidentiale",1,515,292,247,45,0,289,3,560,268,109,180
10,BUZĂU,MÂNZĂLEŞTI,47630,MÂNZĂLEŞTI,"ŞCOALA GIMNAZIALĂ MÎNZĂLEŞTI",274,"Alegeri Prezidentiale",1,622,298,272,26,0,294,4,680,382,152,142
10,BUZĂU,MÂNZĂLEŞTI,47630,BEŞLII,"ŞCOALA GIMNAZIALĂ ”DUMITRU N. CRISTEA” BEŞLII",275,"Alegeri Prezidentiale",1,437,224,190,34,0,221,3,480,256,129,92
10,BUZĂU,MÂNZĂLEŞTI,47630,"VALEA COTOAREI","ŞCOALA PRIMARĂ VALEA COTOAREI",276,"Alegeri Prezidentiale",1,179,95,83,12,0,95,0,200,105,56,39
10,BUZĂU,MÂNZĂLEŞTI,47630,"GURA BĂDICULUI","ŞCOALA GIMNAZIALĂ GURA BĂDICULUI",277,"Alegeri Prezidentiale",1,366,129,112,17,0,128,1,400,271,81,47
10,BUZĂU,MÂNZĂLEŞTI,47630,TRESTIOARA,"ŞCOALA PRIMARĂ TRESTIOARA",278,"Alegeri Prezidentiale",1,290,134,121,13,0,132,2,320,186,72,60
10,BUZĂU,MEREI,47453,MEREI,"ŞCOALA GIMNAZIALĂ MEREI",279,"Alegeri Prezidentiale",1,908,441,345,96,0,435,6,990,549,243,192
10,BUZĂU,MEREI,47453,LIPIA,"GRĂDINIȚA CU PROGRAM NORMAL LIPIA",280,"Alegeri Prezidentiale",1,1598,834,718,113,3,822,12,1750,916,381,441
10,BUZĂU,MEREI,47453,SĂRATA-MONTEORU,"GRĂDINIȚA CU PROGRAM NORMAL SĂRATA- MONTEORU",281,"Alegeri Prezidentiale",1,664,651,320,331,0,647,4,730,79,329,318
10,BUZĂU,MEREI,47453,"GURA SĂRĂŢII","ŞCOALA GURA SĂRĂŢII",282,"Alegeri Prezidentiale",1,133,106,70,36,0,105,1,150,44,43,62
10,BUZĂU,MEREI,47453,"DEALUL VIEI","ŞCOALA PRIMARĂ DEALUL VIEI",283,"Alegeri Prezidentiale",1,648,371,301,70,0,365,6,710,339,213,152
10,BUZĂU,MEREI,47453,"IZVORU DULCE","ŞCOALA GIMNAZIALĂ IZVORU DULCE",284,"Alegeri Prezidentiale",1,734,303,262,41,0,301,2,800,497,147,154
10,BUZĂU,MEREI,47453,NENCIULEŞTI,"ŞCOALA NENCIULEŞTI",285,"Alegeri Prezidentiale",1,265,142,112,30,0,139,3,290,148,72,67
10,BUZĂU,MEREI,47453,OGRĂZILE,"ŞCOALA PRIMARĂ OGRĂZILE",286,"Alegeri Prezidentiale",1,591,286,235,51,0,283,3,650,364,118,165
10,BUZĂU,MIHĂILEŞTI,47578,MIHĂILEŞTI,"ŞCOALA GIMNAZIALA MIHAILESTI",287,"Alegeri Prezidentiale",1,974,414,354,60,0,405,9,1070,656,176,229
10,BUZĂU,MIHĂILEŞTI,47578,MĂRGINEANU,"ŞCOALA PRIMARA MĂRGINEANU",288,"Alegeri Prezidentiale",1,636,264,234,30,0,261,3,700,436,91,170
10,BUZĂU,"MOVILA BANULUI",47774,"MOVILA BANULUI","GRĂDINIȚA CU PROGRAM NORMAL MOVILA BANULUI",289,"Alegeri Prezidentiale",1,1003,564,454,110,0,558,6,1100,536,205,353
10,BUZĂU,"MOVILA BANULUI",47774,LIMPEZIŞ,"GRĂDINIŢA CU PROGRAM NORMAL LIMPEZIŞ",290,"Alegeri Prezidentiale",1,798,476,423,53,0,467,9,870,394,200,267
10,BUZĂU,"MOVILA BANULUI",47774,CIORANCA,"ŞCOALA GENERALA CIORANCA",291,"Alegeri Prezidentiale",1,204,121,88,33,0,118,3,220,99,69,49
10,BUZĂU,MURGEŞTI,47818,MURGEŞTI,"PRIMĂRIA MURGEŞTI",292,"Alegeri Prezidentiale",1,730,484,401,83,0,481,3,800,316,205,276
10,BUZĂU,NĂENI,47854,NĂENI,"ŞCOALA GIMNAZIALĂ NĂENI",293,"Alegeri Prezidentiale",1,455,192,153,39,0,189,3,526,334,65,124
10,BUZĂU,NĂENI,47854,FINŢEŞTI,"ŞCOALA PRIMARĂ FINŢESTI",294,"Alegeri Prezidentiale",1,475,266,218,48,0,264,2,520,254,158,106
10,BUZĂU,NĂENI,47854,VÂRF,"ŞCOALA VÎRF",295,"Alegeri Prezidentiale",1,199,83,68,15,0,79,4,220,137,35,44
10,BUZĂU,NĂENI,47854,PROŞCA,"GRĂDINIŢA PROSCA",296,"Alegeri Prezidentiale",1,181,95,71,24,0,94,1,200,105,54,40
10,BUZĂU,ODĂILE,48021,ODĂILE,"ŞCOALA GIMNAZIALĂ ODĂILE",297,"Alegeri Prezidentiale",1,608,285,245,39,1,284,1,660,375,93,191
10,BUZĂU,PADINA,48138,PADINA,"GRADINITA CU PROGRAM NORMAL NR. 2 COMUNA PADINA",298,"Alegeri Prezidentiale",1,1272,446,406,40,0,444,2,1390,944,235,209
10,BUZĂU,PADINA,48138,PADINA,"CĂMINUL CULTURAL PADINA",299,"Alegeri Prezidentiale",1,904,371,311,60,0,368,3,990,619,200,168
10,BUZĂU,PADINA,48138,PADINA,"SCOALA GIMNAZIALA NR.1 COMUNA PADINA",300,"Alegeri Prezidentiale",1,989,412,336,76,0,401,11,1080,668,172,229
10,BUZĂU,PARDOŞI,48165,PARDOŞI,"ŞCOALA PARDOŞI",301,"Alegeri Prezidentiale",1,314,212,174,38,0,210,2,340,128,86,124
10,BUZĂU,PĂNĂTĂU,48227,PĂNĂTĂU,"ŞCOALA GIMNAZIALĂ PĂNĂTĂU",302,"Alegeri Prezidentiale",1,1245,568,508,60,0,552,16,1360,792,245,307
10,BUZĂU,PĂNĂTĂU,48227,TEGA,"ŞCOALA TEGA",303,"Alegeri Prezidentiale",1,518,262,229,33,0,257,5,570,308,81,176
10,BUZĂU,PĂNĂTĂU,48227,BEGU,"ŞCOALA PRIMARĂ BEGU",304,"Alegeri Prezidentiale",1,184,116,105,11,0,116,0,200,84,37,79
10,BUZĂU,PÂRSCOV,48557,PÂRSCOV,"CĂMINUL CULTURAL PÎRSCOV",305,"Alegeri Prezidentiale",1,1232,490,405,85,0,480,10,1350,860,235,245
10,BUZĂU,PÂRSCOV,48557,PÂRSCOV,"CĂMINUL CULTURAL PÎRSCOV",306,"Alegeri Prezidentiale",1,1193,507,451,56,0,497,10,1310,803,264,233
10,BUZĂU,PÂRSCOV,48557,BĂDILA,"ŞCOALA GENERALĂ BĂDILA",307,"Alegeri Prezidentiale",1,662,201,177,24,0,198,3,720,519,79,119
10,BUZĂU,PÂRSCOV,48557,"LUNCA FRUMOASĂ","ŞCOALA LUNCA FRUMOASA",308,"Alegeri Prezidentiale",1,903,398,370,28,0,394,4,990,592,203,191
10,BUZĂU,PÂRSCOV,48557,ROBEŞTI,"ŞCOALA GENERALĂ ROBEŞTI",309,"Alegeri Prezidentiale",1,475,265,217,48,0,264,1,520,255,126,138
10,BUZĂU,PÂRSCOV,48557,TRESTIENI,"FOSTUL MAGAZIN TRESTIENI",310,"Alegeri Prezidentiale",1,43,22,10,12,0,22,0,50,28,9,13
10,BUZĂU,PIETROASELE,48487,PIETROASELE,"ŞCOALA GIMNAZIALĂ PIETROASELE",311,"Alegeri Prezidentiale",1,1520,695,602,93,0,688,7,1670,975,394,294
10,BUZĂU,PIETROASELE,48487,ŞARÂNGA,"GRĂDINIŢA CU PROGRAM NORMAL DIN SATUL ŞARÎNGA",312,"Alegeri Prezidentiale",1,1162,491,414,77,0,484,7,1306,815,240,244
10,BUZĂU,PODGORIA,48682,PLEŞEŞTI,"ŞCOALA PRIMARĂ PLEȘEȘTI",313,"Alegeri Prezidentiale",1,308,151,117,34,0,151,0,340,189,69,82
10,BUZĂU,PODGORIA,48682,PODGORIA,"ŞCOALA GIMNAZIALĂ PODGORIA",314,"Alegeri Prezidentiale",1,1281,563,509,54,0,554,9,1400,837,242,312
10,BUZĂU,PODGORIA,48682,COŢATCU,"ŞCOALA GIMNAZIALĂ COȚATCU",315,"Alegeri Prezidentiale",1,979,427,380,47,0,423,4,1070,643,173,250
10,BUZĂU,"POŞTA CÂLNĂU",48771,"POŞTA CÂLNĂU","GRĂDINIŢA DE COPII POŞTA CÎLNĂU",316,"Alegeri Prezidentiale",1,1062,612,528,71,13,607,5,1160,548,259,348
10,BUZĂU,"POŞTA CÂLNĂU",48771,"POŞTA CÂLNĂU","GRĂDINIŢA DE COPII POŞTA CÎLNĂU",317,"Alegeri Prezidentiale",1,985,540,482,47,11,533,7,1080,540,267,266
10,BUZĂU,"POŞTA CÂLNĂU",48771,POTÂRNICHEŞTI,"SCOALA GENERALA DIN POTIRNICHESTI",318,"Alegeri Prezidentiale",1,390,227,189,35,3,223,4,430,203,116,107
10,BUZĂU,"POŞTA CÂLNĂU",48771,ZILIŞTEANCA,"ŞCOALA GENERALĂ ZILIŞTEANCA",319,"Alegeri Prezidentiale",1,1109,583,522,52,9,575,8,1210,627,269,306
10,BUZĂU,"POŞTA CÂLNĂU",48771,SUDIŢI,"ŞCOALA GENERALĂ, SATUL SUDIŢI",320,"Alegeri Prezidentiale",1,1463,790,700,81,9,777,13,1600,810,296,481
10,BUZĂU,PUIEŞTI,48842,"PUIEŞTII DE SUS","ŞCOALA PUIEŞTII DE SUS",321,"Alegeri Prezidentiale",1,308,138,106,32,0,137,1,340,202,56,81
10,BUZĂU,PUIEŞTI,48842,"PUIEŞTII DE JOS","ŞCOALA GIMNAZIALĂ PUIEŞTII DE JOS",322,"Alegeri Prezidentiale",1,1081,495,425,70,0,491,4,1180,685,249,242
10,BUZĂU,PUIEŞTI,48842,NICOLEŞTI,"ŞCOALA GIMNAZIALĂ NICOLEŞTI",323,"Alegeri Prezidentiale",1,577,212,184,28,0,211,1,630,418,110,101
10,BUZĂU,PUIEŞTI,48842,DĂSCĂLEŞTI,"GRĂDINIŢA DĂSCĂLEŞTI",324,"Alegeri Prezidentiale",1,577,249,211,38,0,244,5,630,381,119,125
10,BUZĂU,PUIEŞTI,48842,MĂCRINA,"ŞCOALA MĂCRINA",325,"Alegeri Prezidentiale",1,438,193,158,35,0,191,2,480,287,82,109
10,BUZĂU,RACOVIŢENI,48922,RACOVIŢENI,"PRIMĂRIA RACOVIŢENI",326,"Alegeri Prezidentiale",1,1040,511,449,62,0,505,6,1140,629,183,322
10,BUZĂU,RÂMNICELU,48968,RÂMNICELU,"SCOALA GIMNAZIALA NR.1",327,"Alegeri Prezidentiale",1,1013,439,409,30,0,435,4,1110,671,147,288
10,BUZĂU,RÂMNICELU,48968,RÂMNICELU,"SCOALA NR.2 SAT RAMNICELU",328,"Alegeri Prezidentiale",1,1446,496,470,26,0,495,1,1580,1084,135,360
10,BUZĂU,RÂMNICELU,48968,ŞTIUBEI,"SCOALA SAT ŞTIUBEI",329,"Alegeri Prezidentiale",1,466,293,253,40,0,292,1,510,217,106,186
10,BUZĂU,RÂMNICELU,48968,COLIBAŞI,"ŞCOALA SAT COLIBAŞI",330,"Alegeri Prezidentiale",1,326,197,172,25,0,196,1,360,163,63,133
10,BUZĂU,RÂMNICELU,48968,FOTIN,"ŞCOALA SAT FOTIN",331,"Alegeri Prezidentiale",1,178,130,109,21,0,129,1,200,70,47,82
10,BUZĂU,ROBEASCA,49019,ROBEASCA,"ŞCOALA GIMNAZIALĂ ROBEASCA",332,"Alegeri Prezidentiale",1,563,278,218,30,30,273,5,611,333,82,191
10,BUZĂU,ROBEASCA,49019,MOŞEŞTI,"CAMINUL CULTURAL MOŞEŞTI",333,"Alegeri Prezidentiale",1,268,166,99,52,15,164,2,326,160,42,122
10,BUZĂU,RUŞEŢU,49046,RUŞEŢU,"LICEUL TEHNOLOGIC RUȘEȚU",334,"Alegeri Prezidentiale",1,984,502,453,49,0,491,11,1080,578,231,260
10,BUZĂU,RUŞEŢU,49046,RUŞEŢU,"CLĂDIREA GRĂDINIŢEI CU PROGRAM NORMAL",335,"Alegeri Prezidentiale",1,944,417,392,25,0,414,3,1030,613,172,242
10,BUZĂU,RUŞEŢU,49046,RUŞEŢU,"CĂMINUL CULTURAL ”DIMITRIE GUSTI”",336,"Alegeri Prezidentiale",1,944,514,436,78,0,508,6,1030,516,200,308
10,BUZĂU,RUŞEŢU,49046,"SERGENT IONEL ŞTEFAN","ŞCOALA PRIMARĂ",337,"Alegeri Prezidentiale",1,171,120,100,20,0,118,2,190,70,56,62
10,BUZĂU,SĂGEATA,49073,SĂGEATA,"GRĂDINIŢA CU PROGRAM NORMAL SĂGEATA",338,"Alegeri Prezidentiale",1,1124,658,580,59,19,650,8,1230,572,295,355
10,BUZĂU,SĂGEATA,49073,DÂMBROCA,"GRĂDINIȚA CU PROGRAM NORMAL DÂMBROCA",339,"Alegeri Prezidentiale",1,1003,542,481,41,20,534,8,1100,558,275,259
10,BUZĂU,SĂGEATA,49073,BORDUŞANI,"ŞCOALA BORDUŞANI",340,"Alegeri Prezidentiale",1,313,219,180,39,0,216,3,340,121,76,140
10,BUZĂU,SĂGEATA,49073,BEILIC,"ŞCOALA BEILIC",341,"Alegeri Prezidentiale",1,294,161,137,24,0,159,2,320,159,78,81
10,BUZĂU,SĂGEATA,49073,GĂVĂNEŞTI,"ŞCOALA GĂVĂNEŞTI",342,"Alegeri Prezidentiale",1,823,424,366,35,23,419,5,900,476,159,260
10,BUZĂU,SĂGEATA,49073,BANIŢA,"SCOALA BANIŢA",343,"Alegeri Prezidentiale",1,245,147,106,41,0,147,0,270,123,79,68
10,BUZĂU,SĂHĂTENI,49153,SĂHĂTENI,"GRĂDINIȚA CU PROGRAM NORMAL SĂHĂTENI",344,"Alegeri Prezidentiale",2,1302,693,605,88,0,679,14,1430,737,414,265
10,BUZĂU,SĂHĂTENI,49153,"ISTRIŢA DE JOS","ŞCOALA CU CLS.I-IV ISTRIŢA DE JOS",345,"Alegeri Prezidentiale",1,269,140,93,47,0,138,2,290,150,89,49
10,BUZĂU,SĂHĂTENI,49153,GĂGENI,"ŞCOALA CU CLS.I-IV GĂGENI",346,"Alegeri Prezidentiale",1,369,178,153,25,0,173,5,400,222,79,94
10,BUZĂU,SĂHĂTENI,49153,VINTILEANCA,"ŞCOALA CLS.I-VIII VINTILEANCA",347,"Alegeri Prezidentiale",1,700,306,275,31,0,303,3,770,464,147,156
10,BUZĂU,SĂPOCA,49206,SĂPOCA,"ȘCOALA GIMNAZIALĂ SĂPOCA",348,"Alegeri Prezidentiale",1,1432,889,648,114,127,877,12,1730,841,464,413
10,BUZĂU,SĂPOCA,49206,MĂTEŞTI,"ȘCOALA GIMNAZIALĂ MĂTESTI",349,"Alegeri Prezidentiale",1,1399,730,640,89,1,723,7,1530,800,417,306
10,BUZĂU,SĂRULEŞTI,49233,SĂRULEŞTI,"CĂMINUL CULTURAL SĂRULEŞTI",350,"Alegeri Prezidentiale",1,1065,554,487,67,0,542,12,1170,616,200,342
10,BUZĂU,SCORŢOASA,49313,SCORŢOASA,"SALA DE FESTIVITĂŢI SCORTOASA",351,"Alegeri Prezidentiale",1,1011,452,392,54,6,447,5,1110,658,224,223
10,BUZĂU,SCORŢOASA,49313,"GURA VĂII","ŞCOALA PRIMARĂ SAT GURA VĂII",352,"Alegeri Prezidentiale",1,178,103,77,20,6,101,2,200,97,46,55
10,BUZĂU,SCORŢOASA,49313,PLOPEASA,"ŞCOALA PRIMARĂ SAT PLOPEASA DE SUS",353,"Alegeri Prezidentiale",1,152,67,49,18,0,67,0,170,103,13,54
10,BUZĂU,SCORŢOASA,49313,"GRABICINA DE JOS","ŞCOALA PRIMARĂ SAT GRABICINA DE JOS",354,"Alegeri Prezidentiale",1,159,90,72,18,0,89,1,180,90,32,57
10,BUZĂU,SCORŢOASA,49313,"GOLU GRABICINA","ŞCOALA PRIMARĂ SAT GOLU GRABICINA",355,"Alegeri Prezidentiale",1,232,113,81,32,0,112,1,250,137,45,67
10,BUZĂU,SCORŢOASA,49313,"BALTA TOCILA","SCOALA GIMNAZIALĂ SAT BALTA TOCILA",356,"Alegeri Prezidentiale",1,252,125,99,26,0,124,1,270,145,67,57
10,BUZĂU,SCORŢOASA,49313,BECIU,"ŞCOALA PRIMARĂ SAT BECIU",357,"Alegeri Prezidentiale",1,113,68,54,14,0,67,1,130,62,30,37
10,BUZĂU,SCUTELNICI,49439,SCUTELNICI,"GRĂDINIȚA CU PROGRAM NORMAL SCUTELNICI",358,"Alegeri Prezidentiale",1,883,541,413,117,11,533,8,970,429,172,361
10,BUZĂU,SCUTELNICI,49439,BRĂGĂREASA,"ȘCOALA GIMNAZIALĂ BRĂGĂREASA",359,"Alegeri Prezidentiale",1,520,290,241,46,3,289,1,570,280,192,97
10,BUZĂU,SCUTELNICI,49439,ARCANU,"ŞCOALA PRIMARA SAT ARCANU",360,"Alegeri Prezidentiale",1,328,232,199,26,7,230,2,360,128,46,184
10,BUZĂU,SIRIU,49484,"LUNCA JARIŞTEI","ŞCOALA GIMNAZIALA COMUNA SIRIU, JUDETUL BUZAU,DIN SATUL LUNCA JARISTEI",361,"Alegeri Prezidentiale",1,1408,768,710,58,0,755,13,1540,772,456,299
10,BUZĂU,SIRIU,49484,"COLŢU PIETRII","ŞCOALA PRIMARĂ SAT COLŢU PIETRII,COMUNA SIRIU,JUDETUL BUZĂU",362,"Alegeri Prezidentiale",1,1144,652,613,38,1,643,9,1250,598,410,233
10,BUZĂU,SMEENI,49545,SMEENI,"CĂMINUL DE NUNTI SMEENI",363,"Alegeri Prezidentiale",1,1182,425,397,28,0,420,5,1290,865,229,191
10,BUZĂU,SMEENI,49545,SMEENI,"GRĂDINIȚA CU PROGRAM NORMAL SMEENI",364,"Alegeri Prezidentiale",1,1099,478,398,62,18,475,3,1236,758,223,252
10,BUZĂU,SMEENI,49545,SMEENI,"ȘCOALA PRIMARĂ SĂLCIOARA",365,"Alegeri Prezidentiale",1,533,204,176,28,0,204,0,580,376,112,92
10,BUZĂU,SMEENI,49545,MOISICA,"GRĂDINIȚA CU PROGRAM NORMAL MOISICA",366,"Alegeri Prezidentiale",1,289,148,124,24,0,146,2,320,172,67,79
10,BUZĂU,SMEENI,49545,ALBEŞTI,"ŞCOALA GIMNAZIALĂ ALBEŞTI",367,"Alegeri Prezidentiale",1,724,331,305,26,0,327,4,790,459,122,205
10,BUZĂU,SMEENI,49545,UDAŢI-MÂNZU,"GRĂDINIȚA CU PROGRAM NORMAL UDAŢI- MÂNZU",368,"Alegeri Prezidentiale",1,718,371,315,56,0,371,0,790,419,135,236
10,BUZĂU,SMEENI,49545,CĂLŢUNA,"ŞCOALA PRMARĂ CĂLŢUNA",369,"Alegeri Prezidentiale",1,434,196,171,25,0,196,0,470,274,65,131
10,BUZĂU,SMEENI,49545,UDAŢI-LUCIENI,"ŞCOALA PRMARĂ LUCIENI",370,"Alegeri Prezidentiale",1,351,144,128,16,0,144,0,380,236,67,77
10,BUZĂU,STÂLPU,49625,STÂLPU,"SCOALA GIMNAZIALA STILPU",371,"Alegeri Prezidentiale",1,1374,660,607,53,0,655,5,1510,850,287,368
10,BUZĂU,STÂLPU,49625,STÂLPU,"PRIMARIA STILPU",372,"Alegeri Prezidentiale",1,1195,550,491,59,0,542,8,1310,760,236,306
10,BUZĂU,TISĂU,49643,GRĂJDANA,"CAMINUL CULTURAL SAT GRAJDANA",373,"Alegeri Prezidentiale",1,897,469,392,77,0,461,8,980,511,231,230
10,BUZĂU,TISĂU,49643,IZVORANU,"SCOALA PRIMARA, SAT IZVORANU, COMUNA TISAU",374,"Alegeri Prezidentiale",1,95,71,44,27,0,71,0,110,39,31,40
10,BUZĂU,TISĂU,49643,"VALEA SĂLCIILOR","GRADINIŢA CU PROGRAM NORMAL SAT VALEA SĂLCIILOR, COMUNA TISAU",375,"Alegeri Prezidentiale",1,510,214,183,31,0,213,1,560,346,116,97
10,BUZĂU,TISĂU,49643,HALEŞ,"ŞCOALA GIMNAZIALA SAT HALEŞ, COMUNA TISAU",376,"Alegeri Prezidentiale",1,762,349,282,67,0,343,6,866,517,228,115
10,BUZĂU,TISĂU,49643,PĂDURENII,"GRADINITA CU PROGRAM NORMAL SAT PADURENI, COMUNA TISAU",377,"Alegeri Prezidentiale",1,450,171,155,16,0,168,3,490,319,101,67
10,BUZĂU,TISĂU,49643,TISĂU,"GRADINIŢĂ CU PROGRAM NORMAL COMUNA TISAU",378,"Alegeri Prezidentiale",1,616,303,257,46,0,299,4,670,367,193,106
10,BUZĂU,TISĂU,49643,STREZENI,"SCOALA PRIMARĂ SAT STREZENI, COMUNA TISAU",379,"Alegeri Prezidentiale",1,429,200,162,38,0,197,3,470,270,131,66
10,BUZĂU,TOPLICENI,49769,POŞTA,"ŞCOALA PRIMARA POŞTA",380,"Alegeri Prezidentiale",1,426,243,204,39,0,239,4,470,227,110,129
10,BUZĂU,TOPLICENI,49769,TOPLICENI,"ŞCOALA GIMNAZIALA TOPLICENI",381,"Alegeri Prezidentiale",1,1037,432,391,41,0,426,6,1140,708,198,228
10,BUZĂU,TOPLICENI,49769,RĂDUCEŞTI,"GRADINITA CU PROGRAM NORMAL RĂDUCEŞTI",382,"Alegeri Prezidentiale",1,377,180,153,27,0,179,1,410,230,73,106
10,BUZĂU,TOPLICENI,49769,BĂBENI,"ŞCOALA GIMNAZIALA BĂBENI ”ION ARISTOTEL”",383,"Alegeri Prezidentiale",1,836,353,306,46,1,349,4,920,567,191,158
10,BUZĂU,TOPLICENI,49769,DEDULEŞTI,"GRADINITA CU PROGRAM NORMAL DEDULEŞTI",384,"Alegeri Prezidentiale",1,756,356,316,40,0,351,5,822,466,116,235
10,BUZĂU,TOPLICENI,49769,"GURA FĂGETULUI","SCOALA GURA-FAGETULUI",385,"Alegeri Prezidentiale",1,137,95,72,23,0,93,2,159,64,30,63
10,BUZĂU,ŢINTEŞTI,49849,ŢINTEŞTI,"ŞCOALA PRIMARA SAT ŢINTEŞTI",386,"Alegeri Prezidentiale",1,1822,878,798,80,0,862,16,2000,1122,292,570
10,BUZĂU,ŢINTEŞTI,49849,MAXENU,"SPAŢIUL DE UTILITATE PUBLICĂ DIN SATUL MAXENU",387,"Alegeri Prezidentiale",1,1815,864,792,72,0,849,15,1990,1126,346,503
10,BUZĂU,ULMENI,49894,ULMENI,"SCOALA GIMNAZIALA PROFESOR CONSTANTIN DINCA ULMENI",388,"Alegeri Prezidentiale",1,1218,626,520,90,16,621,5,1330,704,269,352
10,BUZĂU,ULMENI,49894,CLONDIRU,"LOCALUL FOSTULUI SFAT POPULAR CLONDIRU",389,"Alegeri Prezidentiale",1,1327,689,589,84,16,680,9,1450,761,336,344
10,BUZĂU,UNGURIU,50549,UNGURIU,"SCOALA GIMNAZIALA ING. OPRISAN IARCA UNGURIU",390,"Alegeri Prezidentiale",1,926,525,415,0,110,513,12,1170,645,272,241
10,BUZĂU,UNGURIU,50549,UNGURIU,"SCOALA GIMNAZIALA ING. OPRISAN IARCA UNGURIU",391,"Alegeri Prezidentiale",1,957,455,369,86,0,450,5,1050,595,251,199
10,BUZĂU,"VADU PAŞII",49956,"VADU PAŞII","SALA DE FESTIVITĂŢI A PRIMĂRIEI COMUNEI VADU PAŞII",392,"Alegeri Prezidentiale",1,1973,1329,1131,198,0,1317,12,2160,831,791,526
10,BUZĂU,"VADU PAŞII",49956,"VADU PAŞII","GRĂDINIŢA CU PROGRAM NORMAL VADU PAŞII",393,"Alegeri Prezidentiale",1,1441,803,750,53,0,793,10,1580,777,463,330
10,BUZĂU,"VADU PAŞII",49956,FOCŞĂNEI,"SCOALA FOCŞĂNEI",394,"Alegeri Prezidentiale",1,1203,710,574,136,0,705,5,1320,610,373,332
10,BUZĂU,"VADU PAŞII",49956,SCURTEŞTI,"SCOALA CIOCÂRLIA",395,"Alegeri Prezidentiale",1,557,311,273,38,0,310,1,610,299,161,149
10,BUZĂU,"VADU PAŞII",49956,SCURTEŞTI,"SCOALA GIMNAZIALA SCURTEŞTI",396,"Alegeri Prezidentiale",1,1632,776,719,57,0,770,6,1790,1014,423,347
10,BUZĂU,"VADU PAŞII",49956,STĂNCEŞTI,"ŞCOALA GIMNAZIALA STĂNCEŞTI",397,"Alegeri Prezidentiale",1,1210,621,576,45,0,611,10,1330,709,292,319
10,BUZĂU,"VALEA RÂMNICULUI",50022,OREAVUL,"GRADINITA CU PROGRAM NORMAL OREAVU",398,"Alegeri Prezidentiale",1,1874,967,904,63,0,959,8,2050,1083,393,566
10,BUZĂU,"VALEA RÂMNICULUI",50022,"VALEA RÂMNICULUI","SCOALA GIMNAZIALA VALEA RAMNICULUI",399,"Alegeri Prezidentiale",1,1813,884,840,44,0,873,11,1990,1106,382,491
10,BUZĂU,"VALEA RÂMNICULUI",50022,RUBLA,"GRADINITA CU PROGRAM NORMAL RUBLA",400,"Alegeri Prezidentiale",1,960,496,460,36,0,495,1,1050,554,183,312
10,BUZĂU,"VALEA SALCIEI",50068,"VALEA SALCIEI","CĂMINUL CULTURAL VALEA SALCIEI",401,"Alegeri Prezidentiale",1,578,321,284,21,16,319,2,630,309,91,228
10,BUZĂU,VÂLCELELE,50399,VÂLCELELE,"SCOALA GIMNAZIALA NR 1 VILCELELE",402,"Alegeri Prezidentiale",1,1149,590,500,90,0,581,9,1260,670,210,371
10,BUZĂU,VERNEŞTI,50102,VERNEŞTI,"ŞCOALA GIMNAZIALĂ ”NICOLAE IOAN JILINSCHI” VERNEȘTI",403,"Alegeri Prezidentiale",1,1908,913,781,132,0,890,23,2090,1177,528,362
10,BUZĂU,VERNEŞTI,50102,CÂNDEŞTI,"ŞCOALA GIMNAZIALĂ SAT CÎNDEȘTI",404,"Alegeri Prezidentiale",1,1390,519,471,48,0,495,24,1520,1001,207,288
10,BUZĂU,VERNEŞTI,50102,CÂNDEŞTI,"ŞCOALA GIMNAZIALĂ SAT CINDEŞTI",405,"Alegeri Prezidentiale",1,1362,499,462,37,0,487,12,1490,991,227,260
10,BUZĂU,VERNEŞTI,50102,ZOREŞTI,"ŞCOALA GIMNAZIALĂ ”VASILE ALDEA” ZOREȘTI",406,"Alegeri Prezidentiale",1,1101,484,415,69,0,476,8,1210,726,264,212
10,BUZĂU,VERNEŞTI,50102,NIŞCOV,"GRĂDINIȚA CU PROGRAM NORMAL NIȘCOV",407,"Alegeri Prezidentiale",1,1076,455,388,67,0,443,12,1180,725,231,212
10,BUZĂU,VERNEŞTI,50102,"SĂSENII NOI","ŞCOALA PRIMARĂ SĂSENII NOI",408,"Alegeri Prezidentiale",2,298,128,102,26,0,125,3,320,192,71,54
10,BUZĂU,VERNEŞTI,50102,MIEREA,"GRADINITA CU PROGRAM NORMAL MIEREA",409,"Alegeri Prezidentiale",1,374,215,168,47,0,212,3,410,195,138,74
10,BUZĂU,"VINTILĂ VODĂ",50228,"VINTILĂ VODĂ","ŞCOALA GIMNAZIALĂ TACHE ŞI ECATERINA TOCILESCU",410,"Alegeri Prezidentiale",1,1256,589,499,66,24,581,8,1406,817,262,319
10,BUZĂU,"VINTILĂ VODĂ",50228,NICULEŞTI,"ŞCOALA PRIMARĂ SAT NICULEŞTI",411,"Alegeri Prezidentiale",1,955,438,356,68,14,436,2,1050,612,175,261
10,BUZĂU,"VINTILĂ VODĂ",50228,COCA-ANTIMIREŞTI,"ŞCOALA PRIMARĂ SAT COCA ANTIMIREŞTI",412,"Alegeri Prezidentiale",1,194,86,68,18,0,83,3,210,124,30,53
10,BUZĂU,VIPEREŞTI,50326,VIPEREŞTI,"ŞCOALA GIMNAZIALA VIPEREŞTI",413,"Alegeri Prezidentiale",2,894,459,400,59,0,454,5,990,531,183,271
10,BUZĂU,VIPEREŞTI,50326,TRONARI,"ŞCOALA PRIMARA TRONARI",414,"Alegeri Prezidentiale",1,752,380,353,27,0,378,2,820,440,97,281
10,BUZĂU,VIPEREŞTI,50326,URSOAIA,"ŞCOALA GIMNAZIALA URSOAIA",415,"Alegeri Prezidentiale",1,855,325,282,43,0,317,8,940,615,175,142
10,BUZĂU,VIPEREŞTI,50326,MUSCEL,"ŞCOALA PRIMARA MUŞCEL",416,"Alegeri Prezidentiale",1,102,55,29,26,0,54,1,120,65,11,43
10,BUZĂU,ZĂRNEŞTI,50415,FUNDENI,"ŞCOALA GIMNAZIALĂ ”CONSTANTIN POPESCU” FUNDENI",417,"Alegeri Prezidentiale",1,1839,1045,928,86,31,1024,21,2020,975,413,611
10,BUZĂU,ZĂRNEŞTI,50415,PRUNENI,"SCOALA GENERALA PRUNENI",418,"Alegeri Prezidentiale",1,306,208,164,43,1,204,4,330,122,80,124
10,BUZĂU,ZĂRNEŞTI,50415,"VADU SOREŞTI","GRĂDINIŢA DE COPII VADU SOREŞTI",419,"Alegeri Prezidentiale",1,1042,576,505,52,19,570,6,1140,564,228,342
10,BUZĂU,ZĂRNEŞTI,50415,ZĂRNEŞTI,"GRĂDINIŢA DE COPII ZĂRNEŞTI",420,"Alegeri Prezidentiale",1,845,592,493,64,35,580,12,920,328,206,374
10,BUZĂU,ZIDURI,50479,ZIDURI,"SALA DE ŞEDINŢE PRIMĂRIA ZIDURI",421,"Alegeri Prezidentiale",1,813,362,321,41,0,361,1,890,528,150,211
10,BUZĂU,ZIDURI,50479,LANURILE,"CĂMINUL CULTURAL LANURILE",422,"Alegeri Prezidentiale",1,589,229,201,28,0,226,3,640,411,116,110
10,BUZĂU,ZIDURI,50479,"HELIADE RĂDULESCU","ŞCOALA PRIMARĂ HELIADE RĂDULESCU",423,"Alegeri Prezidentiale",1,652,257,216,41,0,251,6,710,453,77,174
10,BUZĂU,ZIDURI,50479,COSTIENI,"ŞCOALA PRIMARĂ COSTIENI",424,"Alegeri Prezidentiale",1,603,263,237,26,0,258,5,660,397,85,173
10,BUZĂU,ZIDURI,50479,ZOIŢA,"CĂMINUL CULTURAL ZOIŢA",425,"Alegeri Prezidentiale",1,447,204,183,21,0,202,2,490,286,69,133
10,BUZĂU,ZIDURI,50479,CUCULEASA,"ŞCOALA PRIMARĂ CUCULEASA",426,"Alegeri Prezidentiale",1,359,181,162,19,0,180,1,390,209,99,81
11,CARAŞ-SEVERIN,"MUNICIPIUL REŞIŢA",50790,REŞIŢA,"ȘCOALA GIMNAZIALĂ NR. 5",1,"Alegeri Prezidentiale",1,1217,461,401,38,22,442,19,1341,880,267,175
11,CARAŞ-SEVERIN,"MUNICIPIUL REŞIŢA",50790,REŞIŢA,"CENTRUL DE ZI ”MARIA”",2,"Alegeri Prezidentiale",1,600,226,200,26,0,221,5,652,426,132,89
11,CARAŞ-SEVERIN,"MUNICIPIUL REŞIŢA",50790,REŞIŢA,"GRĂDINIȚA CU PROGRAM NORMAL NR. 2",3,"Alegeri Prezidentiale",1,1086,378,354,24,0,374,4,1196,818,210,164
11,CARAŞ-SEVERIN,"MUNICIPIUL REŞIŢA",50790,REŞIŢA,"ȘCOALA GIMNAZIALĂ NR. 1 (BETON)",4,"Alegeri Prezidentiale",1,594,265,245,20,0,262,3,653,388,180,82
11,CARAŞ-SEVERIN,"MUNICIPIUL REŞIŢA",50790,REŞIŢA,"ȘCOALA GIMNAZIALĂ NR. 1 (BETON)",5,"Alegeri Prezidentiale",1,1074,357,341,16,0,350,7,1182,825,226,124
11,CARAŞ-SEVERIN,"MUNICIPIUL REŞIŢA",50790,REŞIŢA,"ȘCOALA GIMNAZIALĂ NR. 1 (CASA MUNCITOREASCĂ)",6,"Alegeri Prezidentiale",1,1423,505,486,19,0,486,19,1566,1061,302,184
11,CARAŞ-SEVERIN,"MUNICIPIUL REŞIŢA",50790,REŞIŢA,"ȘCOALA GIMNAZIALĂ NR. 1 (CASA MUNCITOREASCĂ)",7,"Alegeri Prezidentiale",1,1059,296,282,14,0,288,8,1165,869,189,99
11,CARAŞ-SEVERIN,"MUNICIPIUL REŞIŢA",50790,REŞIŢA,"ȘCOALA PRIMARĂ DEALU MARE",8,"Alegeri Prezidentiale",1,698,191,187,4,0,181,10,769,578,100,81
11,CARAŞ-SEVERIN,"MUNICIPIUL REŞIŢA",50790,REŞIŢA,"ȘCOALA PRIMARĂ DEALU MARE",9,"Alegeri Prezidentiale",1,841,234,221,12,1,233,1,917,683,146,87
11,CARAŞ-SEVERIN,"MUNICIPIUL REŞIŢA",50790,REŞIŢA,"ȘCOALA GIMNAZIALĂ NR. 2",10,"Alegeri Prezidentiale",1,1059,426,383,43,0,415,11,1166,740,251,164
11,CARAŞ-SEVERIN,"MUNICIPIUL REŞIŢA",50790,REŞIŢA,"ȘCOALA GIMNAZIALĂ NR. 2",11,"Alegeri Prezidentiale",1,1194,563,528,26,9,548,15,1315,752,344,204
11,CARAŞ-SEVERIN,"MUNICIPIUL REŞIŢA",50790,REŞIŢA,"ȘCOALA GIMNAZIALĂ NR. 2",12,"Alegeri Prezidentiale",1,1186,578,529,28,21,561,17,1306,728,372,189
11,CARAŞ-SEVERIN,"MUNICIPIUL REŞIŢA",50790,REŞIŢA,"COLEGIUL NAȚIONAL ”TRAIAN LALESCU” - ȘCOALA PRIMARĂ",13,"Alegeri Prezidentiale",1,630,242,219,23,0,239,3,693,451,124,115
11,CARAŞ-SEVERIN,"MUNICIPIUL REŞIŢA",50790,REŞIŢA,"GRĂDINIȚA CU PROGRAM PRELUNGIT ”PALATUL FERMECAT”",14,"Alegeri Prezidentiale",1,992,447,415,32,0,425,22,1092,645,253,172
11,CARAŞ-SEVERIN,"MUNICIPIUL REŞIŢA",50790,REŞIŢA,"GRĂDINIȚA CU PROGRAM PRELUNGIT ”PALATUL FERMECAT”",15,"Alegeri Prezidentiale",1,1153,543,511,31,1,527,16,1269,726,338,189
11,CARAŞ-SEVERIN,"MUNICIPIUL REŞIŢA",50790,REŞIŢA,"GRĂDINIȚA CU PROGRAM PRELUNGIT ”PALATUL FERMECAT”",16,"Alegeri Prezidentiale",1,1403,545,526,19,0,525,20,1544,999,327,198
11,CARAŞ-SEVERIN,"MUNICIPIUL REŞIŢA",50790,REŞIŢA,"S.C. DRUMURI JUDEȚENE S.A. REȘIȚA AFLAT ÎN PROPRIETATEA CONSILIULUI JUDEȚEAN CARAȘ-SEVERIN",17,"Alegeri Prezidentiale",1,1044,378,362,16,0,369,9,1150,772,224,145
11,CARAŞ-SEVERIN,"MUNICIPIUL REŞIŢA",50790,REŞIŢA,"UNIVERSITATEA ”EFTIMIE MURGU”",18,"Alegeri Prezidentiale",1,542,320,226,66,28,310,10,596,276,178,132
11,CARAŞ-SEVERIN,"MUNICIPIUL REŞIŢA",50790,REŞIŢA,"UNIVERSITATEA ”EFTIMIE MURGU”",19,"Alegeri Prezidentiale",1,1119,544,483,31,30,532,12,1232,688,311,221
11,CARAŞ-SEVERIN,"MUNICIPIUL REŞIŢA",50790,REŞIŢA,"COLEGIUL NAȚIONAL ”TRAIAN LALESCU”",20,"Alegeri Prezidentiale",1,1125,465,420,45,0,451,14,1240,775,306,145
11,CARAŞ-SEVERIN,"MUNICIPIUL REŞIŢA",50790,REŞIŢA,"COLEGIUL NAȚIONAL ”TRAIAN LALESCU”",21,"Alegeri Prezidentiale",1,962,400,372,27,1,385,15,1059,659,242,143
11,CARAŞ-SEVERIN,"MUNICIPIUL REŞIŢA",50790,REŞIŢA,"COLEGIUL NAȚIONAL ”TRAIAN LALESCU”",22,"Alegeri Prezidentiale",1,1283,487,470,17,0,478,9,1412,925,299,179
11,CARAŞ-SEVERIN,"MUNICIPIUL REŞIŢA",50790,REŞIŢA,"COLEGIUL NAȚIONAL ”TRAIAN LALESCU”",23,"Alegeri Prezidentiale",1,752,335,323,12,0,330,5,829,494,217,113
11,CARAŞ-SEVERIN,"MUNICIPIUL REŞIŢA",50790,REŞIŢA,"ȘCOALA GIMNAZIALĂ ”MIHAI PEIA”",24,"Alegeri Prezidentiale",1,870,439,395,44,0,430,9,959,520,251,179
11,CARAŞ-SEVERIN,"MUNICIPIUL REŞIŢA",50790,REŞIŢA,"ȘCOALA GIMNAZIALĂ ”MIHAI PEIA”",25,"Alegeri Prezidentiale",1,768,319,293,25,1,308,11,846,527,185,123
11,CARAŞ-SEVERIN,"MUNICIPIUL REŞIŢA",50790,REŞIŢA,"ȘCOALA GIMNAZIALĂ ”MIHAI PEIA”",26,"Alegeri Prezidentiale",1,899,338,318,15,5,326,12,991,653,207,119
11,CARAŞ-SEVERIN,"MUNICIPIUL REŞIŢA",50790,REŞIŢA,"COLEGIUL TEHNIC REȘIȚA",27,"Alegeri Prezidentiale",1,1197,505,475,30,0,493,12,1313,808,291,202
11,CARAŞ-SEVERIN,"MUNICIPIUL REŞIŢA",50790,REŞIŢA,"COLEGIUL TEHNIC REȘIȚA",28,"Alegeri Prezidentiale",1,754,355,328,27,0,349,6,830,475,217,132
11,CARAŞ-SEVERIN,"MUNICIPIUL REŞIŢA",50790,REŞIŢA,"COLEGIUL TEHNIC REȘIȚA",29,"Alegeri Prezidentiale",1,1027,418,399,19,0,413,5,1123,705,254,159
11,CARAŞ-SEVERIN,"MUNICIPIUL REŞIŢA",50790,REŞIŢA,"GRĂDINIŢA CU PROGRAM NORMAL ”CIUPERCUȚA”",30,"Alegeri Prezidentiale",1,694,260,240,20,0,251,9,763,503,170,81
11,CARAŞ-SEVERIN,"MUNICIPIUL REŞIŢA",50790,REŞIŢA,"GRĂDINIȚA CU PROGRAM NORMAL ”DEGEȚICA”",31,"Alegeri Prezidentiale",1,1096,456,431,25,0,442,14,1207,751,253,189
11,CARAŞ-SEVERIN,"MUNICIPIUL REŞIŢA",50790,REŞIŢA,"LICEUL TEORETIC ”TRAIAN VUIA”",32,"Alegeri Prezidentiale",1,1303,434,400,34,0,424,10,1435,1001,273,151
11,CARAŞ-SEVERIN,"MUNICIPIUL REŞIŢA",50790,REŞIŢA,"LICEUL TEORETIC ”TRAIAN VUIA”",33,"Alegeri Prezidentiale",1,950,378,330,48,0,368,10,1046,668,249,119
11,CARAŞ-SEVERIN,"MUNICIPIUL REŞIŢA",50790,REŞIŢA,"LICEUL TEORETIC ”TRAIAN VUIA”",34,"Alegeri Prezidentiale",1,1426,481,454,27,0,471,10,1579,1098,270,201
11,CARAŞ-SEVERIN,"MUNICIPIUL REŞIŢA",50790,REŞIŢA,"LICEUL TEORETIC ”TRAIAN VUIA”",35,"Alegeri Prezidentiale",1,1075,421,409,12,0,410,11,1185,764,224,186
11,CARAŞ-SEVERIN,"MUNICIPIUL REŞIŢA",50790,REŞIŢA,"LICEUL TEORETIC ”TRAIAN VUIA”",36,"Alegeri Prezidentiale",1,1086,438,419,19,0,425,13,1195,757,261,164
11,CARAŞ-SEVERIN,"MUNICIPIUL REŞIŢA",50790,REŞIŢA,"LICEUL TEORETIC ”TRAIAN VUIA”",37,"Alegeri Prezidentiale",1,911,246,233,13,0,243,3,1004,758,164,79
11,CARAŞ-SEVERIN,"MUNICIPIUL REŞIŢA",50790,REŞIŢA,"ȘCOALA GIMNAZIALĂ NR. 8",38,"Alegeri Prezidentiale",1,1284,520,475,45,0,511,9,1406,886,307,204
11,CARAŞ-SEVERIN,"MUNICIPIUL REŞIŢA",50790,REŞIŢA,"ȘCOALA GIMNAZIALĂ NR. 8",39,"Alegeri Prezidentiale",1,1427,613,583,30,0,603,10,1571,958,340,263
11,CARAŞ-SEVERIN,"MUNICIPIUL REŞIŢA",50790,REŞIŢA,"ȘCOALA GIMNAZIALĂ NR. 8",40,"Alegeri Prezidentiale",1,1094,451,430,21,0,441,10,1204,753,273,168
11,CARAŞ-SEVERIN,"MUNICIPIUL REŞIŢA",50790,REŞIŢA,"COLEGIUL NAŢIONAL”MIRCEA ELIADE”REŞIŢA",41,"Alegeri Prezidentiale",1,1003,372,336,36,0,361,11,1106,734,228,133
11,CARAŞ-SEVERIN,"MUNICIPIUL REŞIŢA",50790,REŞIŢA,"COLEGIUL NAŢIONAL”MIRCEA ELIADE”,REŞIŢA",42,"Alegeri Prezidentiale",1,976,432,410,22,0,423,9,1075,643,252,171
11,CARAŞ-SEVERIN,"MUNICIPIUL REŞIŢA",50790,REŞIŢA,"COLEGIUL TEHNIC CĂRĂŞAN, REȘIȚA",43,"Alegeri Prezidentiale",1,1186,492,476,16,0,478,14,1298,806,291,187
11,CARAŞ-SEVERIN,"MUNICIPIUL REŞIŢA",50790,REŞIŢA,"COLEGIUL TEHNIC CĂRĂŞAN, REȘIȚA",44,"Alegeri Prezidentiale",1,956,371,353,18,0,365,6,1054,683,206,159
11,CARAŞ-SEVERIN,"MUNICIPIUL REŞIŢA",50790,REŞIŢA,"ȘCOALA GIMNAZIALĂ NR. 7,CORP B",45,"Alegeri Prezidentiale",1,1370,605,568,37,0,586,19,1508,903,367,219
11,CARAŞ-SEVERIN,"MUNICIPIUL REŞIŢA",50790,REŞIŢA,"ȘCOALA GIMNAZIALĂ NR. 7,CORP B",46,"Alegeri Prezidentiale",1,1156,492,468,24,0,479,13,1273,781,274,205
11,CARAŞ-SEVERIN,"MUNICIPIUL REŞIŢA",50790,REŞIŢA,"ȘCOALA GIMNAZIALĂ NR. 7,CORP B",47,"Alegeri Prezidentiale",1,1062,442,425,16,1,434,8,1169,727,241,193
11,CARAŞ-SEVERIN,"MUNICIPIUL REŞIŢA",50790,REŞIŢA,"ȘCOALA GIMNAZIALĂ NR. 7,CORP B",48,"Alegeri Prezidentiale",1,860,302,284,18,0,291,11,955,653,183,108
11,CARAŞ-SEVERIN,"MUNICIPIUL REŞIŢA",50790,REŞIŢA,"ȘCOALA GIMNAZIALĂ NR. 7,CORP A",49,"Alegeri Prezidentiale",1,1306,551,516,35,0,540,11,1438,887,324,216
11,CARAŞ-SEVERIN,"MUNICIPIUL REŞIŢA",50790,REŞIŢA,"ȘCOALA GIMNAZIALĂ NR. 7,CORP A",50,"Alegeri Prezidentiale",1,1131,464,423,41,0,452,12,1246,782,279,173
11,CARAŞ-SEVERIN,"MUNICIPIUL REŞIŢA",50790,REŞIŢA,"ȘCOALA GIMNAZIALĂ NR. 7,CORP A",51,"Alegeri Prezidentiale",1,1490,642,624,18,0,628,14,1641,999,357,271
11,CARAŞ-SEVERIN,"MUNICIPIUL REŞIŢA",50790,REŞIŢA,"ȘCOALA GIMNAZIALĂ NR. 7,CORP A",52,"Alegeri Prezidentiale",1,1044,464,414,50,0,451,13,1150,686,300,151
11,CARAŞ-SEVERIN,"MUNICIPIUL REŞIŢA",50790,REŞIŢA,"ȘCOALA GIMNAZIALĂ NR. 9",53,"Alegeri Prezidentiale",1,1082,449,423,26,0,440,9,1151,702,257,183
11,CARAŞ-SEVERIN,"MUNICIPIUL REŞIŢA",50790,REŞIŢA,"ȘCOALA GIMNAZIALĂ NR. 9",54,"Alegeri Prezidentiale",1,1413,559,529,30,0,544,15,1555,996,313,231
11,CARAŞ-SEVERIN,"MUNICIPIUL REŞIŢA",50790,REŞIŢA,"ȘCOALA GIMNAZIALĂ NR. 9",55,"Alegeri Prezidentiale",1,1200,516,480,35,1,502,14,1321,805,310,192
11,CARAŞ-SEVERIN,"MUNICIPIUL REŞIŢA",50790,REŞIŢA,"ȘCOALA GIMNAZIALĂ NR. 9",56,"Alegeri Prezidentiale",1,1413,520,486,34,0,507,13,1556,1036,282,225
11,CARAŞ-SEVERIN,"MUNICIPIUL REŞIŢA",50790,REŞIŢA,"LICEUL DE ARTE ”SABIN PĂUȚA”",57,"Alegeri Prezidentiale",1,967,433,355,50,28,428,5,1065,632,254,174
11,CARAŞ-SEVERIN,"MUNICIPIUL REŞIŢA",50790,REŞIŢA,"LICEUL DE ARTE ”SABIN PĂUȚA”",58,"Alegeri Prezidentiale",1,1214,524,481,25,18,509,15,1336,812,300,209
11,CARAŞ-SEVERIN,"MUNICIPIUL REŞIŢA",50790,REŞIŢA,"LICEUL DE ARTE ”SABIN PĂUȚA”",59,"Alegeri Prezidentiale",1,1329,641,595,30,16,624,17,1463,822,326,298
11,CARAŞ-SEVERIN,"MUNICIPIUL REŞIŢA",50790,REŞIŢA,"LICEUL DE ARTE ”SABIN PĂUȚA”",60,"Alegeri Prezidentiale",1,1097,465,430,16,19,453,12,1208,743,250,203
11,CARAŞ-SEVERIN,"MUNICIPIUL REŞIŢA",50790,REŞIŢA,"ȘCOALA GIMNAZIALĂ NR. 12",61,"Alegeri Prezidentiale",1,1180,525,484,41,0,512,13,1301,776,347,165
11,CARAŞ-SEVERIN,"MUNICIPIUL REŞIŢA",50790,REŞIŢA,"ȘCOALA GIMNAZIALĂ NR. 12",62,"Alegeri Prezidentiale",1,1316,526,507,19,0,506,20,1443,917,338,168
11,CARAŞ-SEVERIN,"MUNICIPIUL REŞIŢA",50790,REŞIŢA,"ȘCOALA GIMNAZIALĂ NR. 12",63,"Alegeri Prezidentiale",1,1160,391,382,9,0,383,8,1277,886,218,165
11,CARAŞ-SEVERIN,"MUNICIPIUL REŞIŢA",50790,REŞIŢA,"ȘCOALA GIMNAZIALĂ NR. 12",64,"Alegeri Prezidentiale",2,1014,435,411,24,0,416,19,1115,680,222,194
11,CARAŞ-SEVERIN,"MUNICIPIUL REŞIŢA",50790,CÂLNIC,"COLEGIUL NAȚIONAL ”MIRCEA ELIADE” - ȘCOALA CÂLNIC (CORP D)",65,"Alegeri Prezidentiale",1,1333,528,503,23,2,517,11,1468,940,313,204
11,CARAŞ-SEVERIN,"MUNICIPIUL REŞIŢA",50790,CUPTOARE,"CĂMINUL CULTURAL CUPTOARE",66,"Alegeri Prezidentiale",1,268,124,110,14,0,124,0,295,171,61,63
11,CARAŞ-SEVERIN,"MUNICIPIUL REŞIŢA",50790,DOMAN,"GRĂDINIȚA CU PROGRAM NORMAL DOMAN",67,"Alegeri Prezidentiale",1,585,209,200,9,0,205,4,645,436,152,53
11,CARAŞ-SEVERIN,"MUNICIPIUL REŞIŢA",50790,SECU,"LICEUL TEORETIC ”DIACONOVICI TIETZ” - ȘCOALA CU CLS I-IV",68,"Alegeri Prezidentiale",1,396,135,121,14,0,134,1,437,302,109,25
11,CARAŞ-SEVERIN,"MUNICIPIUL REŞIŢA",50790,ŢEROVA,"ȘCOALA GIMNAZIALĂ NR. 8 - ȘCOALA PRIMARĂ ȚEROVA",69,"Alegeri Prezidentiale",1,442,177,164,13,0,167,10,487,310,108,59
11,CARAŞ-SEVERIN,"MUNICIPIUL REŞIŢA",50790,MONIOM,"COLEGIUL NAȚIONAL ”MIRCEA ELIADE” - GRĂDINIȚA MONIOM (CORP F)",70,"Alegeri Prezidentiale",1,277,142,130,12,0,135,7,306,164,96,39
11,CARAŞ-SEVERIN,"MUNICIPIUL CARANSEBEŞ",51010,CARANSEBEŞ,"CLĂDIRE A MUNICIPIULUI CARANSEBEȘ (FOSTA ȘCOALĂ PRIMARĂ)",71,"Alegeri Prezidentiale",1,1176,485,443,42,0,476,9,1295,810,275,201
11,CARAŞ-SEVERIN,"MUNICIPIUL CARANSEBEŞ",51010,CARANSEBEŞ,"GRĂDINIȚA CU PROGRAM NORMAL NR. 3",72,"Alegeri Prezidentiale",1,518,248,217,31,0,245,3,570,322,174,71
11,CARAŞ-SEVERIN,"MUNICIPIUL CARANSEBEŞ",51010,CARANSEBEŞ,"MUZEUL DE ETNOGRAFIE ȘI AL REGIMENTULUI DE GRANIȚĂ",73,"Alegeri Prezidentiale",1,1443,681,622,59,0,665,16,1589,908,423,242
11,CARAŞ-SEVERIN,"MUNICIPIUL CARANSEBEŞ",51010,CARANSEBEŞ,"ȘCOALA GIMNAZIALĂ NR. 8",74,"Alegeri Prezidentiale",1,1106,507,425,80,2,497,10,1217,710,312,185
11,CARAŞ-SEVERIN,"MUNICIPIUL CARANSEBEŞ",51010,CARANSEBEŞ,"LICEUL TEHNOLOGIC ”DACIA”",75,"Alegeri Prezidentiale",1,1414,625,554,71,0,616,9,1554,929,381,235
11,CARAŞ-SEVERIN,"MUNICIPIUL CARANSEBEŞ",51010,CARANSEBEŞ,"CASA MUNICIPALĂ DE CULTURĂ ”GEORGE SURU”",76,"Alegeri Prezidentiale",1,1199,649,519,130,0,630,19,1320,671,365,265
11,CARAŞ-SEVERIN,"MUNICIPIUL CARANSEBEŞ",51010,CARANSEBEŞ,"GRĂDINIȚA CU PROGRAM NORMAL NR. 1",77,"Alegeri Prezidentiale",1,1554,684,565,67,52,670,14,1710,1026,420,250
11,CARAŞ-SEVERIN,"MUNICIPIUL CARANSEBEŞ",51010,CARANSEBEŞ,"CLĂDIRE A MUNICIPIULUI CARANSEBEȘ (FOSTA ȘCOALĂ GENERALĂ NR. 7)",78,"Alegeri Prezidentiale",1,1279,439,389,27,23,414,25,1408,969,253,161
11,CARAŞ-SEVERIN,"MUNICIPIUL CARANSEBEŞ",51010,CARANSEBEŞ,"CLĂDIRE A MUNICIPIULUI CARANSEBEȘ (FOSTA ȘCOALĂ GENERALĂ NR.7)",79,"Alegeri Prezidentiale",1,1114,472,432,40,0,463,9,1225,753,291,172
11,CARAŞ-SEVERIN,"MUNICIPIUL CARANSEBEŞ",51010,CARANSEBEŞ,"CLUBUL SPORTIV ȘCOLAR",80,"Alegeri Prezidentiale",1,1165,421,384,36,1,411,10,1283,862,267,144
11,CARAŞ-SEVERIN,"MUNICIPIUL CARANSEBEŞ",51010,CARANSEBEŞ,"GRĂDINIȚA NR. 4",81,"Alegeri Prezidentiale",1,1198,444,403,41,0,432,12,1320,876,258,174
11,CARAŞ-SEVERIN,"MUNICIPIUL CARANSEBEŞ",51010,CARANSEBEŞ,"ȘCOALA GIMNAZIALĂ NR. 2",82,"Alegeri Prezidentiale",1,1347,527,490,37,0,516,11,1483,956,331,185
11,CARAŞ-SEVERIN,"MUNICIPIUL CARANSEBEŞ",51010,CARANSEBEŞ,"ȘCOALA GIMNAZIALĂ NR. 2",83,"Alegeri Prezidentiale",1,1089,465,414,51,0,446,19,1197,732,277,169
11,CARAŞ-SEVERIN,"MUNICIPIUL CARANSEBEŞ",51010,CARANSEBEŞ,"LICEUL TEHNOLOGIC ”DECEBAL”",84,"Alegeri Prezidentiale",1,1320,480,438,42,0,459,21,1452,972,298,161
11,CARAŞ-SEVERIN,"MUNICIPIUL CARANSEBEŞ",51010,CARANSEBEŞ,"LICEUL TEHNOLOGIC ”DECEBAL”",85,"Alegeri Prezidentiale",1,1369,510,477,33,0,495,15,1505,995,324,171
11,CARAŞ-SEVERIN,"MUNICIPIUL CARANSEBEŞ",51010,CARANSEBEŞ,"LICEUL TEHNOLOGIC ”DECEBAL”",86,"Alegeri Prezidentiale",1,1448,627,607,20,0,613,14,1593,966,429,184
11,CARAŞ-SEVERIN,"MUNICIPIUL CARANSEBEŞ",51010,CARANSEBEŞ,"COLEGIUL NAȚIONAL ”C.D. LOGA”",87,"Alegeri Prezidentiale",1,1610,687,584,57,46,671,16,1771,1084,450,221
11,CARAŞ-SEVERIN,"MUNICIPIUL CARANSEBEŞ",51010,CARANSEBEŞ,"GRĂDINIȚA CU PROGRAM NORMAL NR.5",88,"Alegeri Prezidentiale",1,1154,459,417,41,1,449,10,1269,810,286,163
11,CARAŞ-SEVERIN,"MUNICIPIUL CARANSEBEŞ",51010,CARANSEBEŞ,"GRĂDINIȚA CU PROGRAM PRELUNGIT NR. 3",89,"Alegeri Prezidentiale",1,720,270,250,20,0,257,13,792,522,151,106
11,CARAŞ-SEVERIN,"MUNICIPIUL CARANSEBEŞ",51010,CARANSEBEŞ,"ȘCOALA GIMNAZIALĂ NR. 1",90,"Alegeri Prezidentiale",1,1084,381,359,22,0,369,12,1191,810,237,132
11,CARAŞ-SEVERIN,"MUNICIPIUL CARANSEBEŞ",51010,JUPA,"ȘCOALA PRIMARĂ",91,"Alegeri Prezidentiale",1,495,286,241,44,1,282,4,545,259,196,86
11,CARAŞ-SEVERIN,"ORAŞ ANINA",50889,ANINA,"LICEUL ”MATHIAS HAMMER”",92,"Alegeri Prezidentiale",1,859,360,303,29,28,350,10,944,584,198,152
11,CARAŞ-SEVERIN,"ORAŞ ANINA",50889,ANINA,"CENTRUL DE AFACERI ANINA",93,"Alegeri Prezidentiale",1,846,359,305,49,5,345,14,931,572,193,152
11,CARAŞ-SEVERIN,"ORAŞ ANINA",50889,ANINA,"ŞCOALA GIMNAZIALĂ NR.1 CELNIC GRĂDINIŢA CU PROGRAM NORMAL NR.1 CELNIC",94,"Alegeri Prezidentiale",1,644,242,207,33,2,241,1,707,465,129,112
11,CARAŞ-SEVERIN,"ORAŞ ANINA",50889,ANINA,"SEDIUL S.C. GOSTRANS S.A.",95,"Alegeri Prezidentiale",1,518,219,201,18,0,213,6,570,351,115,98
11,CARAŞ-SEVERIN,"ORAŞ ANINA",50889,ANINA,"ŞCOALA GIMNAZIALĂ NR.1 CELNIC GRĂDINIŢA CU PROGRAM NORMAL NR. 2 ORAŞUL NOU",96,"Alegeri Prezidentiale",1,648,210,187,22,1,210,0,712,502,109,101
11,CARAŞ-SEVERIN,"ORAŞ ANINA",50889,ANINA,"CENTRUL DE ZI ANINA",97,"Alegeri Prezidentiale",1,655,257,232,22,3,254,3,720,463,135,119
11,CARAŞ-SEVERIN,"ORAŞ ANINA",50889,ANINA,"SEDIUL DEPOZITUL FINAL CÂNTAR",98,"Alegeri Prezidentiale",1,644,244,221,18,5,237,7,707,463,124,113
11,CARAŞ-SEVERIN,"ORAŞ ANINA",50889,ANINA,"ŞCOALA GIMNAZIALĂ NR.1 CELNIC GRĂDINIŢA CU PROGRAM NORMAL NR.4 SIGISMUND",99,"Alegeri Prezidentiale",1,566,179,157,21,1,177,2,622,443,113,64
11,CARAŞ-SEVERIN,"ORAŞ ANINA",50889,ANINA,"LICEUL ”MATHIAS HAMMER” ANINA ŞCOALA GIMNAZIALĂ NR.2 STEIERDORF",100,"Alegeri Prezidentiale",1,1117,412,362,31,19,398,14,1236,824,251,147
11,CARAŞ-SEVERIN,"ORAŞ ANINA",50889,ANINA,"LICEUL”MATHIAS HAMMER” ANINA GRĂDINIŢA CU PROGRAM NORMAL NR.5 STEIERDORF",101,"Alegeri Prezidentiale",1,558,226,187,34,5,222,4,613,387,137,85
11,CARAŞ-SEVERIN,"ORAŞ ANINA",50889,ANINA,"LICEUL ”MATHIAS HAMMER” ANINA ŞCOALA GIMNAZIALĂ NR.3 BRĂDET",102,"Alegeri Prezidentiale",1,300,140,118,20,2,139,1,329,189,65,74
11,CARAŞ-SEVERIN,"ORAŞ BĂILE HERCULANE",50923,"BĂILE HERCULANE","PROTOPOPIAT ORTODOX ROMÂN",103,"Alegeri Prezidentiale",1,235,176,99,77,0,174,2,259,83,91,83
11,CARAŞ-SEVERIN,"ORAŞ BĂILE HERCULANE",50923,"BĂILE HERCULANE","LICEUL HERCULES(FOSTA SCOALA GENERALA)",104,"Alegeri Prezidentiale",1,1467,1354,579,775,0,1336,18,1613,259,748,588
11,CARAŞ-SEVERIN,"ORAŞ BĂILE HERCULANE",50923,"BĂILE HERCULANE","LICEUL HERCULES",105,"Alegeri Prezidentiale",1,917,414,361,53,0,404,10,1008,594,213,191
11,CARAŞ-SEVERIN,"ORAŞ BĂILE HERCULANE",50923,"BĂILE HERCULANE","LICEUL HERCULES",106,"Alegeri Prezidentiale",1,1048,555,440,113,2,541,14,1152,597,301,240
11,CARAŞ-SEVERIN,"ORAŞ BĂILE HERCULANE",50923,PECINIŞCA,"CĂMINUL CULTURAL",107,"Alegeri Prezidentiale",1,487,279,233,46,0,278,1,535,256,145,133
11,CARAŞ-SEVERIN,"ORAŞ BOCŞA",50969,BOCŞA,"ȘCOALA GIMNAZIALĂ NR. 1 BOCŞA",108,"Alegeri Prezidentiale",1,1340,493,460,33,0,484,9,1474,981,308,176
11,CARAŞ-SEVERIN,"ORAŞ BOCŞA",50969,BOCŞA,"ȘCOALA GIMNAZIALĂ NR. 1 BOCŞA",109,"Alegeri Prezidentiale",1,1199,497,464,32,1,481,16,1319,822,303,178
11,CARAŞ-SEVERIN,"ORAŞ BOCŞA",50969,BOCŞA,"ȘCOALA GIMNAZIALĂ NR. 1 BOCŞA",110,"Alegeri Prezidentiale",1,1283,508,476,32,0,498,10,1410,902,320,178
11,CARAŞ-SEVERIN,"ORAŞ BOCŞA",50969,BOCŞA,"LICEUL TEORETIC TATA OANCEA",111,"Alegeri Prezidentiale",1,1229,481,418,53,10,472,9,1352,871,298,174
11,CARAŞ-SEVERIN,"ORAŞ BOCŞA",50969,BOCŞA,"LICEUL TEORETIC TATA OANCEA",112,"Alegeri Prezidentiale",1,1069,448,416,30,2,441,7,1176,728,264,177
11,CARAŞ-SEVERIN,"ORAŞ BOCŞA",50969,BOCŞA,"LICEUL TEORETIC TATA OANCEA",113,"Alegeri Prezidentiale",1,839,294,272,21,1,290,4,923,629,177,113
11,CARAŞ-SEVERIN,"ORAŞ BOCŞA",50969,BOCŞA,"GRĂDINIȚA CU PROGRAM NORMAL NR. 4 BOCŞA",114,"Alegeri Prezidentiale",1,1423,579,550,27,2,573,6,1565,986,367,206
11,CARAŞ-SEVERIN,"ORAŞ BOCŞA",50969,BOCŞA,"ȘCOALA GIMNAZIALĂ NR. 2 BOCŞA",115,"Alegeri Prezidentiale",1,1271,566,553,12,1,556,10,1398,832,247,309
11,CARAŞ-SEVERIN,"ORAŞ BOCŞA",50969,BOCŞA,"LICEUL TEHNOLOGIC ”CONSTANTIN LUCACI” BOCSA",116,"Alegeri Prezidentiale",1,1561,597,560,37,0,587,10,1717,1120,370,217
11,CARAŞ-SEVERIN,"ORAŞ BOCŞA",50969,BOCŞA,"GRĂDINIȚA CU PROGRAM NORMAL NR. 6 BOCŞA",117,"Alegeri Prezidentiale",1,1218,420,401,19,0,414,6,1340,920,257,157
11,CARAŞ-SEVERIN,"ORAŞ BOCŞA",50969,BOCŞA,"SERVICIU PUBLIC DE GOSPODĂRIE COMUNALĂ",118,"Alegeri Prezidentiale",1,1251,426,401,25,0,423,3,1375,949,251,172
11,CARAŞ-SEVERIN,"ORAŞ BOCŞA",50969,BOCŞA,"ȘCOALA GIMNAZIALĂ NR.1",119,"Alegeri Prezidentiale",1,1338,459,419,24,16,452,7,1472,1013,262,190
11,CARAŞ-SEVERIN,"ORAŞ MOLDOVA NOUĂ",51056,"MOLDOVA NOUĂ","ŞCOALA GIMNAZIALĂ ”ALEXANDRU MOISI”",120,"Alegeri Prezidentiale",1,1268,536,492,43,1,528,8,1395,859,199,329
11,CARAŞ-SEVERIN,"ORAŞ MOLDOVA NOUĂ",51056,"MOLDOVA NOUĂ","CASA DE CULTURĂ",121,"Alegeri Prezidentiale",1,901,362,346,16,0,355,7,991,629,122,233
11,CARAŞ-SEVERIN,"ORAŞ MOLDOVA NOUĂ",51056,"MOLDOVA NOUĂ","GRĂDINIŢA CU PROGRAM NORMAL ”BAMBI”",122,"Alegeri Prezidentiale",1,522,217,197,20,0,216,1,574,357,89,127
11,CARAŞ-SEVERIN,"ORAŞ MOLDOVA NOUĂ",51056,"MOLDOVA NOUĂ","ŞCOALA GIMNAZIALĂ ”SOFIA ARCAN”",123,"Alegeri Prezidentiale",1,1197,396,359,37,0,386,10,1317,921,151,235
11,CARAŞ-SEVERIN,"ORAŞ MOLDOVA NOUĂ",51056,"MOLDOVA NOUĂ","GRĂDINIŢA CU PROGRAM PRELUNGIT ”SF STELIAN”",124,"Alegeri Prezidentiale",1,1077,363,335,28,0,359,4,1185,822,120,239
11,CARAŞ-SEVERIN,"ORAŞ MOLDOVA NOUĂ",51056,"MOLDOVA NOUĂ","LICEUL TEHNOLOGIC ”CLISURA DUNĂRII ” CORP C4- ȘCOALA CU 10 CLASE",125,"Alegeri Prezidentiale",1,1338,353,339,14,0,342,11,1472,1119,116,226
11,CARAŞ-SEVERIN,"ORAŞ MOLDOVA NOUĂ",51056,"MOLDOVA NOUĂ","LICEUL TEHNOLOGIC ”CLISURA DUNĂRII” (CICLUL GIMNAZIAL)",126,"Alegeri Prezidentiale",1,1004,329,296,33,0,320,9,1104,775,143,177
11,CARAŞ-SEVERIN,"ORAŞ MOLDOVA NOUĂ",51056,"MOLDOVA NOUĂ","GRĂDINIŢA CU PROGRAM PRELUNGIT ”LICURICII”",127,"Alegeri Prezidentiale",1,974,331,257,42,32,329,2,1071,740,176,153
11,CARAŞ-SEVERIN,"ORAŞ MOLDOVA NOUĂ",51056,"MOLDOVA NOUĂ","LICEUL TEHNOLOGIC ”CLISURA DUNĂRII” (CICLUL LICEAL)",128,"Alegeri Prezidentiale",1,824,310,252,58,0,301,9,906,596,127,174
11,CARAŞ-SEVERIN,"ORAŞ MOLDOVA NOUĂ",51056,MĂCEŞTI,"ŞCOALA PRIMARĂ ”SVETI PETAR I PAVLE/SFÂNTUL PETRU ŞI PAVEL”",129,"Alegeri Prezidentiale",1,455,222,218,4,0,218,4,501,279,61,157
11,CARAŞ-SEVERIN,"ORAŞ MOLDOVA NOUĂ",51056,"MOLDOVA VECHE","CĂMIN CULTURAL",130,"Alegeri Prezidentiale",1,1283,549,509,40,0,534,15,1411,862,225,309
11,CARAŞ-SEVERIN,"ORAŞ MOLDOVA NOUĂ",51056,MOLDOVIŢA,"CĂMIN CULTURAL",131,"Alegeri Prezidentiale",1,173,92,82,10,0,91,1,190,98,12,79
11,CARAŞ-SEVERIN,"ORAŞ ORAVIŢA",51118,ORAVIŢA,"ŞCOALA GIMNAZIALĂ NR. 3 ORAVIŢA",132,"Alegeri Prezidentiale",1,1000,406,370,36,0,396,10,1049,643,221,175
11,CARAŞ-SEVERIN,"ORAŞ ORAVIŢA",51118,ORAVIŢA,"LICEUL TEORETIC ”GENERAL DRAGALINA”",133,"Alegeri Prezidentiale",1,822,335,300,35,0,327,8,904,569,192,135
11,CARAŞ-SEVERIN,"ORAŞ ORAVIŢA",51118,ORAVIŢA,"GRĂDINIŢA PN NR. 2",134,"Alegeri Prezidentiale",1,874,394,360,33,1,386,8,961,567,200,186
11,CARAŞ-SEVERIN,"ORAŞ ORAVIŢA",51118,ORAVIŢA,"LICEUL TEHNOLOGIC ” MIHAI NOVAC” ORAVIŢA",135,"Alegeri Prezidentiale",1,1158,485,425,48,12,472,13,1273,788,250,222
11,CARAŞ-SEVERIN,"ORAŞ ORAVIŢA",51118,ORAVIŢA,"ŞCOALA GIMNAZIALĂ ” ROMUL LADEA ”ORAVIŢA",136,"Alegeri Prezidentiale",1,1244,455,405,37,13,443,12,1367,912,243,200
11,CARAŞ-SEVERIN,"ORAŞ ORAVIŢA",51118,ORAVIŢA,"ŞCOALA GIMNAZIALĂ ”ROMUL LADEA” ORAVIŢA",137,"Alegeri Prezidentiale",1,1502,497,454,43,0,487,10,1652,1155,242,245
11,CARAŞ-SEVERIN,"ORAŞ ORAVIŢA",51118,ORAVIŢA,"ŞCOALA GIMNAZIALĂ ” ROMUL LADEA” ORAVIŢA",138,"Alegeri Prezidentiale",1,1063,366,309,57,0,359,7,1168,802,205,154
11,CARAŞ-SEVERIN,"ORAŞ ORAVIŢA",51118,ORAVIŢA,"CREŞA CĂMIN",139,"Alegeri Prezidentiale",1,1066,432,368,64,0,422,10,1172,740,212,210
11,CARAŞ-SEVERIN,"ORAŞ ORAVIŢA",51118,AGADICI,"ŞCOALA PRIMARĂ AGADICI",140,"Alegeri Prezidentiale",1,155,91,69,22,0,90,1,170,79,48,42
11,CARAŞ-SEVERIN,"ORAŞ ORAVIŢA",51118,"BRĂDIŞORU DE JOS","ŞCOALA PRIMARĂ BRĂDIŞORU DE JOS",141,"Alegeri Prezidentiale",1,446,156,141,14,1,149,7,490,334,80,69
11,CARAŞ-SEVERIN,"ORAŞ ORAVIŢA",51118,BROŞTENI,"GRĂDINȚA CU PROGRAM NORMAL",142,"Alegeri Prezidentiale",2,511,212,198,14,0,210,2,561,349,115,95
11,CARAŞ-SEVERIN,"ORAŞ ORAVIŢA",51118,"CICLOVA MONTANĂ","CĂMIN CULTURAL",143,"Alegeri Prezidentiale",1,428,204,168,36,0,199,5,470,266,101,98
11,CARAŞ-SEVERIN,"ORAŞ ORAVIŢA",51118,RĂCHITOVA,"CĂMINUL CULTURAL RĂCHITOVA",144,"Alegeri Prezidentiale",1,305,135,110,25,0,135,0,336,201,78,57
11,CARAŞ-SEVERIN,"ORAŞ ORAVIŢA",51118,MARILA,"CENTRUL ADMINISTRATIV",145,"Alegeri Prezidentiale",1,23,51,14,27,10,50,1,74,23,29,21
11,CARAŞ-SEVERIN,"ORAŞ OŢELU ROŞU",51207,"OŢELU ROŞU","CASA DE CULTURĂ",146,"Alegeri Prezidentiale",1,945,396,342,52,2,385,11,1040,644,235,150
11,CARAŞ-SEVERIN,"ORAŞ OŢELU ROŞU",51207,"OŢELU ROŞU","CASA DE CULTURĂ",147,"Alegeri Prezidentiale",1,748,324,281,41,2,316,8,823,499,141,175
11,CARAŞ-SEVERIN,"ORAŞ OŢELU ROŞU",51207,"OŢELU ROŞU","SCOALA GIMNZIALĂ NR. 3",148,"Alegeri Prezidentiale",1,1349,491,463,28,0,483,8,1484,993,291,192
11,CARAŞ-SEVERIN,"ORAŞ OŢELU ROŞU",51207,"OŢELU ROŞU","GRĂDINIŢA CU PROGRAM PRELUNGIT NR. 3",149,"Alegeri Prezidentiale",1,1114,489,452,34,3,480,9,1225,736,279,201
11,CARAŞ-SEVERIN,"ORAŞ OŢELU ROŞU",51207,"OŢELU ROŞU","CANTINA DE AJUTOR SOCIAL",150,"Alegeri Prezidentiale",1,830,398,333,48,17,385,13,913,515,236,149
11,CARAŞ-SEVERIN,"ORAŞ OŢELU ROŞU",51207,"OŢELU ROŞU","GRĂDINIȚA CU PROGRAM NORMAL NR.2",151,"Alegeri Prezidentiale",1,1122,484,457,26,1,470,14,1226,742,267,203
11,CARAŞ-SEVERIN,"ORAŞ OŢELU ROŞU",51207,"OŢELU ROŞU","GRĂDINIŢA CU PROGRAM NORMAL GAI",152,"Alegeri Prezidentiale",1,1114,485,466,19,0,475,10,1225,740,283,192
11,CARAŞ-SEVERIN,"ORAŞ OŢELU ROŞU",51207,"OŢELU ROŞU","GRĂDINIŢA CU PROGRAM NORMAL VALEA OHĂBII",153,"Alegeri Prezidentiale",1,529,205,182,19,4,203,2,582,377,117,86
11,CARAŞ-SEVERIN,"ORAŞ OŢELU ROŞU",51207,"OŢELU ROŞU","S.C. ”ROMFLEX” S.A.",154,"Alegeri Prezidentiale",1,328,132,110,22,0,125,7,361,229,73,52
11,CARAŞ-SEVERIN,"ORAŞ OŢELU ROŞU",51207,"OŢELU ROŞU","S.C. ”ROMFLEX” S.A.",155,"Alegeri Prezidentiale",1,1226,472,447,25,0,464,8,1349,877,279,185
11,CARAŞ-SEVERIN,"ORAŞ OŢELU ROŞU",51207,"OŢELU ROŞU","CĂMINUL CULTURAL CIREȘA",156,"Alegeri Prezidentiale",1,643,335,281,54,0,327,8,707,372,183,144
11,CARAŞ-SEVERIN,"ORAŞ OŢELU ROŞU",51207,MAL,"CĂMINUL CULTURAL MAL",157,"Alegeri Prezidentiale",1,301,204,181,22,1,200,4,331,127,77,123
11,CARAŞ-SEVERIN,ARMENIŞ,51243,"SUB MARGINE","CĂMINUL CULTURAL",158,"Alegeri Prezidentiale",1,144,90,79,11,0,89,1,158,68,64,25
11,CARAŞ-SEVERIN,ARMENIŞ,51243,ARMENIŞ,"ŞCOALA GIMNAZIALĂ",159,"Alegeri Prezidentiale",1,1081,698,637,56,5,691,7,1188,490,508,183
11,CARAŞ-SEVERIN,ARMENIŞ,51243,FENEŞ,"SCOALA PRIMARA FENES",160,"Alegeri Prezidentiale",1,466,270,244,26,0,267,3,513,243,169,98
11,CARAŞ-SEVERIN,ARMENIŞ,51243,"SAT BĂTRÂN","ŞCOALA PRIMARĂ",161,"Alegeri Prezidentiale",1,291,155,142,13,0,155,0,320,165,115,40
11,CARAŞ-SEVERIN,BĂNIA,51305,BĂNIA,"ȘCOALA GIMNAZIALĂ BĂNIA",162,"Alegeri Prezidentiale",1,949,461,430,26,5,453,8,1043,582,229,224
11,CARAŞ-SEVERIN,BĂNIA,51305,GÂRBOVĂŢ,"FOSTA PRIMARIE",163,"Alegeri Prezidentiale",1,459,234,197,37,0,229,5,504,270,130,99
11,CARAŞ-SEVERIN,BĂUŢAR,51332,BĂUŢAR,"ȘCOALA GIMNAZIALĂ BĂUȚAR, CORP B",164,"Alegeri Prezidentiale",1,653,365,333,27,5,354,11,718,353,202,152
11,CARAŞ-SEVERIN,BĂUŢAR,51332,BĂUŢAR,"CASA CULTURALĂ BĂUŢARUL DE SUS",165,"Alegeri Prezidentiale",1,664,386,347,27,12,379,7,730,344,244,135
11,CARAŞ-SEVERIN,BĂUŢAR,51332,BUCOVA,"ȘCOALA GIMNAZIALĂ BUCOVA",166,"Alegeri Prezidentiale",1,737,432,383,46,3,428,4,811,379,268,160
11,CARAŞ-SEVERIN,BERLIŞTE,51387,BERLIŞTE,"ŞCOALA GIMNAZIALĂ BERLIŞTE",167,"Alegeri Prezidentiale",1,301,165,136,28,1,162,3,331,166,97,65
11,CARAŞ-SEVERIN,BERLIŞTE,51387,IAM,"ŞCOALA PRIMARĂ IAM",168,"Alegeri Prezidentiale",1,291,155,128,27,0,149,6,320,165,103,46
11,CARAŞ-SEVERIN,BERLIŞTE,51387,MILCOVENI,"ŞCOALA PRIMARĂ MILCOVENI",169,"Alegeri Prezidentiale",1,186,124,94,29,1,124,0,205,81,75,49
11,CARAŞ-SEVERIN,BERLIŞTE,51387,"RUSOVA NOUĂ","ŞCOALA PRIMARĂ RUSOVA-NOUĂ",170,"Alegeri Prezidentiale",1,158,105,71,34,0,105,0,174,69,70,35
11,CARAŞ-SEVERIN,BERZASCA,51449,BERZASCA,"CASA CULTURALĂ-BERZASCA",171,"Alegeri Prezidentiale",1,1152,530,457,58,15,527,3,1267,737,161,366
11,CARAŞ-SEVERIN,BERZASCA,51449,BIGĂR,"ŞCOALA GIMNAZIALĂ-BIGAR",172,"Alegeri Prezidentiale",1,179,45,39,6,0,45,0,197,152,8,37
11,CARAŞ-SEVERIN,BERZASCA,51449,LIUBCOVA,"GRADINITA LIUBCOVA",173,"Alegeri Prezidentiale",1,883,392,350,38,4,391,1,971,579,97,294
11,CARAŞ-SEVERIN,BERZOVIA,51500,BERZOVIA,"LICEUL TEHNOLOGIC BERZOVIA",174,"Alegeri Prezidentiale",1,875,429,366,63,0,417,12,963,534,253,164
11,CARAŞ-SEVERIN,BERZOVIA,51500,BERZOVIA,"LICEUL TEHNOLOGIC BERZOVIA",175,"Alegeri Prezidentiale",1,880,365,332,33,0,352,13,968,603,234,118
11,CARAŞ-SEVERIN,BERZOVIA,51500,FIZEŞ,"ŞCOALA GIMNAZIALA FIZES",176,"Alegeri Prezidentiale",1,612,279,236,43,0,274,5,673,394,181,93
11,CARAŞ-SEVERIN,BERZOVIA,51500,GHERTENIŞ,"ŞCOALA PRIMARA GHERTENIS",177,"Alegeri Prezidentiale",1,799,392,351,40,1,392,0,879,487,210,182
11,CARAŞ-SEVERIN,BOLVAŞNIŢA,51546,BOLVAŞNIŢA,"CLUBUL TINERETULUI",178,"Alegeri Prezidentiale",1,384,187,170,17,0,184,3,422,235,120,64
11,CARAŞ-SEVERIN,BOLVAŞNIŢA,51546,VÂRCIOROVA,"CLUBUL TINERETULUI",179,"Alegeri Prezidentiale",1,755,414,377,37,0,413,1,831,417,246,167
11,CARAŞ-SEVERIN,BOZOVICI,51573,BOZOVICI,"SCOALA CLASELE I-IV",180,"Alegeri Prezidentiale",1,1128,592,504,75,13,581,11,1240,648,210,371
11,CARAŞ-SEVERIN,BOZOVICI,51573,BOZOVICI,"LICEUL TEORETIC BOZOVICI",181,"Alegeri Prezidentiale",1,668,354,301,47,6,351,3,734,380,115,236
11,CARAŞ-SEVERIN,BOZOVICI,51573,PRILIPEŢ,"ŞCOALA CU CLASELE I - VIII",182,"Alegeri Prezidentiale",1,581,321,277,35,9,311,10,638,317,147,164
11,CARAŞ-SEVERIN,BREBU,51626,APADIA,"CĂMINUL CULTURAL",183,"Alegeri Prezidentiale",1,196,139,91,46,2,138,1,216,77,91,47
11,CARAŞ-SEVERIN,BREBU,51626,BREBU,"ŞCOALA GENERALĂ CU CLASELE I - VIII ”SF. IACOB”",184,"Alegeri Prezidentiale",1,559,356,243,101,12,349,7,614,258,194,155
11,CARAŞ-SEVERIN,BREBU,51626,VALEADENI,"ŞCOALA CU CLASELE I - IV",185,"Alegeri Prezidentiale",1,191,168,99,66,3,165,3,210,42,84,81
11,CARAŞ-SEVERIN,"BREBU NOU",51662,GĂRÂNA,"CĂMINUL CULTURAL",186,"Alegeri Prezidentiale",1,263,159,43,116,0,153,6,288,129,123,30
11,CARAŞ-SEVERIN,BUCHIN,51699,POIANA,"CLĂDIREA APARȚINĂTOARE COMUNEI BUCHIN (FOST SEDIU AL PRIMĂRIEI)",187,"Alegeri Prezidentiale",1,509,325,272,28,25,320,5,560,235,124,196
11,CARAŞ-SEVERIN,BUCHIN,51699,BUCHIN,"ŞCOALA CU CLASELE I - IV",188,"Alegeri Prezidentiale",1,756,359,290,66,3,351,8,831,472,182,169
11,CARAŞ-SEVERIN,BUCHIN,51699,"VALEA TIMIŞULUI",GRĂDINIŢA,189,"Alegeri Prezidentiale",1,434,218,197,19,2,215,3,476,258,123,92
11,CARAŞ-SEVERIN,BUCOŞNIŢA,51751,BUCOŞNIŢA,"SCOALA PRIMARA BUCOSNITA",190,"Alegeri Prezidentiale",1,619,219,201,18,0,219,0,689,470,105,114
11,CARAŞ-SEVERIN,BUCOŞNIŢA,51751,PETROŞNIŢA,"SCOALA GIZMNAZIALA PETROSNITA",191,"Alegeri Prezidentiale",1,809,321,289,32,0,318,3,890,569,169,149
11,CARAŞ-SEVERIN,BUCOŞNIŢA,51751,GOLEŢ,"SCOALA PRIMARA GOLET",192,"Alegeri Prezidentiale",1,436,202,188,14,0,201,1,480,278,129,72
11,CARAŞ-SEVERIN,BUCOŞNIŢA,51751,VĂLIŞOARA,"SCOALA PRIMARA VALISOARA",193,"Alegeri Prezidentiale",1,528,232,214,18,0,230,2,580,348,162,68
11,CARAŞ-SEVERIN,CARAŞOVA,51804,CARAŞOVA,"CĂMINUL CULTURAL",194,"Alegeri Prezidentiale",1,859,333,306,27,0,323,10,944,611,213,110
11,CARAŞ-SEVERIN,CARAŞOVA,51804,IABALCEA,"ŞCOALA PRIMARĂ IABALCEA",195,"Alegeri Prezidentiale",1,163,105,81,24,0,104,1,178,73,74,30
11,CARAŞ-SEVERIN,CARAŞOVA,51804,NERMED,"ŞCOALA PRIMARĂ NERMED",196,"Alegeri Prezidentiale",1,441,204,186,18,0,203,1,484,280,153,50
11,CARAŞ-SEVERIN,CARAŞOVA,51804,CARAŞOVA,"GRĂDINIȚA CU PROGRAM NORMAL CARAȘOVA",197,"Alegeri Prezidentiale",1,1049,333,312,21,0,325,8,1153,820,206,119
11,CARAŞ-SEVERIN,CĂRBUNARI,51840,CĂRBUNARI,"ŞCOALA GIMNAZIALĂ",198,"Alegeri Prezidentiale",1,511,341,256,61,24,336,5,562,221,70,266
11,CARAŞ-SEVERIN,CĂRBUNARI,51840,ŞTINĂPARI,"ŞCOALA PRIMARĂ",199,"Alegeri Prezidentiale",1,281,191,148,33,10,191,0,309,118,41,150
11,CARAŞ-SEVERIN,"CICLOVA ROMÂNĂ",51948,"CICLOVA ROMÂNĂ","SCOALA GIMNAZIALA CICLOVA ROMANA",200,"Alegeri Prezidentiale",1,938,436,374,61,1,426,10,1031,595,202,224
11,CARAŞ-SEVERIN,"CICLOVA ROMÂNĂ",51948,ILIDIA,"ŞCOALA PRIMARA ILIDIA",201,"Alegeri Prezidentiale",1,285,164,109,55,0,161,3,314,150,91,70
11,CARAŞ-SEVERIN,"CICLOVA ROMÂNĂ",51948,SOCOLARI,"CADIREA PRIMARIEI(FOSTUL SEDIU AL PRIMARIEI DIN SOCOLARI)",202,"Alegeri Prezidentiale",1,114,117,51,66,0,115,2,125,8,69,46
11,CARAŞ-SEVERIN,CIUCHICI,51984,CIUCHICI,"CASA DE CULTURĂ",203,"Alegeri Prezidentiale",1,414,234,195,39,0,228,6,434,200,105,123
11,CARAŞ-SEVERIN,CIUCHICI,51984,MACOVIŞTE,"CASA DE CULTURĂ",204,"Alegeri Prezidentiale",1,74,94,47,47,0,89,5,101,7,45,44
11,CARAŞ-SEVERIN,CIUCHICI,51984,PETRILOVA,"CASA DE CULTURĂ",205,"Alegeri Prezidentiale",1,115,91,55,36,0,91,0,127,36,40,51
11,CARAŞ-SEVERIN,CIUCHICI,51984,NICOLINŢ,"SEDIUL FOSTEI PRIMĂRII NICOLINŢ",206,"Alegeri Prezidentiale",1,257,153,108,45,0,152,1,282,129,59,93
11,CARAŞ-SEVERIN,CIUDANOVIŢA,52035,JITIN,"CĂMINUL CULTURAL",207,"Alegeri Prezidentiale",1,101,116,68,48,0,115,1,140,24,53,62
11,CARAŞ-SEVERIN,CIUDANOVIŢA,52035,CIUDANOVIŢA,"ŞCOALA GIMNAZIALĂ",208,"Alegeri Prezidentiale",2,404,216,184,31,1,212,4,414,198,54,158
11,CARAŞ-SEVERIN,"CONSTANTIN DAICOVICIU",51877,MACIOVA,"ŞCOALA CU CLASELE I - VIII",209,"Alegeri Prezidentiale",1,384,198,173,25,0,196,2,421,223,80,116
11,CARAŞ-SEVERIN,"CONSTANTIN DAICOVICIU",51877,ZĂGUJENI,"ŞCOALA CU CLASELE I - VIII",210,"Alegeri Prezidentiale",1,445,236,194,40,2,233,3,489,253,160,73
11,CARAŞ-SEVERIN,"CONSTANTIN DAICOVICIU",51877,"MÂTNICU MARE","ŞCOALA CU CLASELE I - IV",211,"Alegeri Prezidentiale",1,300,174,141,32,1,169,5,329,155,109,60
11,CARAŞ-SEVERIN,"CONSTANTIN DAICOVICIU",51877,PEŞTERE,"ŞCOALA CU CLASELE I - IV",212,"Alegeri Prezidentiale",1,181,111,98,13,0,109,2,199,88,78,31
11,CARAŞ-SEVERIN,"CONSTANTIN DAICOVICIU",51877,PRISACA,"ŞCOALA CU CLASELE I - IV",213,"Alegeri Prezidentiale",1,348,195,160,30,5,188,7,382,187,93,95
11,CARAŞ-SEVERIN,"CONSTANTIN DAICOVICIU",51877,CĂVĂRAN,"GRĂDINIŢA DIN CADRUL ŞCOLII CU CLASELE I - VIII",214,"Alegeri Prezidentiale",1,573,291,247,43,1,284,7,629,338,183,101
11,CARAŞ-SEVERIN,COPĂCELE,52062,COPĂCELE,"ŞCOALA CU CLASELE I - VIII",215,"Alegeri Prezidentiale",1,300,158,123,29,6,155,3,330,172,70,85
11,CARAŞ-SEVERIN,COPĂCELE,52062,OHABA-MÂTNIC,"CĂMINUL CULTURAL OHABA-MÂTNIC",216,"Alegeri Prezidentiale",1,228,184,122,58,4,181,3,250,66,80,101
11,CARAŞ-SEVERIN,COPĂCELE,52062,RUGINOSU,"ŞCOALA CU CLASELE I - IV",217,"Alegeri Prezidentiale",1,96,64,44,20,0,62,2,105,41,42,20
11,CARAŞ-SEVERIN,COPĂCELE,52062,ZORILE,"ŞCOALA CU CLASELE I - IV",218,"Alegeri Prezidentiale",1,308,186,138,45,3,184,2,339,153,94,90
11,CARAŞ-SEVERIN,CORNEA,52115,CORNEA,"SCOALA GIMNAZIALA TRAIAN LALESCU CORNEA,CU CLASELE I- VIII",219,"Alegeri Prezidentiale",1,607,310,278,32,0,308,2,668,358,181,127
11,CARAŞ-SEVERIN,CORNEA,52115,CRUŞOVĂŢ,"GRADINITA CU PROGRAM NORMAL PRICHINDELUL CRUSOVAT",220,"Alegeri Prezidentiale",1,366,202,172,30,0,202,0,402,200,115,87
11,CARAŞ-SEVERIN,CORNEA,52115,CUPTOARE,"SCOALA GIMNAZIALA CU CLASELE I-VIII CUPTOARE-STRUCTURA",221,"Alegeri Prezidentiale",1,498,293,261,32,0,292,1,548,255,158,134
11,CARAŞ-SEVERIN,CORNEREVA,52160,CORNEREVA,"CENTRUL LOCAL DE INFORMARE TURISTICĂ",222,"Alegeri Prezidentiale",1,450,238,198,26,14,237,1,495,257,96,141
11,CARAŞ-SEVERIN,CORNEREVA,52160,BOGÂLTIN,"ŞCOALA PRIMARĂ BOGÎLTIN",223,"Alegeri Prezidentiale",1,324,164,127,33,4,157,7,355,191,60,97
11,CARAŞ-SEVERIN,CORNEREVA,52160,DOBRAIA,"ŞCOALA PRIMARĂ DOBRAIA",224,"Alegeri Prezidentiale",1,69,45,35,10,0,45,0,76,31,16,29
11,CARAŞ-SEVERIN,CORNEREVA,52160,DOLINA,"ŞCOALA PRIMARĂ DOLINA",225,"Alegeri Prezidentiale",1,651,369,354,10,5,364,5,715,346,123,241
11,CARAŞ-SEVERIN,CORNEREVA,52160,GRUNI,"ŞCOALA GIMNAZIALĂ NR. 2 GRUNI",226,"Alegeri Prezidentiale",1,782,403,373,19,11,398,5,860,457,167,231
11,CARAŞ-SEVERIN,CORNEREVA,52160,INELEŢ,"ŞCOALA PRIMARĂ INELEȚ",227,"Alegeri Prezidentiale",1,88,42,30,12,0,42,0,97,55,14,28
11,CARAŞ-SEVERIN,CORONINI,53489,"SFÂNTA ELENA","CĂMINUL CULTURAL",228,"Alegeri Prezidentiale",1,460,210,183,27,0,207,3,506,296,104,103
11,CARAŞ-SEVERIN,CORONINI,53489,CORONINI,"GRĂDINIȚA CU PROGRAM NORMAL CORONINI",229,"Alegeri Prezidentiale",1,1152,759,675,69,15,749,10,1267,508,258,491
11,CARAŞ-SEVERIN,DALBOŞEŢ,52570,DALBOŞEŢ,"CĂMINUL CULTURAL-DALBOSET",230,"Alegeri Prezidentiale",1,829,441,387,40,14,430,11,911,470,224,206
11,CARAŞ-SEVERIN,DALBOŞEŢ,52570,"ŞOPOTU VECHI","ȘCOALA PRIMARĂ ȘOPOTU VECHI",231,"Alegeri Prezidentiale",1,519,277,249,28,0,272,5,570,293,123,149
11,CARAŞ-SEVERIN,DOCLIN,52650,DOCLIN,"ŞCOALA PRIMARĂ DOCLIN",232,"Alegeri Prezidentiale",1,431,305,245,50,10,303,2,473,168,109,194
11,CARAŞ-SEVERIN,DOCLIN,52650,BINIŞ,"ŞCOALA PRIMARĂ BINIŞ",233,"Alegeri Prezidentiale",1,648,363,301,43,19,356,7,712,349,189,167
11,CARAŞ-SEVERIN,DOCLIN,52650,TIROL,"ŞCOALA GIMNAZIALĂ TIROL",234,"Alegeri Prezidentiale",3,537,252,206,38,8,252,0,590,338,137,115
11,CARAŞ-SEVERIN,DOGNECEA,52696,CALINA,"CĂMINUL CULTURAL",235,"Alegeri Prezidentiale",1,78,63,42,21,0,62,1,86,23,35,27
11,CARAŞ-SEVERIN,DOGNECEA,52696,DOGNECEA,"SCOALA GIMNAZIALA DOGNECEA",236,"Alegeri Prezidentiale",1,954,474,413,56,5,472,2,1049,575,287,185
11,CARAŞ-SEVERIN,DOGNECEA,52696,DOGNECEA,"SCOALA GIMNAZIALA",237,"Alegeri Prezidentiale",1,587,343,292,31,20,339,4,646,303,279,60
11,CARAŞ-SEVERIN,DOMAŞNEA,52721,DOMAŞNEA,"CĂMINUL CULTURAL",238,"Alegeri Prezidentiale",1,785,365,294,71,0,355,10,863,498,175,180
11,CARAŞ-SEVERIN,DOMAŞNEA,52721,CĂNICEA,"CĂMINUL CULTURAL",239,"Alegeri Prezidentiale",1,305,139,124,15,0,139,0,335,196,119,20
11,CARAŞ-SEVERIN,"EFTIMIE MURGU",53700,"EFTIMIE MURGU","CĂMINUL CULTURAL",240,"Alegeri Prezidentiale",1,1305,573,518,55,0,566,7,1435,862,346,220
11,CARAŞ-SEVERIN,EZERIŞ,52758,EZERIŞ,"ȘCOALA GIMNAZIALĂ ”AUREL PEIA”",241,"Alegeri Prezidentiale",1,536,341,233,86,22,339,2,589,248,227,112
11,CARAŞ-SEVERIN,EZERIŞ,52758,SOCENI,"ȘCOALA PRIMARĂ SOCENI",242,"Alegeri Prezidentiale",1,550,376,299,65,12,367,9,604,228,283,84
11,CARAŞ-SEVERIN,FÂRLIUG,52785,FÂRLIUG,"ŞCOALA GIMNAZIALĂ FÎRLIUG",243,"Alegeri Prezidentiale",2,641,490,344,116,30,481,8,705,215,316,165
11,CARAŞ-SEVERIN,FÂRLIUG,52785,DEZEŞTI,"CENTRUL AGRICOL DEZEŞTI",244,"Alegeri Prezidentiale",1,151,184,96,72,16,180,4,195,11,78,102
11,CARAŞ-SEVERIN,FÂRLIUG,52785,DULEU,"CĂMINUL CULTURAL",245,"Alegeri Prezidentiale",1,167,120,87,33,0,118,2,184,64,49,69
11,CARAŞ-SEVERIN,FÂRLIUG,52785,SCĂIUŞ,"CĂMINUL CULTURAL",246,"Alegeri Prezidentiale",1,237,180,126,46,8,177,3,261,81,94,83
11,CARAŞ-SEVERIN,FÂRLIUG,52785,"VALEA MARE","CĂMINUL CULTURAL",247,"Alegeri Prezidentiale",1,93,141,69,69,3,136,5,152,11,63,73
11,CARAŞ-SEVERIN,FÂRLIUG,52785,REMETEA-POGĂNICI,"ŞCOALA PRIMARĂ REMETEA-POGĂNICI",248,"Alegeri Prezidentiale",1,174,114,74,37,3,113,1,190,76,65,48
11,CARAŞ-SEVERIN,FOROTIC,52856,COMORÂŞTE,"ŞCOALA PRIMARĂ",249,"Alegeri Prezidentiale",1,453,235,197,38,0,232,3,498,263,115,117
11,CARAŞ-SEVERIN,FOROTIC,52856,"SURDUCU MARE","ŞCOALA PRIMARĂ",250,"Alegeri Prezidentiale",1,348,182,152,30,0,180,2,383,201,131,49
11,CARAŞ-SEVERIN,FOROTIC,52856,FOROTIC,"AZILUL DE BĂTRÂNI-CENTRU DE ZI",251,"Alegeri Prezidentiale",1,562,242,208,34,0,236,6,618,376,172,64
11,CARAŞ-SEVERIN,GÂRNIC,52909,GÂRNIC,"CASA CULTURALĂ ”PETR GLASER”",252,"Alegeri Prezidentiale",1,392,140,128,12,0,138,2,431,291,92,46
11,CARAŞ-SEVERIN,GÂRNIC,52909,"PADINA MATEI","CASA CULTURALA PADINA-MATEI",253,"Alegeri Prezidentiale",1,736,427,393,23,11,424,3,810,383,108,316
11,CARAŞ-SEVERIN,GLIMBOCA,52936,GLIMBOCA,"CĂMINUL CULTURAL",254,"Alegeri Prezidentiale",1,1542,825,732,66,27,812,13,1696,871,537,275
11,CARAŞ-SEVERIN,GORUIA,52954,GORUIA,"CĂMINUL CULTURAL",255,"Alegeri Prezidentiale",1,314,212,168,37,7,205,7,344,132,114,91
11,CARAŞ-SEVERIN,GORUIA,52954,GIURGIOVA,"ŞCOALA CU CLASELE I - IV",256,"Alegeri Prezidentiale",1,123,75,48,26,1,71,4,135,60,32,39
11,CARAŞ-SEVERIN,GORUIA,52954,GÂRLIŞTE,"BIBLIOTECA VALERIU LEU",257,"Alegeri Prezidentiale",1,214,173,100,72,1,170,3,234,61,99,71
11,CARAŞ-SEVERIN,GRĂDINARI,52990,GRĂDINARI,"ŞCOALA GIMNAZIALA PAVEL BORDAN",258,"Alegeri Prezidentiale",1,871,427,348,74,5,422,5,957,530,209,213
11,CARAŞ-SEVERIN,GRĂDINARI,52990,GREONI,"CLADIRE PRIMARIE GREONI",259,"Alegeri Prezidentiale",1,783,343,314,29,0,339,4,861,518,226,113
11,CARAŞ-SEVERIN,IABLANIŢA,53023,IABLANIŢA,"CĂMINUL CULTURAL",260,"Alegeri Prezidentiale",1,606,368,295,73,0,364,4,666,298,163,201
11,CARAŞ-SEVERIN,IABLANIŢA,53023,"GLOBU CRAIOVEI","ŞCOALA PRIMARĂ",261,"Alegeri Prezidentiale",1,531,295,258,37,0,293,2,583,288,149,144
11,CARAŞ-SEVERIN,IABLANIŢA,53023,PETNIC,"CĂMINUL CULTURAL PETNIC",262,"Alegeri Prezidentiale",1,607,312,274,36,2,311,1,667,355,164,147
11,CARAŞ-SEVERIN,LĂPUŞNICEL,53069,LĂPUŞNICEL,"CLĂDIREA AFTER SCHOOL",263,"Alegeri Prezidentiale",1,382,212,177,27,8,211,1,419,207,104,107
11,CARAŞ-SEVERIN,LĂPUŞNICEL,53069,PÂRVOVA,"ŞCOALA GIMNAZIALA",264,"Alegeri Prezidentiale",1,351,262,212,50,0,261,1,385,123,171,90
11,CARAŞ-SEVERIN,LĂPUŞNICEL,53069,ŞUMIŢA,"ŞCOALA GIMNAZIALA",265,"Alegeri Prezidentiale",1,65,57,43,14,0,57,0,71,14,41,16
11,CARAŞ-SEVERIN,"LĂPUŞNICU MARE",53103,"LĂPUŞNICU MARE","CĂMINUL CULTURAL",266,"Alegeri Prezidentiale",1,887,534,445,53,36,525,9,978,444,282,243
11,CARAŞ-SEVERIN,"LĂPUŞNICU MARE",53103,MOCERIŞ,"CĂMINUL CULTURAL",267,"Alegeri Prezidentiale",1,458,297,245,40,12,297,0,495,198,120,177
11,CARAŞ-SEVERIN,LUNCAVIŢA,53130,LUNCAVIŢA,"GRADINITA CU PROGRAM NORMAL LUNCAVITA",268,"Alegeri Prezidentiale",1,657,294,267,27,0,291,3,722,428,152,139
11,CARAŞ-SEVERIN,LUNCAVIŢA,53130,VERENDIN,"SCOALA GIMNAZIALA VERENDIN",269,"Alegeri Prezidentiale",1,1313,651,610,41,0,644,7,1444,793,347,297
11,CARAŞ-SEVERIN,LUPAC,53167,LUPAC,"ŞCOALA GIMNAZIALA LUPAC",270,"Alegeri Prezidentiale",1,744,258,232,26,0,256,2,818,560,177,79
11,CARAŞ-SEVERIN,LUPAC,53167,CLOCOTICI,"ŞCOALA GIMNAZIALA CLOCOTICI",271,"Alegeri Prezidentiale",1,703,271,235,36,0,271,0,773,502,223,48
11,CARAŞ-SEVERIN,LUPAC,53167,RAFNIC,"ŞCOALA PRIMARA RAFNIC",272,"Alegeri Prezidentiale",1,437,185,170,15,0,183,2,480,295,123,60
11,CARAŞ-SEVERIN,LUPAC,53167,VODNIC,"ŞCOALA PRIMARA VODNIC",273,"Alegeri Prezidentiale",1,347,95,89,6,0,94,1,381,286,72,22
11,CARAŞ-SEVERIN,MARGA,53210,MARGA,"CĂMINUL CULTURAL",274,"Alegeri Prezidentiale",1,894,537,458,60,19,524,13,983,446,255,269
11,CARAŞ-SEVERIN,MĂURENI,53247,MĂURENI,"CĂMINUL CULTURAL",275,"Alegeri Prezidentiale",1,1506,665,585,61,19,661,4,1657,992,525,136
11,CARAŞ-SEVERIN,MĂURENI,53247,ŞOŞDEA,"CĂMIN CULTURAL",276,"Alegeri Prezidentiale",1,696,405,346,43,16,399,6,765,360,315,84
11,CARAŞ-SEVERIN,MEHADIA,53274,GLOBURĂU,"ŞCOALA GENERALĂ",277,"Alegeri Prezidentiale",1,191,97,83,14,0,97,0,209,112,62,35
11,CARAŞ-SEVERIN,MEHADIA,53274,PLUGOVA,"ŞCOALA GENERALĂ",278,"Alegeri Prezidentiale",1,652,350,298,52,0,348,2,716,366,188,160
11,CARAŞ-SEVERIN,MEHADIA,53274,"VALEA BOLVAŞNIŢA","ŞCOALA GENERALĂ",279,"Alegeri Prezidentiale",1,547,237,197,40,0,235,2,601,364,87,148
11,CARAŞ-SEVERIN,MEHADIA,53274,MEHADIA,"LICEUL TEHNOLOGIC ”NICOLAE STOICA DE HATEG”",280,"Alegeri Prezidentiale",1,1158,514,462,50,2,511,3,1273,759,267,244
11,CARAŞ-SEVERIN,MEHADIA,53274,MEHADIA,"LICEUL TEHNOLOGIC ”NICOLAE STOICA DE HATEG”",281,"Alegeri Prezidentiale",1,832,318,263,55,0,317,1,914,596,158,159
11,CARAŞ-SEVERIN,MEHADICA,53327,MEHADICA,"ŞCOALA GENERALĂ CU CLASELE I - VIII",282,"Alegeri Prezidentiale",1,576,283,239,44,0,280,3,633,350,157,123
11,CARAŞ-SEVERIN,NAIDĂŞ,53345,LESCOVIŢA,"CĂMINUL CULTURAL",283,"Alegeri Prezidentiale",1,202,191,115,63,13,190,1,222,31,97,93
11,CARAŞ-SEVERIN,NAIDĂŞ,53345,NAIDĂŞ,"PRIMĂRIA VECHE",284,"Alegeri Prezidentiale",1,657,376,301,52,23,372,4,722,346,210,162
11,CARAŞ-SEVERIN,OBREJA,53372,OBREJA,"SCOALA GIMNAZIALA OBREJA",285,"Alegeri Prezidentiale",1,1466,665,594,71,0,646,19,1613,948,369,277
11,CARAŞ-SEVERIN,OBREJA,53372,CIUTA,"SCOALA PRIMARA CIUTA",286,"Alegeri Prezidentiale",1,297,171,147,24,0,163,8,327,156,77,86
11,CARAŞ-SEVERIN,OBREJA,53372,IAZ,"SCOALA PRIMARA IAZ",287,"Alegeri Prezidentiale",1,610,338,275,63,0,334,4,671,333,169,165
11,CARAŞ-SEVERIN,OBREJA,53372,VAR,"SCOALA PRIMARA VAR",288,"Alegeri Prezidentiale",1,326,221,169,52,0,217,4,359,138,132,85
11,CARAŞ-SEVERIN,"OCNA DE FIER",50987,"OCNA DE FIER","ŞCOALA GIMNAZIALĂ",289,"Alegeri Prezidentiale",1,594,373,267,97,9,369,4,653,280,238,131
11,CARAŞ-SEVERIN,PĂLTINIŞ,53425,PĂLTINIŞ,"CENTRUL LOCAL DE INFORMARE TURISTICĂ",290,"Alegeri Prezidentiale",1,559,301,260,41,0,301,0,615,314,215,86
11,CARAŞ-SEVERIN,PĂLTINIŞ,53425,OHABIŢA,"CĂMINUL CULTURAL",291,"Alegeri Prezidentiale",1,64,45,30,15,0,45,0,70,25,19,26
11,CARAŞ-SEVERIN,PĂLTINIŞ,53425,CORNUŢEL,"ŞCOALA GIMNAZIALĂ CORNUȚEL",292,"Alegeri Prezidentiale",1,851,338,311,27,0,336,2,896,558,234,102
11,CARAŞ-SEVERIN,PĂLTINIŞ,53425,DELINEŞTI,"ŞCOALA GIMNAZIALĂ DELINEȘTI",293,"Alegeri Prezidentiale",1,358,209,169,40,0,206,3,393,184,129,77
11,CARAŞ-SEVERIN,PĂLTINIŞ,53425,RUGI,GRĂDINIȚA,294,"Alegeri Prezidentiale",1,219,152,124,28,0,152,0,241,89,69,83
11,CARAŞ-SEVERIN,POJEJENA,53513,POJEJENA,"ŞCOALA GIMNAZIALA ”ATANASIE COJOCARU” POJEJENA",295,"Alegeri Prezidentiale",1,896,478,399,43,36,475,3,986,508,156,319
11,CARAŞ-SEVERIN,POJEJENA,53513,BELOBREŞCA,"ŞCOALA GIMNAZIALA ”BORISLAV CRISTICI” BELOBREȘCA",296,"Alegeri Prezidentiale",1,485,276,212,32,32,273,3,534,258,65,208
11,CARAŞ-SEVERIN,POJEJENA,53513,RADIMNA,"GRĂDINIŢA CU PROGRAM NORMAL RADIMNA",297,"Alegeri Prezidentiale",1,443,266,221,24,21,263,3,487,221,62,201
11,CARAŞ-SEVERIN,POJEJENA,53513,DIVICI,"GRĂDINIŢA CU PROGRAM NORMAL DIVICI",298,"Alegeri Prezidentiale",1,209,143,109,28,6,142,1,231,88,61,81
11,CARAŞ-SEVERIN,POJEJENA,53513,ŞUŞCA,"GRĂDINIŢA CU PROGRAM NORMAL ŞUȘCA",299,"Alegeri Prezidentiale",1,368,212,182,24,6,208,4,405,193,75,133
11,CARAŞ-SEVERIN,PRIGOR,53577,"BORLOVENII VECHI","CĂMINUL CULTURAL",300,"Alegeri Prezidentiale",1,374,196,170,25,1,189,7,410,214,99,90
11,CARAŞ-SEVERIN,PRIGOR,53577,"BORLOVENII NOI","ŞCOALA GENERALĂ",301,"Alegeri Prezidentiale",1,336,169,142,27,0,167,2,369,200,109,58
11,CARAŞ-SEVERIN,PRIGOR,53577,PĂTAŞ,"ŞCOALA GENERALĂ",302,"Alegeri Prezidentiale",1,435,220,185,35,0,216,4,478,258,127,89
11,CARAŞ-SEVERIN,PRIGOR,53577,PUTNA,"ŞCOALA GENERALĂ",303,"Alegeri Prezidentiale",1,139,78,67,11,0,78,0,152,74,47,31
11,CARAŞ-SEVERIN,PRIGOR,53577,PRIGOR,"CLADIRE PRIMARIE (ŞCOALA VECHE)",304,"Alegeri Prezidentiale",1,745,418,383,35,0,409,9,819,401,221,188
11,CARAŞ-SEVERIN,RAMNA,53639,RAMNA,"ŞCOALA GIMNAZIALĂ RAMNA",305,"Alegeri Prezidentiale",1,969,532,439,80,13,523,9,1066,534,279,244
11,CARAŞ-SEVERIN,RAMNA,53639,VALEAPAI,"ŞCOALA CU CLASELE I - IV - VALEAPAI",306,"Alegeri Prezidentiale",1,331,202,144,56,2,200,2,363,161,100,100
11,CARAŞ-SEVERIN,RĂCĂŞDIA,53675,RĂCĂŞDIA,"CĂMINUL CULTURAL",307,"Alegeri Prezidentiale",1,1343,521,460,61,0,507,14,1476,955,303,204
11,CARAŞ-SEVERIN,RĂCĂŞDIA,53675,VRĂNIUŢ,"CLĂDIREA FOSTEI PRIMĂRII VRĂNIUŢ",308,"Alegeri Prezidentiale",1,297,135,75,60,0,134,1,326,191,88,46
11,CARAŞ-SEVERIN,"RUSCA MONTANĂ",53728,"RUSCA MONTANĂ","ŞCOALA GIMNAZIALĂ ŞTEFAN VELOVAN",309,"Alegeri Prezidentiale",1,1307,618,539,70,9,605,13,1438,820,313,292
11,CARAŞ-SEVERIN,"RUSCA MONTANĂ",53728,RUSCHIŢA,"GRĂDINIŢA CU PROGRAM NORMAL",310,"Alegeri Prezidentiale",1,271,128,95,31,2,126,2,298,170,52,74
11,CARAŞ-SEVERIN,SACU,53755,TINCOVA,"GRĂDINIȚA CU PROGRAM NORMAL TINCOVA",311,"Alegeri Prezidentiale",1,371,162,126,36,0,158,4,408,246,97,61
11,CARAŞ-SEVERIN,SACU,53755,SACU,"GRĂDINIȚA CU PROGRAM NORMAL SACU",312,"Alegeri Prezidentiale",1,652,410,309,93,8,400,10,717,307,260,140
11,CARAŞ-SEVERIN,SACU,53755,"SĂLBĂGELU NOU","ȘCOALA PRIMARĂ SĂLBĂGELU NOU",313,"Alegeri Prezidentiale",1,202,98,81,17,0,90,8,222,124,53,37
11,CARAŞ-SEVERIN,"SASCA MONTANĂ",53791,BOGODINŢ,"CĂMINUL CULTURAL",314,"Alegeri Prezidentiale",1,78,81,45,36,0,81,0,86,5,16,65
11,CARAŞ-SEVERIN,"SASCA MONTANĂ",53791,"SASCA ROMÂNĂ","CĂMINUL CULTURAL",315,"Alegeri Prezidentiale",1,274,214,167,39,8,211,3,301,87,101,110
11,CARAŞ-SEVERIN,"SASCA MONTANĂ",53791,SLATINA-NERA,"GRĂDINIȚA CU PROGRAM NORMAL SLATINA-NERA",316,"Alegeri Prezidentiale",1,295,142,84,51,7,138,4,325,183,51,87
11,CARAŞ-SEVERIN,"SASCA MONTANĂ",53791,"SASCA MONTANĂ","SCOALA GIMNAZIALA ”MIHAI NOVAC” SASCA MONTANA",317,"Alegeri Prezidentiale",1,395,228,175,45,8,218,10,434,206,78,140
11,CARAŞ-SEVERIN,"SASCA MONTANĂ",53791,POTOC,"ŞCOALA PRIMARA POTOC",318,"Alegeri Prezidentiale",1,210,140,103,33,4,136,4,231,91,52,84
11,CARAŞ-SEVERIN,SICHEVIŢA,53853,GORNEA,"GRĂDINIŢA CU PROGRAM NORMAL GORNEA",319,"Alegeri Prezidentiale",1,452,268,220,30,18,263,5,498,230,98,165
11,CARAŞ-SEVERIN,SICHEVIŢA,53853,SICHEVIŢA,"CAMIN CULTURAL SICHEVITA",320,"Alegeri Prezidentiale",1,1253,644,577,49,18,635,9,1378,734,324,311
11,CARAŞ-SEVERIN,SICHEVIŢA,53853,LIBORAJDEA,"CENTRU DE INFORMARE TURISTICA COMUNA SICHEVITA",321,"Alegeri Prezidentiale",1,79,43,19,22,2,43,0,87,44,32,11
11,CARAŞ-SEVERIN,SLATINA-TIMIŞ,54056,SLATINA-TIMIŞ,"SCOALA PRIMARA SLATINA -TIMIS",322,"Alegeri Prezidentiale",1,1416,800,704,69,27,785,15,1557,757,636,149
11,CARAŞ-SEVERIN,SLATINA-TIMIŞ,54056,ILOVA,"SCOALA PRIMARA ILOVA",323,"Alegeri Prezidentiale",1,604,331,303,24,4,330,1,664,333,274,56
11,CARAŞ-SEVERIN,SLATINA-TIMIŞ,54056,"SADOVA NOUĂ","SCOALA PRIMARA SADOVA-NOUA",324,"Alegeri Prezidentiale",1,190,127,105,20,2,125,2,208,81,98,27
11,CARAŞ-SEVERIN,SLATINA-TIMIŞ,54056,"SADOVA VECHE","GRADINITA CU PROGRAM NORMAL SADOVA-VECHE",325,"Alegeri Prezidentiale",1,317,150,106,42,2,147,3,349,199,106,41
11,CARAŞ-SEVERIN,SOCOL,54109,SOCOL,"ŞCOALA GIMNAZIALĂ ”SF. SAVA” - SOCOL",326,"Alegeri Prezidentiale",1,586,291,240,30,21,288,3,645,354,89,199
11,CARAŞ-SEVERIN,SOCOL,54109,BAZIAŞ,"CĂMINUL CULTURAL - BAZIAȘ",327,"Alegeri Prezidentiale",1,45,43,24,18,1,42,1,50,7,11,31
11,CARAŞ-SEVERIN,SOCOL,54109,CÂMPIA,"ŞCOALA PRIMARĂ CÎMPIA",328,"Alegeri Prezidentiale",1,458,202,159,32,11,197,5,504,302,97,100
11,CARAŞ-SEVERIN,SOCOL,54109,ZLATIŢA,"ŞCOALA GIMNAZIALĂ- ZLATITA",329,"Alegeri Prezidentiale",1,621,364,303,32,29,359,5,683,319,77,282
11,CARAŞ-SEVERIN,"ŞOPOTU NOU",54163,"ŞOPOTU NOU","CENTRUL LOCAL DE INFORMARE TURISTICĂ",330,"Alegeri Prezidentiale",1,266,156,132,19,5,155,1,292,136,56,99
11,CARAŞ-SEVERIN,"ŞOPOTU NOU",54163,RAVENSCA,"CĂMINUL CULTURAL-RAVENSCA",331,"Alegeri Prezidentiale",1,109,43,34,9,0,43,0,119,76,19,24
11,CARAŞ-SEVERIN,"ŞOPOTU NOU",54163,RĂCHITA,"ŞCOALA PRIMARA - RACHITA",332,"Alegeri Prezidentiale",1,93,59,49,9,1,58,1,101,42,19,39
11,CARAŞ-SEVERIN,"ŞOPOTU NOU",54163,STĂNCILOVA,"CAMININUL CULTURAL-STANCILOVA DE JOS",333,"Alegeri Prezidentiale",1,84,44,33,8,3,43,1,91,47,14,29
11,CARAŞ-SEVERIN,"ŞOPOTU NOU",54163,STĂNCILOVA,"CAMINNUL CULTURAL STANCILOVA DE SUS",334,"Alegeri Prezidentiale",1,125,65,56,9,0,64,1,137,72,27,37
11,CARAŞ-SEVERIN,"ŞOPOTU NOU",54163,"VALEA ROŞIE","CĂMINUL CULTURAL-VALEA ROSIE",335,"Alegeri Prezidentiale",1,207,133,118,15,0,133,0,227,94,36,97
11,CARAŞ-SEVERIN,TÂRNOVA,54350,TÂRNOVA,"ŞCOALA GIMNAZIALĂ TÎRNOVA",336,"Alegeri Prezidentiale",1,1383,690,602,88,0,683,7,1512,822,404,279
11,CARAŞ-SEVERIN,TEREGOVA,54270,TEREGOVA,"CĂMINUL CULTURAL",337,"Alegeri Prezidentiale",1,1198,717,633,57,27,706,11,1318,601,280,426
11,CARAŞ-SEVERIN,TEREGOVA,54270,TEREGOVA,"LICEUL TEHNOLOGIC ”SF. DIMITRIE”",338,"Alegeri Prezidentiale",1,1106,690,612,57,21,684,6,1216,526,237,447
11,CARAŞ-SEVERIN,TEREGOVA,54270,RUSCA,"OFICIUL PRIMĂRIEI",339,"Alegeri Prezidentiale",2,967,587,529,39,19,577,10,1064,477,243,334
11,CARAŞ-SEVERIN,"TICVANIU MARE",54305,CÂRNECEA,"ŞCOALA CU CLASELE I - IV",340,"Alegeri Prezidentiale",1,257,131,96,35,0,130,1,282,151,70,60
11,CARAŞ-SEVERIN,"TICVANIU MARE",54305,SECĂŞENI,"ŞCOALA CU CLASELE I - IV",341,"Alegeri Prezidentiale",1,284,192,128,64,0,184,8,312,119,61,123
11,CARAŞ-SEVERIN,"TICVANIU MARE",54305,"TICVANIU MIC","ŞCOALA CU CLASELE I - IV",342,"Alegeri Prezidentiale",1,263,135,111,24,0,130,5,289,154,81,49
11,CARAŞ-SEVERIN,"TICVANIU MARE",54305,"TICVANIU MARE","CASA DE CULTURĂ ”VIRGIL BIROU”",343,"Alegeri Prezidentiale",1,717,183,156,27,0,183,0,788,605,106,77
11,CARAŞ-SEVERIN,TOPLEŢ,54387,TOPLEŢ,"CĂMINUL CULTURAL",344,"Alegeri Prezidentiale",1,1169,498,460,36,2,495,3,1285,787,318,177
11,CARAŞ-SEVERIN,TOPLEŢ,54387,BÂRZA,"ŞCOALA PRIMARA BÎRZA",345,"Alegeri Prezidentiale",1,1016,402,350,52,0,399,3,1117,715,223,176
11,CARAŞ-SEVERIN,"TURNU RUIENI",54412,"TURNU RUIENI","CĂMINUL CULTURAL TURNU RUIENI",346,"Alegeri Prezidentiale",1,708,329,305,24,0,328,1,779,450,207,121
11,CARAŞ-SEVERIN,"TURNU RUIENI",54412,BORLOVA,"CĂMINUL CULTURAL-BORLOVA",347,"Alegeri Prezidentiale",1,1186,506,465,41,0,499,7,1305,799,352,147
11,CARAŞ-SEVERIN,"TURNU RUIENI",54412,DALCI,"ŞCOALA PRIMARA DALCI",348,"Alegeri Prezidentiale",1,211,127,112,15,0,127,0,232,105,60,67
11,CARAŞ-SEVERIN,"TURNU RUIENI",54412,ZERVEŞTI,"CĂMINUL CULTURAL ZERVESTI",349,"Alegeri Prezidentiale",1,438,216,194,22,0,213,3,482,266,114,99
11,CARAŞ-SEVERIN,"TURNU RUIENI",54412,ZLAGNA,"CĂMINUL CULTURAL-ZLAGNA",350,"Alegeri Prezidentiale",1,254,178,157,20,1,178,0,279,101,119,59
11,CARAŞ-SEVERIN,VĂLIUG,54485,VĂLIUG,"ŞCOALA GIMNAZIALĂ ”PETRE SAVA BĂLEAN”",351,"Alegeri Prezidentiale",1,651,380,283,97,0,371,9,715,335,279,92
11,CARAŞ-SEVERIN,VĂRĂDIA,54500,VĂRĂDIA,"CĂMINUL CULTURAL VĂRĂDIA",352,"Alegeri Prezidentiale",1,644,361,296,55,10,352,9,707,346,102,250
11,CARAŞ-SEVERIN,VĂRĂDIA,54500,MERCINA,"CLĂDIREA ADMINISTRAŢIEI LOCALE",353,"Alegeri Prezidentiale",1,475,260,207,48,5,259,1,523,263,107,152
11,CARAŞ-SEVERIN,VERMEŞ,54537,ERSIG,"ŞCOALA PRIMARĂ ERSIG",354,"Alegeri Prezidentiale",1,254,150,116,34,0,150,0,279,129,104,46
11,CARAŞ-SEVERIN,VERMEŞ,54537,IZGAR,"ŞCOALA PRIMARĂ IZGAR",355,"Alegeri Prezidentiale",1,238,157,111,46,0,155,2,262,105,85,70
11,CARAŞ-SEVERIN,VERMEŞ,54537,VERMEŞ,"SALA DE SPORT",356,"Alegeri Prezidentiale",1,797,581,465,93,23,569,12,877,296,258,311
11,CARAŞ-SEVERIN,VRANI,54573,VRANI,"CĂMINUL CULTURAL VRANI",357,"Alegeri Prezidentiale",1,688,386,308,58,20,381,5,756,370,171,210
11,CARAŞ-SEVERIN,VRANI,54573,CIORTEA,"SCOALA PRIMARA CIORTEA",358,"Alegeri Prezidentiale",1,147,100,81,17,2,97,3,161,61,41,56
11,CARAŞ-SEVERIN,ZĂVOI,54617,ZĂVOI,"CĂMINUL CULTURAL-ZAVOI",359,"Alegeri Prezidentiale",1,1489,650,606,43,1,640,10,1538,888,389,251
11,CARAŞ-SEVERIN,ZĂVOI,54617,MĂGURA,"ŞCOALA PRIMARĂ MĂGURA",360,"Alegeri Prezidentiale",1,449,281,257,24,0,278,3,494,213,198,80
11,CARAŞ-SEVERIN,ZĂVOI,54617,MĂRU,"ŞCOALA GIMNAZIALA MĂRU",361,"Alegeri Prezidentiale",1,886,490,462,28,0,484,6,975,485,397,87
11,CARAŞ-SEVERIN,ZĂVOI,54617,"POIANA MĂRULUI","OCOLUL SILVIC",362,"Alegeri Prezidentiale",1,59,134,28,106,0,131,3,165,31,105,26
11,CARAŞ-SEVERIN,ZĂVOI,54617,VOISLOVA,"ŞCOALA PRIMARĂ VOISLOVA",363,"Alegeri Prezidentiale",1,467,274,242,32,0,271,3,514,240,180,91
11,CARAŞ-SEVERIN,"ZORLENŢU MARE",54699,ZORLENCIOR,"CĂMINUL CULTURAL",364,"Alegeri Prezidentiale",1,116,133,72,57,4,132,1,168,35,49,83
11,CARAŞ-SEVERIN,"ZORLENŢU MARE",54699,"ZORLENŢU MARE","ŞCOALA GIMNAZIALA ZORLENTU MARE",365,"Alegeri Prezidentiale",1,687,714,381,282,51,704,10,755,41,438,266
12,CĂLĂRAŞI,"MUNICIPIUL CĂLĂRAŞI",92569,CĂLĂRAŞI,"SCOALA GIMNAZIALA CAROL I CALARASI",1,"Alegeri Prezidentiale",1,1394,755,693,61,1,742,13,1500,745,428,314
12,CĂLĂRAŞI,"MUNICIPIUL CĂLĂRAŞI",92569,CĂLĂRAŞI,"SCOALA GIMNAZIALA CAROL I CALARASI",2,"Alegeri Prezidentiale",1,619,327,314,13,0,322,5,786,459,202,120
12,CĂLĂRAŞI,"MUNICIPIUL CĂLĂRAŞI",92569,CĂLĂRAŞI,"SCOALA GIMNAZIALA CAROL I CALARASI",3,"Alegeri Prezidentiale",1,1001,546,504,42,0,532,14,1100,554,304,228
12,CĂLĂRAŞI,"MUNICIPIUL CĂLĂRAŞI",92569,CĂLĂRAŞI,"SCOALA GIMNAZIALA CAROL I CALARASI",4,"Alegeri Prezidentiale",1,797,555,400,21,134,548,7,900,345,318,230
12,CĂLĂRAŞI,"MUNICIPIUL CĂLĂRAŞI",92569,CĂLĂRAŞI,"COLEGIUL NAŢIONAL ”BARBU ŞTIRBEI”",5,"Alegeri Prezidentiale",1,1122,643,579,47,17,626,17,1200,557,336,290
12,CĂLĂRAŞI,"MUNICIPIUL CĂLĂRAŞI",92569,CĂLĂRAŞI,"COLEGIUL NAŢIONAL ”BARBU ŞTIRBEI”",6,"Alegeri Prezidentiale",1,988,409,383,26,0,400,9,1100,691,204,196
12,CĂLĂRAŞI,"MUNICIPIUL CĂLĂRAŞI",92569,CĂLĂRAŞI,"GRĂDINIŢA CU PR.NORMAL NR.5 CALARASI",7,"Alegeri Prezidentiale",1,1353,616,585,30,1,603,13,1500,884,338,265
12,CĂLĂRAŞI,"MUNICIPIUL CĂLĂRAŞI",92569,CĂLĂRAŞI,"GRĂDINIŢA CU PR.NORMAL NR.4 CALARASI",8,"Alegeri Prezidentiale",1,1528,633,583,50,0,625,8,1600,967,345,280
12,CĂLĂRAŞI,"MUNICIPIUL CĂLĂRAŞI",92569,CĂLĂRAŞI,"GRĂDINIŢA CU PR. PREL.(MICRO6)",9,"Alegeri Prezidentiale",1,1375,645,614,31,0,631,14,1500,855,326,305
12,CĂLĂRAŞI,"MUNICIPIUL CĂLĂRAŞI",92569,CĂLĂRAŞI,"COLEGIUL AGRICOL ”SANDU ALDEA” CALARASI",10,"Alegeri Prezidentiale",1,1207,577,528,49,0,565,12,1400,823,316,249
12,CĂLĂRAŞI,"MUNICIPIUL CĂLĂRAŞI",92569,CĂLĂRAŞI,"COLEGIUL AGRICOL ”SANDU ALDEA” CALARASI",11,"Alegeri Prezidentiale",1,1033,538,512,26,0,530,8,1092,554,302,228
12,CĂLĂRAŞI,"MUNICIPIUL CĂLĂRAŞI",92569,CĂLĂRAŞI,"COLEGIUL AGRICOL ”SANDU ALDEA” CALARASI",12,"Alegeri Prezidentiale",1,1031,364,346,18,0,356,8,1100,736,187,169
12,CĂLĂRAŞI,"MUNICIPIUL CĂLĂRAŞI",92569,CĂLĂRAŞI,"LIC. TEORETIC ”MIHAI EMINESCU”",13,"Alegeri Prezidentiale",1,1042,570,538,32,0,559,11,1200,630,339,220
12,CĂLĂRAŞI,"MUNICIPIUL CĂLĂRAŞI",92569,CĂLĂRAŞI,"LIC. TEORETIC ”MIHAI EMINESCU”",14,"Alegeri Prezidentiale",1,1413,663,630,33,0,652,11,1500,837,388,264
12,CĂLĂRAŞI,"MUNICIPIUL CĂLĂRAŞI",92569,CĂLĂRAŞI,"LIC. TEORETIC ”MIHAI EMINESCU”",15,"Alegeri Prezidentiale",1,1282,603,581,22,0,597,6,1300,697,331,266
12,CĂLĂRAŞI,"MUNICIPIUL CĂLĂRAŞI",92569,CĂLĂRAŞI,"ŞCOALA GIMNAZIALA MIHAI VITEAZUL CALARASI",16,"Alegeri Prezidentiale",1,1302,613,579,34,0,606,7,1400,787,367,239
12,CĂLĂRAŞI,"MUNICIPIUL CĂLĂRAŞI",92569,CĂLĂRAŞI,"ŞCOALA GIMNAZIALA MIHAI VITEAZUL CALARASI",17,"Alegeri Prezidentiale",1,1185,541,519,22,0,533,8,1300,759,315,218
12,CĂLĂRAŞI,"MUNICIPIUL CĂLĂRAŞI",92569,CĂLĂRAŞI,"ŞCOALA GIMNAZIALA MIHAI VITEAZUL CALARASI",18,"Alegeri Prezidentiale",1,1374,596,576,19,1,584,12,1500,904,347,237
12,CĂLĂRAŞI,"MUNICIPIUL CĂLĂRAŞI",92569,CĂLĂRAŞI,"ŞCOALA GIMNAZIALA MIHAI VITEAZUL CALARASI",19,"Alegeri Prezidentiale",1,734,357,332,25,0,353,4,900,543,197,156
12,CĂLĂRAŞI,"MUNICIPIUL CĂLĂRAŞI",92569,CĂLĂRAŞI,"SALA DE SPORT A SCOLII GIMNAZIALE NICOLAE TITULESCU",20,"Alegeri Prezidentiale",1,782,428,386,42,0,421,7,900,472,255,166
12,CĂLĂRAŞI,"MUNICIPIUL CĂLĂRAŞI",92569,CĂLĂRAŞI,"SALA DE SPORT A SCOLII GIMNAZIALE NICOLAE TITULESCU",21,"Alegeri Prezidentiale",1,1485,616,598,18,0,606,10,1500,884,334,272
12,CĂLĂRAŞI,"MUNICIPIUL CĂLĂRAŞI",92569,CĂLĂRAŞI,"GRĂDINIŢA CU PR.PREL.NR.1",22,"Alegeri Prezidentiale",2,1101,590,557,33,0,577,13,1300,710,307,270
12,CĂLĂRAŞI,"MUNICIPIUL CĂLĂRAŞI",92569,CĂLĂRAŞI,"GRĂDINIŢA CU PROGRAM NORMAL NR.2 CALARASI",23,"Alegeri Prezidentiale",1,1699,769,739,30,0,762,7,1800,1031,411,351
12,CĂLĂRAŞI,"MUNICIPIUL CĂLĂRAŞI",92569,CĂLĂRAŞI,"LICEUL DANUBIUS CALARASI",24,"Alegeri Prezidentiale",1,1605,655,635,20,0,639,16,1700,1045,399,240
12,CĂLĂRAŞI,"MUNICIPIUL CĂLĂRAŞI",92569,CĂLĂRAŞI,"LICEUL DANUBIUS CALARASI",25,"Alegeri Prezidentiale",1,1535,714,679,35,0,706,8,1600,886,400,306
12,CĂLĂRAŞI,"MUNICIPIUL CĂLĂRAŞI",92569,CĂLĂRAŞI,"LICEUL DANUBIUS CALARASI",26,"Alegeri Prezidentiale",1,1847,677,654,22,1,670,7,1900,1223,429,241
12,CĂLĂRAŞI,"MUNICIPIUL CĂLĂRAŞI",92569,CĂLĂRAŞI,"LICEUL DANUBIUS CALARASI",27,"Alegeri Prezidentiale",1,1477,406,378,28,0,393,13,1500,1094,170,223
12,CĂLĂRAŞI,"MUNICIPIUL CĂLĂRAŞI",92569,CĂLĂRAŞI,"CREŞA SĂPTĂMÂNALĂ CU 100 LOCURI",28,"Alegeri Prezidentiale",1,1420,581,558,23,0,568,13,1500,919,351,217
12,CĂLĂRAŞI,"MUNICIPIUL CĂLĂRAŞI",92569,CĂLĂRAŞI,"CREŞA SĂPTĂMÂNALĂ CU 100 LOCURI",29,"Alegeri Prezidentiale",1,802,308,280,28,0,302,6,900,592,197,105
12,CĂLĂRAŞI,"MUNICIPIUL CĂLĂRAŞI",92569,CĂLĂRAŞI,"ŞCOALA GIMNAZIALA T.VLADIMIRESCU",30,"Alegeri Prezidentiale",1,1440,697,657,40,0,682,15,1500,803,406,276
12,CĂLĂRAŞI,"MUNICIPIUL CĂLĂRAŞI",92569,CĂLĂRAŞI,"ŞCOALA GIMNAZIALA T.VLADIMIRESCU",31,"Alegeri Prezidentiale",1,1246,655,621,34,0,642,13,1400,745,382,260
12,CĂLĂRAŞI,"MUNICIPIUL CĂLĂRAŞI",92569,CĂLĂRAŞI,"ŞCOALA GIMNAZIALA T.VLADIMIRESCU",32,"Alegeri Prezidentiale",1,1299,642,617,25,0,619,23,1400,758,382,237
12,CĂLĂRAŞI,"MUNICIPIUL CĂLĂRAŞI",92569,CĂLĂRAŞI,"ŞCOALA GIMNAZIALA T.VLADIMIRESCU",33,"Alegeri Prezidentiale",1,1385,658,633,25,0,644,14,1500,842,405,239
12,CĂLĂRAŞI,"MUNICIPIUL CĂLĂRAŞI",92569,CĂLĂRAŞI,"SALA DE SPORT DE LA ŞC.12",34,"Alegeri Prezidentiale",1,1277,693,581,112,0,687,6,1300,607,430,257
12,CĂLĂRAŞI,"MUNICIPIUL CĂLĂRAŞI",92569,CĂLĂRAŞI,"SALA DE SPORT DE LA ŞC.12",35,"Alegeri Prezidentiale",1,1140,496,462,34,0,480,16,1300,804,300,180
12,CĂLĂRAŞI,"MUNICIPIUL CĂLĂRAŞI",92569,CĂLĂRAŞI,"ŞCOALA GIMNAZIALA MIRCEA VODĂ",36,"Alegeri Prezidentiale",1,1261,684,627,57,0,668,16,1300,616,409,259
12,CĂLĂRAŞI,"MUNICIPIUL CĂLĂRAŞI",92569,CĂLĂRAŞI,"ŞCOALA GIMNAZIALA MIRCEA VODĂ",37,"Alegeri Prezidentiale",1,1162,486,464,22,0,475,11,1300,814,290,185
12,CĂLĂRAŞI,"MUNICIPIUL CĂLĂRAŞI",92569,CĂLĂRAŞI,"ŞCOALA GIMNAZIALA MIRCEA VODĂ",38,"Alegeri Prezidentiale",1,1549,768,748,20,0,754,14,1600,832,511,243
12,CĂLĂRAŞI,"MUNICIPIUL CĂLĂRAŞI",92569,CĂLĂRAŞI,"ŞCOALA GIMNAZIALA MIRCEA VODĂ",39,"Alegeri Prezidentiale",1,1053,483,469,14,0,479,4,1200,717,264,215
12,CĂLĂRAŞI,"MUNICIPIUL CĂLĂRAŞI",92569,CĂLĂRAŞI,"GRADINITA CU PROGRAM PRELUNGIT NR.9 VOINICEL",40,"Alegeri Prezidentiale",1,1500,679,658,20,1,668,11,1600,921,415,253
12,CĂLĂRAŞI,"MUNICIPIUL CĂLĂRAŞI",92569,CĂLĂRAŞI,"GRADINITA CU PROGRAM PRELUNGIT NR.9 VOINICEL",41,"Alegeri Prezidentiale",1,1089,497,480,17,0,489,8,1200,703,280,209
12,CĂLĂRAŞI,"MUNICIPIUL CĂLĂRAŞI",92569,CĂLĂRAŞI,"GRĂDINIŢA CU PR.PRELUNGIT NR.5 ARICEL CALARASI",42,"Alegeri Prezidentiale",2,802,406,388,18,0,400,6,900,494,224,176
12,CĂLĂRAŞI,"MUNICIPIUL CĂLĂRAŞI",92569,CĂLĂRAŞI,"COLEGIUL ECONOMIC SEDIUL B",43,"Alegeri Prezidentiale",1,1105,525,502,23,0,517,8,1200,675,268,249
12,CĂLĂRAŞI,"MUNICIPIUL CĂLĂRAŞI",92569,CĂLĂRAŞI,"LICEUL TEHNOLOGIC TRANSPORTURI AUTO CALARASI",44,"Alegeri Prezidentiale",1,1224,614,571,38,5,606,8,1300,686,350,256
12,CĂLĂRAŞI,"MUNICIPIUL CĂLĂRAŞI",92569,CĂLĂRAŞI,"ŞCOALA GIMNAZIALA C-TIN BRÂNCOVEANU",45,"Alegeri Prezidentiale",1,1369,717,640,18,59,706,11,1500,783,422,284
12,CĂLĂRAŞI,"MUNICIPIUL CĂLĂRAŞI",92569,CĂLĂRAŞI,"ŞCOALA GIMNAZIALA C-TIN BRÂNCOVEANU",46,"Alegeri Prezidentiale",1,1111,406,388,18,0,398,8,1300,894,198,200
12,CĂLĂRAŞI,"MUNICIPIUL CĂLĂRAŞI",92569,CĂLĂRAŞI,"ŞCOALA GIMNAZIALA C-TIN BRÂNCOVEANU",47,"Alegeri Prezidentiale",1,1181,576,554,22,0,568,8,1300,724,324,244
12,CĂLĂRAŞI,"MUNICIPIUL CĂLĂRAŞI",92569,CĂLĂRAŞI,"ŞCOALA PRIMARA NR.6",48,"Alegeri Prezidentiale",1,1008,457,439,18,0,447,10,1100,643,289,158
12,CĂLĂRAŞI,"MUNICIPIUL CĂLĂRAŞI",92569,CĂLĂRAŞI,"ŞCOALA PRIMARA NR.6",49,"Alegeri Prezidentiale",1,977,450,429,21,0,443,7,1100,650,246,197
12,CĂLĂRAŞI,"MUNICIPIUL CĂLĂRAŞI",92569,CĂLĂRAŞI,"OBORUL DUMINICAL",50,"Alegeri Prezidentiale",1,607,274,217,57,0,269,5,700,426,146,123
12,CĂLĂRAŞI,"MUNICIPIUL CĂLĂRAŞI",92569,CĂLĂRAŞI,"COLEGIUL ECONOMIC SEDIU",51,"Alegeri Prezidentiale",2,1452,827,779,48,0,809,18,1500,673,424,385
12,CĂLĂRAŞI,"MUNICIPIUL OLTENIŢA",100610,OLTENIŢA,"GRĂDINIŢA NR.5 (INCINTA ŞCOALA GIMNAZIALĂ ”AL.D.GHICA”)",52,"Alegeri Prezidentiale",1,1918,775,721,54,0,763,12,2000,1225,306,457
12,CĂLĂRAŞI,"MUNICIPIUL OLTENIŢA",100610,OLTENIŢA,"CANTINA DE AJUTOR SOCIAL",53,"Alegeri Prezidentiale",1,1249,647,614,32,1,636,11,1400,753,240,396
12,CĂLĂRAŞI,"MUNICIPIUL OLTENIŢA",100610,OLTENIŢA,"ŞCOALA GIMNAZIALĂ ”PROF.LUCIAN PAVEL” LOCAL NR.1",54,"Alegeri Prezidentiale",1,1168,499,465,34,0,493,6,1300,801,194,299
12,CĂLĂRAŞI,"MUNICIPIUL OLTENIŢA",100610,OLTENIŢA,"ŞCOALA GIMNAZIALĂ ”PROF.LUCIAN PAVEL” LOCAL NR.2",55,"Alegeri Prezidentiale",1,1493,723,681,42,0,717,6,1500,777,297,420
12,CĂLĂRAŞI,"MUNICIPIUL OLTENIŢA",100610,OLTENIŢA,"PRIMARIA MUNICIPIULUI OLTENITA",56,"Alegeri Prezidentiale",1,1784,896,781,97,18,887,9,1800,904,374,513
12,CĂLĂRAŞI,"MUNICIPIUL OLTENIŢA",100610,OLTENIŢA,"PRIMARIA MUNICIPIULUI OLTENITA",57,"Alegeri Prezidentiale",1,1816,874,822,52,0,860,14,1900,1026,388,472
12,CĂLĂRAŞI,"MUNICIPIUL OLTENIŢA",100610,OLTENIŢA,"ŞCOALA GIMNAZIALĂ ”SPIRU HARET”",58,"Alegeri Prezidentiale",1,1843,766,689,47,30,748,18,1900,1134,315,433
12,CĂLĂRAŞI,"MUNICIPIUL OLTENIŢA",100610,OLTENIŢA,"LICEUL TEORETIC ”NEAGOE BASARAB”",59,"Alegeri Prezidentiale",1,1818,888,761,72,55,867,21,1900,1012,382,485
12,CĂLĂRAŞI,"MUNICIPIUL OLTENIŢA",100610,OLTENIŢA,"ŞCOALA GIMNAZIALĂ ”ALEXANDRU VLAHUŢĂ”",60,"Alegeri Prezidentiale",1,1709,708,681,27,0,698,10,1800,1092,288,410
12,CĂLĂRAŞI,"MUNICIPIUL OLTENIŢA",100610,OLTENIŢA,"GRADINITA NR.4",61,"Alegeri Prezidentiale",1,1690,692,661,31,0,686,6,1800,1108,295,391
12,CĂLĂRAŞI,"MUNICIPIUL OLTENIŢA",100610,OLTENIŢA,"ŞCOALA GIMNAZIALĂ ”PROF.LUCIAN PAVEL” LOCAL NR.3",62,"Alegeri Prezidentiale",1,1666,630,598,32,0,615,15,1700,1070,255,360
12,CĂLĂRAŞI,"MUNICIPIUL OLTENIŢA",100610,OLTENIŢA,"ŞCOALA CU CLS I-IV ”CONSTANTIN DECULESCU”",63,"Alegeri Prezidentiale",1,1713,477,456,21,0,467,10,1800,1323,211,256
12,CĂLĂRAŞI,"MUNICIPIUL OLTENIŢA",100610,OLTENIŢA,"ŞCOALA GIMNAZIALĂ ”MIRCEA ELIADE”",64,"Alegeri Prezidentiale",1,1297,544,504,40,0,534,10,1400,856,254,280
12,CĂLĂRAŞI,"MUNICIPIUL OLTENIŢA",100610,OLTENIŢA,"GRADINITA NR.2",65,"Alegeri Prezidentiale",1,1601,695,667,28,0,686,9,1700,1005,294,392
12,CĂLĂRAŞI,"ORAŞ BUDEŞTI",101458,BUDEŞTI,"SCOALA GIMNAZIALA GHEORGHE MANU",66,"Alegeri Prezidentiale",1,1858,690,610,80,0,682,8,1900,1210,253,429
12,CĂLĂRAŞI,"ORAŞ BUDEŞTI",101458,BUDEŞTI,"SCOALA GIMNAZIALA GHEORGHE MANU",67,"Alegeri Prezidentiale",1,1934,716,632,84,0,693,23,2000,1284,240,453
12,CĂLĂRAŞI,"ORAŞ BUDEŞTI",101458,APROZI,"SCOALA GIMNAZIALA NR.1APROZI",68,"Alegeri Prezidentiale",1,805,412,303,109,0,405,7,900,488,208,197
12,CĂLĂRAŞI,"ORAŞ BUDEŞTI",101458,BUCIUMENI,"SCOALA PRIMARA NR.2 BUCIUMENI",69,"Alegeri Prezidentiale",1,511,314,229,85,0,309,5,600,286,123,186
12,CĂLĂRAŞI,"ORAŞ BUDEŞTI",101458,GRUIU,"SCOALA PRIMARA NR.1 GRUIU",70,"Alegeri Prezidentiale",1,590,407,271,136,0,405,2,700,293,206,199
12,CĂLĂRAŞI,"ORAŞ FUNDULEA",103032,FUNDULEA,"LICEUL TEHNOLOGIC NR. 1",71,"Alegeri Prezidentiale",1,916,602,494,108,0,595,7,1100,498,327,268
12,CĂLĂRAŞI,"ORAŞ FUNDULEA",103032,FUNDULEA,"GRADINITA CU PROGRAM PRELUNGIT",72,"Alegeri Prezidentiale",1,1402,869,669,200,0,855,14,1500,631,408,447
12,CĂLĂRAŞI,"ORAŞ FUNDULEA",103032,FUNDULEA,"SCOALA GIMNAZIALA MIRCEA NEDELCIU",73,"Alegeri Prezidentiale",1,1071,615,485,130,0,606,9,1200,585,300,306
12,CĂLĂRAŞI,"ORAŞ FUNDULEA",103032,FUNDULEA,"GRADINITA CU PROGRAM NORMAL NR. 2 CRANGU",74,"Alegeri Prezidentiale",1,1330,712,585,127,0,701,11,1400,688,344,357
12,CĂLĂRAŞI,"ORAŞ FUNDULEA",103032,GOSTILELE,"SCOALA GIMNAZIALA NR. 1 GOSTILELE",75,"Alegeri Prezidentiale",1,520,337,228,109,0,334,3,600,263,147,187
12,CĂLĂRAŞI,"ORAŞ LEHLIU-GARĂ",93888,LEHLIU-GARĂ,PRIMARIE,76,"Alegeri Prezidentiale",1,1531,1097,820,254,23,1074,23,1600,503,485,589
12,CĂLĂRAŞI,"ORAŞ LEHLIU-GARĂ",93888,LEHLIU-GARĂ,"CASA DE CULTURA",77,"Alegeri Prezidentiale",1,1593,1133,839,294,0,1112,21,1700,567,590,522
12,CĂLĂRAŞI,"ORAŞ LEHLIU-GARĂ",93888,RĂZVANI,"SCOALA CU CLS. I-VIII",78,"Alegeri Prezidentiale",1,756,373,325,48,0,368,5,900,527,156,212
12,CĂLĂRAŞI,"ORAŞ LEHLIU-GARĂ",93888,RĂZVANI,"SCOALA CU CLS. I-IV",79,"Alegeri Prezidentiale",1,1065,520,441,79,0,507,13,1200,680,235,272
12,CĂLĂRAŞI,"ORAŞ LEHLIU-GARĂ",93888,BUZOENI,"SCOALA CU CLS. I-IV",80,"Alegeri Prezidentiale",1,367,241,175,66,0,230,11,500,259,96,134
12,CĂLĂRAŞI,"ALEXANDRU ODOBESCU",94125,"NICOLAE BĂLCESCU","SCOALA GIMNAZIALA NR1 NICOLAE BALCESCU",81,"Alegeri Prezidentiale",1,1007,609,497,89,23,599,10,1100,491,385,214
12,CĂLĂRAŞI,"ALEXANDRU ODOBESCU",94125,"ALEXANDRU ODOBESCU","SCOALA GIMNAZIALA NR. 2 ALEXANDRU ODOBESCU",82,"Alegeri Prezidentiale",1,904,512,419,68,25,506,6,1000,488,350,156
12,CĂLĂRAŞI,"ALEXANDRU ODOBESCU",94125,GĂLĂŢUI,"DRAGNEA DANIELA INTREPRINDERE INDIVIDUALA",83,"Alegeri Prezidentiale",1,253,206,129,70,7,206,0,400,194,124,82
12,CĂLĂRAŞI,BELCIUGATELE,101083,BELCIUGATELE,"SCOALA GIMNAZIALA NR. 1 BELCIUGATELE",84,"Alegeri Prezidentiale",1,1253,859,547,312,0,848,11,1300,441,599,249
12,CĂLĂRAŞI,BELCIUGATELE,101083,MĂRIUŢA,"SCOALA PRIMARA MARIUTA",85,"Alegeri Prezidentiale",1,390,241,150,91,0,240,1,500,259,158,82
12,CĂLĂRAŞI,BORCEA,92961,BORCEA,"SCOALA GIMNAZIALA NR. 3 BORCEA",86,"Alegeri Prezidentiale",1,1051,376,336,40,0,372,4,1200,824,196,176
12,CĂLĂRAŞI,BORCEA,92961,BORCEA,"GRADINITA CU PROGRAM NORMAL NR. 3 BORCEA",87,"Alegeri Prezidentiale",1,915,440,389,50,1,436,4,1100,660,244,192
12,CĂLĂRAŞI,BORCEA,92961,BORCEA,"LICEUL TEHNOLOGIC NR. 1 BORCEA CLASELE I-IV SALA A",88,"Alegeri Prezidentiale",1,1564,704,612,92,0,695,9,1600,896,337,358
12,CĂLĂRAŞI,BORCEA,92961,BORCEA,"LICEUL TEHNOLOGIC NR. 1 BORCEA CLASELE I-IV SALA B",89,"Alegeri Prezidentiale",1,1490,653,557,96,0,646,7,1500,847,304,342
12,CĂLĂRAŞI,BORCEA,92961,BORCEA,"SCOALA GIMNAZIALA NR. 2 BORCEA",90,"Alegeri Prezidentiale",1,1744,686,627,59,0,678,8,1800,1114,325,353
12,CĂLĂRAŞI,CĂSCIOARELE,101724,CĂSCIOARELE,"CAMINUL CULTURAL",91,"Alegeri Prezidentiale",2,1473,752,667,84,1,747,5,1500,748,442,305
12,CĂLĂRAŞI,CHIRNOGI,101804,CHIRNOGI,"SCOALA CU CLASELE I-VIII, NR.1",92,"Alegeri Prezidentiale",1,1574,629,578,51,0,611,18,1700,1071,276,335
12,CĂLĂRAŞI,CHIRNOGI,101804,CHIRNOGI,"SCOALA CU CLASELE I-VIII, NR.2",93,"Alegeri Prezidentiale",1,1573,679,642,37,0,667,12,1600,921,300,367
12,CĂLĂRAŞI,CHIRNOGI,101804,CHIRNOGI,"SCOALA CU CLASELE I-VIII, NR.2",94,"Alegeri Prezidentiale",1,1583,653,617,36,0,646,7,1700,1047,274,372
12,CĂLĂRAŞI,CHIRNOGI,101804,CHIRNOGI,"SCOALA CU CLASELE I-VIII, NR.3",95,"Alegeri Prezidentiale",1,1230,550,491,59,0,541,9,1390,840,230,311
12,CĂLĂRAŞI,CHISELET,101822,CHISELET,"ȘCOALA GIMNAZIALĂ NR. 1",96,"Alegeri Prezidentiale",1,572,286,209,77,0,281,5,700,414,134,147
12,CĂLĂRAŞI,CHISELET,101822,CHISELET,"ȘCOALA GIMNAZIALĂ NR. 1",97,"Alegeri Prezidentiale",1,1332,528,502,26,0,521,7,1400,872,343,178
12,CĂLĂRAŞI,CHISELET,101822,CHISELET,"SPAŢIU COMERCIAL CONSUMCOOP MȂNĂSTIREA",98,"Alegeri Prezidentiale",1,651,373,303,70,0,361,12,800,427,196,165
12,CĂLĂRAŞI,CIOCĂNEŞTI,93085,CIOCĂNEŞTI,"SCOALA SMARDAN",99,"Alegeri Prezidentiale",1,758,385,288,88,9,377,8,900,515,237,140
12,CĂLĂRAŞI,CIOCĂNEŞTI,93085,CIOCĂNEŞTI,"SCOALA MARGINENI",100,"Alegeri Prezidentiale",1,696,345,276,67,2,342,3,800,455,209,133
12,CĂLĂRAŞI,CIOCĂNEŞTI,93085,CIOCĂNEŞTI,"GRADINITA NR.1 SARBI",101,"Alegeri Prezidentiale",1,1035,545,458,77,10,538,7,1100,555,351,187
12,CĂLĂRAŞI,CIOCĂNEŞTI,93085,CIOCĂNEŞTI,"SCOALA ANDOLINA",102,"Alegeri Prezidentiale",1,850,452,316,51,85,445,7,1000,548,302,143
12,CĂLĂRAŞI,CRIVĂŢ,180055,CRIVĂŢ,"SCOALA GIMNAZIALA ”NICOLAE PETRESCU”",103,"Alegeri Prezidentiale",1,807,405,307,94,4,394,11,900,495,241,153
12,CĂLĂRAŞI,CRIVĂŢ,180055,CRIVĂŢ,"SCOALA GIMNAZIALA ”NICOLAE PETRESCU”",104,"Alegeri Prezidentiale",1,861,423,344,70,9,419,4,1000,577,278,141
12,CĂLĂRAŞI,CURCANI,102419,CURCANI,"SCOALA NR. 1",105,"Alegeri Prezidentiale",1,1208,538,460,78,0,532,6,1300,762,239,293
12,CĂLĂRAŞI,CURCANI,102419,CURCANI,"SCOALA NR. 1",106,"Alegeri Prezidentiale",1,1056,520,406,112,2,509,11,1200,680,269,240
12,CĂLĂRAŞI,CURCANI,102419,CURCANI,"SCOALA NR. 1",107,"Alegeri Prezidentiale",1,1164,519,462,57,0,513,6,1300,781,233,280
12,CĂLĂRAŞI,CURCANI,102419,CURCANI,"SCOALA NR. 2",108,"Alegeri Prezidentiale",1,736,379,319,60,0,375,4,900,521,200,175
12,CĂLĂRAŞI,"CUZA VODĂ",93281,CEACU,"ŞCOALA PRIMARĂ NR.1 CEACU",109,"Alegeri Prezidentiale",1,1066,594,491,103,0,585,9,1200,606,320,265
12,CĂLĂRAŞI,"CUZA VODĂ",93281,"CUZA VODĂ","ŞCOALA GIMNAZIALĂ NR.1 CUZA VODĂ",110,"Alegeri Prezidentiale",1,1691,838,705,133,0,830,8,1700,862,464,366
12,CĂLĂRAŞI,"CUZA VODĂ",93281,"CĂLĂRAŞII VECHI","ŞCOALA PRIMARĂ NR.1 CĂLĂRAŞI VECHI",111,"Alegeri Prezidentiale",1,548,311,250,61,0,306,5,700,389,132,174
12,CĂLĂRAŞI,DICHISENI,93325,DICHISENI,"ŞC. GIMNAZIALĂ NR.1 DICHISENI",112,"Alegeri Prezidentiale",1,732,414,312,79,23,405,9,900,486,286,119
12,CĂLĂRAŞI,DICHISENI,93325,COSLOGENI,"ŞC. PRIMARĂ NR.1",113,"Alegeri Prezidentiale",1,710,393,335,40,18,384,9,800,407,274,110
12,CĂLĂRAŞI,"DOR MĂRUNT",93370,"DOR MĂRUNT","SCOALA GIMNAZIALĂ NR.2 DOR MĂRUNT GARĂ",114,"Alegeri Prezidentiale",1,1467,459,459,0,0,454,5,1500,1041,268,186
12,CĂLĂRAŞI,"DOR MĂRUNT",93370,"DOR MĂRUNT","ȘCOALA GIMNAZIALĂ NR.1 DOR MĂRUNT SAT",115,"Alegeri Prezidentiale",1,1331,491,394,97,0,489,2,1400,909,323,166
12,CĂLĂRAŞI,"DOR MĂRUNT",93370,OGORU,"PROPRIETATE PRIVATA",116,"Alegeri Prezidentiale",1,274,147,121,26,0,143,4,400,253,77,66
12,CĂLĂRAŞI,"DOR MĂRUNT",93370,ÎNFRĂŢIREA,"GRĂDINIȚA CU PROGRAM NORMAL NR.3 INFRĂȚIREA",117,"Alegeri Prezidentiale",1,261,129,89,40,0,127,2,400,271,50,77
12,CĂLĂRAŞI,"DOR MĂRUNT",93370,"DOR MĂRUNT","ȘCOALA GIMNAZIALĂ NR.2 DOR MĂRUNT GARĂ",118,"Alegeri Prezidentiale",1,77,96,18,78,0,96,0,300,204,52,44
12,CĂLĂRAŞI,"DOR MĂRUNT",93370,DÂLGA-GARĂ,"ȘCOALA GIMNAZIALĂ NR.1 DÎLGA GARĂ",119,"Alegeri Prezidentiale",1,1056,366,316,50,0,363,3,1200,834,249,114
12,CĂLĂRAŞI,"DOR MĂRUNT",93370,DÂLGA,"ȘCOALA PRIMARĂ NR.1 DÎLGA SAT",120,"Alegeri Prezidentiale",1,610,284,231,53,0,283,1,696,412,200,83
12,CĂLĂRAŞI,DOROBANŢU,93441,DOROBANŢU,"ŞCOALA GIMNAZIALĂ NR. 1 DOROBANȚU, CORP B",121,"Alegeri Prezidentiale",1,1187,634,503,131,0,624,10,1300,666,396,228
12,CĂLĂRAŞI,DOROBANŢU,93441,VĂRĂŞTI,"ŞCOALA PRIMARĂ NR. 1 VĂRĂŞTI",122,"Alegeri Prezidentiale",1,770,386,311,75,0,384,2,900,514,258,126
12,CĂLĂRAŞI,DOROBANŢU,93441,BOŞNEAGU,"ŞCOALA DIN SATUL BOŞNEAGU",123,"Alegeri Prezidentiale",1,302,172,122,50,0,169,3,500,328,108,61
12,CĂLĂRAŞI,DRAGALINA,93487,DRAGALINA,"SCOALA GIMNAZIALA NR.1 DRAGALINA",124,"Alegeri Prezidentiale",1,1154,489,429,58,2,485,4,1300,811,259,226
12,CĂLĂRAŞI,DRAGALINA,93487,DRAGALINA,"SCOALA GIMNAZIALA NR.1 DRAGALINA",125,"Alegeri Prezidentiale",1,1268,493,452,40,1,492,1,1300,807,297,195
12,CĂLĂRAŞI,DRAGALINA,93487,DRAGALINA,"SCOALA GIMNAZIALA NR.1 DRAGALINA",126,"Alegeri Prezidentiale",1,1351,522,475,47,0,513,9,1400,878,243,270
12,CĂLĂRAŞI,DRAGALINA,93487,DRAGALINA,"SCOALA GIMNAZIALA NR.1 DRAGALINA",127,"Alegeri Prezidentiale",1,1100,378,346,32,0,372,6,1200,822,198,174
12,CĂLĂRAŞI,DRAGALINA,93487,"DRAJNA NOUĂ","SCOALA GIMNAZIALA NR.1 DRAJNA NOUA",128,"Alegeri Prezidentiale",1,1071,538,470,68,0,531,7,1200,662,383,148
12,CĂLĂRAŞI,DRAGALINA,93487,"CONSTANTIN BRÂNCOVEANU","SCOALA GIMNAZIALA NR.2 CONSTANTIN BRANCOVEANU",129,"Alegeri Prezidentiale",1,744,399,308,91,0,396,3,900,501,210,186
12,CĂLĂRAŞI,"DRAGOŞ VODĂ",93539,"DRAGOŞ VODĂ","SCOALA GIMNAZIALA NR.1",130,"Alegeri Prezidentiale",1,1038,487,429,39,19,484,3,1100,613,303,181
12,CĂLĂRAŞI,"DRAGOŞ VODĂ",93539,"DRAGOŞ VODĂ","SCOALA GIMNAZIALA NR.1",131,"Alegeri Prezidentiale",1,1023,471,347,105,19,465,6,1100,629,296,169
12,CĂLĂRAŞI,"DRAGOŞ VODĂ",93539,SOCOALELE,"GRĂDINIȚA CU PROGRAM NORMAL NR. 3",132,"Alegeri Prezidentiale",1,173,137,77,46,14,137,0,300,163,98,39
12,CĂLĂRAŞI,FRĂSINET,102838,FRĂSINET,"SCOALA GIMNAZIALA NR.1 FRASINET",133,"Alegeri Prezidentiale",1,873,504,406,98,0,504,0,1000,496,234,270
12,CĂLĂRAŞI,FRĂSINET,102838,LUPTĂTORI,"SCOALA PRIMARA NR.1 LUPTATORI",134,"Alegeri Prezidentiale",1,438,262,190,72,0,259,3,500,238,120,139
12,CĂLĂRAŞI,FRUMUŞANI,102945,PASĂREA,"SCOALA GENERALA PASAREA",135,"Alegeri Prezidentiale",1,580,383,249,134,0,379,4,700,317,229,150
12,CĂLĂRAŞI,FRUMUŞANI,102945,FRUMUŞANI,"SCOALA GENERALA NR 1.FRUMUSANI",136,"Alegeri Prezidentiale",1,926,350,228,122,0,342,8,1100,750,202,140
12,CĂLĂRAŞI,FRUMUŞANI,102945,FRUMUŞANI,"SCOALA GENERALA NR 1.FRUMUSANI",137,"Alegeri Prezidentiale",1,983,394,221,173,0,388,6,1100,706,204,184
12,CĂLĂRAŞI,FRUMUŞANI,102945,ORĂŞTI,"SCOALA GENERALA ORĂȘTI",138,"Alegeri Prezidentiale",1,516,276,164,112,0,274,2,600,324,142,132
12,CĂLĂRAŞI,FRUMUŞANI,102945,ORĂŞTI,"SCOALA GENERALA ORASTI",139,"Alegeri Prezidentiale",1,772,478,279,199,0,473,5,900,422,279,194
12,CĂLĂRAŞI,FUNDENI,103014,FUNDENI,"GRĂDINIȚA CU PROGRAM NORMAL NR. 1",140,"Alegeri Prezidentiale",1,1268,717,563,154,0,709,8,1300,583,406,303
12,CĂLĂRAŞI,FUNDENI,103014,FUNDENI,"ȘCOALA PRIMARĂ NR. 2",141,"Alegeri Prezidentiale",1,1188,745,445,300,0,738,7,1300,555,315,423
12,CĂLĂRAŞI,FUNDENI,103014,FUNDENI,"SCOALA CLASELE 1-4 NR. 3",142,"Alegeri Prezidentiale",1,1189,582,471,111,0,577,5,1300,718,234,343
12,CĂLĂRAŞI,GĂLBINAŞI,179962,GĂLBINAŞI,"SCOALA GIMNAZIĂ NR. 1 GĂLBINAȘI",143,"Alegeri Prezidentiale",1,1399,742,606,136,0,730,12,1500,758,190,540
12,CĂLĂRAŞI,GĂLBINAŞI,179962,GĂLBINAŞI,"ȘCOALA GIMNAZIALĂ NR. 1 GĂLBINAȘI",144,"Alegeri Prezidentiale",1,1283,677,549,128,0,669,8,1300,623,195,474
12,CĂLĂRAŞI,GRĂDIŞTEA,93664,GRĂDIŞTEA,"ŞCOALA VECHE",145,"Alegeri Prezidentiale",1,1768,1099,918,181,0,1086,13,1800,701,686,400
12,CĂLĂRAŞI,GRĂDIŞTEA,93664,RASA,"ŞCOALA VECHE",146,"Alegeri Prezidentiale",1,1036,558,466,92,0,551,7,1100,542,366,185
12,CĂLĂRAŞI,GRĂDIŞTEA,93664,CUNEŞTI,"ŞCOALA CUNEŞTI",147,"Alegeri Prezidentiale",1,703,405,337,67,1,397,8,800,395,243,154
12,CĂLĂRAŞI,GRĂDIŞTEA,93664,BOGATA,"ŞCOALA BOGATA",148,"Alegeri Prezidentiale",1,482,278,226,52,0,277,1,600,322,163,114
12,CĂLĂRAŞI,GURBĂNEŞTI,103568,GURBĂNEŞTI,"SCOALA GIMNAZIALA NR. 1 GURBANESTI",149,"Alegeri Prezidentiale",1,442,377,193,184,0,373,4,500,123,272,101
12,CĂLĂRAŞI,GURBĂNEŞTI,103568,COŢOFANCA,"GRADINITA CU PROGRAM NORMAL COTOFANCA",150,"Alegeri Prezidentiale",1,306,236,136,100,0,227,9,500,264,142,85
12,CĂLĂRAŞI,GURBĂNEŞTI,103568,"VALEA PRESNEI","GRADINITA CU PROGRAM NORMAL VALEA PRESNEI",151,"Alegeri Prezidentiale",1,147,120,71,49,0,119,1,300,180,60,59
12,CĂLĂRAŞI,ILEANA,103764,ILEANA,"SCOALA ILEANA",152,"Alegeri Prezidentiale",1,767,426,296,130,0,418,8,900,474,107,311
12,CĂLĂRAŞI,ILEANA,103764,FLORICA,"SCOALA FLORICA",153,"Alegeri Prezidentiale",1,513,220,163,57,0,219,1,600,380,107,112
12,CĂLĂRAŞI,ILEANA,103764,ŞTEFĂNEŞTI,"SCOALA STEFANESTI",154,"Alegeri Prezidentiale",1,613,382,260,122,0,379,3,699,317,146,233
12,CĂLĂRAŞI,ILEANA,103764,ARŢARI,"SCOALA ARTARI",155,"Alegeri Prezidentiale",1,504,271,225,46,0,267,4,591,320,67,200
12,CĂLĂRAŞI,INDEPENDENŢA,93771,INDEPENDENŢA,"GRADINITA DE COPII",156,"Alegeri Prezidentiale",1,1771,927,855,72,0,914,13,1800,873,608,306
12,CĂLĂRAŞI,INDEPENDENŢA,93771,VIŞINII,"GRADINITA DE COPII",157,"Alegeri Prezidentiale",1,436,197,164,33,0,194,3,500,303,141,53
12,CĂLĂRAŞI,INDEPENDENŢA,93771,POTCOAVA,"GRĂDINIŢA ALBĂ CA ZĂPADA",158,"Alegeri Prezidentiale",1,646,314,243,71,0,314,0,800,486,174,140
12,CĂLĂRAŞI,JEGĂLIA,93815,JEGĂLIA,"SCOALA GIMNAZIALA NR. 1",159,"Alegeri Prezidentiale",1,1580,749,687,62,0,745,4,1700,951,499,246
12,CĂLĂRAŞI,JEGĂLIA,93815,GÂLDĂU,"SCOALA PRIMARA NR. 1",160,"Alegeri Prezidentiale",1,1136,533,502,31,0,527,6,1300,767,301,226
12,CĂLĂRAŞI,JEGĂLIA,93815,IEZERU,"SALA DE EDUCAȚIE FIZICĂ ȘCOLARĂ",161,"Alegeri Prezidentiale",1,771,393,349,44,0,391,2,900,507,263,128
12,CĂLĂRAŞI,LEHLIU,93851,LEHLIU,"CAMIN CULTURAL",162,"Alegeri Prezidentiale",1,1391,806,689,117,0,792,14,1500,694,310,482
12,CĂLĂRAŞI,LEHLIU,93851,SĂPUNARI,"SCOALA SAPUNARI",163,"Alegeri Prezidentiale",1,651,342,262,54,26,333,9,800,458,169,164
12,CĂLĂRAŞI,LUICA,104083,LUICA,"SCOALA CU CLASELE I-VIII LUICA",164,"Alegeri Prezidentiale",1,1258,485,415,70,0,478,7,1400,915,235,243
12,CĂLĂRAŞI,LUICA,104083,"VALEA STÂNII","SCOALA CU CLASELE I-IV VALEA STANII",165,"Alegeri Prezidentiale",1,433,206,158,48,0,205,1,500,294,132,73
12,CĂLĂRAŞI,LUPŞANU,93931,NUCETU,"GRADINITA CU PROGRAM NORMAL NR.4 NUCETU",166,"Alegeri Prezidentiale",1,509,297,220,77,0,292,5,600,303,145,147
12,CĂLĂRAŞI,LUPŞANU,93931,LUPŞANU,"GRADINITA CU PROGRAM NORMAL NR.3 LUPSANU",167,"Alegeri Prezidentiale",1,488,227,175,52,0,227,0,600,373,111,116
12,CĂLĂRAŞI,LUPŞANU,93931,"RADU VODĂ","SCOALA GIMNAZIALA NR.1 RADU-VODA",168,"Alegeri Prezidentiale",1,940,385,303,82,0,376,9,1100,715,157,219
12,CĂLĂRAŞI,LUPŞANU,93931,PLEVNA,"SCOALA PRIMARA NR.1 PLEVNA",169,"Alegeri Prezidentiale",1,500,204,141,63,0,202,2,600,396,113,89
12,CĂLĂRAŞI,MÂNĂSTIREA,104181,MÂNĂSTIREA,"LICEUL TEHNOLOGIC MATEI BASARAB",170,"Alegeri Prezidentiale",1,1399,563,487,76,0,559,4,1500,937,335,224
12,CĂLĂRAŞI,MÂNĂSTIREA,104181,MÂNĂSTIREA,"LICEUL TEHNOLOGIC MATEI BASARAB",171,"Alegeri Prezidentiale",1,1448,629,566,63,0,615,14,1500,871,347,268
12,CĂLĂRAŞI,MÂNĂSTIREA,104181,COCONI,"GRĂDINIŢA CU PROGRAM NORMAL NR. 3, COCONI",172,"Alegeri Prezidentiale",1,667,289,224,65,0,286,3,800,511,150,136
12,CĂLĂRAŞI,MÂNĂSTIREA,104181,SULTANA,"ŞCOALA GIMNAZIALĂ NR. 2 SULTANA",173,"Alegeri Prezidentiale",1,770,361,294,67,0,354,7,900,539,195,159
12,CĂLĂRAŞI,MITRENI,100638,MITRENI,"SCOALA GIMNAZIALA NR. 2 MITRENI",174,"Alegeri Prezidentiale",1,1139,609,508,101,0,598,11,1300,691,263,335
12,CĂLĂRAŞI,MITRENI,100638,"VALEA ROŞIE","SCOALA GIMNAZIALA NR. 1 VALEA ROSIE",175,"Alegeri Prezidentiale",1,1808,762,645,117,0,746,16,1900,1138,369,377
12,CĂLĂRAŞI,MITRENI,100638,CLĂTEŞTI,"GRADINITA CU PROGRAM NORMAL NR. 3 CLATESTI",176,"Alegeri Prezidentiale",1,408,203,156,47,0,202,1,500,297,123,79
12,CĂLĂRAŞI,MODELU,92587,MODELU,"SCOALA GENERALA NR.1",177,"Alegeri Prezidentiale",1,1585,773,723,50,0,764,9,1700,927,513,251
12,CĂLĂRAŞI,MODELU,92587,MODELU,"SCOALA GENERALA NR.1",178,"Alegeri Prezidentiale",1,1655,698,668,30,0,692,6,1700,1002,437,255
12,CĂLĂRAŞI,MODELU,92587,MODELU,"SCOALA GENERALA NR.1",179,"Alegeri Prezidentiale",1,1579,734,670,64,0,727,7,1600,866,471,256
12,CĂLĂRAŞI,MODELU,92587,MODELU,"SCOALA GENERALA NR.2",180,"Alegeri Prezidentiale",1,1609,742,710,32,0,736,6,1700,958,458,278
12,CĂLĂRAŞI,MODELU,92587,TONEA,"SCOALA TONEA",181,"Alegeri Prezidentiale",1,1650,649,611,38,0,639,10,1700,1051,447,192
12,CĂLĂRAŞI,NANA,104323,NANA,"SCOALA GIMNAZIALA NR. 1",182,"Alegeri Prezidentiale",2,1267,516,431,44,41,509,7,1399,883,262,247
12,CĂLĂRAŞI,NANA,104323,NANA,"SCOALA GIMNAZIALA NR. 1",183,"Alegeri Prezidentiale",1,551,295,221,58,16,290,5,700,405,132,158
12,CĂLĂRAŞI,"NICOLAE BĂLCESCU",104341,"NICOLAE BĂLCESCU","SCOALA CU CLASELE I-VIII",184,"Alegeri Prezidentiale",1,1018,556,444,112,0,546,10,1100,544,280,266
12,CĂLĂRAŞI,"NICOLAE BĂLCESCU",104341,"FÂNTÂNA DOAMNEI","SCOALA CU CLASELE I-IV",185,"Alegeri Prezidentiale",1,207,185,113,72,0,182,3,400,215,108,74
12,CĂLĂRAŞI,PERIŞORU,94223,PERIŞORU,"CĂMIN CULTURAL PERIŞORU",186,"Alegeri Prezidentiale",1,1822,698,637,61,0,689,9,1900,1202,373,316
12,CĂLĂRAŞI,PERIŞORU,94223,PERIŞORU,"CĂMIN CULTURAL PERIŞORU",187,"Alegeri Prezidentiale",1,1792,596,548,48,0,589,7,1800,1204,302,287
12,CĂLĂRAŞI,PERIŞORU,94223,"TUDOR VLADIMIRESCU","ŞCOALA GIMNAZIALA NR. 2 PERIŞORU",188,"Alegeri Prezidentiale",1,600,271,225,46,0,266,5,700,429,157,109
12,CĂLĂRAŞI,PLĂTĂREŞTI,104635,PLĂTĂREŞTI,"PRIMĂRIA PLĂTĂREŞTI",189,"Alegeri Prezidentiale",1,1074,642,431,211,0,631,11,1200,558,346,285
12,CĂLĂRAŞI,PLĂTĂREŞTI,104635,DOROBANŢU,"ŞCOALA PRIMARĂ NR.3 DOROBANȚU",190,"Alegeri Prezidentiale",1,781,373,235,138,0,369,4,900,527,212,157
12,CĂLĂRAŞI,PLĂTĂREŞTI,104635,"PODU PITARULUI","GRĂDINIȚA CU PROGRAM NORMAL NR.5 PODU PITARULUI",191,"Alegeri Prezidentiale",1,460,167,134,33,0,163,4,600,433,100,63
12,CĂLĂRAŞI,PLĂTĂREŞTI,104635,"PODU PITARULUI","GRĂDINIȚA CU PROGRAM NORMAL NR.5 PODU PITARULUI",192,"Alegeri Prezidentiale",1,318,228,147,81,0,225,3,500,272,159,66
12,CĂLĂRAŞI,RADOVANU,104751,RADOVANU,"ȘCOALA GIMNAZIALĂ ”DIMITRIE ION GHICA ” CORP B",193,"Alegeri Prezidentiale",1,978,423,373,48,2,418,5,1100,677,220,198
12,CĂLĂRAŞI,RADOVANU,104751,RADOVANU,"ȘCOALA GIMNAZIALĂ ”DIMITRIE ION GHICA ”",194,"Alegeri Prezidentiale",1,926,515,391,122,2,511,4,1100,585,266,245
12,CĂLĂRAŞI,RADOVANU,104751,RADOVANU,"ȘCOALA CU CLASELE I-IV COADELE",195,"Alegeri Prezidentiale",1,949,446,381,62,3,441,5,1100,654,235,206
12,CĂLĂRAŞI,RADOVANU,104751,"VALEA POPII","ȘCOALA CU CLASELE I-IV VALEA POPII",196,"Alegeri Prezidentiale",1,463,270,216,54,0,265,5,600,330,128,137
12,CĂLĂRAŞI,ROSEŢI,94312,ROSEŢI,"SCOALA GENERALA CU CLS I-IV-SECTOR",197,"Alegeri Prezidentiale",1,1898,761,729,32,0,740,21,1900,1139,345,395
12,CĂLĂRAŞI,ROSEŢI,94312,ROSEŢI,"SCOALA GIMNAZIALA IANCU ROSETTI-CENTRU",198,"Alegeri Prezidentiale",1,1265,611,559,52,0,606,5,1400,789,312,294
12,CĂLĂRAŞI,ROSEŢI,94312,ROSEŢI,"SCOALA CU CLS. I-IV-DEAL",199,"Alegeri Prezidentiale",1,1847,865,831,34,0,855,10,1900,1035,468,387
12,CĂLĂRAŞI,SĂRULEŞTI,104886,SĂRULEŞTI-GARĂ,"GRADINITA CU 4 GRUPE",200,"Alegeri Prezidentiale",1,1135,627,534,93,0,622,5,1300,673,220,402
12,CĂLĂRAŞI,SĂRULEŞTI,104886,SĂNDULIŢA,"SCOALA CU CLASELE I-IV",201,"Alegeri Prezidentiale",1,471,293,227,66,0,288,5,600,307,111,177
12,CĂLĂRAŞI,SĂRULEŞTI,104886,SĂRULEŞTI,"SCOALA CU CLASELE I-IV",202,"Alegeri Prezidentiale",1,338,183,136,47,0,180,3,500,317,61,119
12,CĂLĂRAŞI,SĂRULEŞTI,104886,SOLACOLU,"SCOALA CU CLASELE I-IV",203,"Alegeri Prezidentiale",1,206,98,64,34,0,96,2,400,302,45,51
12,CĂLĂRAŞI,SOHATU,105222,SOHATU,"ȘCOALA GENERALA NR.1",204,"Alegeri Prezidentiale",1,1262,667,457,210,0,651,16,1300,633,351,300
12,CĂLĂRAŞI,SOHATU,105222,PROGRESU,"ȘCOALA GENERALA NR.2",205,"Alegeri Prezidentiale",1,771,473,309,164,0,470,3,900,427,294,176
12,CĂLĂRAŞI,SPANŢOV,105259,SPANŢOV,"SCOALA GIMNAZIALA NR. 1 SPANTOV",206,"Alegeri Prezidentiale",1,822,413,384,29,0,406,7,1000,587,224,182
12,CĂLĂRAŞI,SPANŢOV,105259,"CETATEA VECHE","GRĂDINIŢA CU PROGRAM NORMAL NR. 3",207,"Alegeri Prezidentiale",1,695,360,323,37,0,355,5,800,440,200,155
12,CĂLĂRAŞI,SPANŢOV,105259,STANCEA,"ŞCOALA GIMNAZIALĂ NR. 2 STANCEA",208,"Alegeri Prezidentiale",1,1247,563,521,42,0,557,6,1400,837,383,174
12,CĂLĂRAŞI,SPANŢOV,105259,STANCEA,"ŞCOALA PRIMARĂ NR. 1 CLINCIU",209,"Alegeri Prezidentiale",1,866,454,436,18,0,449,5,1000,546,243,206
12,CĂLĂRAŞI,ŞOLDANU,105384,ŞOLDANU,"ŞCOALA GIMNAZIALĂ ”CONSTANTIN TEODORESCU” ŞOLDANU",210,"Alegeri Prezidentiale",1,1758,812,665,146,1,801,11,1800,988,395,406
12,CĂLĂRAŞI,ŞOLDANU,105384,NEGOEŞTI,"ŞCOALA PRIMARĂ NR.1 NEGOEŞTI",211,"Alegeri Prezidentiale",1,819,381,284,97,0,374,7,900,519,181,193
12,CĂLĂRAŞI,"ŞTEFAN CEL MARE",94562,"ŞTEFAN CEL MARE","SCOALA GIMNAZIALA DRAGOS MARIN",212,"Alegeri Prezidentiale",1,1548,597,561,35,1,583,14,1600,1003,272,311
12,CĂLĂRAŞI,"ŞTEFAN CEL MARE",94562,"ŞTEFAN CEL MARE","SCOALA GIMNAZIALA DRAGOS MARIN",213,"Alegeri Prezidentiale",1,1106,486,434,51,1,477,9,1200,714,238,239
12,CĂLĂRAŞI,"ŞTEFAN VODĂ",94580,"ŞTEFAN VODĂ","ŞCOALA CU CLS. I-VIII ŞTEFAN VODĂ",214,"Alegeri Prezidentiale",1,1068,438,397,41,0,435,3,1200,762,270,165
12,CĂLĂRAŞI,"ŞTEFAN VODĂ",94580,"ŞTEFAN VODĂ","ŞCOALA CU CLS. I-VIII ŞTEFAN VODĂ",215,"Alegeri Prezidentiale",1,808,384,327,57,0,376,8,900,516,227,149
12,CĂLĂRAŞI,"TĂMĂDĂU MARE",105455,"TĂMĂDĂU MARE","SCOALA GIMNAZIALA NR.1",216,"Alegeri Prezidentiale",1,1242,580,427,153,0,559,21,1400,820,281,278
12,CĂLĂRAŞI,"TĂMĂDĂU MARE",105455,PLUMBUITA,"SCOALA PRIMARA NR.2",217,"Alegeri Prezidentiale",1,718,294,200,94,0,293,1,800,506,161,132
12,CĂLĂRAŞI,ULMENI,105605,ULMENI,"SCOALA GIMNAZIALA GRIGORE MOISIL",218,"Alegeri Prezidentiale",1,1273,702,591,111,0,692,10,1300,598,348,344
12,CĂLĂRAŞI,ULMENI,105605,ULMENI,"SCOALA GIMNAZIALA NR.2 ULMENI",219,"Alegeri Prezidentiale",1,1435,548,502,46,0,542,6,1500,952,338,204
12,CĂLĂRAŞI,ULMENI,105605,ULMENI,"SCOALA PRIMARA NR.3 ULMENI",220,"Alegeri Prezidentiale",1,1258,653,593,60,0,649,4,1400,747,273,376
12,CĂLĂRAŞI,ULMU,94606,ULMU,"SCOALA CU CLASELE I-VIII ULMU",221,"Alegeri Prezidentiale",1,662,384,284,86,14,376,8,800,416,249,127
12,CĂLĂRAŞI,ULMU,94606,FĂUREI,"SCOALA CU CLASELE I-IV FAUREI",222,"Alegeri Prezidentiale",1,330,250,176,62,12,245,5,500,250,190,55
12,CĂLĂRAŞI,ULMU,94606,ZIMBRU,"FOSTA SCOALA PRIMARA ZIMBRU",223,"Alegeri Prezidentiale",1,97,90,54,36,0,90,0,300,210,59,31
12,CĂLĂRAŞI,UNIREA,94651,UNIREA,"SCOALA GIMNAZIALA NR 1 (LOCAL LANGA BISERICA)",224,"Alegeri Prezidentiale",1,1077,721,574,115,32,710,11,1200,479,419,291
12,CĂLĂRAŞI,UNIREA,94651,UNIREA,"SCOALA GIMNAZIALA NR 1 (LOCAL LANGA CAMINUL CULTURAL)",225,"Alegeri Prezidentiale",1,1207,816,644,115,57,804,12,1300,484,426,378
12,CĂLĂRAŞI,"VALEA ARGOVEI",105712,"VALEA ARGOVEI","SCOALA GIMNAZIALA VALEA ARGOVEI",226,"Alegeri Prezidentiale",1,1345,591,450,141,0,583,8,1400,809,299,284
12,CĂLĂRAŞI,"VALEA ARGOVEI",105712,SILIŞTEA,"SCOALA GENERALA SILISTEA",227,"Alegeri Prezidentiale",1,544,252,178,74,0,248,4,600,348,127,121
12,CĂLĂRAŞI,VASILAŢI,105829,VASILAŢI,"ȘCOALA CONSTANTIN BRÂNCOVEANU, LOCALUL CU ETAJ",228,"Alegeri Prezidentiale",1,961,432,323,109,0,426,6,1100,668,231,195
12,CĂLĂRAŞI,VASILAŢI,105829,VASILAŢI,"GRĂDINIȚA CU PROGRAM NORMAL VASILAȚI",229,"Alegeri Prezidentiale",1,1735,719,601,115,3,713,6,1800,1081,318,395
12,CĂLĂRAŞI,VASILAŢI,105829,NUCI,"ȘCOALA GIMNAZIALĂ NUCI",230,"Alegeri Prezidentiale",1,283,158,114,44,0,158,0,400,242,60,98
12,CĂLĂRAŞI,VASILAŢI,105829,POPEŞTI,"ȘCOALA GIMNAZIALĂ POPEȘTI",231,"Alegeri Prezidentiale",1,272,133,97,36,0,132,1,400,267,72,60
12,CĂLĂRAŞI,VÂLCELELE,94731,VÂLCELELE,"SCOALA GIMNAZIALA  FLORENTA ALBU VILCELELE",232,"Alegeri Prezidentiale",1,918,509,350,120,39,502,7,1108,599,249,253
12,CĂLĂRAŞI,VÂLCELELE,94731,FLOROAICA,"CONSILIUL LOCAL VILCELELE",233,"Alegeri Prezidentiale",1,480,303,204,83,16,296,7,599,296,196,100
12,CĂLĂRAŞI,"VLAD ŢEPEŞ",94768,"VLAD ŢEPEŞ","ȘCOALA VLAD ȚEPEȘ",234,"Alegeri Prezidentiale",1,1223,439,351,88,0,429,10,1400,961,215,214
12,CĂLĂRAŞI,"VLAD ŢEPEŞ",94768,"MIHAI VITEAZU","GRĂDINIȚA MIHAI VITEAZU",235,"Alegeri Prezidentiale",1,423,264,161,103,0,262,2,500,236,142,120
13,CLUJ,"MUNICIPIUL CLUJ-NAPOCA",54975,CLUJ-NAPOCA,"COLEGIUL ECONOMIC ”IULIAN POP”",1,"Alegeri Prezidentiale",1,793,726,14,668,44,716,10,882,156,667,49
13,CLUJ,"MUNICIPIUL CLUJ-NAPOCA",54975,CLUJ-NAPOCA,"COLEGIUL ECONOMIC ”IULIAN POP”",2,"Alegeri Prezidentiale",1,1173,860,547,228,85,840,20,1287,427,698,142
13,CLUJ,"MUNICIPIUL CLUJ-NAPOCA",54975,CLUJ-NAPOCA,"COLEGIUL TEHNIC DE TELECOMUNICATII ”AUGUSTIN MAIOR”,",3,"Alegeri Prezidentiale",1,1539,1464,668,794,2,1434,30,1690,226,1283,151
13,CLUJ,"MUNICIPIUL CLUJ-NAPOCA",54975,CLUJ-NAPOCA,"COLEGIUL TEHNIC DE TELECOMUNICATII ”AUGUSTIN MAIOR”,",4,"Alegeri Prezidentiale",1,1384,1573,689,875,9,1532,41,1669,96,1357,175
13,CLUJ,"MUNICIPIUL CLUJ-NAPOCA",54975,CLUJ-NAPOCA,"ŞCOALA ”ION CREANGĂ” ,",5,"Alegeri Prezidentiale",1,1049,967,597,370,0,953,14,1151,184,819,134
13,CLUJ,"MUNICIPIUL CLUJ-NAPOCA",54975,CLUJ-NAPOCA,"ŞCOALA ”ION CREANGĂ” ,",6,"Alegeri Prezidentiale",1,1533,1066,839,227,0,1052,14,1675,609,821,231
13,CLUJ,"MUNICIPIUL CLUJ-NAPOCA",54975,CLUJ-NAPOCA,"ŞCOALA ”ION CREANGĂ” ,",7,"Alegeri Prezidentiale",1,1253,844,632,210,2,832,12,1375,531,694,138
13,CLUJ,"MUNICIPIUL CLUJ-NAPOCA",54975,CLUJ-NAPOCA,"GRADINITA DUMBRAVA MINUNATA",8,"Alegeri Prezidentiale",2,1258,760,580,179,1,749,11,1373,613,648,101
13,CLUJ,"MUNICIPIUL CLUJ-NAPOCA",54975,CLUJ-NAPOCA,"GRADINITA ”DUMBRAVA MINUNATĂ”",9,"Alegeri Prezidentiale",1,1580,963,856,105,2,938,25,1735,772,753,185
13,CLUJ,"MUNICIPIUL CLUJ-NAPOCA",54975,CLUJ-NAPOCA,"GRĂDINIŢA ”DUMBRAVA MINUNATĂ” (FOSTA 66),",10,"Alegeri Prezidentiale",1,1507,910,775,135,0,896,14,1663,753,741,155
13,CLUJ,"MUNICIPIUL CLUJ-NAPOCA",54975,CLUJ-NAPOCA,"ŞCOALA ”IULIU HAŢIEGANU” (FOSTĂ NR.21)",11,"Alegeri Prezidentiale",1,899,700,449,194,57,692,8,986,286,571,121
13,CLUJ,"MUNICIPIUL CLUJ-NAPOCA",54975,CLUJ-NAPOCA,"ŞCOALA ”IULIU HAŢIEGANU” (FOSTĂ NR.21)",12,"Alegeri Prezidentiale",1,898,729,469,235,25,717,12,985,256,590,127
13,CLUJ,"MUNICIPIUL CLUJ-NAPOCA",54975,CLUJ-NAPOCA,"ŞCOALA ”IULIU HAŢIEGANU” (FOSTĂ NR.21)",13,"Alegeri Prezidentiale",1,1176,1061,713,292,56,1056,5,1291,230,925,131
13,CLUJ,"MUNICIPIUL CLUJ-NAPOCA",54975,CLUJ-NAPOCA,"ŞCOALA ”IULIU HAŢIEGANU” (FOSTĂ NR.21)",14,"Alegeri Prezidentiale",1,1971,1337,1178,159,0,1320,17,2165,828,1182,138
13,CLUJ,"MUNICIPIUL CLUJ-NAPOCA",54975,CLUJ-NAPOCA,"ŞCOALA ”IULIU HAŢIEGANU” (FOSTĂ NR.21)",15,"Alegeri Prezidentiale",1,1431,845,713,132,0,828,17,1571,726,696,132
13,CLUJ,"MUNICIPIUL CLUJ-NAPOCA",54975,CLUJ-NAPOCA,"ŞCOALA ”IULIU HAŢIEGANU” (FOSTĂ NR.21)",16,"Alegeri Prezidentiale",1,1599,955,867,88,0,939,16,1760,805,746,193
13,CLUJ,"MUNICIPIUL CLUJ-NAPOCA",54975,CLUJ-NAPOCA,"ŞCOALA ”IULIU HAŢIEGANU” (FOSTĂ NR.21)",17,"Alegeri Prezidentiale",1,1472,842,742,99,1,829,13,1416,574,655,174
13,CLUJ,"MUNICIPIUL CLUJ-NAPOCA",54975,CLUJ-NAPOCA,"GRĂDINIŢA ”ALBINUŢA” (FOSTĂ CĂSUŢA POVEŞTILOR), STR. GRIGORE ALEXANDRESCU, NR.21/A",18,"Alegeri Prezidentiale",1,1628,854,797,57,0,829,25,1688,834,637,192
13,CLUJ,"MUNICIPIUL CLUJ-NAPOCA",54975,CLUJ-NAPOCA,"ŞCOALA ”IULIU HAŢIEGANU” (FOSTĂ NR.21),",19,"Alegeri Prezidentiale",1,1555,955,725,230,0,935,20,1716,761,768,167
13,CLUJ,"MUNICIPIUL CLUJ-NAPOCA",54975,CLUJ-NAPOCA,"ŞCOALA ”IULIU HAŢIEGANU” (FOSTĂ NR.21),",20,"Alegeri Prezidentiale",1,1868,1195,1011,184,0,1172,23,2052,857,944,228
13,CLUJ,"MUNICIPIUL CLUJ-NAPOCA",54975,CLUJ-NAPOCA,"ŞCOALA ”IULIU HAŢIEGANU” (FOSTĂ NR.21),",21,"Alegeri Prezidentiale",1,1370,868,669,196,3,848,20,1504,636,686,162
13,CLUJ,"MUNICIPIUL CLUJ-NAPOCA",54975,CLUJ-NAPOCA,"COLEGIUL TEHNIC NAPOCA",22,"Alegeri Prezidentiale",1,1503,1247,799,448,0,1219,28,1658,411,998,221
13,CLUJ,"MUNICIPIUL CLUJ-NAPOCA",54975,CLUJ-NAPOCA,"LICEUL CU PROGRAM SPORTIV (FOSTA SCOALA NR.20).",23,"Alegeri Prezidentiale",1,1600,1102,886,216,0,1079,23,1757,655,897,182
13,CLUJ,"MUNICIPIUL CLUJ-NAPOCA",54975,CLUJ-NAPOCA,"LICEUL CU PROGRAM SPORTIV (FOSTA SCOALA NR.20).",24,"Alegeri Prezidentiale",1,1568,1029,904,125,0,1007,22,1722,693,860,147
13,CLUJ,"MUNICIPIUL CLUJ-NAPOCA",54975,CLUJ-NAPOCA,"LICEUL CU PROGRAM SPORTIV (FOSTA SCOALA NR.20).",25,"Alegeri Prezidentiale",1,1533,967,835,132,0,949,18,1683,716,782,167
13,CLUJ,"MUNICIPIUL CLUJ-NAPOCA",54975,CLUJ-NAPOCA,"LICEUL TEORETIC ”EUGEN PORA”",26,"Alegeri Prezidentiale",1,1638,1262,897,364,1,1233,29,1799,537,1028,205
13,CLUJ,"MUNICIPIUL CLUJ-NAPOCA",54975,CLUJ-NAPOCA,"LICEUL TEORETIC ”EUGEN PORA”",27,"Alegeri Prezidentiale",1,1603,1071,852,219,0,1044,27,1760,689,850,194
13,CLUJ,"MUNICIPIUL CLUJ-NAPOCA",54975,CLUJ-NAPOCA,"LICEUL TEORETIC ”EUGEN PORA”",28,"Alegeri Prezidentiale",1,880,814,457,324,33,804,10,965,151,665,139
13,CLUJ,"MUNICIPIUL CLUJ-NAPOCA",54975,CLUJ-NAPOCA,"LICEUL TEORETIC ”EUGEN PORA”",29,"Alegeri Prezidentiale",1,1695,1014,847,166,1,998,16,1862,848,799,199
13,CLUJ,"MUNICIPIUL CLUJ-NAPOCA",54975,CLUJ-NAPOCA,"SCOALA INTERNATIONALA ”SPECTRUM”",30,"Alegeri Prezidentiale",1,1734,1460,997,459,4,1445,15,1904,444,1256,189
13,CLUJ,"MUNICIPIUL CLUJ-NAPOCA",54975,CLUJ-NAPOCA,"SCOALA INTERNATIONALA ”SPECTRUM”",31,"Alegeri Prezidentiale",2,1418,1000,763,237,0,983,17,1557,557,848,135
13,CLUJ,"MUNICIPIUL CLUJ-NAPOCA",54975,CLUJ-NAPOCA,"SCOALA INTERNATIONALA ”SPECTRUM”",32,"Alegeri Prezidentiale",1,1272,1012,633,379,0,995,17,1378,366,869,126
13,CLUJ,"MUNICIPIUL CLUJ-NAPOCA",54975,CLUJ-NAPOCA,"SCOALA INTERNATIONALA ”SPECTRUM”",33,"Alegeri Prezidentiale",1,1180,835,634,128,73,808,27,1338,503,617,191
13,CLUJ,"MUNICIPIUL CLUJ-NAPOCA",54975,CLUJ-NAPOCA,"LICEUL TEORETIC ”EUGEN PORA”, STR.MOGOŞOAIA NR.6",34,"Alegeri Prezidentiale",2,1600,893,786,107,0,875,18,1457,564,676,199
13,CLUJ,"MUNICIPIUL CLUJ-NAPOCA",54975,CLUJ-NAPOCA,"SALA SPORTURILOR ”HOREA DEMIAN”",35,"Alegeri Prezidentiale",1,907,850,468,352,30,840,10,995,145,725,115
13,CLUJ,"MUNICIPIUL CLUJ-NAPOCA",54975,CLUJ-NAPOCA,"SALA SPORTURILOR ”HOREA DEMIAN”",36,"Alegeri Prezidentiale",1,1403,920,700,198,22,902,18,1519,599,774,128
13,CLUJ,"MUNICIPIUL CLUJ-NAPOCA",54975,CLUJ-NAPOCA,"SALA SPORTURILOR ”HOREA DEMIAN”",37,"Alegeri Prezidentiale",1,1388,997,755,217,25,982,15,1524,527,830,152
13,CLUJ,"MUNICIPIUL CLUJ-NAPOCA",54975,CLUJ-NAPOCA,"CENTRUL REGIONAL DE EXCELENŢĂ,",38,"Alegeri Prezidentiale",1,1610,940,795,145,0,915,25,1768,828,753,162
13,CLUJ,"MUNICIPIUL CLUJ-NAPOCA",54975,CLUJ-NAPOCA,"LICEUL TEORETIC ”ONISIFOR GHIBU”,",39,"Alegeri Prezidentiale",1,1725,1153,1033,120,0,1130,23,1895,742,897,233
13,CLUJ,"MUNICIPIUL CLUJ-NAPOCA",54975,CLUJ-NAPOCA,"LICEUL TEORETIC ”ONISIFOR GHIBU”,",40,"Alegeri Prezidentiale",1,1534,1085,809,275,1,1056,29,1684,599,907,149
13,CLUJ,"MUNICIPIUL CLUJ-NAPOCA",54975,CLUJ-NAPOCA,"LICEUL TEORETIC ”ONISIFOR GHIBU”,",41,"Alegeri Prezidentiale",1,1264,860,712,148,0,844,16,1387,527,722,122
13,CLUJ,"MUNICIPIUL CLUJ-NAPOCA",54975,CLUJ-NAPOCA,"LICEUL TEORETIC ”ONISIFOR GHIBU”,",42,"Alegeri Prezidentiale",1,1652,1272,929,343,0,1252,20,1814,542,1054,198
13,CLUJ,"MUNICIPIUL CLUJ-NAPOCA",54975,CLUJ-NAPOCA,"LICEUL TEORETIC ”ONISIFOR GHIBU”,",43,"Alegeri Prezidentiale",1,1270,880,697,183,0,856,24,1394,514,682,174
13,CLUJ,"MUNICIPIUL CLUJ-NAPOCA",54975,CLUJ-NAPOCA,"GRADINIŢA” MICA SIRENA” (FOSTĂ 64),",44,"Alegeri Prezidentiale",1,1483,960,820,140,0,942,18,1628,668,783,159
13,CLUJ,"MUNICIPIUL CLUJ-NAPOCA",54975,CLUJ-NAPOCA,"GRADINIŢA ”LICURICI” (FOSTA STELUŢA FERMECATĂ), STR.FÂNTÂNELE NR.46",45,"Alegeri Prezidentiale",1,1362,935,756,179,0,921,14,1495,560,733,188
13,CLUJ,"MUNICIPIUL CLUJ-NAPOCA",54975,CLUJ-NAPOCA,"GRADINIŢA ”LICURICI” (FOSTA STELUŢA FERMECATĂ), STR.FÂNTÂNELE NR.46",46,"Alegeri Prezidentiale",1,1628,1095,897,198,0,1078,17,1788,693,915,163
13,CLUJ,"MUNICIPIUL CLUJ-NAPOCA",54975,CLUJ-NAPOCA,"INSTITUTUL DE CERCETARI ÎN CHIMIE ”RALUCA RIPAN”",47,"Alegeri Prezidentiale",1,1643,1118,913,205,0,1103,15,1806,688,928,175
13,CLUJ,"MUNICIPIUL CLUJ-NAPOCA",54975,CLUJ-NAPOCA,"GRADINITA MICA SIRENA (FOSTA 12)",48,"Alegeri Prezidentiale",1,1453,930,797,133,0,911,19,1595,665,729,182
13,CLUJ,"MUNICIPIUL CLUJ-NAPOCA",54975,CLUJ-NAPOCA,"INSTITUTUL DE CERCETARI ÎN CHIMIE” RALUCA RIPAN”,",49,"Alegeri Prezidentiale",1,1516,1080,908,172,0,1065,15,1663,583,892,173
13,CLUJ,"MUNICIPIUL CLUJ-NAPOCA",54975,CLUJ-NAPOCA,"INSTITUTUL DE CERCETARI ÎN CHIMIE” RALUCA RIPAN”,",50,"Alegeri Prezidentiale",1,1857,1160,989,171,0,1142,18,2030,870,934,208
13,CLUJ,"MUNICIPIUL CLUJ-NAPOCA",54975,CLUJ-NAPOCA,"LICEUL DE INFORMATICĂ „TIBERIU POPOVICIU”",51,"Alegeri Prezidentiale",1,1559,1234,858,348,28,1214,20,1712,478,1033,181
13,CLUJ,"MUNICIPIUL CLUJ-NAPOCA",54975,CLUJ-NAPOCA,"LICEUL DE INFORMATICĂ „TIBERIU POPOVICIU”",52,"Alegeri Prezidentiale",1,1498,1384,853,513,18,1354,30,1645,261,1164,190
13,CLUJ,"MUNICIPIUL CLUJ-NAPOCA",54975,CLUJ-NAPOCA,"LICEUL DE INFORMATICĂ „TIBERIU POPOVICIU”",53,"Alegeri Prezidentiale",1,1610,1212,896,281,35,1186,26,1767,555,1004,182
13,CLUJ,"MUNICIPIUL CLUJ-NAPOCA",54975,CLUJ-NAPOCA,"LICEUL DE INFORMATICĂ „TIBERIU POPOVICIU”",54,"Alegeri Prezidentiale",2,1348,973,724,230,19,943,30,1481,508,829,114
13,CLUJ,"MUNICIPIUL CLUJ-NAPOCA",54975,CLUJ-NAPOCA,"LICEUL DE INFORMATICĂ „TIBERIU POPOVICIU”",55,"Alegeri Prezidentiale",1,1187,846,641,180,25,825,21,1304,458,691,134
13,CLUJ,"MUNICIPIUL CLUJ-NAPOCA",54975,CLUJ-NAPOCA,"LICEUL DE INFORMATICĂ „TIBERIU POPOVICIU”",56,"Alegeri Prezidentiale",1,1880,1542,1038,493,11,1517,25,2075,533,1351,166
13,CLUJ,"MUNICIPIUL CLUJ-NAPOCA",54975,CLUJ-NAPOCA,"LICEUL DE INFORMATICĂ „TIBERIU POPOVICIU”",57,"Alegeri Prezidentiale",1,2048,1682,1210,471,1,1652,30,2210,528,1534,118
13,CLUJ,"MUNICIPIUL CLUJ-NAPOCA",54975,CLUJ-NAPOCA,"LICEUL DE INFORMATICĂ „TIBERIU POPOVICIU”",58,"Alegeri Prezidentiale",2,1889,1444,1027,416,1,1415,29,2075,631,1267,148
13,CLUJ,"MUNICIPIUL CLUJ-NAPOCA",54975,CLUJ-NAPOCA,"LICEUL DE INFORMATICĂ „TIBERIU POPOVICIU”",59,"Alegeri Prezidentiale",1,1709,1651,990,660,1,1623,28,1898,247,1483,140
13,CLUJ,"MUNICIPIUL CLUJ-NAPOCA",54975,CLUJ-NAPOCA,"ASOCIAŢIA ”CARITATEA”",60,"Alegeri Prezidentiale",1,1964,1737,1217,520,0,1714,23,2157,420,1531,183
13,CLUJ,"MUNICIPIUL CLUJ-NAPOCA",54975,CLUJ-NAPOCA,"GRADINIŢA ”ZÎNA ZORILOR”, STR.L.PASTEUR NR.12",61,"Alegeri Prezidentiale",1,1791,1376,908,455,13,1346,30,1967,591,1152,194
13,CLUJ,"MUNICIPIUL CLUJ-NAPOCA",54975,CLUJ-NAPOCA,"FACULTATEA DE ARHITECTURĂ ŞI URBANISM, STR.OBSERVATORULUI NR.72",62,"Alegeri Prezidentiale",1,1529,1764,780,984,0,1732,32,1879,115,1554,178
13,CLUJ,"MUNICIPIUL CLUJ-NAPOCA",54975,CLUJ-NAPOCA,"FACULTATEA DE ARHITECTURĂ ŞI URBANISM, STR.OBSERVATORULUI NR.72",63,"Alegeri Prezidentiale",1,1400,1329,727,602,0,1307,22,1537,208,1186,121
13,CLUJ,"MUNICIPIUL CLUJ-NAPOCA",54975,CLUJ-NAPOCA,"FACULTATEA DE ARHITECTURĂ ŞI URBANISM, STR.OBSERVATORULUI NR.72",64,"Alegeri Prezidentiale",1,1122,1292,618,674,0,1273,19,1439,147,1155,118
13,CLUJ,"MUNICIPIUL CLUJ-NAPOCA",54975,CLUJ-NAPOCA,"FACULTATEA DE ARHITECTURĂ ŞI URBANISM, STR.OBSERVATORULUI NR.72",65,"Alegeri Prezidentiale",1,1292,1146,686,460,0,1119,27,1426,280,999,120
13,CLUJ,"MUNICIPIUL CLUJ-NAPOCA",54975,CLUJ-NAPOCA,"”PALATUL COPIILOR ”",66,"Alegeri Prezidentiale",1,1451,1230,664,566,0,1202,28,1585,355,1017,185
13,CLUJ,"MUNICIPIUL CLUJ-NAPOCA",54975,CLUJ-NAPOCA,"SCOALA ”IOAN BOB”",67,"Alegeri Prezidentiale",1,1414,1496,669,715,112,1470,26,1660,164,1231,239
13,CLUJ,"MUNICIPIUL CLUJ-NAPOCA",54975,CLUJ-NAPOCA,"COLEGIUL NAŢIONAL ”G.COŞBUC”",68,"Alegeri Prezidentiale",1,1159,926,629,243,54,907,19,1272,346,733,174
13,CLUJ,"MUNICIPIUL CLUJ-NAPOCA",54975,CLUJ-NAPOCA,"LICEUL TEORETIC ”GH. SINCAI”",69,"Alegeri Prezidentiale",2,1428,1259,799,459,1,1230,29,1568,309,1068,162
13,CLUJ,"MUNICIPIUL CLUJ-NAPOCA",54975,CLUJ-NAPOCA,"LICEUL TEORETIC ”GH. SINCAI”",70,"Alegeri Prezidentiale",1,1173,1237,716,382,139,1213,24,1287,50,895,318
13,CLUJ,"MUNICIPIUL CLUJ-NAPOCA",54975,CLUJ-NAPOCA,"LICEUL TEORETIC ”GH. SINCAI”",71,"Alegeri Prezidentiale",1,1674,1240,916,324,0,1210,30,1830,590,963,247
13,CLUJ,"MUNICIPIUL CLUJ-NAPOCA",54975,CLUJ-NAPOCA,"LICEUL TEORETIC ”GH. SINCAI”",72,"Alegeri Prezidentiale",1,1158,1078,705,370,3,1051,27,1271,193,880,171
13,CLUJ,"MUNICIPIUL CLUJ-NAPOCA",54975,CLUJ-NAPOCA,"LICEUL TEORETIC ”GH. SINCAI”",73,"Alegeri Prezidentiale",1,1408,979,761,185,33,964,15,1546,567,801,163
13,CLUJ,"MUNICIPIUL CLUJ-NAPOCA",54975,CLUJ-NAPOCA,"LICEUL TEORETIC ”GH. SINCAI”",74,"Alegeri Prezidentiale",1,1380,982,746,233,3,953,29,1507,525,811,142
13,CLUJ,"MUNICIPIUL CLUJ-NAPOCA",54975,CLUJ-NAPOCA,"ŞCOALA ”LIVIU REBREANU”",75,"Alegeri Prezidentiale",2,1569,978,797,181,0,963,15,1723,745,776,187
13,CLUJ,"MUNICIPIUL CLUJ-NAPOCA",54975,CLUJ-NAPOCA,"ŞCOALA ”LIVIU REBREANU”",76,"Alegeri Prezidentiale",1,1577,1060,838,222,0,1049,11,1732,672,873,176
13,CLUJ,"MUNICIPIUL CLUJ-NAPOCA",54975,CLUJ-NAPOCA,"ŞCOALA ”LIVIU REBREANU”",77,"Alegeri Prezidentiale",1,1573,911,769,142,0,886,25,1726,815,730,156
13,CLUJ,"MUNICIPIUL CLUJ-NAPOCA",54975,CLUJ-NAPOCA,"GRADINIŢA ”UNIVERSUL COPIILOR” (FOSTĂ NR.71)",78,"Alegeri Prezidentiale",1,1447,1029,754,275,0,1008,21,1581,552,820,188
13,CLUJ,"MUNICIPIUL CLUJ-NAPOCA",54975,CLUJ-NAPOCA,"ŞCOALA ” LIVIU REBREANU”( FOSTA CONSTANTIN BRÂNCOVEANU),ALEEA RETEZAT NR.4",79,"Alegeri Prezidentiale",1,1540,1016,761,255,0,998,18,1683,667,829,169
13,CLUJ,"MUNICIPIUL CLUJ-NAPOCA",54975,CLUJ-NAPOCA,"ŞCOALA ” LIVIU REBREANU” ( FOSTA CONSTANTIN BRÂNCOVEANU), ALEEA RETEZAT NR.4",80,"Alegeri Prezidentiale",2,1115,728,607,31,90,718,10,1224,496,550,168
13,CLUJ,"MUNICIPIUL CLUJ-NAPOCA",54975,CLUJ-NAPOCA,"ŞCOALA ” LIVIU REBREANU” ( FOSTA CONSTANTIN BRÂNCOVEANU), ALEEA RETEZAT NR.4",81,"Alegeri Prezidentiale",1,1366,898,691,207,0,886,12,1500,602,736,150
13,CLUJ,"MUNICIPIUL CLUJ-NAPOCA",54975,CLUJ-NAPOCA,"ŞCOALA ” LIVIU REBREANU” ( FOSTA CONSTANTIN BRÂNCOVEANU), ALEEA RETEZAT NR.4",82,"Alegeri Prezidentiale",1,936,616,484,57,75,608,8,1027,411,487,121
13,CLUJ,"MUNICIPIUL CLUJ-NAPOCA",54975,CLUJ-NAPOCA,"GRADINIŢA” BUBURUZA” (FOSTĂ NR. 70),",83,"Alegeri Prezidentiale",1,1138,758,548,136,74,752,6,1239,481,608,144
13,CLUJ,"MUNICIPIUL CLUJ-NAPOCA",54975,CLUJ-NAPOCA,"GRADINIŢA” BUBURUZA” (FOSTĂ NR. 70),",84,"Alegeri Prezidentiale",1,1560,913,735,178,0,903,10,1713,800,734,169
13,CLUJ,"MUNICIPIUL CLUJ-NAPOCA",54975,CLUJ-NAPOCA,"GRADINIŢA ”ACADEMIA PITICILOR”(FOSTĂ NR. 72),",85,"Alegeri Prezidentiale",1,1727,1167,944,223,0,1148,19,1905,738,933,215
13,CLUJ,"MUNICIPIUL CLUJ-NAPOCA",54975,CLUJ-NAPOCA,"GRADINIŢA ”ACADEMIA PITICILOR”(FOSTĂ NR. 72),",86,"Alegeri Prezidentiale",1,1457,916,699,217,0,898,18,1600,684,749,149
13,CLUJ,"MUNICIPIUL CLUJ-NAPOCA",54975,CLUJ-NAPOCA,"FOSTA ŞCOALĂ NR.6,",87,"Alegeri Prezidentiale",1,1390,762,648,114,0,748,14,1534,772,623,125
13,CLUJ,"MUNICIPIUL CLUJ-NAPOCA",54975,CLUJ-NAPOCA,"FOSTA ŞCOALĂ NR.6,",88,"Alegeri Prezidentiale",1,1559,1003,881,122,0,978,25,1704,701,798,180
13,CLUJ,"MUNICIPIUL CLUJ-NAPOCA",54975,CLUJ-NAPOCA,"FOSTA ŞCOALĂ NR.6,",89,"Alegeri Prezidentiale",1,1571,977,809,168,0,959,18,1725,748,781,178
13,CLUJ,"MUNICIPIUL CLUJ-NAPOCA",54975,CLUJ-NAPOCA,"FOSTA ŞCOALĂ NR.6,",90,"Alegeri Prezidentiale",1,1189,785,658,127,0,769,16,1307,522,622,147
13,CLUJ,"MUNICIPIUL CLUJ-NAPOCA",54975,CLUJ-NAPOCA,"ŞCOALA ”OCTAVIAN GOGA”",91,"Alegeri Prezidentiale",1,1512,1008,748,260,0,987,21,1644,636,843,144
13,CLUJ,"MUNICIPIUL CLUJ-NAPOCA",54975,CLUJ-NAPOCA,"ŞCOALA ”OCTAVIAN GOGA”",92,"Alegeri Prezidentiale",1,1433,1032,681,350,1,1019,13,1608,576,897,122
13,CLUJ,"MUNICIPIUL CLUJ-NAPOCA",54975,CLUJ-NAPOCA,"ŞCOALA ”OCTAVIAN GOGA”",93,"Alegeri Prezidentiale",1,1573,1005,718,287,0,990,15,1727,722,871,119
13,CLUJ,"MUNICIPIUL CLUJ-NAPOCA",54975,CLUJ-NAPOCA,"COLEGIUL NAŢIONAL”GEORGE COŞBUC”,",94,"Alegeri Prezidentiale",1,1194,786,604,119,63,772,14,1302,516,621,151
13,CLUJ,"MUNICIPIUL CLUJ-NAPOCA",54975,CLUJ-NAPOCA,"COLEGIUL NAŢIONAL”GEORGE COŞBUC”,",95,"Alegeri Prezidentiale",1,934,636,514,55,67,619,17,1024,388,497,122
13,CLUJ,"MUNICIPIUL CLUJ-NAPOCA",54975,CLUJ-NAPOCA,"GRADINIŢA ”POIENIŢA”,",96,"Alegeri Prezidentiale",1,1618,1252,906,346,0,1229,23,1777,525,1032,197
13,CLUJ,"MUNICIPIUL CLUJ-NAPOCA",54975,CLUJ-NAPOCA,"GRADINIŢA ”POIENIŢA”,",97,"Alegeri Prezidentiale",1,1490,1046,876,169,1,1031,15,1636,590,934,97
13,CLUJ,"MUNICIPIUL CLUJ-NAPOCA",54975,CLUJ-NAPOCA,"GRADINIŢA ”POIENIŢA”,",98,"Alegeri Prezidentiale",1,1852,1263,1004,259,0,1244,19,2034,771,1089,155
13,CLUJ,"MUNICIPIUL CLUJ-NAPOCA",54975,CLUJ-NAPOCA,"GRADINIŢA ”POIENIŢA”,",99,"Alegeri Prezidentiale",2,1283,1109,792,317,0,1094,15,1408,299,961,133
13,CLUJ,"MUNICIPIUL CLUJ-NAPOCA",54975,CLUJ-NAPOCA,"ŞCOALA ”CONSTANTIN BRÂNCUŞI”",100,"Alegeri Prezidentiale",1,1862,1328,1093,228,7,1308,20,1745,417,1093,215
13,CLUJ,"MUNICIPIUL CLUJ-NAPOCA",54975,CLUJ-NAPOCA,"ŞCOALA ”CONSTANTIN BRÂNCUŞI”",101,"Alegeri Prezidentiale",2,1600,1279,913,366,0,1248,31,1757,478,1066,182
13,CLUJ,"MUNICIPIUL CLUJ-NAPOCA",54975,CLUJ-NAPOCA,"ŞCOALA ”CONSTANTIN BRÂNCUŞI”",102,"Alegeri Prezidentiale",1,1300,1002,764,238,0,980,22,1427,425,834,146
13,CLUJ,"MUNICIPIUL CLUJ-NAPOCA",54975,CLUJ-NAPOCA,"ŞCOALA ”CONSTANTIN BRÂNCUŞI”",103,"Alegeri Prezidentiale",2,1522,982,819,160,3,961,21,1671,689,761,200
13,CLUJ,"MUNICIPIUL CLUJ-NAPOCA",54975,CLUJ-NAPOCA,"GRĂDINIŢA ”LUMEA COPIILOR”, STR.SEPTIMIU ALBINI NR 53",104,"Alegeri Prezidentiale",1,986,838,522,176,140,822,16,1082,244,667,155
13,CLUJ,"MUNICIPIUL CLUJ-NAPOCA",54975,CLUJ-NAPOCA,"CREŞA ”CASTELUL FERMECAT”, STR.SEPTIMIU ALBINI NR.91",105,"Alegeri Prezidentiale",1,1489,986,816,169,1,966,20,1635,649,781,185
13,CLUJ,"MUNICIPIUL CLUJ-NAPOCA",54975,CLUJ-NAPOCA,"CREŞA ”CASTELUL FERMECAT”, STR.SEPTIMIU ALBINI NR.91",106,"Alegeri Prezidentiale",1,1524,946,837,109,0,932,14,1673,727,764,168
13,CLUJ,"MUNICIPIUL CLUJ-NAPOCA",54975,CLUJ-NAPOCA,"GRĂDINIŢA ” LUMEA COPIILOR” (FOSTĂ NR. 20),",107,"Alegeri Prezidentiale",1,1694,1024,767,256,1,1001,23,1760,736,855,146
13,CLUJ,"MUNICIPIUL CLUJ-NAPOCA",54975,CLUJ-NAPOCA,"GRĂDINIŢA ” LUMEA COPIILOR” (FOSTĂ NR. 20),",108,"Alegeri Prezidentiale",1,1574,1029,802,227,0,1004,25,1728,699,832,172
13,CLUJ,"MUNICIPIUL CLUJ-NAPOCA",54975,CLUJ-NAPOCA,"LICEUL TEORETIC ”LUCIAN BLAGA”",109,"Alegeri Prezidentiale",1,1597,991,854,137,0,965,26,1754,763,777,188
13,CLUJ,"MUNICIPIUL CLUJ-NAPOCA",54975,CLUJ-NAPOCA,"LICEUL TEORETIC ”LUCIAN BLAGA”",110,"Alegeri Prezidentiale",1,1335,862,695,165,2,843,19,1466,604,681,162
13,CLUJ,"MUNICIPIUL CLUJ-NAPOCA",54975,CLUJ-NAPOCA,"LICEUL TEORETIC ”LUCIAN BLAGA”",111,"Alegeri Prezidentiale",1,1268,954,638,316,0,946,8,1392,438,780,166
13,CLUJ,"MUNICIPIUL CLUJ-NAPOCA",54975,CLUJ-NAPOCA,"LICEUL TEORETIC ”LUCIAN BLAGA”",112,"Alegeri Prezidentiale",1,1440,1029,758,271,0,1014,15,1581,552,842,172
13,CLUJ,"MUNICIPIUL CLUJ-NAPOCA",54975,CLUJ-NAPOCA,"ŞCOALA ” N.TITULESCU”",113,"Alegeri Prezidentiale",1,1749,1289,909,380,0,1274,15,1921,632,1064,210
13,CLUJ,"MUNICIPIUL CLUJ-NAPOCA",54975,CLUJ-NAPOCA,"ŞCOALA ” N.TITULESCU”",114,"Alegeri Prezidentiale",1,2072,1433,1155,278,0,1410,23,2276,843,1209,201
13,CLUJ,"MUNICIPIUL CLUJ-NAPOCA",54975,CLUJ-NAPOCA,"LICEUL TEHNOLOGIC ”AL. BORZA”",115,"Alegeri Prezidentiale",1,1502,1517,818,699,0,1486,31,1649,132,1311,175
13,CLUJ,"MUNICIPIUL CLUJ-NAPOCA",54975,CLUJ-NAPOCA,"LICEUL TEHNOLOGIC ”AL. BORZA”",116,"Alegeri Prezidentiale",1,1111,1312,596,716,0,1287,25,1459,147,1129,158
13,CLUJ,"MUNICIPIUL CLUJ-NAPOCA",54975,CLUJ-NAPOCA,"COLEGIUL TEHNIC DE TRANSPORTURI” TRANSILVANIA”",117,"Alegeri Prezidentiale",1,1490,1064,809,255,0,1037,27,1635,571,872,165
13,CLUJ,"MUNICIPIUL CLUJ-NAPOCA",54975,CLUJ-NAPOCA,"COLEGIUL TEHNIC DE TRANSPORTURI” TRANSILVANIA”",118,"Alegeri Prezidentiale",1,1851,1232,1083,149,0,1212,20,2033,801,992,220
13,CLUJ,"MUNICIPIUL CLUJ-NAPOCA",54975,CLUJ-NAPOCA,"COLEGIUL TEHNIC ”ENERGETIC”",119,"Alegeri Prezidentiale",1,1566,1217,882,333,2,1202,15,1720,503,971,231
13,CLUJ,"MUNICIPIUL CLUJ-NAPOCA",54975,CLUJ-NAPOCA,"UNIVERSITATEA ”BABES-BOLYAI” - FACULTATEA DE ŞTIINŢE ECONOMICE ŞI GESTIUNEA AFACERILOR,",120,"Alegeri Prezidentiale",1,1893,1892,955,937,0,1864,28,2079,187,1646,218
13,CLUJ,"MUNICIPIUL CLUJ-NAPOCA",54975,CLUJ-NAPOCA,"UNIVERSITATEA ”BABES-BOLYAI” - FACULTATEA DE ŞTIINŢE ECONOMICE ŞI GESTIUNEA AFACERILOR,",121,"Alegeri Prezidentiale",1,1295,1604,635,969,0,1580,24,1722,118,1399,181
13,CLUJ,"MUNICIPIUL CLUJ-NAPOCA",54975,CLUJ-NAPOCA,"ŞCOALA ”ION AGÂRBICEANU”,",122,"Alegeri Prezidentiale",1,1263,1015,640,343,32,996,19,1386,371,830,166
13,CLUJ,"MUNICIPIUL CLUJ-NAPOCA",54975,CLUJ-NAPOCA,"ŞCOALA ”ION AGÂRBICEANU”,",123,"Alegeri Prezidentiale",1,1380,1208,744,464,0,1191,17,1507,299,1060,131
13,CLUJ,"MUNICIPIUL CLUJ-NAPOCA",54975,CLUJ-NAPOCA,"ŞCOALA ”ION AGÂRBICEANU”,",124,"Alegeri Prezidentiale",1,1505,1027,784,243,0,1013,14,1653,626,864,149
13,CLUJ,"MUNICIPIUL CLUJ-NAPOCA",54975,CLUJ-NAPOCA,"ŞCOALA ”ION AGÂRBICEANU”,",125,"Alegeri Prezidentiale",1,1388,917,715,202,0,904,13,1524,607,760,144
13,CLUJ,"MUNICIPIUL CLUJ-NAPOCA",54975,CLUJ-NAPOCA,"ŞCOALA ”ION AGÂRBICEANU”,",126,"Alegeri Prezidentiale",1,1394,927,740,186,1,915,12,1522,595,767,148
13,CLUJ,"MUNICIPIUL CLUJ-NAPOCA",54975,CLUJ-NAPOCA,"ŞCOALA ”ION AGÂRBICEANU”,",127,"Alegeri Prezidentiale",1,1394,900,726,174,0,886,14,1530,630,741,145
13,CLUJ,"MUNICIPIUL CLUJ-NAPOCA",54975,CLUJ-NAPOCA,"ŞCOALA ”ION AGÂRBICEANU”,",128,"Alegeri Prezidentiale",2,1260,781,561,149,71,774,7,1383,602,639,135
13,CLUJ,"MUNICIPIUL CLUJ-NAPOCA",54975,CLUJ-NAPOCA,"GRĂDINŢA ”MĂMARUŢA” (FOSTĂ NR. 42),",129,"Alegeri Prezidentiale",1,1590,1292,894,376,22,1257,35,1746,454,1049,208
13,CLUJ,"MUNICIPIUL CLUJ-NAPOCA",54975,CLUJ-NAPOCA,"COLEGIUL TEHNIC ”ANGHEL SALIGNY”,",130,"Alegeri Prezidentiale",1,1446,1295,775,500,20,1279,16,1586,291,1090,189
13,CLUJ,"MUNICIPIUL CLUJ-NAPOCA",54975,CLUJ-NAPOCA,"COLEGIUL TEHNIC ”ANGHEL SALIGNY”,",131,"Alegeri Prezidentiale",2,1223,948,658,256,34,911,37,1342,394,740,171
13,CLUJ,"MUNICIPIUL CLUJ-NAPOCA",54975,CLUJ-NAPOCA,"COLEGIUL TEHNIC ”ANGHEL SALIGNY”,",132,"Alegeri Prezidentiale",1,1540,1222,855,347,20,1201,21,1692,470,949,252
13,CLUJ,"MUNICIPIUL CLUJ-NAPOCA",54975,CLUJ-NAPOCA,"COLEGIUL TEHNIC ”ANGHEL SALIGNY”",133,"Alegeri Prezidentiale",1,1567,1035,794,221,20,1007,28,1721,686,834,173
13,CLUJ,"MUNICIPIUL CLUJ-NAPOCA",54975,CLUJ-NAPOCA,"COLEGIUL DE MUZICĂ ”SIGISMUND TODUŢĂ” (FOSTUL GRUP SCOLAR DE MATERIAL RULANT- UNIREA)",134,"Alegeri Prezidentiale",1,1595,1004,853,151,0,991,13,1752,748,809,182
13,CLUJ,"MUNICIPIUL CLUJ-NAPOCA",54975,CLUJ-NAPOCA,"COLEGIUL DE MUZICĂ ”SIGISMUND TODUŢĂ” (FOSTUL GRUP SCOLAR DE MATERIAL RULANT- UNIREA)",135,"Alegeri Prezidentiale",1,882,938,403,387,148,919,19,1017,79,771,148
13,CLUJ,"MUNICIPIUL CLUJ-NAPOCA",54975,CLUJ-NAPOCA,"LICEUL TEORETIC ”A. IANCU”,",136,"Alegeri Prezidentiale",1,1545,1056,830,226,0,1030,26,1697,641,860,170
13,CLUJ,"MUNICIPIUL CLUJ-NAPOCA",54975,CLUJ-NAPOCA,"LICEUL TEORETIC ”VICTOR BABEŞ” (FOSTA SCOALA ”DAVID PRODAN”),",137,"Alegeri Prezidentiale",1,1789,1098,903,195,0,1072,26,1965,867,897,175
13,CLUJ,"MUNICIPIUL CLUJ-NAPOCA",54975,CLUJ-NAPOCA,"SEMINARUL TEOLOGIC ORTODOX (FOSTĂ ŞCOALA ”DAVID PRODAN”),",138,"Alegeri Prezidentiale",1,1737,1061,884,177,0,1046,15,1908,847,887,159
13,CLUJ,"MUNICIPIUL CLUJ-NAPOCA",54975,CLUJ-NAPOCA,"ŞCOALA ”HOREA”",139,"Alegeri Prezidentiale",1,1535,1071,693,348,30,1045,26,1686,615,856,189
13,CLUJ,"MUNICIPIUL CLUJ-NAPOCA",54975,CLUJ-NAPOCA,"LICEUL TEORETIC ”N. BALCESCU”,",140,"Alegeri Prezidentiale",1,1419,1546,653,893,0,1514,32,1808,262,1299,215
13,CLUJ,"MUNICIPIUL CLUJ-NAPOCA",54975,CLUJ-NAPOCA,"LICEUL TEORETIC UNITARIAN” JANOS ZSIGMOND”",141,"Alegeri Prezidentiale",1,1317,1573,568,979,26,1529,44,1646,73,1349,180
13,CLUJ,"MUNICIPIUL CLUJ-NAPOCA",54975,CLUJ-NAPOCA,"PAVILIONUL ”EXPO TRANSILVANIA”",142,"Alegeri Prezidentiale",1,1721,1263,973,290,0,1243,20,1890,627,1035,208
13,CLUJ,"MUNICIPIUL CLUJ-NAPOCA",54975,CLUJ-NAPOCA,"PAVILIONUL ”EXPO TRANSILVANIA”",143,"Alegeri Prezidentiale",1,1174,936,667,269,0,918,18,1288,352,804,114
13,CLUJ,"MUNICIPIUL CLUJ-NAPOCA",54975,CLUJ-NAPOCA,"PAVILIONUL ”EXPO TRANSILVANIA”",144,"Alegeri Prezidentiale",1,1567,1082,912,170,0,1062,20,1721,639,868,194
13,CLUJ,"MUNICIPIUL CLUJ-NAPOCA",54975,CLUJ-NAPOCA,"PAVILIONUL ”EXPO TRANSILVANIA”",145,"Alegeri Prezidentiale",1,1425,1005,755,250,0,992,13,1574,569,835,157
13,CLUJ,"MUNICIPIUL CLUJ-NAPOCA",54975,CLUJ-NAPOCA,"PAVILIONUL ”EXPO TRANSILVANIA”",146,"Alegeri Prezidentiale",1,1335,988,649,339,0,975,13,1466,478,860,115
13,CLUJ,"MUNICIPIUL CLUJ-NAPOCA",54975,CLUJ-NAPOCA,"PAVILIONUL ”EXPO TRANSILVANIA”",147,"Alegeri Prezidentiale",1,1559,1063,778,284,1,1043,20,1704,641,906,137
13,CLUJ,"MUNICIPIUL CLUJ-NAPOCA",54975,CLUJ-NAPOCA,"PAVILIONUL ”EXPO TRANSILVANIA”",148,"Alegeri Prezidentiale",1,1442,925,766,159,0,909,16,1583,658,745,164
13,CLUJ,"MUNICIPIUL CLUJ-NAPOCA",54975,CLUJ-NAPOCA,"GRĂDINIŢA ”DEGEŢICA” (FOSTĂ NR. 53),",149,"Alegeri Prezidentiale",1,1605,1098,881,217,0,1087,11,1763,665,913,174
13,CLUJ,"MUNICIPIUL CLUJ-NAPOCA",54975,CLUJ-NAPOCA,"GRĂDINIŢA ”DEGEŢICA” (FOSTĂ NR. 53),",150,"Alegeri Prezidentiale",1,1525,972,765,207,0,962,10,1675,703,845,117
13,CLUJ,"MUNICIPIUL CLUJ-NAPOCA",54975,CLUJ-NAPOCA,"ŞCOALA ” AL.VAIDA VOEVOD”,",151,"Alegeri Prezidentiale",1,1616,1170,887,283,0,1149,21,1775,605,1009,140
13,CLUJ,"MUNICIPIUL CLUJ-NAPOCA",54975,CLUJ-NAPOCA,"ŞCOALA ” AL.VAIDA VOEVOD”,",152,"Alegeri Prezidentiale",1,1652,1080,940,140,0,1068,12,1814,734,932,136
13,CLUJ,"MUNICIPIUL CLUJ-NAPOCA",54975,CLUJ-NAPOCA,"ŞCOALA ” AL.VAIDA VOEVOD”,",153,"Alegeri Prezidentiale",1,1472,1000,831,168,1,991,9,1616,616,854,137
13,CLUJ,"MUNICIPIUL CLUJ-NAPOCA",54975,CLUJ-NAPOCA,"ŞCOALA ” AL.VAIDA VOEVOD”,",154,"Alegeri Prezidentiale",1,1205,884,614,270,0,870,14,1323,439,743,127
13,CLUJ,"MUNICIPIUL CLUJ-NAPOCA",54975,CLUJ-NAPOCA,"ŞCOALA ” AL.VAIDA VOEVOD”,",155,"Alegeri Prezidentiale",1,1252,1003,673,330,0,988,15,1374,371,868,120
13,CLUJ,"MUNICIPIUL CLUJ-NAPOCA",54975,CLUJ-NAPOCA,"GRUP ŞCOLAR ”SAMUS”",156,"Alegeri Prezidentiale",1,1640,1132,822,310,0,1101,31,1801,669,913,188
13,CLUJ,"MUNICIPIUL CLUJ-NAPOCA",54975,CLUJ-NAPOCA,"GRUP ŞCOLAR ”SAMUS”",157,"Alegeri Prezidentiale",1,1646,1100,834,266,0,1082,18,1808,708,910,172
13,CLUJ,"MUNICIPIUL CLUJ-NAPOCA",54975,CLUJ-NAPOCA,"GRUP ŞCOLAR ”SAMUS”",158,"Alegeri Prezidentiale",1,1562,1184,825,359,0,1175,9,1723,539,969,206
13,CLUJ,"MUNICIPIUL CLUJ-NAPOCA",54975,CLUJ-NAPOCA,"COLEGIUL TEHNIC ”ANA ASLAN”( FOSTUL GRUP SC. CHIMIE IND ”TERAPIA” ),",159,"Alegeri Prezidentiale",1,1619,986,709,245,32,965,21,1428,442,806,159
13,CLUJ,"MUNICIPIUL CLUJ-NAPOCA",54975,CLUJ-NAPOCA,"COLEGIUL TEHNIC ”ANA ASLAN”( FOSTUL GRUP SC. CHIMIE IND ”TERAPIA” ),",160,"Alegeri Prezidentiale",1,1553,975,701,249,25,950,25,1705,730,774,176
13,CLUJ,"MUNICIPIUL CLUJ-NAPOCA",54975,CLUJ-NAPOCA,"EPARHIA REFORMATĂ DIN ARDEAL , STR.HOREA NR.51",161,"Alegeri Prezidentiale",1,1333,1144,611,523,10,1123,21,1463,319,961,162
13,CLUJ,"MUNICIPIUL CLUJ-NAPOCA",54975,CLUJ-NAPOCA,"ŞCOALA ”HOREA” (FOSTĂ NR.27)",162,"Alegeri Prezidentiale",1,1523,1093,871,222,0,1060,33,1672,579,927,133
13,CLUJ,"MUNICIPIUL CLUJ-NAPOCA",54975,CLUJ-NAPOCA,"LICEUL TEOLOGIC ”EMANUEL”",163,"Alegeri Prezidentiale",2,1734,1086,962,124,0,1064,22,1904,818,915,149
13,CLUJ,"MUNICIPIUL CLUJ-NAPOCA",54975,CLUJ-NAPOCA,"LICEUL TEOLOGIC ”EMANUEL”",164,"Alegeri Prezidentiale",1,1570,959,818,141,0,929,30,1868,909,764,165
13,CLUJ,"MUNICIPIUL CLUJ-NAPOCA",54975,CLUJ-NAPOCA,"GRĂDINIŢA ”NEGHINIŢĂ”",165,"Alegeri Prezidentiale",1,1936,1078,978,100,0,1059,19,2135,1057,902,157
13,CLUJ,"MUNICIPIUL CLUJ-NAPOCA",54975,CLUJ-NAPOCA,"GRĂDINIŢA ”NEGHINIŢĂ”",166,"Alegeri Prezidentiale",1,1358,821,666,155,0,805,16,1491,670,691,114
13,CLUJ,"MUNICIPIUL CLUJ-NAPOCA",54975,CLUJ-NAPOCA,"GRĂDINIŢA ”NEGHINIŢĂ”",167,"Alegeri Prezidentiale",2,1674,1092,905,187,0,1076,16,1838,746,900,176
13,CLUJ,"MUNICIPIUL CLUJ-NAPOCA",54975,CLUJ-NAPOCA,"GRĂDINIŢA ”NEGHINIŢĂ”",168,"Alegeri Prezidentiale",1,1801,1067,961,106,0,1046,21,1978,911,892,154
13,CLUJ,"MUNICIPIUL CLUJ-NAPOCA",54975,CLUJ-NAPOCA,"ŞCOALA ”EMIL ISAC”",169,"Alegeri Prezidentiale",1,1523,903,853,50,0,888,15,1680,777,741,147
13,CLUJ,"MUNICIPIUL CLUJ-NAPOCA",54975,CLUJ-NAPOCA,"ŞCOALA ”EMIL ISAC”",170,"Alegeri Prezidentiale",2,996,706,504,202,0,692,14,1093,387,575,117
13,CLUJ,"MUNICIPIUL CLUJ-NAPOCA",54975,CLUJ-NAPOCA,"ŞCOALA ”NICOLAE IORGA”",171,"Alegeri Prezidentiale",1,1595,1018,783,234,1,1008,10,1752,734,859,149
13,CLUJ,"MUNICIPIUL CLUJ-NAPOCA",54975,CLUJ-NAPOCA,"ŞCOALA ”NICOLAE IORGA”",172,"Alegeri Prezidentiale",1,1668,1078,860,218,0,1065,13,1832,754,931,134
13,CLUJ,"MUNICIPIUL CLUJ-NAPOCA",54975,CLUJ-NAPOCA,"ŞCOALA ”NICOLAE IORGA”",173,"Alegeri Prezidentiale",1,1413,853,725,128,0,842,11,1551,698,722,120
13,CLUJ,"MUNICIPIUL CLUJ-NAPOCA",54975,CLUJ-NAPOCA,"ŞCOALA ”NICOLAE IORGA”",174,"Alegeri Prezidentiale",1,1982,1219,1083,136,0,1205,14,2177,958,1064,141
13,CLUJ,"MUNICIPIUL CLUJ-NAPOCA",54975,CLUJ-NAPOCA,"LICEUL TEHNOLOGIC NR.1 (FOSTUL GRUP ŞCOLAR TEHNOFRIG), STR.MARAMUREŞULUI NR.165/A",175,"Alegeri Prezidentiale",1,1900,838,709,129,0,833,5,1867,1029,763,70
13,CLUJ,"MUNICIPIUL CLUJ-NAPOCA",54975,CLUJ-NAPOCA,"LICEUL TEHNOLOGIC NR.1 (FOSTUL GRUP ŞCOLAR TEHNOFRIG), STR.MARAMUREŞULUI NR.165/A",176,"Alegeri Prezidentiale",1,1971,1273,1052,221,0,1249,24,2134,861,1111,138
13,CLUJ,"MUNICIPIUL CLUJ-NAPOCA",54975,CLUJ-NAPOCA,"LICEUL TEHNOLOGIC ”AUREL VLAICU”",177,"Alegeri Prezidentiale",2,1290,905,648,257,0,890,15,1416,511,779,111
13,CLUJ,"MUNICIPIUL CLUJ-NAPOCA",54975,CLUJ-NAPOCA,"LICEUL TEHNOLOGIC ”AUREL VLAICU”",178,"Alegeri Prezidentiale",1,1748,1006,873,133,0,994,12,1920,914,843,151
13,CLUJ,"MUNICIPIUL CLUJ-NAPOCA",54975,CLUJ-NAPOCA,"GARAJE COMPANIA DE TRANSPORT PUBLIC CLUJ-NAPOCA S.A.",179,"Alegeri Prezidentiale",1,1644,958,854,103,1,949,9,1805,847,821,128
13,CLUJ,"MUNICIPIUL CLUJ-NAPOCA",54975,CLUJ-NAPOCA,"ŞCOALA ”TRAIAN DARJAN”",180,"Alegeri Prezidentiale",1,1694,1015,878,137,0,996,19,2065,1050,836,160
13,CLUJ,"MUNICIPIUL CLUJ-NAPOCA",54975,CLUJ-NAPOCA,"ŞCOALA ”TRAIAN DARJAN”",181,"Alegeri Prezidentiale",1,1905,1178,1038,140,0,1155,23,2093,915,1009,146
13,CLUJ,"MUNICIPIUL CLUJ-NAPOCA",54975,CLUJ-NAPOCA,"ŞCOALA ”TRAIAN DARJAN”",182,"Alegeri Prezidentiale",1,1811,1043,955,88,0,1028,15,1953,910,894,134
13,CLUJ,"MUNICIPIUL CLUJ-NAPOCA",54975,CLUJ-NAPOCA,"ŞCOALA ”TRAIAN DARJAN”",183,"Alegeri Prezidentiale",1,1436,838,771,67,0,829,9,1577,739,700,129
13,CLUJ,"MUNICIPIUL CÂMPIA TURZII",55357,"CÂMPIA TURZII","COLEGIUL TEHNIC ”VICTOR UNGUREANU”",184,"Alegeri Prezidentiale",1,1204,460,416,44,0,452,8,1323,863,316,136
13,CLUJ,"MUNICIPIUL CÂMPIA TURZII",55357,"CÂMPIA TURZII","COLEGIUL TEHNIC ”VICTOR UNGUREANU”",185,"Alegeri Prezidentiale",1,1169,518,486,32,0,504,14,1285,767,348,156
13,CLUJ,"MUNICIPIUL CÂMPIA TURZII",55357,"CÂMPIA TURZII","COLEGIUL TEHNIC ”VICTOR UNGUREANU”",186,"Alegeri Prezidentiale",1,1291,524,493,31,0,520,4,1419,895,363,157
13,CLUJ,"MUNICIPIUL CÂMPIA TURZII",55357,"CÂMPIA TURZII","LICEUL TEORETIC ”PAVEL DAN”",187,"Alegeri Prezidentiale",1,850,415,380,33,2,405,10,934,519,307,98
13,CLUJ,"MUNICIPIUL CÂMPIA TURZII",55357,"CÂMPIA TURZII","LICEUL TEORETIC ”PAVEL DAN”",188,"Alegeri Prezidentiale",1,1023,457,436,21,0,446,11,1124,667,334,112
13,CLUJ,"MUNICIPIUL CÂMPIA TURZII",55357,"CÂMPIA TURZII","LICEUL TEORETIC ”PAVEL DAN”",189,"Alegeri Prezidentiale",1,1028,492,431,61,0,483,9,1130,638,367,116
13,CLUJ,"MUNICIPIUL CÂMPIA TURZII",55357,"CÂMPIA TURZII","LICEUL TEORETIC ”PAVEL DAN”",190,"Alegeri Prezidentiale",1,1342,605,567,37,1,600,5,1475,870,478,122
13,CLUJ,"MUNICIPIUL CÂMPIA TURZII",55357,"CÂMPIA TURZII","LICEUL TEORETIC ”PAVEL DAN”",191,"Alegeri Prezidentiale",2,1072,497,442,55,0,490,7,1178,681,329,161
13,CLUJ,"MUNICIPIUL CÂMPIA TURZII",55357,"CÂMPIA TURZII","LICEUL TEORETIC ”PAVEL DAN”",192,"Alegeri Prezidentiale",2,1190,556,510,46,0,543,13,1308,752,398,145
13,CLUJ,"MUNICIPIUL CÂMPIA TURZII",55357,"CÂMPIA TURZII","ȘCOALA GIMNAZIALĂ ”AVRAM IANCU”",193,"Alegeri Prezidentiale",2,1200,588,547,41,0,579,9,1319,731,401,178
13,CLUJ,"MUNICIPIUL CÂMPIA TURZII",55357,"CÂMPIA TURZII","ȘCOALA GIMNAZIALĂ ”AVRAM IANCU”",194,"Alegeri Prezidentiale",2,1247,616,558,58,0,599,17,1371,755,410,189
13,CLUJ,"MUNICIPIUL CÂMPIA TURZII",55357,"CÂMPIA TURZII","ȘCOALA GIMNAZIALĂ ”AVRAM IANCU”",195,"Alegeri Prezidentiale",1,1191,592,529,34,29,572,20,1309,717,414,158
13,CLUJ,"MUNICIPIUL CÂMPIA TURZII",55357,"CÂMPIA TURZII","GRĂDINIȚA ”PINOCCHIO”",196,"Alegeri Prezidentiale",2,1268,655,626,27,2,642,13,1394,739,453,189
13,CLUJ,"MUNICIPIUL CÂMPIA TURZII",55357,"CÂMPIA TURZII","GRĂDINIȚA ”PINOCCHIO”",197,"Alegeri Prezidentiale",1,1343,590,567,23,0,583,7,1476,886,456,127
13,CLUJ,"MUNICIPIUL CÂMPIA TURZII",55357,"CÂMPIA TURZII","GRĂDINIȚA ”PINOCCHIO”",198,"Alegeri Prezidentiale",1,1384,677,639,38,0,666,11,1521,844,517,149
13,CLUJ,"MUNICIPIUL CÂMPIA TURZII",55357,"CÂMPIA TURZII","ȘCOALA GIMNAZIALĂ ”MIHAI VITEAZU”",199,"Alegeri Prezidentiale",1,1100,549,505,44,0,539,10,1209,660,399,140
13,CLUJ,"MUNICIPIUL CÂMPIA TURZII",55357,"CÂMPIA TURZII","ȘCOALA GIMNAZIALĂ ”MIHAI VITEAZU”",200,"Alegeri Prezidentiale",1,1525,742,672,70,0,733,9,1677,935,507,226
13,CLUJ,"MUNICIPIUL CÂMPIA TURZII",55357,"CÂMPIA TURZII","ȘCOALA GIMNAZIALĂ ”MIHAI VITEAZU”",201,"Alegeri Prezidentiale",1,1404,650,621,29,0,643,7,1543,893,469,174
13,CLUJ,"MUNICIPIUL CÂMPIA TURZII",55357,"CÂMPIA TURZII","ȘCOALA GIMNAZIALĂ ”MIHAI VITEAZU”",202,"Alegeri Prezidentiale",2,1185,488,435,53,0,483,5,1303,815,365,118
13,CLUJ,"MUNICIPIUL DEJ",55008,DEJ,"S.C. VASROM S.R.L DEJ",203,"Alegeri Prezidentiale",1,1292,529,498,29,2,522,7,1420,891,385,137
13,CLUJ,"MUNICIPIUL DEJ",55008,DEJ,"SCOALA GENERALA NR.1 DEJ",204,"Alegeri Prezidentiale",1,1327,695,612,82,1,684,11,1414,719,503,181
13,CLUJ,"MUNICIPIUL DEJ",55008,DEJ,"SCOALA MIHAI EMINESCU DEJ",205,"Alegeri Prezidentiale",1,831,461,314,38,109,451,10,913,452,322,129
13,CLUJ,"MUNICIPIUL DEJ",55008,DEJ,"SCOALA MIHAI EMINESCU DEJ",206,"Alegeri Prezidentiale",1,971,457,437,20,0,450,7,1067,610,306,144
13,CLUJ,"MUNICIPIUL DEJ",55008,DEJ,"SCOALA MIHAI EMINESCU DEJ",207,"Alegeri Prezidentiale",2,1575,884,789,94,1,866,18,1732,848,577,289
13,CLUJ,"MUNICIPIUL DEJ",55008,DEJ,"LICEUL AL.P.ILARIAN DIN DEJ",208,"Alegeri Prezidentiale",1,1524,720,690,30,0,706,14,1675,955,474,232
13,CLUJ,"MUNICIPIUL DEJ",55008,DEJ,"LICEUL AL.P.ILARIAN DIN DEJ",209,"Alegeri Prezidentiale",1,1522,782,725,57,0,769,13,1673,891,490,279
13,CLUJ,"MUNICIPIUL DEJ",55008,DEJ,"OCOLUL SILVIC DEJ",210,"Alegeri Prezidentiale",1,1366,758,649,37,72,739,19,1502,744,490,249
13,CLUJ,"MUNICIPIUL DEJ",55008,DEJ,"CLUBUL COPIILOR DEJ",211,"Alegeri Prezidentiale",1,1429,725,677,48,0,711,14,1571,846,466,245
13,CLUJ,"MUNICIPIUL DEJ",55008,DEJ,"CAMINUL CULTURAL DEJ",212,"Alegeri Prezidentiale",1,740,397,375,22,0,392,5,813,416,251,141
13,CLUJ,"MUNICIPIUL DEJ",55008,DEJ,"SCOALA GENERALA AVRAM IANCU DEJ",213,"Alegeri Prezidentiale",1,1410,661,620,41,0,654,7,1550,889,439,215
13,CLUJ,"MUNICIPIUL DEJ",55008,DEJ,"SCOALA GENERALA AVRAM IANCU DEJ",214,"Alegeri Prezidentiale",1,1515,722,683,39,0,717,5,1666,944,498,219
13,CLUJ,"MUNICIPIUL DEJ",55008,DEJ,"SERVICIUL DE ADMINISTRARE AL DOMENIULUI PUBLIC DEJ",215,"Alegeri Prezidentiale",1,1675,871,816,55,0,860,11,1842,971,623,237
13,CLUJ,"MUNICIPIUL DEJ",55008,DEJ,"SCOALA GENERALA NR.5 DEJ",216,"Alegeri Prezidentiale",1,1526,724,656,68,0,714,10,1678,954,497,217
13,CLUJ,"MUNICIPIUL DEJ",55008,DEJ,"SCOALA GENERALA NR.5 DEJ",217,"Alegeri Prezidentiale",1,1429,746,721,24,1,738,8,1571,825,492,246
13,CLUJ,"MUNICIPIUL DEJ",55008,DEJ,"GRADINITA PITICOT DEJ",218,"Alegeri Prezidentiale",1,960,506,460,46,0,498,8,1055,549,353,145
13,CLUJ,"MUNICIPIUL DEJ",55008,DEJ,"GRADINITA PITICOT DEJ",219,"Alegeri Prezidentiale",1,1252,544,512,31,1,531,13,1376,832,377,154
13,CLUJ,"MUNICIPIUL DEJ",55008,DEJ,"GRADINITA PITICOT DEJ",220,"Alegeri Prezidentiale",1,1385,695,667,27,1,686,9,1523,828,463,223
13,CLUJ,"MUNICIPIUL DEJ",55008,DEJ,"GRADINITA PARADISUL PITICILOR DEJ",221,"Alegeri Prezidentiale",1,1251,634,589,45,0,628,6,1375,741,419,209
13,CLUJ,"MUNICIPIUL DEJ",55008,DEJ,"SCOALA GENERALA AVRAM IANCU DEJ - CORP B",222,"Alegeri Prezidentiale",1,1384,647,603,43,1,642,5,1521,874,459,183
13,CLUJ,"MUNICIPIUL DEJ",55008,DEJ,"SCOALA GENERALA AVRAM IANCU DEJ - CORP B",223,"Alegeri Prezidentiale",1,1410,661,632,29,0,649,12,1550,889,482,167
13,CLUJ,"MUNICIPIUL DEJ",55008,DEJ,"SCOALA GENERALA OCNA DEJ",224,"Alegeri Prezidentiale",1,1026,520,485,35,0,519,1,1128,608,403,116
13,CLUJ,"MUNICIPIUL DEJ",55008,DEJ,"SCOALA GENERALA OCNA DEJ",225,"Alegeri Prezidentiale",1,1084,552,533,19,0,549,3,1191,639,398,151
13,CLUJ,"MUNICIPIUL DEJ",55008,DEJ,"GRADINITA DE COPII LUMEA PITICILOR",226,"Alegeri Prezidentiale",2,1431,616,599,17,0,606,10,1573,957,463,143
13,CLUJ,"MUNICIPIUL DEJ",55008,"ŞOMCUTU MIC","CAMINUL CULTURAL SOMCUTU MIC",227,"Alegeri Prezidentiale",1,477,211,188,23,0,210,1,524,313,126,84
13,CLUJ,"MUNICIPIUL DEJ",55008,PINTIC,"ŞCOALA GENERALĂ PINTIC",228,"Alegeri Prezidentiale",1,187,82,58,24,0,82,0,205,123,49,33
13,CLUJ,"MUNICIPIUL GHERLA",55384,GHERLA,"LICEUL TEORETIC PETRU MAIOR GHERLA",229,"Alegeri Prezidentiale",1,1531,841,704,56,81,816,25,1683,842,541,275
13,CLUJ,"MUNICIPIUL GHERLA",55384,GHERLA,"LICEUL TEORETIC PETRU MAIOR GHERLA",230,"Alegeri Prezidentiale",1,1625,911,828,83,0,895,16,1787,876,658,237
13,CLUJ,"MUNICIPIUL GHERLA",55384,GHERLA,"SCOALA GIMNAZIALA NR. 2",231,"Alegeri Prezidentiale",1,1463,758,709,49,0,743,15,1608,850,560,183
13,CLUJ,"MUNICIPIUL GHERLA",55384,GHERLA,"ŞCOALA GIMNAZIALĂ NR.1",232,"Alegeri Prezidentiale",1,1056,531,491,40,0,522,9,1161,630,382,140
13,CLUJ,"MUNICIPIUL GHERLA",55384,GHERLA,"SCOALA GIMNAZIALA NR. 1",233,"Alegeri Prezidentiale",1,1303,683,614,69,0,675,8,1432,749,470,205
13,CLUJ,"MUNICIPIUL GHERLA",55384,GHERLA,"SCOALA GIMNAZIALA NR. 1",234,"Alegeri Prezidentiale",1,1220,606,562,44,0,598,8,1341,735,443,155
13,CLUJ,"MUNICIPIUL GHERLA",55384,GHERLA,"ŞCOALA GIMNAZIALĂ NR.2",235,"Alegeri Prezidentiale",1,1794,919,867,51,1,910,9,1937,1018,724,186
13,CLUJ,"MUNICIPIUL GHERLA",55384,GHERLA,"ŞCOALA GIMNAZIALĂ NR.2",236,"Alegeri Prezidentiale",1,858,444,405,39,0,438,6,943,499,329,109
13,CLUJ,"MUNICIPIUL GHERLA",55384,GHERLA,"LICEUL TEORETIC ANA IPĂTESCU",237,"Alegeri Prezidentiale",1,1589,863,794,57,12,847,16,1697,834,666,181
13,CLUJ,"MUNICIPIUL GHERLA",55384,GHERLA,"LICEUL TEORETIC ANA IPĂTESCU",238,"Alegeri Prezidentiale",1,1403,714,655,57,2,706,8,1492,778,536,170
13,CLUJ,"MUNICIPIUL GHERLA",55384,GHERLA,"LICEUL TEORETIC ANA IPATESCU",239,"Alegeri Prezidentiale",1,1389,775,706,51,18,765,10,1477,702,588,177
13,CLUJ,"MUNICIPIUL GHERLA",55384,GHERLA,"LICEUL TEORETIC ANA IPATESCU",240,"Alegeri Prezidentiale",1,1447,706,662,44,0,699,7,1541,835,532,167
13,CLUJ,"MUNICIPIUL GHERLA",55384,GHERLA,"CLUBUL COPIILOR GHERLA",241,"Alegeri Prezidentiale",1,1520,778,717,61,0,777,1,1671,893,589,188
13,CLUJ,"MUNICIPIUL GHERLA",55384,GHERLA,"SCOALA CLS. I - IV BAITA",242,"Alegeri Prezidentiale",1,395,267,167,16,84,266,1,434,167,157,109
13,CLUJ,"MUNICIPIUL GHERLA",55384,HĂŞDATE,"ŞCOALA CLS. I - IV HĂŞDATE",243,"Alegeri Prezidentiale",1,279,260,122,19,119,258,2,306,46,111,147
13,CLUJ,"MUNICIPIUL GHERLA",55384,SILIVAŞ,"ŞCOALA CLS. I - IV SILIVAŞ",244,"Alegeri Prezidentiale",1,162,208,46,16,146,203,5,327,119,67,136
13,CLUJ,"MUNICIPIUL TURDA",55259,TURDA,"LICEUL TEORETIC ”JOSIKA MIKLOS”",245,"Alegeri Prezidentiale",1,904,466,398,68,0,458,8,993,527,342,116
13,CLUJ,"MUNICIPIUL TURDA",55259,TURDA,"LICEUL TEORETIC ”JOSIKA MIKLOS”",246,"Alegeri Prezidentiale",1,1177,636,598,37,1,622,14,1294,658,454,168
13,CLUJ,"MUNICIPIUL TURDA",55259,TURDA,"SCOALA GIMNAZIALĂ ”TEODOR MURĂŞANU”",247,"Alegeri Prezidentiale",1,1130,590,525,65,0,576,14,1242,652,436,140
13,CLUJ,"MUNICIPIUL TURDA",55259,TURDA,"COLEGIUL TEHNIC ”DR.IOAN RAŢIU”",248,"Alegeri Prezidentiale",1,1378,641,613,28,0,632,9,1515,874,501,131
13,CLUJ,"MUNICIPIUL TURDA",55259,TURDA,"COLEGIUL TEHNIC ”DR.IOAN RAŢIU”",249,"Alegeri Prezidentiale",1,998,351,297,54,0,348,3,1097,746,260,88
13,CLUJ,"MUNICIPIUL TURDA",55259,TURDA,"COLEGIUL TEHNIC ”DR.IOAN RAŢIU”",250,"Alegeri Prezidentiale",1,1079,368,351,17,0,364,4,1186,818,252,112
13,CLUJ,"MUNICIPIUL TURDA",55259,TURDA,"ŞCOALA GIMNAZIALĂ ”TEODOR MURĂŞANU”",251,"Alegeri Prezidentiale",1,1544,717,677,39,1,701,16,1697,980,539,162
13,CLUJ,"MUNICIPIUL TURDA",55259,TURDA,"ŞCOALA GIMNAZIALĂ ”TEODOR MURĂŞANU”",252,"Alegeri Prezidentiale",1,1203,626,547,79,0,616,10,1322,696,475,141
13,CLUJ,"MUNICIPIUL TURDA",55259,TURDA,"SCOALA GIMNAZIALA ”TEODOR MURĂŞANU”",253,"Alegeri Prezidentiale",1,1132,556,515,41,0,550,6,1244,688,423,127
13,CLUJ,"MUNICIPIUL TURDA",55259,TURDA,"COLEGIUL TEHNIC",254,"Alegeri Prezidentiale",1,1200,703,596,72,35,695,8,1319,616,527,168
13,CLUJ,"MUNICIPIUL TURDA",55259,TURDA,"COLEGIUL TEHNIC",255,"Alegeri Prezidentiale",1,1148,648,557,53,38,641,7,1262,614,488,153
13,CLUJ,"MUNICIPIUL TURDA",55259,TURDA,"COLEGIUL NAŢIONAL ”MIHAI VITEAZU”",256,"Alegeri Prezidentiale",1,1064,513,450,61,2,508,5,1169,656,382,126
13,CLUJ,"MUNICIPIUL TURDA",55259,TURDA,"COLEGIUL ”EMIL NEGRUŢIU”",257,"Alegeri Prezidentiale",1,1224,641,580,61,0,635,6,1345,704,501,134
13,CLUJ,"MUNICIPIUL TURDA",55259,TURDA,"ŞCOALA GIMNAZIALĂ ”ANDREI ŞAGUNA”",258,"Alegeri Prezidentiale",1,1233,550,515,35,0,539,11,1355,805,403,136
13,CLUJ,"MUNICIPIUL TURDA",55259,TURDA,"ŞCOALA GIMNAZIALĂ ”ANDREI ŞAGUNA”",259,"Alegeri Prezidentiale",1,959,549,471,78,0,543,6,1054,505,417,126
13,CLUJ,"MUNICIPIUL TURDA",55259,TURDA,"ŞCOALA GIMNAZIALĂ ”ANDREI ŞAGUNA”",260,"Alegeri Prezidentiale",1,1063,513,476,37,0,507,6,1168,655,400,107
13,CLUJ,"MUNICIPIUL TURDA",55259,TURDA,"ŞCOALA GIMNAZIALĂ ”AVRAM IANCU”",261,"Alegeri Prezidentiale",1,989,508,443,65,0,504,4,1087,579,377,127
13,CLUJ,"MUNICIPIUL TURDA",55259,TURDA,"ŞCOALA GIMNAZIALĂ ”AVRAM IANCU”",262,"Alegeri Prezidentiale",1,1158,549,519,30,0,540,9,1273,724,402,138
13,CLUJ,"MUNICIPIUL TURDA",55259,TURDA,"ŞCOALA GIMNAZIALĂ ”AVRAM IANCU”",263,"Alegeri Prezidentiale",1,1139,603,571,31,1,597,6,1252,649,452,145
13,CLUJ,"MUNICIPIUL TURDA",55259,TURDA,"ŞCOALA GIMNAZIALĂ ”AVRAM IANCU”",264,"Alegeri Prezidentiale",1,1236,572,555,17,0,565,7,1359,787,401,164
13,CLUJ,"MUNICIPIUL TURDA",55259,TURDA,"ŞCOALA GIMNAZIALĂ ”ION OPRIŞ”",265,"Alegeri Prezidentiale",1,1210,691,621,70,0,685,6,1290,599,508,177
13,CLUJ,"MUNICIPIUL TURDA",55259,TURDA,"ŞCOALA GIMNAZIALĂ ”ION OPRIŞ”",266,"Alegeri Prezidentiale",1,1031,547,504,43,0,538,9,1133,586,405,133
13,CLUJ,"MUNICIPIUL TURDA",55259,TURDA,"ŞCOALA GIMNAZIALĂ ”ION OPRIŞ”",267,"Alegeri Prezidentiale",1,1314,652,623,29,0,642,10,1444,792,476,166
13,CLUJ,"MUNICIPIUL TURDA",55259,TURDA,"LICEUL TEORETIC ”LIVIU REBREANU”",268,"Alegeri Prezidentiale",1,1403,707,647,60,0,694,13,1542,835,547,147
13,CLUJ,"MUNICIPIUL TURDA",55259,TURDA,"LICEUL TEORETIC ”LIVIU REBREANU”",269,"Alegeri Prezidentiale",1,1483,624,568,56,0,617,7,1630,1006,461,156
13,CLUJ,"MUNICIPIUL TURDA",55259,TURDA,"LICEUL TEORETIC ”LIVIU REBREANU”",270,"Alegeri Prezidentiale",1,1398,655,626,29,0,647,8,1537,882,472,175
13,CLUJ,"MUNICIPIUL TURDA",55259,TURDA,"LICEUL TEORETIC ”LIVIU REBREANU”",271,"Alegeri Prezidentiale",1,1260,617,596,21,0,602,15,1385,768,470,132
13,CLUJ,"MUNICIPIUL TURDA",55259,TURDA,"LICEUL TEORETIC ”LIVIU REBREANU”",272,"Alegeri Prezidentiale",1,1438,702,673,29,0,689,13,1581,879,546,143
13,CLUJ,"MUNICIPIUL TURDA",55259,TURDA,"LICEUL TEORETIC ”LIVIU REBREANU”",273,"Alegeri Prezidentiale",1,1060,435,402,33,0,430,5,1165,730,303,127
13,CLUJ,"MUNICIPIUL TURDA",55259,TURDA,"ŞCOALA GIMNAZIALĂ ”HOREA CLOŞCA ŞI CRIŞAN”",274,"Alegeri Prezidentiale",1,1385,701,631,70,0,695,6,1523,822,552,143
13,CLUJ,"MUNICIPIUL TURDA",55259,TURDA,"ŞCOALA GIMNAZIALĂ ”HOREA CLOŞCA ŞI CRIŞAN”",275,"Alegeri Prezidentiale",1,1398,646,615,31,0,634,12,1537,891,464,170
13,CLUJ,"MUNICIPIUL TURDA",55259,TURDA,"ŞCOALA GIMNAZIALĂ ”HOREA CLOŞCA ŞI CRIŞAN”",276,"Alegeri Prezidentiale",1,1367,614,592,21,1,606,8,1503,889,439,167
13,CLUJ,"MUNICIPIUL TURDA",55259,TURDA,"ŞCOALA GIMNAZIALĂ ”HOREA CLOŞCA ŞI CRIŞAN”",277,"Alegeri Prezidentiale",1,1325,608,577,31,0,594,14,1457,849,426,168
13,CLUJ,"MUNICIPIUL TURDA",55259,TURDA,"ŞCOALA GIMNAZIALĂ ”HOREA CLOŞCA ŞI CRIŞAN”",278,"Alegeri Prezidentiale",1,1202,581,546,35,0,574,7,1321,740,455,119
13,CLUJ,"MUNICIPIUL TURDA",55259,TURDA,"ŞCOALA GIMNAZIALĂ ”HOREA CLOŞCA ŞI CRIŞAN”",279,"Alegeri Prezidentiale",1,1195,539,525,14,0,535,4,1314,775,397,138
13,CLUJ,"MUNICIPIUL TURDA",55259,TURDA,"ŞCOALA GIMNAZIALĂ ”HOREA CLOŞCA ŞI CRIŞAN”",280,"Alegeri Prezidentiale",1,1357,572,555,17,0,560,12,1492,920,415,145
13,CLUJ,"MUNICIPIUL TURDA",55259,TURDA,"ŞCOALA PROFESIONALĂ POIANA",281,"Alegeri Prezidentiale",1,1283,669,648,21,0,666,3,1410,741,507,159
13,CLUJ,"MUNICIPIUL TURDA",55259,TURDA,"ŞCOALA PROFESIONALĂ POIANA",282,"Alegeri Prezidentiale",1,1456,778,745,33,0,775,3,1601,823,629,146
13,CLUJ,"ORAŞ HUEDIN",55446,HUEDIN,"SCOALA NOUA CU 16 SALI DE CLASA",283,"Alegeri Prezidentiale",1,1037,458,407,50,1,450,8,1140,682,346,104
13,CLUJ,"ORAŞ HUEDIN",55446,HUEDIN,"GRUPUL SCOLAR HUEDIN",284,"Alegeri Prezidentiale",1,1525,598,495,78,25,591,7,1532,934,456,135
13,CLUJ,"ORAŞ HUEDIN",55446,HUEDIN,"CASA DE COPII",285,"Alegeri Prezidentiale",1,1617,813,725,88,0,802,11,1778,965,563,239
13,CLUJ,"ORAŞ HUEDIN",55446,HUEDIN,"PRIMARIA ORAS HUEDIN",286,"Alegeri Prezidentiale",1,1408,601,503,98,0,584,17,1548,947,440,144
13,CLUJ,"ORAŞ HUEDIN",55446,HUEDIN,"LICEUL TEORETIC OCTAVIAN GOGA",287,"Alegeri Prezidentiale",1,1384,733,599,134,0,726,7,1521,788,586,140
13,CLUJ,"ORAŞ HUEDIN",55446,HUEDIN,"FOSTA CASĂ PAROHIALĂ",288,"Alegeri Prezidentiale",1,353,70,55,15,0,67,3,287,217,55,12
13,CLUJ,"ORAŞ HUEDIN",55446,BICĂLATU,"CAMIN CULTURAL",289,"Alegeri Prezidentiale",1,253,110,89,21,0,108,2,277,167,95,13
13,CLUJ,AGHIREŞU,55473,AGHIREŞU,"SCOALA GENERALA AGHIRESU",290,"Alegeri Prezidentiale",1,1069,434,365,69,0,428,6,1175,741,347,81
13,CLUJ,AGHIREŞU,55473,AGHIREŞU-FABRICI,"CĂMINUL CULTURAL AGHIREŞU FABRICI",291,"Alegeri Prezidentiale",1,1172,557,517,40,0,551,6,1288,731,449,102
13,CLUJ,AGHIREŞU,55473,AGHIREŞU-FABRICI,"SCOALA GENERALA AGHIRESU-FABRICI",292,"Alegeri Prezidentiale",1,1388,598,550,48,0,596,2,1526,928,509,87
13,CLUJ,AGHIREŞU,55473,ARGHIŞU,"CAMIN CULTURAL ARGHISU",293,"Alegeri Prezidentiale",1,100,59,39,20,0,58,1,109,50,45,13
13,CLUJ,AGHIREŞU,55473,BĂGARA,"SCOALA GENERALA BAGARA",294,"Alegeri Prezidentiale",1,320,140,105,35,0,132,8,351,211,112,20
13,CLUJ,AGHIREŞU,55473,DÂNCU,"SCOALA GENERALA DANCU",295,"Alegeri Prezidentiale",1,57,37,14,23,0,36,1,62,25,23,13
13,CLUJ,AGHIREŞU,55473,DOROLŢU,"CAMIN CULTURAL DOROLTU",296,"Alegeri Prezidentiale",2,72,67,43,24,0,67,0,78,11,65,2
13,CLUJ,AGHIREŞU,55473,INUCU,"SCOALA GENERALA INUCU",297,"Alegeri Prezidentiale",1,258,119,90,29,0,119,0,283,164,100,19
13,CLUJ,AGHIREŞU,55473,LEGHIA,"CAMIN CULTURAL LEGHIA",298,"Alegeri Prezidentiale",1,386,180,154,26,0,178,2,424,244,154,24
13,CLUJ,AGHIREŞU,55473,MACĂU,"IMOBIL CONSILIU NR. 7",299,"Alegeri Prezidentiale",1,509,226,193,33,0,217,9,559,333,203,14
13,CLUJ,AGHIREŞU,55473,TICU,"SCOALA GENERALA TICU",300,"Alegeri Prezidentiale",1,51,48,23,25,0,46,2,55,7,39,7
13,CLUJ,AGHIREŞU,55473,TICU-COLONIE,"SCOALA GENERALA TICU-COLONIE",301,"Alegeri Prezidentiale",1,129,61,41,20,0,61,0,141,80,54,7
13,CLUJ,AITON,55598,AITON,"CAMIN CULTURAL AITON",302,"Alegeri Prezidentiale",2,493,288,197,91,0,282,6,541,253,223,59
13,CLUJ,AITON,55598,REDIU,"CAMIN CULTURAL REDIU",303,"Alegeri Prezidentiale",1,378,264,174,89,1,263,1,415,151,227,36
13,CLUJ,ALUNIŞ,55623,ALUNIŞ,"CAMIN CULTURAL ALUNIS",304,"Alegeri Prezidentiale",1,436,200,161,39,0,198,2,479,279,158,40
13,CLUJ,ALUNIŞ,55623,CORNENI,"CAMIN CULTURAL CORNENI",305,"Alegeri Prezidentiale",1,105,46,26,20,0,45,1,115,69,31,14
13,CLUJ,ALUNIŞ,55623,GHIROLT,"SEDIU ADMINISTRATIV GHIROLT",306,"Alegeri Prezidentiale",1,324,156,120,36,0,156,0,355,199,123,33
13,CLUJ,ALUNIŞ,55623,VALE,"CAMIN CULTURAL VALE",307,"Alegeri Prezidentiale",1,73,90,41,49,0,89,1,94,4,59,30
13,CLUJ,APAHIDA,55687,APAHIDA,"SALA SPORT LICEU TEHNOLOGIC ”ŞTEFAN PASCU”",308,"Alegeri Prezidentiale",1,1831,1137,948,189,0,1119,18,1663,526,963,156
13,CLUJ,APAHIDA,55687,APAHIDA,"SALA SPORT LICEU TEHNOLOGIC ”ŞTEFAN PASCU”",309,"Alegeri Prezidentiale",2,1635,984,829,155,0,979,5,1806,822,844,135
13,CLUJ,APAHIDA,55687,APAHIDA,"SALA SPORT LICEU TEHNOLOGIC ”ŞTEFAN PASCU”",310,"Alegeri Prezidentiale",1,1781,1118,932,185,1,1110,8,1958,840,970,140
13,CLUJ,APAHIDA,55687,APAHIDA,"SALA SPORT LICEU TEHNOLOGIC ”ŞTEFAN PASCU”",311,"Alegeri Prezidentiale",2,1440,868,717,151,0,856,12,1583,715,733,123
13,CLUJ,APAHIDA,55687,SÂNNICOARĂ,"CĂMIN CULTURAL SÎNNICOARĂ",312,"Alegeri Prezidentiale",1,1852,1391,1108,283,0,1377,14,2036,645,1178,199
13,CLUJ,APAHIDA,55687,DEZMIR,"SEDIU PRIMĂRIE DEZMIR",313,"Alegeri Prezidentiale",1,1700,1249,913,335,1,1239,10,1869,620,1050,189
13,CLUJ,APAHIDA,55687,PATA,"SEDIU PRIMĂRIE PATA",314,"Alegeri Prezidentiale",1,502,381,282,99,0,376,5,551,170,269,107
13,CLUJ,APAHIDA,55687,CORPADEA,"CĂMIN CULTURAL CORPADEA",315,"Alegeri Prezidentiale",1,347,217,153,64,0,216,1,381,164,173,43
13,CLUJ,APAHIDA,55687,CÂMPENEŞTI,"SEDIU SECTOR PISCICOLA",316,"Alegeri Prezidentiale",1,135,171,80,91,0,169,2,248,77,141,28
13,CLUJ,AŞCHILEU,55776,"AŞCHILEU MARE","GRĂDINIŢA AŞCHILEU MARE",317,"Alegeri Prezidentiale",1,442,231,165,66,0,229,2,477,246,149,80
13,CLUJ,AŞCHILEU,55776,"AŞCHILEU MIC","GRĂDINIŢA AŞCHILEU MIC",318,"Alegeri Prezidentiale",1,230,131,86,45,0,130,1,252,121,78,52
13,CLUJ,AŞCHILEU,55776,CRISTOREL,"GRĂDINIŢA CRISTOREL",319,"Alegeri Prezidentiale",1,303,144,114,30,0,143,1,332,188,113,30
13,CLUJ,AŞCHILEU,55776,FODORA,"ŞCOALA PRIMARĂ FODORA",320,"Alegeri Prezidentiale",1,204,157,88,69,0,156,1,223,66,109,47
13,CLUJ,BACIU,55838,BACIU,"GRĂDINIȚĂ CU PROGRAM PRELUNGIT (STRUCTURĂ BLOCURI)",321,"Alegeri Prezidentiale",1,1611,1439,895,544,0,1417,22,1771,332,1308,109
13,CLUJ,BACIU,55838,BACIU,"CASA DE CULTURĂ BACIU",322,"Alegeri Prezidentiale",1,1658,1055,899,156,0,1035,20,1823,768,895,140
13,CLUJ,BACIU,55838,BACIU,"CASA DE CULTURĂ BACIU",323,"Alegeri Prezidentiale",1,1726,1150,957,192,1,1131,19,1898,748,981,150
13,CLUJ,BACIU,55838,BACIU,"CASA DE CULTURĂ BACIU",324,"Alegeri Prezidentiale",1,1119,593,455,137,1,582,11,1238,645,494,88
13,CLUJ,BACIU,55838,CORUŞU,"ȘCOALA CORUȘU",325,"Alegeri Prezidentiale",1,470,330,229,101,0,327,3,481,151,248,79
13,CLUJ,BACIU,55838,MERA,"ȘCOALA MERA",326,"Alegeri Prezidentiale",1,1290,542,490,52,0,541,1,1410,868,487,54
13,CLUJ,BACIU,55838,POPEŞTI,"ȘCOALA POPEȘTI",327,"Alegeri Prezidentiale",1,557,447,314,133,0,443,4,612,165,369,74
13,CLUJ,BACIU,55838,"SĂLIŞTEA NOUĂ","ȘCOALA SĂLIȘTEA NOUĂ",328,"Alegeri Prezidentiale",1,145,145,90,55,0,143,2,194,49,126,17
13,CLUJ,BACIU,55838,SUCEAGU,"ȘCOALA SUCEAGU",329,"Alegeri Prezidentiale",1,1141,589,457,94,38,584,5,1254,665,493,91
13,CLUJ,BĂIŞOARA,55918,BĂIŞOARA,"ŞCOALA GENERALĂ BĂIŞOARA",330,"Alegeri Prezidentiale",1,839,444,347,95,2,442,2,923,479,305,137
13,CLUJ,BĂIŞOARA,55918,SĂCEL,"ŞCOALA PRIMARĂ SĂCEL",331,"Alegeri Prezidentiale",1,343,197,161,36,0,194,3,377,180,165,29
13,CLUJ,BĂIŞOARA,55918,"MUNTELE BĂIŞORII","ŞCOALA PRIMARĂ MUNTELE BĂIŞORII",332,"Alegeri Prezidentiale",1,267,201,120,81,0,198,3,294,93,164,34
13,CLUJ,BĂIŞOARA,55918,"MUNTELE CACOVEI","ŞCOALA PRIMARĂ MUNTELE CACOVEI",333,"Alegeri Prezidentiale",2,79,50,37,13,0,48,2,87,37,28,20
13,CLUJ,BĂIŞOARA,55918,"MUNTELE SĂCELULUI","ŞCOALA PRIMARĂ MUNTELE SĂCELULUI",334,"Alegeri Prezidentiale",1,56,41,24,17,0,41,0,62,21,32,9
13,CLUJ,BĂIŞOARA,55918,"MOARA DE PĂDURE","GOSPODĂRIA D-NEI. PAŞCA TODORICA, SAT MOARA DE PĂDURE, NR. 24",335,"Alegeri Prezidentiale",1,118,88,40,48,0,86,2,130,42,67,19
13,CLUJ,BELIŞ,56014,BELIŞ,"PRIMĂRIA BELIŞ",336,"Alegeri Prezidentiale",1,494,549,223,326,0,545,4,643,94,436,109
13,CLUJ,BELIŞ,56014,BĂLCEŞTI,"MAGAZINUL SATESC (MAGAZIE DE MANA)",337,"Alegeri Prezidentiale",2,116,91,56,35,0,88,3,128,37,75,13
13,CLUJ,BELIŞ,56014,"DEALU BOTII","ŞCOALA PRIMARĂ DEALU BOTII",338,"Alegeri Prezidentiale",1,48,38,28,10,0,36,2,53,15,23,13
13,CLUJ,BELIŞ,56014,SMIDA,"ŞCOALA PRIMARĂ SMIDA",339,"Alegeri Prezidentiale",1,45,52,18,34,0,51,1,150,98,35,16
13,CLUJ,BELIŞ,56014,"GIURCUŢA DE SUS","MAGAZINUL SǍTESC",340,"Alegeri Prezidentiale",1,109,96,68,28,0,95,1,120,24,44,51
13,CLUJ,BELIŞ,56014,"POIANA HOREA","ŞCOALA PRIMARǍ POIANA HOREA",341,"Alegeri Prezidentiale",1,290,146,132,14,0,143,3,319,173,105,38
13,CLUJ,BOBÂLNA,56096,BĂBDIU,"SCOLA GENERALA BABDIU",342,"Alegeri Prezidentiale",1,129,87,56,31,0,86,1,142,55,47,39
13,CLUJ,BOBÂLNA,56096,BOBÂLNA,"SCOALA GENERALA BOBÎLNA",343,"Alegeri Prezidentiale",1,303,183,131,52,0,183,0,318,135,68,115
13,CLUJ,BOBÂLNA,56096,MAIA,"SCOALA GENERALA MAIA",344,"Alegeri Prezidentiale",2,182,119,78,41,0,118,1,200,81,64,54
13,CLUJ,BOBÂLNA,56096,OŞORHEL,"SCOALA GENERALA OSORHEL",345,"Alegeri Prezidentiale",1,105,62,37,25,0,60,2,116,54,27,33
13,CLUJ,BOBÂLNA,56096,PRUNI,"CAMINUL CULTURAL PRUNI",346,"Alegeri Prezidentiale",1,25,29,13,16,0,29,0,43,14,12,17
13,CLUJ,BOBÂLNA,56096,RĂZBUNENI,"SCOALA GENERALA RAZBUNENI",347,"Alegeri Prezidentiale",1,191,171,109,62,0,169,2,210,39,83,86
13,CLUJ,BOBÂLNA,56096,SUARĂŞ,"CAMINUL CULTURAL SUARĂŞ",348,"Alegeri Prezidentiale",1,114,110,55,55,0,110,0,125,15,69,41
13,CLUJ,BOBÂLNA,56096,VÂLCELELE,"SCOALA GENERALA VÎLCELELE",349,"Alegeri Prezidentiale",2,82,54,30,24,0,54,0,90,36,29,25
13,CLUJ,BONŢIDA,56210,BONŢIDA,"CAMIN CULTURAL BONTIDA",350,"Alegeri Prezidentiale",1,1583,743,645,98,0,740,3,1741,998,572,168
13,CLUJ,BONŢIDA,56210,BONŢIDA,"CLUBUL TINERETULUI",351,"Alegeri Prezidentiale",1,854,432,362,70,0,428,4,939,507,360,68
13,CLUJ,BONŢIDA,56210,RĂSCRUCI,"SCOALA GENERALA RASCRUCI",352,"Alegeri Prezidentiale",1,1246,761,592,168,1,749,12,1387,626,647,102
13,CLUJ,BONŢIDA,56210,COASTA,"CAMIN CULTURAL COASTA",353,"Alegeri Prezidentiale",1,90,71,38,33,0,70,1,99,28,55,15
13,CLUJ,BONŢIDA,56210,TĂUŞENI,"CAMINUL CULTURAL TAUSENI",354,"Alegeri Prezidentiale",1,40,57,18,39,0,55,2,79,22,44,11
13,CLUJ,BORŞA,56265,BORŞA,"CONSILIUL LOCAL BORSA",355,"Alegeri Prezidentiale",1,874,726,456,225,45,723,3,961,235,625,98
13,CLUJ,BORŞA,56265,GIULA,"CAMINUL CULTURAL GIULA",356,"Alegeri Prezidentiale",1,109,109,52,57,0,107,2,120,11,90,17
13,CLUJ,BORŞA,56265,CIUMĂFAIA,"SCOALA GENERALA CIUMĂFAIA",357,"Alegeri Prezidentiale",1,127,92,50,41,1,91,1,140,48,74,17
13,CLUJ,BUZA,56327,BUZA,"CAMINUL CULTURAL BUZA",358,"Alegeri Prezidentiale",2,997,441,384,56,1,434,7,1088,647,365,69
13,CLUJ,CĂIANU,56354,CĂIANU,"CAMINUL CULTURAL",359,"Alegeri Prezidentiale",1,600,312,255,57,0,310,2,660,348,248,62
13,CLUJ,CĂIANU,56354,BĂRĂI,"CAMINUL CULTURAL BĂRĂI",360,"Alegeri Prezidentiale",1,206,111,69,42,0,109,2,227,116,87,22
13,CLUJ,CĂIANU,56354,CĂIANU-VAMĂ,"SCOALA GENERALĂ CĂIANU VAMĂ",361,"Alegeri Prezidentiale",2,473,248,193,55,0,246,2,520,272,210,36
13,CLUJ,CĂIANU,56354,VAIDA-CĂMĂRAŞ,"SCOALA GIMNAZIALA VAIDA CĂMĂRAS",362,"Alegeri Prezidentiale",1,713,265,223,42,0,264,1,784,519,250,14
13,CLUJ,CĂLĂRAŞI,56425,CĂLĂRAŞI,"CAMINUL CULTURAL CALARASI",363,"Alegeri Prezidentiale",1,783,320,292,27,1,319,1,861,541,278,41
13,CLUJ,CĂLĂRAŞI,56425,BOGATA,"CĂMINUL CULTURAL BOGATA",364,"Alegeri Prezidentiale",1,936,388,363,24,1,385,3,1030,642,315,70
13,CLUJ,CĂLĂRAŞI,56425,CĂLĂRAŞI-GARĂ,"CAMINUL CULTURAL CALARASI -GARA",365,"Alegeri Prezidentiale",1,317,170,150,20,0,168,2,349,179,136,32
13,CLUJ,CĂLĂŢELE,56461,CĂLĂŢELE,"ŞCOALA DIN CĂLĂŢELE",366,"Alegeri Prezidentiale",1,716,294,239,55,0,285,9,788,494,196,89
13,CLUJ,CĂLĂŢELE,56461,CĂLĂŢELE,"CAMINUL CULTURAL CĂLĂŢELE PĂDURE",367,"Alegeri Prezidentiale",1,213,114,95,19,0,113,1,234,120,71,42
13,CLUJ,CĂLĂŢELE,56461,CĂLATA,"SCOALA CĂLATA",368,"Alegeri Prezidentiale",1,313,185,151,34,0,182,3,344,159,141,41
13,CLUJ,CĂLĂŢELE,56461,VĂLENI,"CĂMINUL CULTURAL VĂLENI",369,"Alegeri Prezidentiale",1,262,120,103,17,0,120,0,288,168,104,16
13,CLUJ,CĂLĂŢELE,56461,FINCIU,"CĂMINUL CULTURAL FINCIU",370,"Alegeri Prezidentiale",1,109,80,56,24,0,80,0,120,40,61,19
13,CLUJ,CĂLĂŢELE,56461,"DEALU NEGRU","ŞCOALA DIN DEALU NEGRU",371,"Alegeri Prezidentiale",1,345,277,182,95,0,276,1,380,103,213,63
13,CLUJ,CĂMĂRAŞU,56522,CĂMĂRAŞU,"CAMIN CULTURAL CAMARASU",372,"Alegeri Prezidentiale",1,1209,548,485,63,0,531,17,1330,782,352,179
13,CLUJ,CĂMĂRAŞU,56522,NĂOIU,"CAMIN CULTURAL NAOIU",373,"Alegeri Prezidentiale",1,367,183,149,34,0,181,2,404,221,82,99
13,CLUJ,CĂMĂRAŞU,56522,SÂMBOLENI,"CAMIN CULTURAL SIMBOLENI",374,"Alegeri Prezidentiale",1,477,209,176,33,0,208,1,525,316,133,75
13,CLUJ,"CĂPUŞU MARE",56568,"CĂPUŞU MARE","CĂMINUL CULTURAL CĂPUŞU MARE",375,"Alegeri Prezidentiale",1,681,319,248,71,0,314,5,749,430,265,49
13,CLUJ,"CĂPUŞU MARE",56568,"CĂPUŞU MIC","CENTRUL DE INFORMARE TURISTICĂ",376,"Alegeri Prezidentiale",2,594,305,220,85,0,297,8,653,348,258,39
13,CLUJ,"CĂPUŞU MARE",56568,AGÂRBICIU,"ȘCOALA PRIMARĂ AGÂRBICIU",377,"Alegeri Prezidentiale",1,374,285,242,42,1,283,2,411,126,244,39
13,CLUJ,"CĂPUŞU MARE",56568,DUMBRAVA,"FOSTUL SEDIU CAP",378,"Alegeri Prezidentiale",1,295,167,126,41,0,164,3,325,158,134,30
13,CLUJ,"CĂPUŞU MARE",56568,PĂNICENI,"CĂMINUL CLULTURAL",379,"Alegeri Prezidentiale",2,230,138,111,27,0,137,1,253,115,103,34
13,CLUJ,"CĂPUŞU MARE",56568,"DÂNGĂU MARE","ŞCOLA CU CLASELE I-IV DÎNGĂUL MARE",380,"Alegeri Prezidentiale",1,378,211,154,56,1,209,2,416,205,143,66
13,CLUJ,CĂŞEIU,56666,CĂŞEIU,"CĂMINUL CULTURAL",381,"Alegeri Prezidentiale",1,1216,600,544,56,0,592,8,1338,738,410,182
13,CLUJ,CĂŞEIU,56666,COPLEAN,"ŞCOALA COPLEAN",382,"Alegeri Prezidentiale",2,356,192,158,34,0,190,2,392,200,139,51
13,CLUJ,CĂŞEIU,56666,RUGĂŞEŞTI,"ŞCOALA GIMNAZIALĂ RUGĂŞEŞTI",383,"Alegeri Prezidentiale",1,881,412,371,41,0,407,5,969,557,276,131
13,CLUJ,CĂŞEIU,56666,GUGA,"ŞCOALA GUGA",384,"Alegeri Prezidentiale",1,259,129,111,18,0,127,2,285,156,83,44
13,CLUJ,CĂŞEIU,56666,"GÂRBĂU DEJULUI","ŞCOALA GARBĂUL DEJULUI",385,"Alegeri Prezidentiale",1,184,105,67,38,0,103,2,202,97,72,31
13,CLUJ,CĂŞEIU,56666,SĂLĂTRUC,"ŞCOALA SĂLĂTRUC",386,"Alegeri Prezidentiale",1,120,80,47,33,0,78,2,132,52,56,22
13,CLUJ,CĂŞEIU,56666,URIŞOR,"ŞCOALA PRIMARĂ URIŞOR",387,"Alegeri Prezidentiale",1,809,398,360,38,0,396,2,890,492,297,99
13,CLUJ,CĂTINA,56773,CĂTINA,"PRIMĂRIA COM.CĂTINA",388,"Alegeri Prezidentiale",1,907,400,346,54,0,400,0,998,598,290,110
13,CLUJ,CĂTINA,56773,FELDIOARA,"ŞCOLA CU CLS.I-IV FELDIOARA",389,"Alegeri Prezidentiale",1,409,201,158,43,0,199,2,450,249,149,50
13,CLUJ,CĂTINA,56773,COPRU,"CĂMINUL CULTURAL COPRU",390,"Alegeri Prezidentiale",1,94,69,50,19,0,69,0,103,34,46,23
13,CLUJ,CÂŢCĂU,57314,CÂŢCĂU,"SCOALA GIMNAZIALA CÎŢCĂU",391,"Alegeri Prezidentiale",1,1227,750,658,82,10,734,16,1350,600,547,187
13,CLUJ,CÂŢCĂU,57314,MUNCEL,"ŞCOAL GEN. MUNCEL",392,"Alegeri Prezidentiale",1,180,100,74,26,0,100,0,198,98,71,29
13,CLUJ,CÂŢCĂU,57314,SĂLIŞCA,"ŞCOALA GEN. SĂLIŞCA",393,"Alegeri Prezidentiale",1,458,435,315,105,15,433,2,504,69,377,56
13,CLUJ,"CEANU MARE",56844,"CEANU MARE","CAMIN CULTURAL CEANU MARE",394,"Alegeri Prezidentiale",1,1130,498,426,72,0,496,2,1243,745,342,154
13,CLUJ,"CEANU MARE",56844,BOIAN,"GRADINITA BOIAN",395,"Alegeri Prezidentiale",1,741,380,325,52,3,379,1,815,435,272,107
13,CLUJ,"CEANU MARE",56844,BOLDUŢ,"CAMIN CULTURAL BOLDUT",396,"Alegeri Prezidentiale",1,661,351,316,35,0,343,8,727,376,184,159
13,CLUJ,"CEANU MARE",56844,IACOBENI,"CAMIN CULTURAL IACOBENI",397,"Alegeri Prezidentiale",1,521,272,224,48,0,266,6,573,301,168,98
13,CLUJ,"CEANU MARE",56844,"DOSU NAPULUI","SCOALA DOSU NAPULUI",398,"Alegeri Prezidentiale",1,114,60,31,29,0,60,0,125,65,37,23
13,CLUJ,CHINTENI,56988,CHINTENI,"PRIMĂRIA COMUNEI CHINTENI",399,"Alegeri Prezidentiale",2,1386,993,741,252,0,972,21,1525,532,802,170
13,CLUJ,CHINTENI,56988,DEUŞU,"ȘCOALA CLS.I-IV DEUȘU",400,"Alegeri Prezidentiale",1,590,364,250,114,0,358,6,649,285,281,77
13,CLUJ,CHINTENI,56988,MĂCICAŞU,"ȘCOALA CLS.I-IV MĂCICAȘU",401,"Alegeri Prezidentiale",1,350,203,167,36,0,200,3,385,182,137,63
13,CLUJ,CHINTENI,56988,FEIURDENI,"PUNCT LUCRU FEIURDENI AL PRIMĂRIEI COMUNEI CHINTENI",402,"Alegeri Prezidentiale",1,386,256,177,79,0,254,2,425,169,142,112
13,CLUJ,CHIUIEŞTI,57083,CHIUIEŞTI,"SCOALA GIMNAZ. CHIUIESTI",403,"Alegeri Prezidentiale",1,1241,722,634,87,1,716,6,1365,643,555,161
13,CLUJ,CHIUIEŞTI,57083,MĂGOAJA,"SCOALA PRIMARA MAGOAJA",404,"Alegeri Prezidentiale",1,316,168,125,43,0,165,3,348,180,119,46
13,CLUJ,CHIUIEŞTI,57083,STRÂMBU,"SCOALA PRIMARA STRAMBU",405,"Alegeri Prezidentiale",1,337,200,145,55,0,197,3,371,171,138,59
13,CLUJ,CHIUIEŞTI,57083,HUTA,"SCOALA PRIMARA HUTA",406,"Alegeri Prezidentiale",1,101,69,56,13,0,69,0,111,42,50,19
13,CLUJ,CIUCEA,57163,CIUCEA,"SCOALA CU CL. I - VIII, CIUCEA",407,"Alegeri Prezidentiale",1,737,483,388,95,0,472,11,811,328,292,180
13,CLUJ,CIUCEA,57163,CIUCEA,"SCOALA CLASELE I - IV CALEA LATA",408,"Alegeri Prezidentiale",1,202,102,76,26,0,100,2,222,120,85,15
13,CLUJ,CIUCEA,57163,VÂNĂTORI,"SCOALA CLS.I-IV VANATORI",409,"Alegeri Prezidentiale",2,355,205,183,22,0,202,3,391,186,149,53
13,CLUJ,CIURILA,57225,CIURILA,"CONSILIUL LOCAL CIURILA",410,"Alegeri Prezidentiale",1,204,176,106,70,0,176,0,224,48,140,36
13,CLUJ,CIURILA,57225,"FILEA DE JOS","SCOALA GIMNAZIALA",411,"Alegeri Prezidentiale",2,229,189,116,73,0,184,5,252,63,118,66
13,CLUJ,CIURILA,57225,ŞUTU,"SCOALA GIMNAZIALA",412,"Alegeri Prezidentiale",2,284,152,105,47,0,151,1,312,160,120,31
13,CLUJ,CIURILA,57225,SĂLICEA,"CĂMINUL CULTURAL SĂLICEA",413,"Alegeri Prezidentiale",1,370,500,209,291,0,485,15,527,27,425,60
13,CLUJ,CIURILA,57225,SĂLIŞTE,"CAMIN CULTURAL SALISTE",414,"Alegeri Prezidentiale",1,75,61,39,22,0,60,1,83,22,50,10
13,CLUJ,COJOCNA,57350,COJOCNA,"ȘCOALA GIMNAZIALĂ COJOCNA SALA NR.4",415,"Alegeri Prezidentiale",1,1022,470,388,81,1,462,8,1124,654,378,84
13,CLUJ,COJOCNA,57350,COJOCNA,"ȘCOALA GIMNAZIALĂ COJOCNA SALA NR.7",416,"Alegeri Prezidentiale",1,883,402,340,61,1,395,7,971,569,333,62
13,CLUJ,COJOCNA,57350,BOJU,"ŞCOALA BOJU",417,"Alegeri Prezidentiale",2,339,236,159,77,0,236,0,373,137,194,42
13,CLUJ,COJOCNA,57350,BOJ-CĂTUN,"MAGAZIN COOPERATIST BOJU CATUN (FOSTUL)",418,"Alegeri Prezidentiale",1,184,88,63,25,0,87,1,202,114,75,12
13,CLUJ,COJOCNA,57350,CARA,"BIROUL PRIMĂRIEI CARA",419,"Alegeri Prezidentiale",1,682,356,279,76,1,351,5,758,402,287,64
13,CLUJ,COJOCNA,57350,"IURIU DE CÂMPIE","CĂMINUL CULTURAL IURIU DE CÎMPIE",420,"Alegeri Prezidentiale",1,199,125,70,55,0,124,1,219,94,77,47
13,CLUJ,CORNEŞTI,57449,IGRIŢIA,"CĂMIN CULTURAL IGRIŢIA",421,"Alegeri Prezidentiale",1,33,31,16,15,0,30,1,36,5,12,18
13,CLUJ,CORNEŞTI,57449,"TIOCU DE SUS","CĂMIN CULTURAL TIOCU DE SUS",422,"Alegeri Prezidentiale",1,72,63,29,34,0,62,1,79,16,45,17
13,CLUJ,CORNEŞTI,57449,"TIOCU DE JOS","CĂMIN CULTURAL TIOCU DE JOS",423,"Alegeri Prezidentiale",1,96,67,43,24,0,66,1,106,39,48,18
13,CLUJ,CORNEŞTI,57449,CORNEŞTI,"ŞCOALA GIMNAZIALĂ LIA MANOLIU CORNEŞTI",424,"Alegeri Prezidentiale",1,185,107,79,28,0,102,5,204,97,77,25
13,CLUJ,CORNEŞTI,57449,STOIANA,"COOPERATIVA VECHE- STOIANA",425,"Alegeri Prezidentiale",1,169,109,81,28,0,108,1,186,77,67,41
13,CLUJ,CORNEŞTI,57449,MORĂU,"CĂMIN CULTURAL MORĂU",426,"Alegeri Prezidentiale",1,44,64,25,39,0,64,0,83,19,45,19
13,CLUJ,CORNEŞTI,57449,LUJERDIU,"CENTRUL DE INFORMARE ŞI PROMOVARE TURISTICĂ LUJERDIU",427,"Alegeri Prezidentiale",1,253,187,118,69,0,185,2,278,91,157,28
13,CLUJ,CORNEŞTI,57449,BÂRLEA,"CĂMIN CULTURAL BÎRLEA",428,"Alegeri Prezidentiale",1,123,98,71,27,0,97,1,136,38,58,39
13,CLUJ,CORNEŞTI,57449,TIOLTIUR,"CĂMIN CULTURAL TIOLTIUR",429,"Alegeri Prezidentiale",2,145,81,55,26,0,80,1,160,79,56,24
13,CLUJ,CUZDRIOARA,55062,CUZDRIOARA,"SCOALA GIMNAZIALA CUZDRIOARA",430,"Alegeri Prezidentiale",1,905,448,406,42,0,445,3,996,548,301,144
13,CLUJ,CUZDRIOARA,55062,CUZDRIOARA,"SCOALA GIMNAZIALA CUZDRIOARA",431,"Alegeri Prezidentiale",1,832,391,359,31,1,387,4,915,524,269,118
13,CLUJ,CUZDRIOARA,55062,MĂNĂŞTUREL,"CĂMINUL CULTURAL",432,"Alegeri Prezidentiale",1,698,251,220,31,0,249,2,768,517,177,72
13,CLUJ,DĂBÂCA,57546,DĂBÂCA,"ŞCOALA GIMNAZIALĂ CU CLASELE I-VIII ”GELU ROMÂNUL”",433,"Alegeri Prezidentiale",1,537,350,237,112,1,349,1,591,241,252,97
13,CLUJ,DĂBÂCA,57546,"LUNA DE JOS","ŞCOALA CU CLASELE I-IV LUNA DE JOS",434,"Alegeri Prezidentiale",1,538,296,205,91,0,292,4,592,296,240,52
13,CLUJ,DĂBÂCA,57546,PÂGLIŞA,"CĂMINUL CULTURAL PÎGLIŞA",435,"Alegeri Prezidentiale",1,80,66,34,32,0,65,1,88,22,37,28
13,CLUJ,FELEACU,57582,FELEACU,"CAMINUL CULTURAL FELEACU DIN LOCALITATEA FELEACU",436,"Alegeri Prezidentiale",1,1642,1192,868,324,0,1175,17,1806,614,981,194
13,CLUJ,FELEACU,57582,GHEORGHIENI,"CAMINUL CULTURAL DIN LOCALITATEA GHEORGHENI",437,"Alegeri Prezidentiale",1,880,475,313,162,0,457,18,968,493,435,22
13,CLUJ,FELEACU,57582,VÂLCELE,"FOSTUL SEDIU CAP VILCELE DIN LOCALITATEA VILCELE",438,"Alegeri Prezidentiale",1,846,533,410,123,0,525,8,931,398,457,68
13,CLUJ,"FIZEŞU GHERLII",57644,"FIZEŞU GHERLII","SCOALA PRIMARA FIZESU GHERLII",439,"Alegeri Prezidentiale",1,1109,396,348,48,0,391,5,1220,824,321,70
13,CLUJ,"FIZEŞU GHERLII",57644,NICULA,"CAMIN CULTURAL NICULA",440,"Alegeri Prezidentiale",1,546,248,197,51,0,244,4,601,353,170,74
13,CLUJ,"FIZEŞU GHERLII",57644,BONŢ,"SCOALA CLS.I-IV BONT",441,"Alegeri Prezidentiale",1,281,129,105,24,0,129,0,309,180,87,42
13,CLUJ,"FIZEŞU GHERLII",57644,SĂCĂLAIA,"SCOALA CLS.I-IV SACALAIA",442,"Alegeri Prezidentiale",1,206,130,97,33,0,128,2,227,97,88,40
13,CLUJ,FLOREŞTI,57706,FLOREŞTI,"GRĂDINIȚA CU PROGRAM PRELUNGIT FLOREȘTI",443,"Alegeri Prezidentiale",1,1632,1147,826,321,0,1131,16,1795,648,1022,109
13,CLUJ,FLOREŞTI,57706,FLOREŞTI,"GRĂDINIȚA CU PROGRAM PRELUNGIT FLOREȘTI",444,"Alegeri Prezidentiale",1,1425,1120,814,305,1,1109,11,1568,448,998,111
13,CLUJ,FLOREŞTI,57706,FLOREŞTI,"GRĂDINIȚA CU PROGRAM PRELUNGIT FLOREȘTI",445,"Alegeri Prezidentiale",1,1564,1066,718,348,0,1053,13,1720,654,977,76
13,CLUJ,FLOREŞTI,57706,FLOREŞTI,"GRĂDINIȚA CU PROGRAM PRELUNGIT FLOREȘTI",446,"Alegeri Prezidentiale",1,1553,997,785,212,0,988,9,1708,711,895,93
13,CLUJ,FLOREŞTI,57706,FLOREŞTI,"GRĂDINIȚA CU PROGRAM PRELUNGIR FLOREȘTI",447,"Alegeri Prezidentiale",1,1379,954,685,268,1,940,14,1517,563,841,99
13,CLUJ,FLOREŞTI,57706,FLOREŞTI,"PRIMĂRIA COMUNEI FLOREȘTI",448,"Alegeri Prezidentiale",1,1533,1248,740,508,0,1226,22,1686,438,1041,185
13,CLUJ,FLOREŞTI,57706,FLOREŞTI,"PRIMĂRIA COMUNEI FLOREȘTI",449,"Alegeri Prezidentiale",1,1391,1130,647,483,0,1117,13,1530,400,986,131
13,CLUJ,FLOREŞTI,57706,FLOREŞTI,"ȘCOALA GIMNAZIALĂ ”GHEORGHE ȘINCAI” FLOREȘTI",450,"Alegeri Prezidentiale",1,1563,1009,812,197,0,1002,7,1719,710,912,90
13,CLUJ,FLOREŞTI,57706,FLOREŞTI,"ȘCOALA GIMNAZIALĂ ”GHEORGHE ȘINCAI” FLOREȘTI",451,"Alegeri Prezidentiale",1,976,838,515,323,0,828,10,1074,236,704,124
13,CLUJ,FLOREŞTI,57706,FLOREŞTI,"ȘCOALA GIMNAZIALĂ ”GHEORGHE ȘINCAI” FLOREȘTI",452,"Alegeri Prezidentiale",1,1666,1054,920,134,0,1031,23,1833,779,920,111
13,CLUJ,FLOREŞTI,57706,FLOREŞTI,"GRADINITA NR.2",453,"Alegeri Prezidentiale",1,1368,1109,778,331,0,1097,12,1505,396,995,102
13,CLUJ,FLOREŞTI,57706,FLOREŞTI,"GRADINITA NR.2",454,"Alegeri Prezidentiale",1,1489,999,802,196,1,984,15,1638,639,860,124
13,CLUJ,FLOREŞTI,57706,FLOREŞTI,ȘCOALA,455,"Alegeri Prezidentiale",1,1658,1162,871,291,0,1150,12,1824,662,1056,94
13,CLUJ,FLOREŞTI,57706,FLOREŞTI,ȘCOALA,456,"Alegeri Prezidentiale",1,1649,962,767,195,0,952,10,1814,852,891,61
13,CLUJ,FLOREŞTI,57706,FLOREŞTI,ȘCOALA,457,"Alegeri Prezidentiale",1,1739,1317,880,437,0,1301,16,1913,596,1187,114
13,CLUJ,FLOREŞTI,57706,FLOREŞTI,ȘCOALA,458,"Alegeri Prezidentiale",1,1593,1104,774,330,0,1096,8,1752,648,981,115
13,CLUJ,FLOREŞTI,57706,FLOREŞTI,ȘCOALA,459,"Alegeri Prezidentiale",1,1919,1171,898,273,0,1165,6,2111,940,1064,101
13,CLUJ,FLOREŞTI,57706,"LUNA DE SUS","SCOALA LUNA DE SUS",460,"Alegeri Prezidentiale",1,806,503,383,120,0,495,8,887,384,438,57
13,CLUJ,FLOREŞTI,57706,"LUNA DE SUS","SCOALA LUNA DE SUS",461,"Alegeri Prezidentiale",1,1007,593,490,85,18,585,8,1108,515,530,55
13,CLUJ,FLOREŞTI,57706,TĂUŢI,"CAMINUL CULTURAL TAUTI",462,"Alegeri Prezidentiale",1,198,212,99,113,0,210,2,218,6,176,34
13,CLUJ,FLOREŞTI,57706,FLOREŞTI,"ȘCOALA GIMNAZIALĂ ”GHEORGHE ȘINCAI” FLOREȘTI-GRĂDINIȚA",463,"Alegeri Prezidentiale",1,1819,872,737,135,0,862,10,2001,1129,783,79
13,CLUJ,FLOREŞTI,57706,FLOREŞTI,"ȘCOALA GIMNAZIALĂ ”GHEORGHE ȘINCAI” FLOREȘTI-GRĂDINIȚA",464,"Alegeri Prezidentiale",1,1555,1025,821,204,0,1016,9,1711,686,931,85
13,CLUJ,FRATA,57742,FRATA,"CAMINUL CULTURAL FRATA",465,"Alegeri Prezidentiale",1,1529,603,513,89,1,598,5,1682,1079,485,113
13,CLUJ,FRATA,57742,BERCHIEŞU,"CAMINUL CULTURAL BERCHIESU",466,"Alegeri Prezidentiale",1,498,230,188,42,0,229,1,548,318,175,54
13,CLUJ,FRATA,57742,"POIANA FRĂŢII","CAMINUL CULTURAL POIANA FRATII",467,"Alegeri Prezidentiale",1,176,84,62,22,0,84,0,194,110,63,21
13,CLUJ,FRATA,57742,"SOPORU DE CÂMPIE","CAMINUL CULTURAL SOPORU DE CIMPIE",468,"Alegeri Prezidentiale",1,978,336,297,39,0,331,5,1076,740,237,94
13,CLUJ,GÂRBĂU,57948,GÂRBĂU,"CAMINUL CULTURAL GARBAU",469,"Alegeri Prezidentiale",2,572,329,271,58,0,324,5,629,300,250,74
13,CLUJ,GÂRBĂU,57948,VIŞTEA,"SCOALA PRIMARA VISTEA",470,"Alegeri Prezidentiale",1,593,334,289,45,0,331,3,652,318,291,40
13,CLUJ,GÂRBĂU,57948,TUREA,"SCOALA CU CLASELE I-IV TUREA",471,"Alegeri Prezidentiale",1,431,218,180,38,0,217,1,474,256,195,22
13,CLUJ,GÂRBĂU,57948,NĂDĂŞELU,"CĂMINUL CULTURAL NĂDĂȘELU",472,"Alegeri Prezidentiale",1,205,177,109,68,0,175,2,226,49,143,32
13,CLUJ,GÂRBĂU,57948,CORNEŞTI,"CAMINUL CULTURAL CORNESTI",473,"Alegeri Prezidentiale",1,94,74,36,38,0,74,0,103,29,61,13
13,CLUJ,GEACA,57831,GEACA,"CAMIN CULTURAL GEACA",474,"Alegeri Prezidentiale",1,432,214,160,54,0,212,2,475,261,150,62
13,CLUJ,GEACA,57831,SUCUTARD,"CAMINUL CULTURAL SUCUTARD",475,"Alegeri Prezidentiale",1,282,159,120,39,0,158,1,310,151,127,31
13,CLUJ,GEACA,57831,LACU,"CAMINUL CULTURAL LACU",476,"Alegeri Prezidentiale",1,224,118,101,17,0,115,3,246,128,90,25
13,CLUJ,GEACA,57831,LEGII,"CAMINUL CULTURAL LEGII",477,"Alegeri Prezidentiale",2,120,86,52,34,0,84,2,132,46,67,17
13,CLUJ,GEACA,57831,CHIRIŞ,"SCOALA CHIRIS",478,"Alegeri Prezidentiale",1,63,34,20,14,0,34,0,69,35,24,10
13,CLUJ,GEACA,57831,PUINI,"CAMINUL CULTURAL PUINI",479,"Alegeri Prezidentiale",1,71,41,23,18,0,41,0,78,37,26,15
13,CLUJ,GILĂU,57902,GILĂU,"CASA DE CULTURĂ ”DUMITRU SOPON”",480,"Alegeri Prezidentiale",1,1884,1231,985,245,1,1213,18,2072,841,999,214
13,CLUJ,GILĂU,57902,GILĂU,"CĂMINUL CULTURAL VECHI GILĂU",481,"Alegeri Prezidentiale",1,1885,1149,984,164,1,1134,15,2074,925,935,199
13,CLUJ,GILĂU,57902,GILĂU,"LICEUL TEORETIC ”GELU VOIEVOD”, CLĂDIREA INTERNAT",482,"Alegeri Prezidentiale",1,1962,1012,898,114,0,996,16,2158,1146,824,172
13,CLUJ,GILĂU,57902,"SOMEŞU RECE","CĂMINUL CULTURAL SOMEȘU RECE",483,"Alegeri Prezidentiale",1,1051,663,471,192,0,655,8,1156,493,509,146
13,CLUJ,GILĂU,57902,"SOMEŞU RECE","GRĂDINIȚA - UZINA ELECTRICĂ",484,"Alegeri Prezidentiale",2,521,233,178,55,0,231,2,573,340,150,81
13,CLUJ,IARA,58008,AGRIŞ,SCOALA,485,"Alegeri Prezidentiale",1,324,114,92,22,0,114,0,356,242,88,26
13,CLUJ,IARA,58008,"CACOVA IERII",SCOALA,486,"Alegeri Prezidentiale",1,334,149,124,25,0,148,1,367,218,101,47
13,CLUJ,IARA,58008,"FĂGETU IERII",SCOALA,487,"Alegeri Prezidentiale",1,251,113,96,17,0,113,0,276,163,78,35
13,CLUJ,IARA,58008,IARA,"ȘCOALA GIMNAZIALA CU CLASELE V-VIII IARA",488,"Alegeri Prezidentiale",1,756,309,248,61,0,305,4,832,523,209,96
13,CLUJ,IARA,58008,IARA,"SCOALA GIMNAZIALA CU CLASELE V-VII IARA",489,"Alegeri Prezidentiale",1,870,285,260,25,0,282,3,957,672,183,99
13,CLUJ,IARA,58008,MAŞCA,SCOALA,490,"Alegeri Prezidentiale",1,124,50,33,17,0,50,0,136,86,39,11
13,CLUJ,IARA,58008,OCOLIŞEL,SCOALA,491,"Alegeri Prezidentiale",1,105,50,34,16,0,50,0,116,66,30,20
13,CLUJ,IARA,58008,SURDUC,SCOALA,492,"Alegeri Prezidentiale",1,245,121,101,20,0,120,1,270,149,96,24
13,CLUJ,IARA,58008,"VALEA VADULUI",SCOALA,493,"Alegeri Prezidentiale",2,38,47,15,32,0,46,1,62,15,37,9
13,CLUJ,IARA,58008,BORZEŞTI,"CASA PROPRIETATE PARTICULARA",494,"Alegeri Prezidentiale",1,55,46,17,29,0,46,0,61,15,32,14
13,CLUJ,IARA,58008,BURU,"CASA PROPRIETATE PARTICULARĂ",495,"Alegeri Prezidentiale",1,135,91,54,37,0,89,2,149,58,67,22
13,CLUJ,IARA,58008,LUNGEŞTI,"CASA PROPRIETATE PARTICULARĂ",496,"Alegeri Prezidentiale",1,34,35,15,20,0,35,0,37,2,21,14
13,CLUJ,IARA,58008,"MĂGURA IERII","CASA PROPRIETATE PARTICULARĂ",497,"Alegeri Prezidentiale",1,20,22,7,15,0,22,0,43,21,15,7
13,CLUJ,ICLOD,58142,ICLOD,"CENTRUL CULTURAL ICLOD",498,"Alegeri Prezidentiale",1,1668,881,733,147,1,874,7,1835,954,696,178
13,CLUJ,ICLOD,58142,FUNDĂTURA,"SCOALA DIN FUNDATURA",499,"Alegeri Prezidentiale",1,562,334,281,53,0,330,4,618,284,271,59
13,CLUJ,ICLOD,58142,LIVADA,"SCOALA DIN LIVADA",500,"Alegeri Prezidentiale",1,874,462,377,85,0,460,2,961,499,359,101
13,CLUJ,ICLOD,58142,ORMAN,"SCOALA DIN ORMAN",501,"Alegeri Prezidentiale",1,442,193,148,45,0,192,1,486,293,158,34
13,CLUJ,"IZVORU CRIŞULUI",58204,NADĂŞU,"CĂMINUL CULTURAL",502,"Alegeri Prezidentiale",1,184,113,85,28,0,111,2,202,89,85,26
13,CLUJ,"IZVORU CRIŞULUI",58204,"IZVORU CRIŞULUI","PRIMĂRIA COMUNEI",503,"Alegeri Prezidentiale",1,768,225,201,24,0,213,12,845,620,197,16
13,CLUJ,"IZVORU CRIŞULUI",58204,ŞAULA,"ŞCOALA GENERALĂ",504,"Alegeri Prezidentiale",1,320,143,123,20,0,138,5,352,209,129,9
13,CLUJ,"JICHIŞU DE JOS",55106,"JICHIŞU DE JOS","CĂMINUL CULTURAL",505,"Alegeri Prezidentiale",1,355,218,176,40,2,213,5,391,173,122,91
13,CLUJ,"JICHIŞU DE JOS",55106,CODOR,"CĂMINUL CULTURAL",506,"Alegeri Prezidentiale",1,339,197,175,22,0,196,1,373,176,126,70
13,CLUJ,"JICHIŞU DE JOS",55106,"JICHIŞU DE SUS","ŞCOALA GENERALĂ",507,"Alegeri Prezidentiale",1,189,104,83,21,0,103,1,208,104,67,36
13,CLUJ,"JICHIŞU DE JOS",55106,TĂRPIU,"ŞCOALA GENERALĂ",508,"Alegeri Prezidentiale",1,83,60,39,21,0,60,0,91,31,44,16
13,CLUJ,"JICHIŞU DE JOS",55106,ŞIGĂU,"ŞCOALA GENERALĂ",509,"Alegeri Prezidentiale",1,17,33,8,25,0,33,0,49,16,10,23
13,CLUJ,JUCU,58259,"JUCU DE MIJLOC","ŞCOALA PRIMARĂ",510,"Alegeri Prezidentiale",1,990,597,475,122,0,593,4,1089,492,492,101
13,CLUJ,JUCU,58259,GĂDĂLIN,"ŞCOALA PRIMARĂ",511,"Alegeri Prezidentiale",1,520,356,244,112,0,351,5,572,216,237,114
13,CLUJ,JUCU,58259,VIŞEA,"ŞCOALA PRIMARĂ",512,"Alegeri Prezidentiale",1,453,254,202,52,0,249,5,498,244,208,41
13,CLUJ,JUCU,58259,JUC-HERGHELIE,"GRĂDINIȚA CU PROGRAM NORMAL",513,"Alegeri Prezidentiale",1,368,224,174,50,0,223,1,405,181,175,48
13,CLUJ,JUCU,58259,"JUCU DE SUS","ȘCOALA GIMNAZIALĂ ”GEORGE BARIȚIU”",514,"Alegeri Prezidentiale",1,1496,843,651,192,0,840,3,1646,803,693,147
13,CLUJ,LUNA,58311,LUNA,"CĂMINUL CULTURAL ”PROF. NICOLAE MAZARE” LUNA",515,"Alegeri Prezidentiale",1,1121,504,447,56,1,496,8,1233,729,375,121
13,CLUJ,LUNA,58311,LUNA,"CĂMINUL CULTURAL ”PROF. NICOLAE MAZARE” LUNA",516,"Alegeri Prezidentiale",1,1018,456,401,54,1,448,8,1120,664,306,142
13,CLUJ,LUNA,58311,LUNCANI,"CAMINUL CULTURAL LUNCANI",517,"Alegeri Prezidentiale",1,1260,477,418,59,0,472,5,1386,909,376,96
13,CLUJ,LUNA,58311,GLIGOREŞTI,"GRĂDINIŢA GLIGORESTI",518,"Alegeri Prezidentiale",1,461,246,207,39,0,244,2,507,261,197,47
13,CLUJ,MĂGURI-RĂCĂTĂU,58357,"MUNTELE RECE","SCOALA GIMNAZIALA MUNTELE-RECE",519,"Alegeri Prezidentiale",1,440,181,111,70,0,179,2,484,303,101,78
13,CLUJ,MĂGURI-RĂCĂTĂU,58357,MĂGURI-RĂCĂTĂU,"PRIMARIA COMUNEI",520,"Alegeri Prezidentiale",1,712,281,228,53,0,279,2,783,502,219,60
13,CLUJ,MĂGURI-RĂCĂTĂU,58357,MĂGURI,"SCOALA GENERALA",521,"Alegeri Prezidentiale",1,730,271,255,16,0,269,2,803,532,221,48
13,CLUJ,MĂNĂSTIRENI,58393,MĂNĂSTIRENI,"PRIMĂRIA COMUNEI",522,"Alegeri Prezidentiale",1,724,405,314,91,0,401,4,796,391,286,115
13,CLUJ,MĂNĂSTIRENI,58393,BEDECIU,"ŞCOALA GENERALĂ",523,"Alegeri Prezidentiale",1,438,265,225,40,0,261,4,482,217,145,116
13,CLUJ,MĂRGĂU,58464,SCRIND-FRĂSINET,"CĂMIN CULTURAL",524,"Alegeri Prezidentiale",1,152,148,84,64,0,144,4,167,19,93,51
13,CLUJ,MĂRGĂU,58464,BUTENI,"CĂMIN CULTURAL",525,"Alegeri Prezidentiale",1,178,136,85,51,0,136,0,192,56,99,37
13,CLUJ,MĂRGĂU,58464,MĂRGĂU,"PRIMĂRIA COMUNEI MĂRGĂU",526,"Alegeri Prezidentiale",1,360,216,176,40,0,213,3,396,180,122,91
13,CLUJ,MĂRGĂU,58464,RĂCHIŢELE,"CĂMIN CULTURAL",527,"Alegeri Prezidentiale",2,598,377,304,72,1,373,4,658,281,273,100
13,CLUJ,MĂRIŞEL,58534,MĂRIŞEL,"ŞCOALA GENERALĂ",528,"Alegeri Prezidentiale",1,94,121,53,68,0,115,6,148,27,108,7
13,CLUJ,MĂRIŞEL,58534,MĂRIŞEL,"ŞCOALA GENERALĂ",529,"Alegeri Prezidentiale",1,1030,566,475,91,0,560,6,1133,567,454,106
13,CLUJ,MĂRIŞEL,58534,MĂRIŞEL,"ŞCOALA GENERALĂ",530,"Alegeri Prezidentiale",1,140,79,67,12,0,78,1,154,75,44,34
13,CLUJ,MICA,55160,MICA,"CĂMINUL CULTURAL",531,"Alegeri Prezidentiale",1,568,394,317,71,6,388,6,625,231,237,151
13,CLUJ,MICA,55160,MĂNĂSTIREA,"CĂMINUL CULTURAL",532,"Alegeri Prezidentiale",1,598,351,297,50,4,347,4,658,307,232,115
13,CLUJ,MICA,55160,NIREŞ,"FOSTUL SEDIU CAP",533,"Alegeri Prezidentiale",1,898,475,438,37,0,471,4,988,513,326,145
13,CLUJ,MICA,55160,SÂNMĂRGHITA,"ŞCOALA GENERALĂ",534,"Alegeri Prezidentiale",1,886,412,365,47,0,410,2,975,563,321,89
13,CLUJ,"MIHAI VITEAZU",55277,"MIHAI VITEAZU","ŞCOALA GENERALĂ",535,"Alegeri Prezidentiale",1,1522,701,627,74,0,690,11,1674,973,546,144
13,CLUJ,"MIHAI VITEAZU",55277,CHEIA,"ŞCOALA GENERALĂ",536,"Alegeri Prezidentiale",1,469,214,175,39,0,212,2,516,302,165,47
13,CLUJ,"MIHAI VITEAZU",55277,CORNEŞTI,"CAMIN CULTURAL",537,"Alegeri Prezidentiale",1,635,317,251,65,1,315,2,699,382,243,72
13,CLUJ,"MIHAI VITEAZU",55277,"MIHAI VITEAZU","CASĂ DE CULTURĂ",538,"Alegeri Prezidentiale",1,1344,660,578,82,0,653,7,1478,818,523,130
13,CLUJ,"MIHAI VITEAZU",55277,"MIHAI VITEAZU","SALA DE SPORT",539,"Alegeri Prezidentiale",1,939,440,382,58,0,431,9,1033,593,309,122
13,CLUJ,"MINTIU GHERLII",58552,"MINTIU GHERLII","PRIMĂRIA COMUNEI",540,"Alegeri Prezidentiale",1,1279,663,593,70,0,656,7,1407,744,449,207
13,CLUJ,"MINTIU GHERLII",58552,BUNEŞTI,"ŞCOALA GENERALĂ",541,"Alegeri Prezidentiale",1,756,335,303,32,0,332,3,832,497,271,61
13,CLUJ,"MINTIU GHERLII",58552,NIMA,"ŞCOALA GENERALĂ",542,"Alegeri Prezidentiale",1,582,340,305,35,0,338,2,640,300,197,141
13,CLUJ,"MINTIU GHERLII",58552,PĂDURENII,"ŞCOALA GENERALĂ",543,"Alegeri Prezidentiale",1,76,61,32,29,0,61,0,84,23,42,19
13,CLUJ,"MINTIU GHERLII",58552,PETREŞTI,"ŞCOALA GENERALĂ",544,"Alegeri Prezidentiale",1,199,119,87,32,0,119,0,219,100,89,30
13,CLUJ,"MINTIU GHERLII",58552,SALATIU,"ŞCOALA GENERALĂ",545,"Alegeri Prezidentiale",1,222,108,86,22,0,107,1,244,136,82,25
13,CLUJ,MOCIU,58623,MOCIU,"CAMIN CULTURAL MOCIU - SALA MICA",546,"Alegeri Prezidentiale",1,1320,655,549,106,0,647,8,1452,797,483,164
13,CLUJ,MOCIU,58623,CHESĂU,"ŞCOALA ELEMENTARA",547,"Alegeri Prezidentiale",1,263,121,108,13,0,121,0,289,168,113,8
13,CLUJ,MOCIU,58623,CRIŞENI,"ŞCOALA GENERALĂ",548,"Alegeri Prezidentiale",1,209,130,96,34,0,128,2,230,100,94,34
13,CLUJ,MOCIU,58623,"GHIRIŞU ROMÂN","CAMIN CULTURAL",549,"Alegeri Prezidentiale",1,268,212,154,58,0,207,5,295,83,170,37
13,CLUJ,MOCIU,58623,"ZORENII DE VALE","CLADIRE MULTIFUNCTIONALA",550,"Alegeri Prezidentiale",1,255,173,141,32,0,172,1,281,108,129,43
13,CLUJ,MOCIU,58623,BOTENI,"SALĂ MULTIFUNCŢIONALĂ",551,"Alegeri Prezidentiale",1,180,95,69,26,0,94,1,198,103,74,20
13,CLUJ,MOCIU,58623,ROŞIENI,"CLADIRE MULTIFUNCŢIONALĂ",552,"Alegeri Prezidentiale",1,140,75,53,22,0,75,0,154,79,59,16
13,CLUJ,MOLDOVENEŞTI,58721,MOLDOVENEŞTI,"PRIMĂRIA COMUNEI",553,"Alegeri Prezidentiale",1,581,224,183,41,0,219,5,639,415,182,37
13,CLUJ,MOLDOVENEŞTI,58721,MOLDOVENEŞTI,"ŞCOALA CU CLASELE I-VIII",554,"Alegeri Prezidentiale",1,413,171,151,20,0,169,2,454,283,144,25
13,CLUJ,MOLDOVENEŞTI,58721,PLĂIEŞTI,"ŞCOALA CU CLASELE I-IV",555,"Alegeri Prezidentiale",1,536,199,166,33,0,194,5,590,391,179,15
13,CLUJ,MOLDOVENEŞTI,58721,BĂDENI,"CASA SATULUI",556,"Alegeri Prezidentiale",1,562,257,215,42,0,255,2,618,361,220,35
13,CLUJ,MOLDOVENEŞTI,58721,STEJERIŞ,"CLĂDIREA PRIMĂRIEI",557,"Alegeri Prezidentiale",1,157,91,55,36,0,88,3,173,82,75,13
13,CLUJ,MOLDOVENEŞTI,58721,PIETROASA,"CĂMINUL CULTURAL",558,"Alegeri Prezidentiale",1,106,64,39,25,0,64,0,117,53,58,6
13,CLUJ,MOLDOVENEŞTI,58721,PODENI,"ŞCOALA CU CLASELE I-IV",559,"Alegeri Prezidentiale",1,364,179,121,58,0,178,1,400,221,131,47
13,CLUJ,NEGRENI,60169,NEGRENI,"CĂMINUL CULTURAL",560,"Alegeri Prezidentiale",1,1322,720,632,87,1,707,13,1454,734,509,198
13,CLUJ,NEGRENI,60169,BUCEA,"CASA DE CULTURĂ",561,"Alegeri Prezidentiale",1,577,320,283,37,0,317,3,635,315,221,96
13,CLUJ,NEGRENI,60169,PRELUCELE,"SCOALA CU CLASELE I-IV",562,"Alegeri Prezidentiale",1,100,52,44,8,0,52,0,110,58,35,17
13,CLUJ,PANTICEU,58856,SĂRATA,"SCOALA PRIMARĂ",563,"Alegeri Prezidentiale",1,246,127,92,35,0,124,3,271,144,96,28
13,CLUJ,PANTICEU,58856,PANTICEU,"SCOALĂ GENERALĂ IULIU HAȚIEGANU PANTICEU",564,"Alegeri Prezidentiale",1,518,307,223,84,0,303,4,570,263,224,79
13,CLUJ,PANTICEU,58856,"CUBLEŞU SOMEŞAN","ŞCOALA CLASELE I-IV",565,"Alegeri Prezidentiale",1,306,161,105,56,0,160,1,337,176,105,55
13,CLUJ,PANTICEU,58856,DÂRJA,"CLADIRE SCOALA",566,"Alegeri Prezidentiale",1,172,120,75,45,0,117,3,189,69,95,22
13,CLUJ,PANTICEU,58856,CĂTĂLINA,"CAMIN CULTURAL",567,"Alegeri Prezidentiale",1,56,58,21,37,0,58,0,62,4,45,13
13,CLUJ,PĂLATCA,58794,PĂLATCA,"CĂMINUL CULTURAL PĂLATCA",568,"Alegeri Prezidentiale",1,609,375,288,87,0,373,2,670,295,292,81
13,CLUJ,PĂLATCA,58794,SAVA,"CĂMINUL CULTURAL SAVA",569,"Alegeri Prezidentiale",1,252,147,91,56,0,147,0,277,130,117,30
13,CLUJ,"PETREŞTII DE JOS",58918,PLAIURI,"CĂMINUL CULTURAL",570,"Alegeri Prezidentiale",1,96,68,34,34,0,68,0,106,38,41,27
13,CLUJ,"PETREŞTII DE JOS",58918,"PETREŞTII DE MIJLOC","ŞCOALA GENERALĂ",571,"Alegeri Prezidentiale",1,111,70,43,27,0,70,0,122,52,50,20
13,CLUJ,"PETREŞTII DE JOS",58918,DELENI,"ŞCOALA GENERALĂ",572,"Alegeri Prezidentiale",1,178,157,97,60,0,156,1,196,39,121,35
13,CLUJ,"PETREŞTII DE JOS",58918,CRĂEŞTI,"ŞCOALA GENERALĂ",573,"Alegeri Prezidentiale",1,168,107,74,33,0,105,2,185,78,89,16
13,CLUJ,"PETREŞTII DE JOS",58918,"PETREŞTII DE JOS","CĂMIN CULTURAL",574,"Alegeri Prezidentiale",1,489,255,202,53,0,254,1,538,283,210,44
13,CLUJ,"PETREŞTII DE JOS",58918,LIVADA,"CAMIN CULTURAL LIVADA",575,"Alegeri Prezidentiale",1,162,101,60,41,0,99,2,178,77,72,27
13,CLUJ,"PETREŞTII DE JOS",58918,"PETREŞTII DE SUS","CAMINUL CULTURAL",576,"Alegeri Prezidentiale",1,75,42,23,19,0,41,1,83,41,26,15
13,CLUJ,PLOSCOŞ,58990,PLOSCOŞ,"CĂMINUL CULTURAL",577,"Alegeri Prezidentiale",1,334,156,122,34,0,154,2,367,211,113,41
13,CLUJ,PLOSCOŞ,58990,"VALEA FLORILOR","ŞCOALA CU CLASELE I-IV",578,"Alegeri Prezidentiale",1,224,131,94,37,0,129,2,246,115,101,28
13,CLUJ,POIENI,59041,POIENI,"PRIMĂRIA COMUNEI POIENI",579,"Alegeri Prezidentiale",2,948,455,376,79,0,451,4,1043,588,330,121
13,CLUJ,POIENI,59041,BOLOGA,"ŞCOALA PRIMARA BOLOGA",580,"Alegeri Prezidentiale",1,515,296,255,41,0,293,3,567,271,200,93
13,CLUJ,POIENI,59041,MORLACA,"ŞCOALA PRIMARA MORLACA",581,"Alegeri Prezidentiale",1,602,292,242,50,0,289,3,662,370,201,88
13,CLUJ,POIENI,59041,HODIŞU,"ŞCOALA HODIŞU",582,"Alegeri Prezidentiale",1,299,164,130,34,0,160,4,329,165,119,41
13,CLUJ,POIENI,59041,"VALEA DRĂGANULUI","ŞCOALA GIMNAZIALA ”AUREL MUNTEANU” VALEA DRĂGANULUI",583,"Alegeri Prezidentiale",1,1290,719,588,131,0,709,10,1419,700,482,227
13,CLUJ,POIENI,59041,TRANIŞU,"ŞCOALA TRANIŞU",584,"Alegeri Prezidentiale",1,287,132,108,24,0,130,2,316,184,89,41
13,CLUJ,POIENI,59041,"LUNCA VIŞAGULUI","ŞCOALA LUNCA VIŞAGULUI",585,"Alegeri Prezidentiale",1,183,109,69,40,0,107,2,201,92,55,52
13,CLUJ,RECEA-CRISTUR,59130,RECEA-CRISTUR,"SEDIUL PRIMĂRIEI SALA DE SEDINŢE",586,"Alegeri Prezidentiale",2,554,437,296,120,21,428,9,609,172,342,86
13,CLUJ,RECEA-CRISTUR,59130,ELCIU,ŞCOALA,587,"Alegeri Prezidentiale",1,81,89,47,42,0,88,1,89,0,75,13
13,CLUJ,RECEA-CRISTUR,59130,PUSTUŢA,ŞCOALA,588,"Alegeri Prezidentiale",1,71,59,34,25,0,57,2,78,19,47,10
13,CLUJ,RECEA-CRISTUR,59130,OSOI,ŞCOALA,589,"Alegeri Prezidentiale",1,79,80,46,34,0,80,0,87,7,64,16
13,CLUJ,RECEA-CRISTUR,59130,CIUBĂNCUŢA,ŞCOALA,590,"Alegeri Prezidentiale",1,127,97,69,28,0,97,0,140,43,71,26
13,CLUJ,RECEA-CRISTUR,59130,CIUBANCA,"CAMINUL CULTURAL CIUBANCA",591,"Alegeri Prezidentiale",1,74,90,48,42,0,89,1,96,6,66,23
13,CLUJ,RIŞCA,59238,RIŞCA,"ŞCOALA GIMNAZIALĂ CU CLASELE I-VIII",592,"Alegeri Prezidentiale",1,765,385,299,85,1,383,2,842,457,304,79
13,CLUJ,RIŞCA,59238,"DEALU MARE","ŞCOALA PRIMARĂ CU CLASELE I-IV",593,"Alegeri Prezidentiale",1,311,183,161,22,0,182,1,342,159,146,36
13,CLUJ,RIŞCA,59238,MĂRCEŞTI,"ŞCOALA PRIMARĂ CU CLASELE I-IV",594,"Alegeri Prezidentiale",1,150,90,71,19,0,89,1,165,75,76,13
13,CLUJ,SĂCUIEU,59283,SĂCUIEU,"CĂMINUL CULTURAL",595,"Alegeri Prezidentiale",1,457,201,159,42,0,197,4,503,302,154,43
13,CLUJ,SĂCUIEU,59283,ROGOJEL,"CĂMINUL CULTURAL",596,"Alegeri Prezidentiale",1,514,262,236,26,0,262,0,565,303,234,28
13,CLUJ,SĂCUIEU,59283,VIŞAGU,"ŞCOALA GENERALĂ CU CLASELE I-IV",597,"Alegeri Prezidentiale",1,211,117,95,22,0,115,2,232,115,68,47
13,CLUJ,SĂNDULEŞTI,55311,SĂNDULEŞTI,ŞCOALA,598,"Alegeri Prezidentiale",1,601,360,262,98,0,357,3,661,301,203,154
13,CLUJ,SĂNDULEŞTI,55311,COPĂCENI,"ŞCOALA SIMION BALINT",599,"Alegeri Prezidentiale",1,1139,601,530,71,0,595,6,1153,552,462,133
13,CLUJ,SĂVĂDISLA,59327,SĂVĂDISLA,"CĂMINUL CULTURAL",600,"Alegeri Prezidentiale",2,860,477,337,116,24,466,11,926,449,409,57
13,CLUJ,SĂVĂDISLA,59327,LITA,"CĂMINUL CULTURAL",601,"Alegeri Prezidentiale",1,252,177,123,54,0,177,0,277,100,140,37
13,CLUJ,SĂVĂDISLA,59327,VĂLIŞOARA,"CĂMINUL CULTURAL",602,"Alegeri Prezidentiale",1,45,68,20,48,0,67,1,90,22,46,21
13,CLUJ,SĂVĂDISLA,59327,VLAHA,"CĂMINUL CULTURAL",603,"Alegeri Prezidentiale",2,754,473,358,115,0,461,12,829,356,440,21
13,CLUJ,SĂVĂDISLA,59327,HĂŞDATE,"ŞCOALA CU CLASELE I-VIII",604,"Alegeri Prezidentiale",1,389,250,188,62,0,248,2,428,178,207,41
13,CLUJ,SĂVĂDISLA,59327,FINIŞEL,"ŞCOALA CU CLASELE I-VIII",605,"Alegeri Prezidentiale",1,661,320,265,55,0,319,1,707,387,220,99
13,CLUJ,SĂVĂDISLA,59327,LITENI,"ŞCOALA CU CLASELE I-IV",606,"Alegeri Prezidentiale",1,322,206,140,66,0,204,2,354,148,194,10
13,CLUJ,SĂVĂDISLA,59327,STOLNA,"ŞCOALA CU CLASELE I-IV",607,"Alegeri Prezidentiale",1,204,174,124,50,0,173,1,224,50,142,31
13,CLUJ,SÂNCRAIU,59434,SÂNCRAIU,"SANCRAIU NR.330 CAMINUL CULTURAL",608,"Alegeri Prezidentiale",1,937,600,536,50,14,574,26,1031,431,488,86
13,CLUJ,SÂNCRAIU,59434,ALUNIŞU,"ALUNISU NR.74 CAMINUL CULTURAL",609,"Alegeri Prezidentiale",1,96,79,51,28,0,75,4,106,27,56,19
13,CLUJ,SÂNCRAIU,59434,DOMOŞU,"DOMOSU NR.22 CAMINUL CULTURAL",610,"Alegeri Prezidentiale",1,298,195,170,23,2,187,8,328,133,171,16
13,CLUJ,SÂNMĂRTIN,59498,SÂNMĂRTIN,"PRIMARIA SANMARTIN",611,"Alegeri Prezidentiale",1,198,117,97,20,0,117,0,218,101,71,46
13,CLUJ,SÂNMĂRTIN,59498,CEABA,"SC. PRIM. CEABA",612,"Alegeri Prezidentiale",1,178,137,101,36,0,137,0,196,59,83,54
13,CLUJ,SÂNMĂRTIN,59498,CUTCA,"SC. GIMNAZIALA CUTCA",613,"Alegeri Prezidentiale",2,319,250,217,33,0,250,0,351,101,47,203
13,CLUJ,SÂNMĂRTIN,59498,SÂMBOIENI,"CAMIN CULT. SAMBOIENI",614,"Alegeri Prezidentiale",1,118,106,83,23,0,105,1,130,24,31,74
13,CLUJ,SÂNMĂRTIN,59498,TÂRGUŞOR,"SC. PRIM. TARGUSOR",615,"Alegeri Prezidentiale",1,95,79,53,26,0,78,1,105,26,19,59
13,CLUJ,SÂNMĂRTIN,59498,MĂHAL,"SC. PRIM. MAHAL",616,"Alegeri Prezidentiale",1,68,61,40,21,0,61,0,75,14,32,29
13,CLUJ,SÂNMĂRTIN,59498,"DIVICIORII MARI","SC. PRIM. DIV-MARI",617,"Alegeri Prezidentiale",1,119,115,80,35,0,114,1,131,16,46,68
13,CLUJ,SÂNMĂRTIN,59498,"DIVICIORII MICI","SC. PRIM. DIV-MICI",618,"Alegeri Prezidentiale",1,50,55,30,25,0,55,0,55,0,18,37
13,CLUJ,SÂNPAUL,59586,SÂNPAUL,"SEDIUL PRIMARIEI",619,"Alegeri Prezidentiale",1,709,361,281,78,2,357,4,780,419,293,64
13,CLUJ,SÂNPAUL,59586,ŞARDU,"SEDIUL ŞCOLII GEN SARDU",620,"Alegeri Prezidentiale",1,340,231,181,50,0,231,0,374,143,197,34
13,CLUJ,SÂNPAUL,59586,BERINDU,"SEDIUL ŞCOLII GEN BERINDU",621,"Alegeri Prezidentiale",1,361,200,144,56,0,199,1,397,197,148,51
13,CLUJ,SÂNPAUL,59586,MIHĂIEŞTI,"CAMINUL CULTURAL MIHAIESTI",622,"Alegeri Prezidentiale",1,218,139,106,33,0,139,0,240,101,116,23
13,CLUJ,SÂNPAUL,59586,"TOPA MICĂ","MAGAZINUL COOPERAŢIEI",623,"Alegeri Prezidentiale",1,191,121,73,48,0,121,0,210,89,101,20
13,CLUJ,SIC,59416,SIC,"CAMIN CULTURAL SIC",624,"Alegeri Prezidentiale",1,760,139,105,34,0,133,6,836,697,105,28
13,CLUJ,SIC,59416,SIC,"CAMIN CULTURAL SIC",625,"Alegeri Prezidentiale",2,1212,159,159,0,0,157,2,1333,1174,129,28
13,CLUJ,SUATU,59657,SUATU,"SEDIUL ADMINISTRATIV AL PRIMARIEI SUATU",626,"Alegeri Prezidentiale",1,1063,535,426,109,0,532,3,1169,634,453,79
13,CLUJ,SUATU,59657,ARUNCUTA,"SEDIUL ADMINISTRATIV DIN ARUNCUTA",627,"Alegeri Prezidentiale",1,264,150,97,53,0,149,1,290,140,102,47
13,CLUJ,"TRITENII DE JOS",59693,"TRITENII DE JOS","SCOALA PAVEL DAN",628,"Alegeri Prezidentiale",1,1253,508,462,46,0,504,4,1378,870,382,122
13,CLUJ,"TRITENII DE JOS",59693,"TRITENII DE SUS","SCOALA PRIMARA",629,"Alegeri Prezidentiale",1,878,429,401,28,0,429,0,966,537,283,146
13,CLUJ,"TRITENII DE JOS",59693,COLONIA,"SCOALA PRIMARA",630,"Alegeri Prezidentiale",1,396,199,174,25,0,199,0,436,237,178,21
13,CLUJ,"TRITENII DE JOS",59693,PĂDURENII,"CAMIN CULTURAL",631,"Alegeri Prezidentiale",1,973,381,357,24,0,377,4,1070,689,286,91
13,CLUJ,"TRITENII DE JOS",59693,TRITENII-HOTAR,"CAMIN CULTURAL",632,"Alegeri Prezidentiale",1,234,121,97,24,0,120,1,257,136,86,34
13,CLUJ,"TRITENII DE JOS",59693,CLAPA,"CASA PARTICULARA",633,"Alegeri Prezidentiale",1,68,37,19,18,0,36,1,75,38,24,12
13,CLUJ,TURENI,59764,TURENI,"PRIMARIA COMUNEI TURENI , NR. 243",634,"Alegeri Prezidentiale",1,778,489,377,112,0,483,6,856,367,412,71
13,CLUJ,TURENI,59764,"CEANU MIC","CAMINUL CULTURAL CEANU MIC , NR.184",635,"Alegeri Prezidentiale",1,323,147,110,37,0,145,2,355,208,118,27
13,CLUJ,TURENI,59764,COMŞEŞTI,"SCOALA CU CLS. I-IV COMSESTI , NR.111",636,"Alegeri Prezidentiale",1,184,90,78,12,0,88,2,202,112,78,10
13,CLUJ,TURENI,59764,MĂRTINEŞTI,"SCOALA CU CLS. I-IV MĂRTINEŞTI ,NR.60",637,"Alegeri Prezidentiale",1,294,172,115,57,0,171,1,323,151,150,21
13,CLUJ,TURENI,59764,MICEŞTI,"SCOALA CU CLS. I - IV MICESTI , NR.57",638,"Alegeri Prezidentiale",1,210,161,88,73,0,159,2,231,70,121,38
13,CLUJ,ŢAGA,59826,ŢAGA,"PRIMĂRIA ŢAGA",639,"Alegeri Prezidentiale",1,605,306,261,45,0,304,2,666,360,229,75
13,CLUJ,ŢAGA,59826,SÂNTIOANA,"CĂMIN CULTURAL SÎNTIOANA",640,"Alegeri Prezidentiale",1,446,196,165,31,0,194,2,491,295,122,72
13,CLUJ,ŢAGA,59826,NĂSAL,"FOSTA ŞCOALĂ I- IV NĂSAL",641,"Alegeri Prezidentiale",1,252,135,91,44,0,135,0,277,142,96,39
13,CLUJ,ŢAGA,59826,SÂNTEJUDE,"CĂMINUL CULTURAL SÎNTEJUDE",642,"Alegeri Prezidentiale",1,198,147,97,50,0,145,2,218,71,102,43
13,CLUJ,UNGURAŞ,59880,UNGURAŞ,"GRADINITA CU PROGRAM NORMAL",643,"Alegeri Prezidentiale",1,752,257,247,10,0,251,6,827,570,223,28
13,CLUJ,UNGURAŞ,59880,UNGURAŞ,"CAMINUL CULTURAL UNGURAS",644,"Alegeri Prezidentiale",1,751,257,232,25,0,249,8,826,569,212,37
13,CLUJ,UNGURAŞ,59880,BATIN,"SCOALA GIMNAZIALA BATIN",645,"Alegeri Prezidentiale",1,554,259,230,29,0,257,2,609,350,177,80
13,CLUJ,UNGURAŞ,59880,"VALEA UNGURAŞULUI","GRADINIŢA CU PROGRAM NORMAL VALEA UNGURAŞULUI",646,"Alegeri Prezidentiale",1,164,97,71,26,0,96,1,180,83,85,11
13,CLUJ,VAD,59942,VAD,"CĂMIN CULTURAL VAD",647,"Alegeri Prezidentiale",1,264,208,138,57,13,207,1,290,82,143,64
13,CLUJ,VAD,59942,CETAN,"ȘCOALA CETAN",648,"Alegeri Prezidentiale",1,490,322,241,67,14,320,2,539,217,230,90
13,CLUJ,VAD,59942,"BOGATA DE JOS","CENTRU DE ZI PENTRU COPII",649,"Alegeri Prezidentiale",2,187,146,114,25,7,143,3,206,60,99,44
13,CLUJ,VAD,59942,"CURTUIUŞU DEJULUI","ȘCOALA CURTUIUȘ",650,"Alegeri Prezidentiale",2,130,108,74,28,6,106,2,143,35,80,26
13,CLUJ,VAD,59942,"BOGATA DE SUS","ȘCOALA BOGATA DE SUS",651,"Alegeri Prezidentiale",1,205,161,112,32,17,156,5,226,65,135,21
13,CLUJ,VAD,59942,"VALEA GROŞILOR","ȘCOALA VALEA GROȘILOR",652,"Alegeri Prezidentiale",1,206,151,90,49,12,148,3,227,76,101,47
13,CLUJ,VAD,59942,CALNA,"CĂMIN CULTURAL CALNA",653,"Alegeri Prezidentiale",1,112,79,58,15,6,79,0,123,44,47,32
13,CLUJ,"VALEA IERII",60026,"VALEA IERII","ȘCOALA GIMNAZIALĂ VALEA IERII",654,"Alegeri Prezidentiale",1,803,439,371,68,0,434,5,883,444,330,104
13,CLUJ,VIIŞOARA,60062,VIIŞOARA,"SCOALA GEN CLS I-VIII",655,"Alegeri Prezidentiale",1,1382,613,561,51,1,604,9,1520,907,549,55
13,CLUJ,VIIŞOARA,60062,VIIŞOARA,"SCOLA GEN CLS I-IV",656,"Alegeri Prezidentiale",1,1362,576,531,43,2,566,10,1498,922,422,144
13,CLUJ,VIIŞOARA,60062,VIIŞOARA,"SCOLA GEN CLS I-IV",657,"Alegeri Prezidentiale",2,1293,564,528,34,2,551,13,1422,858,358,193
13,CLUJ,VIIŞOARA,60062,URCA,"SCOALA GEN CLS I-VIII URCA",658,"Alegeri Prezidentiale",1,782,367,335,32,0,361,6,860,493,253,108
13,CLUJ,VULTURENI,60099,VULTURENI,"PRIMARIA COMUNEI VULTURENI",659,"Alegeri Prezidentiale",1,322,174,119,55,0,172,2,354,180,120,52
13,CLUJ,VULTURENI,60099,BĂBUŢIU,"CASA PAROHIALA BABUTIU",660,"Alegeri Prezidentiale",1,187,138,91,47,0,136,2,206,68,111,25
13,CLUJ,VULTURENI,60099,BĂDEŞTI,"CAMINUL CULTURAL BADESTI",661,"Alegeri Prezidentiale",1,101,91,53,38,0,90,1,111,20,78,12
13,CLUJ,VULTURENI,60099,CHIDEA,"FUNDATIA KIDE",662,"Alegeri Prezidentiale",1,94,87,41,46,0,85,2,103,16,79,6
13,CLUJ,VULTURENI,60099,FĂURENI,"CAMINUL CULTURAL FAURENI",663,"Alegeri Prezidentiale",1,148,124,75,49,0,123,1,163,39,106,17
13,CLUJ,VULTURENI,60099,ŞOIMENI,"SCOALA SOIMENI",664,"Alegeri Prezidentiale",1,265,178,126,52,0,175,3,292,114,125,50
14,CONSTANŢA,"MUNICIPIUL CONSTANŢA",60419,CONSTANŢA,"COLEGIUL NATIONAL ” MIHAI EMINESCU”",1,"Alegeri Prezidentiale",1,801,438,355,83,0,431,7,900,462,315,116
14,CONSTANŢA,"MUNICIPIUL CONSTANŢA",60419,CONSTANŢA,"COLEGIUL NATIONAL ” MIHAI EMINESCU”",2,"Alegeri Prezidentiale",2,618,356,272,83,1,346,10,700,344,242,104
14,CONSTANŢA,"MUNICIPIUL CONSTANŢA",60419,CONSTANŢA,"COLEGIUL NAȚIONAL „MIHAI EMINESCU„",3,"Alegeri Prezidentiale",1,901,466,383,75,8,456,10,1000,534,342,114
14,CONSTANŢA,"MUNICIPIUL CONSTANŢA",60419,CONSTANŢA,"COLEGIUL NAŢIONAL MIRCEA CEL BĂTRÂN",4,"Alegeri Prezidentiale",1,596,415,286,129,0,405,10,700,285,290,115
14,CONSTANŢA,"MUNICIPIUL CONSTANŢA",60419,CONSTANŢA,"COLEGIUL NAŢIONAL MIRCEA CEL BĂTRÂN",5,"Alegeri Prezidentiale",1,583,460,340,120,0,453,7,599,139,341,112
14,CONSTANŢA,"MUNICIPIUL CONSTANŢA",60419,CONSTANŢA,"ŞCOALA GIMNAZIALA NR.28 ” DAN BARBILIAN”",6,"Alegeri Prezidentiale",1,437,227,203,24,0,222,5,500,273,142,80
14,CONSTANŢA,"MUNICIPIUL CONSTANŢA",60419,CONSTANŢA,"COLEGIUL COMERCIAL ”CAROL I”",7,"Alegeri Prezidentiale",1,1383,855,789,66,0,834,21,1500,645,615,219
14,CONSTANŢA,"MUNICIPIUL CONSTANŢA",60419,CONSTANŢA,"COLEGIUL COMERCIAL ”CAROL I”",8,"Alegeri Prezidentiale",2,853,508,455,53,0,496,12,900,392,344,152
14,CONSTANŢA,"MUNICIPIUL CONSTANŢA",60419,CONSTANŢA,"COLEGIUL NATIONAL PEDAGOGIC ”CONSTANTIN BRĂTESCU”",9,"Alegeri Prezidentiale",1,1593,913,811,102,0,884,29,1800,887,643,241
14,CONSTANŢA,"MUNICIPIUL CONSTANŢA",60419,CONSTANŢA,"COLEGIUL NATIONAL PEDAGOGIC ”CONSTANTIN BRĂTESCU”",10,"Alegeri Prezidentiale",1,1225,666,604,62,0,645,21,1292,626,464,181
14,CONSTANŢA,"MUNICIPIUL CONSTANŢA",60419,CONSTANŢA,"COLEGIUL NATIONAL PEDAGOGIC ”CONSTANTIN BRĂTESCU”",11,"Alegeri Prezidentiale",1,1228,684,628,56,0,669,15,1400,716,473,196
14,CONSTANŢA,"MUNICIPIUL CONSTANŢA",60419,CONSTANŢA,"LICEUL TEHNOLOGIC ”IOAN N.ROMAN” (ŞCOALA NR.25)",12,"Alegeri Prezidentiale",1,1168,565,518,47,0,552,13,1300,735,381,171
14,CONSTANŢA,"MUNICIPIUL CONSTANŢA",60419,CONSTANŢA,"LICEUL TEHNOLOGIC ”IOAN N.ROMAN” (ŞCOALA NR.25)",13,"Alegeri Prezidentiale",1,1125,551,488,63,0,540,11,1200,649,378,162
14,CONSTANŢA,"MUNICIPIUL CONSTANŢA",60419,CONSTANŢA,"TEATRUL DE STAT CONSTANȚA (TEATRUL ”FANTASIO” )",14,"Alegeri Prezidentiale",1,647,418,345,73,0,411,7,700,282,280,131
14,CONSTANŢA,"MUNICIPIUL CONSTANŢA",60419,CONSTANŢA,"TEATRUL DE STAT CONSTANȚA (TEATRUL ”FANTASIO” )",15,"Alegeri Prezidentiale",1,809,481,428,53,0,471,10,900,419,330,141
14,CONSTANŢA,"MUNICIPIUL CONSTANŢA",60419,CONSTANŢA,"LICEUL TEORETIC ”TRAIAN”",16,"Alegeri Prezidentiale",1,848,567,447,120,0,557,10,900,333,392,165
14,CONSTANŢA,"MUNICIPIUL CONSTANŢA",60419,CONSTANŢA,"LICEUL TEORETIC ”TRAIAN”",17,"Alegeri Prezidentiale",1,444,240,224,16,0,231,9,500,260,173,58
14,CONSTANŢA,"MUNICIPIUL CONSTANŢA",60419,CONSTANŢA,"LICEUL TEORETIC ”TRAIAN”",18,"Alegeri Prezidentiale",1,1273,726,671,55,0,710,16,1400,674,516,194
14,CONSTANŢA,"MUNICIPIUL CONSTANŢA",60419,CONSTANŢA,"ŞCOALA GIMNAZIALA NR. 24 ”ION JALEA”",19,"Alegeri Prezidentiale",1,1210,691,618,73,0,681,10,1300,609,483,198
14,CONSTANŢA,"MUNICIPIUL CONSTANŢA",60419,CONSTANŢA,"ŞCOALA GIMNAZIALA NR. 24 ”ION JALEA”",20,"Alegeri Prezidentiale",1,1117,718,669,49,0,698,20,1200,482,478,220
14,CONSTANŢA,"MUNICIPIUL CONSTANŢA",60419,CONSTANŢA,"ŞCOALA GIMNAZIALA NR. 24 ”ION JALEA”",21,"Alegeri Prezidentiale",1,1416,852,771,78,3,837,15,1600,748,596,241
14,CONSTANŢA,"MUNICIPIUL CONSTANŢA",60419,CONSTANŢA,"LICEUL CU PROGRAM SPORTIV ”NICOLAE ROTARU ” (ŞCOALA NR.34)",22,"Alegeri Prezidentiale",1,1437,833,796,37,0,818,15,1600,767,538,280
14,CONSTANŢA,"MUNICIPIUL CONSTANŢA",60419,CONSTANŢA,"LICEUL CU PROGRAM SPORTIV ”NICOLAE ROTARU ” (ŞCOALA NR.34)",23,"Alegeri Prezidentiale",1,1147,694,610,84,0,689,5,1300,606,479,210
14,CONSTANŢA,"MUNICIPIUL CONSTANŢA",60419,CONSTANŢA,"LICEUL CU PROGRAM SPORTIV ”NICOLAE ROTARU ” (ŞCOALA NR.34)",24,"Alegeri Prezidentiale",1,1266,713,682,31,0,703,10,1400,687,482,221
14,CONSTANŢA,"MUNICIPIUL CONSTANŢA",60419,CONSTANŢA,"LICEUL CU PROGRAM SPORTIV ”NICOLAE ROTARU ” (ŞCOALA NR.34)",25,"Alegeri Prezidentiale",1,1468,853,824,28,1,836,17,1600,747,539,297
14,CONSTANŢA,"MUNICIPIUL CONSTANŢA",60419,CONSTANŢA,"COLEGIUL NAȚIONAL DE ARTE ”REGINA MARIA” (ȘCOALA NR. 42)",26,"Alegeri Prezidentiale",1,959,605,516,89,0,586,19,1100,495,423,163
14,CONSTANŢA,"MUNICIPIUL CONSTANŢA",60419,CONSTANŢA,"COLEGIUL NAȚIONAL DE ARTE ”REGINA MARIA” (ȘCOALA NR. 42)",27,"Alegeri Prezidentiale",1,896,584,548,36,0,568,16,1000,416,405,163
14,CONSTANŢA,"MUNICIPIUL CONSTANŢA",60419,CONSTANŢA,"COLEGIUL NAȚIONAL DE ARTE ”REGINA MARIA” (ȘCOALA NR. 42)",28,"Alegeri Prezidentiale",1,1053,599,559,40,0,587,12,1200,601,401,186
14,CONSTANŢA,"MUNICIPIUL CONSTANŢA",60419,CONSTANŢA,"COLEGIUL NAȚIONAL DE ARTE ”REGINA MARIA” (ȘCOALA NR. 42)",29,"Alegeri Prezidentiale",1,574,390,322,68,0,379,11,600,210,233,146
14,CONSTANŢA,"MUNICIPIUL CONSTANŢA",60419,CONSTANŢA,"LICEUL TEORETIC ”OVIDIUS”",30,"Alegeri Prezidentiale",1,1556,945,774,150,21,929,16,1700,755,676,253
14,CONSTANŢA,"MUNICIPIUL CONSTANŢA",60419,CONSTANŢA,"LICEUL TEORETIC ”OVIDIUS”",31,"Alegeri Prezidentiale",1,1183,787,631,126,30,767,19,1300,514,533,234
14,CONSTANŢA,"MUNICIPIUL CONSTANŢA",60419,CONSTANŢA,"ANEXĂ ŞCOALA GIMNAZIALĂ NR.8",32,"Alegeri Prezidentiale",1,934,585,528,57,0,566,19,1000,415,375,191
14,CONSTANŢA,"MUNICIPIUL CONSTANŢA",60419,CONSTANŢA,"ANEXĂ ŞCOALA GIMNAZIALĂ NR.8",33,"Alegeri Prezidentiale",1,1676,869,814,55,0,848,21,1800,931,574,274
14,CONSTANŢA,"MUNICIPIUL CONSTANŢA",60419,CONSTANŢA,"ANEXĂ ŞCOALA GIMNAZIALĂ NR.8",34,"Alegeri Prezidentiale",1,1393,607,584,23,0,596,11,1500,893,380,216
14,CONSTANŢA,"MUNICIPIUL CONSTANŢA",60419,CONSTANŢA,"ANEXĂ ŞCOALA GIMNAZIALĂ NR.8",35,"Alegeri Prezidentiale",1,1275,682,662,20,0,665,17,1400,718,397,268
14,CONSTANŢA,"MUNICIPIUL CONSTANŢA",60419,CONSTANŢA,"ANEXĂ ŞCOALA GIMNAZIALĂ NR.8",36,"Alegeri Prezidentiale",1,1290,665,645,20,0,658,7,1400,735,444,214
14,CONSTANŢA,"MUNICIPIUL CONSTANŢA",60419,CONSTANŢA,"ANEXĂ ŞCOALA GIMNAZIALĂ NR.8",37,"Alegeri Prezidentiale",1,1705,853,832,21,0,843,10,1900,1047,560,283
14,CONSTANŢA,"MUNICIPIUL CONSTANŢA",60419,CONSTANŢA,"LICEUL TEHNOLOGIC ”C.A.ROSETTI”",38,"Alegeri Prezidentiale",1,1116,707,629,78,0,687,20,1200,493,504,183
14,CONSTANŢA,"MUNICIPIUL CONSTANŢA",60419,CONSTANŢA,"LICEUL TEHNOLOGIC ”C.A.ROSETTI”",39,"Alegeri Prezidentiale",1,1178,649,587,47,15,636,13,1300,651,434,202
14,CONSTANŢA,"MUNICIPIUL CONSTANŢA",60419,CONSTANŢA,"LICEUL TEHNOLOGIC ”C.A.ROSETTI”",40,"Alegeri Prezidentiale",1,1104,724,625,98,1,712,12,1200,476,518,194
14,CONSTANŢA,"MUNICIPIUL CONSTANŢA",60419,CONSTANŢA,"LICEUL TEHNOLOGIC ”C.A.ROSETTI”",41,"Alegeri Prezidentiale",1,866,518,478,40,0,499,19,1000,482,345,154
14,CONSTANŢA,"MUNICIPIUL CONSTANŢA",60419,CONSTANŢA,"ŞCOALA GIMNAZIALA NR. 16 ”MARIN IONESCU DOBROGIANU”",42,"Alegeri Prezidentiale",1,1603,915,810,91,14,885,30,1800,885,611,274
14,CONSTANŢA,"MUNICIPIUL CONSTANŢA",60419,CONSTANŢA,"ŞCOALA GIMNAZIALA NR. 16 ”MARIN IONESCU DOBROGIANU”",43,"Alegeri Prezidentiale",1,1646,886,824,62,0,873,13,1800,914,576,297
14,CONSTANŢA,"MUNICIPIUL CONSTANŢA",60419,CONSTANŢA,"ŞCOALA GIMNAZIALA NR. 16 ”MARIN IONESCU DOBROGIANU”",44,"Alegeri Prezidentiale",1,1646,953,851,100,2,927,26,1800,847,656,271
14,CONSTANŢA,"MUNICIPIUL CONSTANŢA",60419,CONSTANŢA,"ŞCOALA GIMNAZIALA NR. 16 ”MARIN IONESCU DOBROGIANU”",45,"Alegeri Prezidentiale",1,1514,809,701,108,0,797,12,1700,891,568,229
14,CONSTANŢA,"MUNICIPIUL CONSTANŢA",60419,CONSTANŢA,"ŞCOALA GIMNAZIALA NR. 16 ”MARIN IONESCU DOBROGIANU”",46,"Alegeri Prezidentiale",1,1539,903,811,92,0,881,22,1700,797,572,309
14,CONSTANŢA,"MUNICIPIUL CONSTANŢA",60419,CONSTANŢA,"LICEUL TEORETIC ” LUCIAN BLAGA”",47,"Alegeri Prezidentiale",1,1823,1089,894,195,0,1065,24,2000,911,726,339
14,CONSTANŢA,"MUNICIPIUL CONSTANŢA",60419,CONSTANŢA,"COLEGIUL TEHNIC DE MARINĂ ”ALEXANDRU IOAN CUZA” (LICEUL DE MARINA)",48,"Alegeri Prezidentiale",1,1796,905,809,96,0,892,13,2000,1095,636,256
14,CONSTANŢA,"MUNICIPIUL CONSTANŢA",60419,CONSTANŢA,"COLEGIUL TEHNIC DE MARINĂ ”ALEXANDRU IOAN CUZA” (LICEUL DE MARINA)",49,"Alegeri Prezidentiale",1,1539,834,771,63,0,809,25,1700,866,551,258
14,CONSTANŢA,"MUNICIPIUL CONSTANŢA",60419,CONSTANŢA,"COLEGIUL TEHNIC DE MARINĂ ”ALEXANDRU IOAN CUZA” (LICEUL DE MARINA)",50,"Alegeri Prezidentiale",1,1601,896,850,46,0,872,24,1793,897,606,266
14,CONSTANŢA,"MUNICIPIUL CONSTANŢA",60419,CONSTANŢA,"COLEGIUL TEHNIC DE MARINĂ ”ALEXANDRU IOAN CUZA” (LICEUL DE MARINA)",51,"Alegeri Prezidentiale",1,1626,867,832,35,0,849,18,1792,925,589,260
14,CONSTANŢA,"MUNICIPIUL CONSTANŢA",60419,CONSTANŢA,"COLEGIUL TEHNIC DE MARINĂ ”ALEXANDRU IOAN CUZA” (LICEUL DE MARINA)",52,"Alegeri Prezidentiale",1,1538,805,780,25,0,778,27,1700,895,525,253
14,CONSTANŢA,"MUNICIPIUL CONSTANŢA",60419,CONSTANŢA,"COLEGIUL TEHNIC DE MARINĂ ”ALEXANDRU IOAN CUZA” (LICEUL DE MARINA)",53,"Alegeri Prezidentiale",1,1450,853,811,42,0,833,20,1600,747,594,239
14,CONSTANŢA,"MUNICIPIUL CONSTANŢA",60419,CONSTANŢA,"SCOALA GIMNAZIALA ”GRIGORE ANTIPA” (ŞCOALA NR. 15 )",54,"Alegeri Prezidentiale",1,1515,861,801,60,0,846,15,1700,839,558,288
14,CONSTANŢA,"MUNICIPIUL CONSTANŢA",60419,CONSTANŢA,"SCOALA GIMNAZIALA ”GRIGORE ANTIPA” (ŞCOALA NR. 15 )",55,"Alegeri Prezidentiale",1,1759,917,869,48,0,905,12,1900,983,667,238
14,CONSTANŢA,"MUNICIPIUL CONSTANŢA",60419,CONSTANŢA,"SCOALA GIMNAZIALA ”GRIGORE ANTIPA” (ŞCOALA NR. 15 )",56,"Alegeri Prezidentiale",1,857,478,442,36,0,471,7,900,422,342,129
14,CONSTANŢA,"MUNICIPIUL CONSTANŢA",60419,CONSTANŢA,"ŞCOALA GIMNAZIALA NR. 17 ”ION MINULESCU”",57,"Alegeri Prezidentiale",1,1772,960,906,54,0,942,18,1900,940,713,229
14,CONSTANŢA,"MUNICIPIUL CONSTANŢA",60419,CONSTANŢA,"ŞCOALA GIMNAZIALA NR. 17 ”ION MINULESCU”",58,"Alegeri Prezidentiale",1,1883,1082,986,95,1,1052,30,2100,1018,777,275
14,CONSTANŢA,"MUNICIPIUL CONSTANŢA",60419,CONSTANŢA,"ŞCOALA GIMNAZIALA NR. 17 ”ION MINULESCU”",59,"Alegeri Prezidentiale",1,1738,859,823,35,1,833,26,1900,1041,554,279
14,CONSTANŢA,"MUNICIPIUL CONSTANŢA",60419,CONSTANŢA,"ŞCOALA GIMNAZIALA NR. 17 ”ION MINULESCU”",60,"Alegeri Prezidentiale",1,1692,932,897,35,0,910,22,1600,668,662,248
14,CONSTANŢA,"MUNICIPIUL CONSTANŢA",60419,CONSTANŢA,"ŞCOALA GIMNAZIALA NR. 33 ”ANGHEL SALIGNY”",61,"Alegeri Prezidentiale",1,1258,691,648,43,0,677,14,1400,709,471,206
14,CONSTANŢA,"MUNICIPIUL CONSTANŢA",60419,CONSTANŢA,"ŞCOALA GIMNAZIALA NR. 33 ”ANGHEL SALIGNY”",62,"Alegeri Prezidentiale",1,1655,904,863,41,0,889,15,1800,896,584,305
14,CONSTANŢA,"MUNICIPIUL CONSTANŢA",60419,CONSTANŢA,"ŞCOALA GIMNAZIALA NR. 33 ”ANGHEL SALIGNY”",63,"Alegeri Prezidentiale",1,951,562,514,48,0,549,13,1000,438,392,157
14,CONSTANŢA,"MUNICIPIUL CONSTANŢA",60419,CONSTANŢA,"ŞCOALA GIMNAZIALA NR. 33 ”ANGHEL SALIGNY”",64,"Alegeri Prezidentiale",1,1365,820,769,51,0,803,17,1500,680,539,264
14,CONSTANŢA,"MUNICIPIUL CONSTANŢA",60419,CONSTANŢA,"ŞCOALA GIMNAZIALA NR. 37",65,"Alegeri Prezidentiale",1,1204,677,617,60,0,658,19,1300,623,444,214
14,CONSTANŢA,"MUNICIPIUL CONSTANŢA",60419,CONSTANŢA,"ŞCOALA GIMNAZIALA NR. 37",66,"Alegeri Prezidentiale",1,1323,775,691,84,0,764,11,1500,725,492,272
14,CONSTANŢA,"MUNICIPIUL CONSTANŢA",60419,CONSTANŢA,"ŞCOALA GIMNAZIALA NR. 37",67,"Alegeri Prezidentiale",1,1273,697,652,45,0,681,16,1400,703,432,249
14,CONSTANŢA,"MUNICIPIUL CONSTANŢA",60419,CONSTANŢA,"ŞCOALA GIMNAZIALA NR. 18 ”JEAN BART”",68,"Alegeri Prezidentiale",1,1256,716,661,54,1,702,14,1400,684,490,212
14,CONSTANŢA,"MUNICIPIUL CONSTANŢA",60419,CONSTANŢA,"ŞCOALA GIMNAZIALA NR. 18 ”JEAN BART”",69,"Alegeri Prezidentiale",1,1802,948,904,43,1,928,20,2000,1052,645,283
14,CONSTANŢA,"MUNICIPIUL CONSTANŢA",60419,CONSTANŢA,"ŞCOALA GIMNAZIALA NR. 18 ”JEAN BART”",70,"Alegeri Prezidentiale",1,1257,691,637,52,2,678,13,1400,709,473,205
14,CONSTANŢA,"MUNICIPIUL CONSTANŢA",60419,CONSTANŢA,"ŞCOALA GIMNAZIALA NR. 18 ”JEAN BART”",71,"Alegeri Prezidentiale",1,1038,643,593,49,1,625,18,1100,457,469,156
14,CONSTANŢA,"MUNICIPIUL CONSTANŢA",60419,CONSTANŢA,"LICEUL TEHNOLOGIC ”GHEORGHE MIRON COSTIN” (INDUSTRIE ALIMENTARA)",72,"Alegeri Prezidentiale",1,1299,715,658,57,0,697,18,1400,685,506,191
14,CONSTANŢA,"MUNICIPIUL CONSTANŢA",60419,CONSTANŢA,"LICEUL TEHNOLOGIC ”GHEORGHE MIRON COSTIN” (INDUSTRIE ALIMENTARA)",73,"Alegeri Prezidentiale",2,1593,738,682,56,0,730,8,1800,1062,505,225
14,CONSTANŢA,"MUNICIPIUL CONSTANŢA",60419,CONSTANŢA,"LICEUL TEHNOLOGIC ”DIMITRIE LEONIDA”",74,"Alegeri Prezidentiale",1,1764,1001,952,49,0,980,21,1900,898,702,278
14,CONSTANŢA,"MUNICIPIUL CONSTANŢA",60419,CONSTANŢA,"LICEUL TEHNOLOGIC ”DIMITRIE LEONIDA”",75,"Alegeri Prezidentiale",1,1747,945,905,40,0,921,24,1900,955,630,291
14,CONSTANŢA,"MUNICIPIUL CONSTANŢA",60419,CONSTANŢA,"ŞCOALA GIMNAZIALA NR. 40 ”AUREL VLAICU”",76,"Alegeri Prezidentiale",1,1580,766,709,57,0,755,11,1700,934,548,207
14,CONSTANŢA,"MUNICIPIUL CONSTANŢA",60419,CONSTANŢA,"ŞCOALA GIMNAZIALA NR. 40 ”AUREL VLAICU”",77,"Alegeri Prezidentiale",1,820,484,395,89,0,470,14,900,416,306,164
14,CONSTANŢA,"MUNICIPIUL CONSTANŢA",60419,CONSTANŢA,"ŞCOALA GIMNAZIALA NR. 40 ”AUREL VLAICU”",78,"Alegeri Prezidentiale",1,1433,788,716,72,0,772,16,1607,819,555,217
14,CONSTANŢA,"MUNICIPIUL CONSTANŢA",60419,CONSTANŢA,"ŞCOALA GIMNAZIALA NR. 40 ”AUREL VLAICU”",79,"Alegeri Prezidentiale",1,1633,883,857,26,0,858,25,1800,917,590,268
14,CONSTANŢA,"MUNICIPIUL CONSTANŢA",60419,CONSTANŢA,"ŞCOALA GIMNAZIALA NR. 40 ”AUREL VLAICU”",80,"Alegeri Prezidentiale",1,841,424,390,34,0,418,6,891,467,298,120
14,CONSTANŢA,"MUNICIPIUL CONSTANŢA",60419,CONSTANŢA,"ŞCOALA GIMNAZIALA NR. 40 ”AUREL VLAICU”",81,"Alegeri Prezidentiale",1,871,410,390,20,0,401,9,1000,590,281,120
14,CONSTANŢA,"MUNICIPIUL CONSTANŢA",60419,CONSTANŢA,"ŞCOALA GIMNAZIALA NR. 40 ”AUREL VLAICU”",82,"Alegeri Prezidentiale",1,1249,461,429,32,0,454,7,1400,939,298,156
14,CONSTANŢA,"MUNICIPIUL CONSTANŢA",60419,CONSTANŢA,"GRĂDINIȚA CU PROGRAM NORMAL NR.34",83,"Alegeri Prezidentiale",1,1625,812,779,33,0,797,15,1752,940,562,235
14,CONSTANŢA,"MUNICIPIUL CONSTANŢA",60419,CONSTANŢA,"GRĂDINIȚA CU PROGRAM NORMAL NR.34",84,"Alegeri Prezidentiale",1,1324,690,652,38,0,685,5,1492,802,493,192
14,CONSTANŢA,"MUNICIPIUL CONSTANŢA",60419,CONSTANŢA,"ŞCOALA GIMNAZIALA NR. 31",85,"Alegeri Prezidentiale",1,1588,724,681,43,0,716,8,1700,976,484,232
14,CONSTANŢA,"MUNICIPIUL CONSTANŢA",60419,CONSTANŢA,"ŞCOALA GIMNAZIALA NR. 31",86,"Alegeri Prezidentiale",1,1217,557,528,29,0,548,9,1300,743,338,210
14,CONSTANŢA,"MUNICIPIUL CONSTANŢA",60419,CONSTANŢA,"ŞCOALA GIMNAZIALA NR. 31",87,"Alegeri Prezidentiale",1,1288,503,462,41,0,497,6,1400,897,313,184
14,CONSTANŢA,"MUNICIPIUL CONSTANŢA",60419,CONSTANŢA,"LICEUL TEHNOLOGIC ”GHEORGHE DUCA”",88,"Alegeri Prezidentiale",1,1617,833,769,64,0,815,18,1800,967,545,270
14,CONSTANŢA,"MUNICIPIUL CONSTANŢA",60419,CONSTANŢA,"ŞCOALA GIMNAZIALA ”MARIN SORESCU” (SCOALA NR. 20 )",89,"Alegeri Prezidentiale",1,870,482,444,38,0,473,9,1000,518,313,160
14,CONSTANŢA,"MUNICIPIUL CONSTANŢA",60419,CONSTANŢA,"ŞCOALA GIMNAZIALA NR. 22 ”I.C.BRATIANU”",90,"Alegeri Prezidentiale",1,1829,919,852,67,0,887,32,2000,1081,612,275
14,CONSTANŢA,"MUNICIPIUL CONSTANŢA",60419,CONSTANŢA,"ŞCOALA GIMNAZIALA NR. 22 ”I.C.BRATIANU”",91,"Alegeri Prezidentiale",1,1257,711,662,45,4,695,16,1400,689,497,198
14,CONSTANŢA,"MUNICIPIUL CONSTANŢA",60419,CONSTANŢA,"CENTRUL SCOLAR PENTRU EDUCATIE INCLUZIVA”MARIA MONTESSORI” (ŞCOALA AJUTATOARE NR. 2)",92,"Alegeri Prezidentiale",1,1647,801,769,32,0,779,22,1800,999,548,231
14,CONSTANŢA,"MUNICIPIUL CONSTANŢA",60419,CONSTANŢA,"CENTRUL SCOLAR PENTRU EDUCATIE INCLUZIVA”MARIA MONTESSORI” (ŞCOALA AJUTATOARE NR. 2)",93,"Alegeri Prezidentiale",1,806,452,423,29,0,441,11,900,448,306,135
14,CONSTANŢA,"MUNICIPIUL CONSTANŢA",60419,CONSTANŢA,"CENTRUL SCOLAR PENTRU EDUCATIE INCLUZIVA”MARIA MONTESSORI” (ŞCOALA AJUTATOARE NR. 2)",94,"Alegeri Prezidentiale",1,1126,611,561,50,0,599,12,1200,589,467,132
14,CONSTANŢA,"MUNICIPIUL CONSTANŢA",60419,CONSTANŢA,"CENTRUL SCOLAR PENTRU EDUCATIE INCLUZIVA”MARIA MONTESSORI” (ŞCOALA AJUTATOARE NR. 2)",95,"Alegeri Prezidentiale",1,865,475,446,29,0,459,16,1000,525,316,143
14,CONSTANŢA,"MUNICIPIUL CONSTANŢA",60419,CONSTANŢA,"ŞCOALA GIMNAZIALA NR. 8",96,"Alegeri Prezidentiale",1,1964,1083,942,141,0,1059,24,2000,917,757,302
14,CONSTANŢA,"MUNICIPIUL CONSTANŢA",60419,CONSTANŢA,"ŞCOALA GIMNAZIALA NR. 8",97,"Alegeri Prezidentiale",1,1461,866,758,108,0,852,14,1600,734,592,260
14,CONSTANŢA,"MUNICIPIUL CONSTANŢA",60419,CONSTANŢA,"ŞCOALA GIMNAZIALA NR. 8",98,"Alegeri Prezidentiale",1,1586,881,821,60,0,864,17,1700,819,637,227
14,CONSTANŢA,"MUNICIPIUL CONSTANŢA",60419,CONSTANŢA,"ŞCOALA GIMNAZIALA NR. 8",99,"Alegeri Prezidentiale",1,1503,875,804,71,0,860,15,1700,825,631,229
14,CONSTANŢA,"MUNICIPIUL CONSTANŢA",60419,CONSTANŢA,"ŞCOALA GIMNAZIALA NR.23 ”CONSTANTIN BRÂNCOVEANU”",100,"Alegeri Prezidentiale",1,1514,957,773,184,0,934,23,1700,743,728,206
14,CONSTANŢA,"MUNICIPIUL CONSTANŢA",60419,CONSTANŢA,"ŞCOALA GIMNAZIALA NR.23 ”CONSTANTIN BRÂNCOVEANU”",101,"Alegeri Prezidentiale",1,1616,1119,860,259,0,1094,25,1800,681,850,244
14,CONSTANŢA,"MUNICIPIUL CONSTANŢA",60419,CONSTANŢA,"ŞCOALA GIMNAZIALA NR.23 ”CONSTANTIN BRÂNCOVEANU”",102,"Alegeri Prezidentiale",1,1873,1257,1106,151,0,1237,20,2098,841,1035,202
14,CONSTANŢA,"MUNICIPIUL CONSTANŢA",60419,CONSTANŢA,"ŞCOALA GIMNAZIALA NR. 39 ”NICOLAE TONITZA”",103,"Alegeri Prezidentiale",1,1766,1135,1016,119,0,1115,20,1900,765,772,343
14,CONSTANŢA,"MUNICIPIUL CONSTANŢA",60419,CONSTANŢA,"ŞCOALA GIMNAZIALA NR. 39 ”NICOLAE TONITZA”",104,"Alegeri Prezidentiale",1,1539,884,848,36,0,861,23,1700,816,603,258
14,CONSTANŢA,"MUNICIPIUL CONSTANŢA",60419,CONSTANŢA,"ŞCOALA GIMNAZIALA NR. 39 ”NICOLAE TONITZA”",105,"Alegeri Prezidentiale",1,1697,950,895,55,0,934,16,1900,950,663,271
14,CONSTANŢA,"MUNICIPIUL CONSTANŢA",60419,CONSTANŢA,"ŞCOALA GIMNAZIALA NR. 39 ”NICOLAE TONITZA”",106,"Alegeri Prezidentiale",1,1856,1086,1047,39,0,1067,19,2000,914,747,320
14,CONSTANŢA,"MUNICIPIUL CONSTANŢA",60419,CONSTANŢA,"CENTRUL DE PERFECȚIONARE AL MARINEI CIVILE",107,"Alegeri Prezidentiale",1,1955,1115,987,128,0,1091,24,2000,885,850,241
14,CONSTANŢA,"MUNICIPIUL CONSTANŢA",60419,CONSTANŢA,"CENTRUL DE PERFECȚIONARE AL MARINEI CIVILE",108,"Alegeri Prezidentiale",1,1836,1003,928,75,0,980,23,1990,987,691,289
14,CONSTANŢA,"MUNICIPIUL CONSTANŢA",60419,CONSTANŢA,"CENTRUL DE PERFECȚIONARE AL MARINEI CIVILE",109,"Alegeri Prezidentiale",1,1473,808,752,56,0,791,17,1648,840,619,172
14,CONSTANŢA,"MUNICIPIUL CONSTANŢA",60419,CONSTANŢA,"ŞCOALA GIMNAZIALA NR. 10 ”MIHAIL KOICIU”",110,"Alegeri Prezidentiale",1,1445,816,736,79,1,795,21,1600,784,561,234
14,CONSTANŢA,"MUNICIPIUL CONSTANŢA",60419,CONSTANŢA,"ŞCOALA GIMNAZIALA NR. 10 ”MIHAIL KOICIU”",111,"Alegeri Prezidentiale",1,1200,677,637,40,0,662,15,1300,623,453,209
14,CONSTANŢA,"MUNICIPIUL CONSTANŢA",60419,CONSTANŢA,"ŞCOALA GIMNAZIALA NR. 10 ”MIHAIL KOICIU”",112,"Alegeri Prezidentiale",1,1837,1035,1009,26,0,1021,14,2000,965,732,289
14,CONSTANŢA,"MUNICIPIUL CONSTANŢA",60419,CONSTANŢA,"ŞCOALA GIMNAZIALA NR. 10 ”MIHAIL KOICIU”",113,"Alegeri Prezidentiale",2,1532,828,785,43,0,810,18,1700,872,570,240
14,CONSTANŢA,"MUNICIPIUL CONSTANŢA",60419,CONSTANŢA,"ŞCOALA GIMNAZIALA NR. 10 ”MIHAIL KOICIU”",114,"Alegeri Prezidentiale",1,1479,795,736,59,0,783,12,1600,805,558,225
14,CONSTANŢA,"MUNICIPIUL CONSTANŢA",60419,CONSTANŢA,"CENTRUL ȘCOLAR ”ALBATROS”",115,"Alegeri Prezidentiale",1,1138,632,573,59,0,617,15,1300,668,437,180
14,CONSTANŢA,"MUNICIPIUL CONSTANŢA",60419,CONSTANŢA,"CENTRUL ȘCOLAR ”ALBATROS”",116,"Alegeri Prezidentiale",1,1667,901,853,44,4,878,23,1801,900,594,284
14,CONSTANŢA,"MUNICIPIUL CONSTANŢA",60419,CONSTANŢA,"CENTRUL ȘCOLAR ”ALBATROS”",117,"Alegeri Prezidentiale",1,977,545,494,51,0,530,15,1100,555,366,164
14,CONSTANŢA,"MUNICIPIUL CONSTANŢA",60419,CONSTANŢA,"CENTRUL ȘCOLAR ”ALBATROS”",118,"Alegeri Prezidentiale",1,1031,545,523,22,0,528,17,1100,555,385,143
14,CONSTANŢA,"MUNICIPIUL CONSTANŢA",60419,CONSTANŢA,"CENTRUL ȘCOLAR ”ALBATROS”",119,"Alegeri Prezidentiale",1,775,396,369,27,0,388,8,900,504,248,140
14,CONSTANŢA,"MUNICIPIUL CONSTANŢA",60419,CONSTANŢA,"CENTRUL SCOLAR PENTRU EDUCATIE INCLUZIVA ”DELFINUL” (ŞCOALA AJUTATOARE NR. 1)",120,"Alegeri Prezidentiale",1,1624,803,760,43,0,790,13,1800,997,536,254
14,CONSTANŢA,"MUNICIPIUL CONSTANŢA",60419,CONSTANŢA,"CENTRUL SCOLAR PENTRU EDUCATIE INCLUZIVA ”DELFINUL” (ŞCOALA AJUTATOARE NR. 1)",121,"Alegeri Prezidentiale",1,1759,786,762,24,0,774,12,1900,1114,552,222
14,CONSTANŢA,"MUNICIPIUL CONSTANŢA",60419,CONSTANŢA,"ŞCOALA GIMNAZIALA NR. 12 ”B. P. HASDEU”",122,"Alegeri Prezidentiale",1,1760,1082,996,86,0,1060,22,1900,818,706,354
14,CONSTANŢA,"MUNICIPIUL CONSTANŢA",60419,CONSTANŢA,"ŞCOALA GIMNAZIALA NR. 12 ”B. P. HASDEU”",123,"Alegeri Prezidentiale",1,1459,868,697,170,1,844,24,1600,732,596,248
14,CONSTANŢA,"MUNICIPIUL CONSTANŢA",60419,CONSTANŢA,"ŞCOALA GIMNAZIALA ”DIMITRIE ȘTIUBEI” (ŞCOALA NR.36 )",124,"Alegeri Prezidentiale",1,1328,821,728,93,0,805,16,1500,679,609,196
14,CONSTANŢA,"MUNICIPIUL CONSTANŢA",60419,CONSTANŢA,"SCOALA GIMNAZIALA ”DIMITRIE ȘTIUBEI” (ŞCOALA NR.36)",125,"Alegeri Prezidentiale",1,2167,1164,1086,78,0,1135,29,2200,1036,690,445
14,CONSTANŢA,"MUNICIPIUL CONSTANŢA",60419,CONSTANŢA,"SCOALA GIMNAZIALA ”DIMITRIE ȘTIUBEI” (ŞCOALA NR.36)",126,"Alegeri Prezidentiale",1,1857,1030,967,63,0,1012,18,2000,970,693,319
14,CONSTANŢA,"MUNICIPIUL CONSTANŢA",60419,CONSTANŢA,"SCOALA GIMNAZIALA ”DIMITRIE ȘTIUBEI” (ŞCOALA NR.36)",127,"Alegeri Prezidentiale",1,1455,850,796,54,0,829,21,1600,750,595,234
14,CONSTANŢA,"MUNICIPIUL CONSTANŢA",60419,CONSTANŢA,"SCOALA GIMNAZIALA ”DIMITRIE ȘTIUBEI” (ŞCOALA NR.36)",128,"Alegeri Prezidentiale",1,1744,1015,923,92,0,999,16,1900,885,724,275
14,CONSTANŢA,"MUNICIPIUL CONSTANŢA",60419,CONSTANŢA,"GRĂDINIŢA CU PROGRAM PRELUNGIT ”MUGUREL” (GRĂDINIŢA NR. 43)",129,"Alegeri Prezidentiale",1,1410,759,695,64,0,742,17,1608,849,480,262
14,CONSTANŢA,"MUNICIPIUL CONSTANŢA",60419,CONSTANŢA,"GRĂDINIŢA CU PROGRAM PRELUNGIT ”MUGUREL” (GRĂDINIŢA NR. 43)",130,"Alegeri Prezidentiale",2,1541,925,853,72,0,909,16,1692,767,598,311
14,CONSTANŢA,"MUNICIPIUL CONSTANŢA",60419,CONSTANŢA,"GRĂDINIŢA CU PROGRAM NORMAL NR. 51",131,"Alegeri Prezidentiale",1,1525,889,785,103,1,867,22,1700,811,590,277
14,CONSTANŢA,"MUNICIPIUL CONSTANŢA",60419,CONSTANŢA,"GRĂDINIŢA CU PROGRAM NORMAL NR. 51",132,"Alegeri Prezidentiale",1,1519,911,814,97,0,901,10,1700,789,620,281
14,CONSTANŢA,"MUNICIPIUL CONSTANŢA",60419,CONSTANŢA,"AGENȚIA FISCALĂ NR.1-4",133,"Alegeri Prezidentiale",1,1690,973,897,74,2,954,19,1900,927,685,269
14,CONSTANŢA,"MUNICIPIUL CONSTANŢA",60419,CONSTANŢA,"AGENȚIA FISCALĂ NR.1-4",134,"Alegeri Prezidentiale",1,1447,840,779,61,0,822,18,1600,760,545,277
14,CONSTANŢA,"MUNICIPIUL CONSTANŢA",60419,CONSTANŢA,"LICEUL TEORETIC ”GEORGE CĂLINESCU”",135,"Alegeri Prezidentiale",1,1103,677,617,60,0,665,12,1200,523,434,231
14,CONSTANŢA,"MUNICIPIUL CONSTANŢA",60419,CONSTANŢA,"LICEUL TEORETIC ”GEORGE CĂLINESCU”",136,"Alegeri Prezidentiale",1,1047,677,608,68,1,666,11,1200,523,450,216
14,CONSTANŢA,"MUNICIPIUL CONSTANŢA",60419,CONSTANŢA,"LICEUL TEORETIC ”GEORGE CĂLINESCU”",137,"Alegeri Prezidentiale",1,1052,677,605,72,0,655,22,1200,523,480,175
14,CONSTANŢA,"MUNICIPIUL CONSTANŢA",60419,CONSTANŢA,"ŞCOALA GIMNAZIALA NR.14",138,"Alegeri Prezidentiale",1,1785,994,901,93,0,968,26,2000,1006,712,256
14,CONSTANŢA,"MUNICIPIUL CONSTANŢA",60419,CONSTANŢA,"ŞCOALA GIMNAZIALA NR.14",139,"Alegeri Prezidentiale",1,1948,989,920,64,5,966,23,2100,1111,724,242
14,CONSTANŢA,"MUNICIPIUL CONSTANŢA",60419,CONSTANŢA,"ŞCOALA GIMNAZIALA NR.14",140,"Alegeri Prezidentiale",1,931,484,366,27,91,467,17,1000,516,316,151
14,CONSTANŢA,"MUNICIPIUL CONSTANŢA",60419,CONSTANŢA,"ŞCOALA GIMNAZIALA NR. 38 ”DIMITRIE CANTEMIR”",141,"Alegeri Prezidentiale",1,955,673,568,105,0,658,15,1100,427,460,198
14,CONSTANŢA,"MUNICIPIUL CONSTANŢA",60419,CONSTANŢA,"ŞCOALA GIMNAZIALA NR. 38 ”DIMITRIE CANTEMIR”",142,"Alegeri Prezidentiale",1,998,627,536,91,0,615,12,1100,473,379,236
14,CONSTANŢA,"MUNICIPIUL CONSTANŢA",60419,CONSTANŢA,"LICEUL TEORETIC ”DECEBAL”",143,"Alegeri Prezidentiale",1,927,542,483,59,0,525,17,1000,458,356,169
14,CONSTANŢA,"MUNICIPIUL CONSTANŢA",60419,CONSTANŢA,"LICEUL TEORETIC ”DECEBAL”",144,"Alegeri Prezidentiale",1,593,367,267,100,0,357,10,700,333,280,77
14,CONSTANŢA,"MUNICIPIUL CONSTANŢA",60419,CONSTANŢA,"LICEUL TEORETIC ”DECEBAL”",145,"Alegeri Prezidentiale",1,760,457,375,81,1,450,7,800,343,324,126
14,CONSTANŢA,"MUNICIPIUL CONSTANŢA",60419,CONSTANŢA,"LICEUL TEORETIC ”DECEBAL”",146,"Alegeri Prezidentiale",1,880,434,390,44,0,419,15,1000,566,285,134
14,CONSTANŢA,"MUNICIPIUL CONSTANŢA",60419,CONSTANŢA,"LICEUL TEHNOLOGIC ”VIRGIL MADGEARU” (ŞCOALA NR.35)",147,"Alegeri Prezidentiale",1,800,584,414,170,0,571,13,900,316,394,177
14,CONSTANŢA,"MUNICIPIUL CONSTANŢA",60419,CONSTANŢA,"LICEUL TEHNOLOGIC ”VIRGIL MADGEARU” (ŞCOALA NR.35)",148,"Alegeri Prezidentiale",1,1134,673,564,108,1,657,16,1200,527,473,184
14,CONSTANŢA,"MUNICIPIUL CONSTANŢA",60419,CONSTANŢA,"LICEUL TEHNOLOGIC ”VIRGIL MADGEARU” (ŞCOALA NR.35)",149,"Alegeri Prezidentiale",1,774,448,401,47,0,439,9,900,452,281,158
14,CONSTANŢA,"MUNICIPIUL CONSTANŢA",60419,CONSTANŢA,"GRĂDINIŢA CU PROGRAM PRELUNGIT”AMICII” (GRĂDINIŢA NR.12 )",150,"Alegeri Prezidentiale",1,1178,790,584,206,0,769,21,1300,510,532,237
14,CONSTANŢA,"MUNICIPIUL CONSTANŢA",60419,CONSTANŢA,"ŞCOALA GIMNAZIALA NR. 29 ”MIHAI VITEAZUL”",151,"Alegeri Prezidentiale",1,673,435,315,120,0,430,5,700,265,302,128
14,CONSTANŢA,"MUNICIPIUL CONSTANŢA",60419,CONSTANŢA,"ŞCOALA GIMNAZIALA NR. 29 ”MIHAI VITEAZUL”",152,"Alegeri Prezidentiale",1,750,488,407,81,0,483,5,800,312,331,152
14,CONSTANŢA,"MUNICIPIUL CONSTANŢA",60419,CONSTANŢA,"ŞCOALA GIMNAZIALA NR. 29 ”MIHAI VITEAZUL”",153,"Alegeri Prezidentiale",1,1251,690,608,82,0,672,18,1400,710,463,209
14,CONSTANŢA,"MUNICIPIUL CONSTANŢA",60419,CONSTANŢA,"ŞCOALA NR. 29 ”MIHAI VITEAZU”",154,"Alegeri Prezidentiale",1,682,465,401,64,0,455,10,800,335,291,164
14,CONSTANŢA,"MUNICIPIUL CONSTANŢA",60419,CONSTANŢA,"ŞCOALA GIMNAZIALA NR. 7 ”REMUS OPREANU”",155,"Alegeri Prezidentiale",1,1252,714,664,50,0,698,16,1400,686,478,220
14,CONSTANŢA,"MUNICIPIUL CONSTANŢA",60419,CONSTANŢA,"ŞCOALA GIMNAZIALA NR. 7 ”REMUS OPREANU”",156,"Alegeri Prezidentiale",1,756,436,378,58,0,430,6,808,372,325,105
14,CONSTANŢA,"MUNICIPIUL CONSTANŢA",60419,CONSTANŢA,"ŞCOALA GIMNAZIALA NR. 7 ”REMUS OPREANU”",157,"Alegeri Prezidentiale",1,1309,796,675,120,1,781,15,1400,604,513,268
14,CONSTANŢA,"MUNICIPIUL CONSTANŢA",60419,CONSTANŢA,"ŞCOALA GIMNAZIALA NR. 7 ”REMUS OPREANU”",158,"Alegeri Prezidentiale",1,1395,936,826,109,1,920,16,1500,564,622,298
14,CONSTANŢA,"MUNICIPIUL CONSTANŢA",60419,CONSTANŢA,"ŞCOALA GIMNAZIALA NR. 7 ”REMUS OPREANU”",159,"Alegeri Prezidentiale",1,1189,763,643,120,0,753,10,1300,537,503,250
14,CONSTANŢA,"MUNICIPIUL CONSTANŢA",60419,CONSTANŢA,"ŞCOALA GIMNAZIALA NR.6 ”NICOLAE TITULESCU”",160,"Alegeri Prezidentiale",1,939,567,531,36,0,556,11,1000,433,397,159
14,CONSTANŢA,"MUNICIPIUL CONSTANŢA",60419,CONSTANŢA,"ŞCOALA GIMNAZIALA NR.6 ”NICOLAE TITULESCU”",161,"Alegeri Prezidentiale",1,1111,662,642,19,1,648,14,1200,538,458,190
14,CONSTANŢA,"MUNICIPIUL CONSTANŢA",60419,CONSTANŢA,"ŞCOALA GIMNAZIALA NR.6 ”NICOLAE TITULESCU”",162,"Alegeri Prezidentiale",1,1005,652,565,87,0,640,12,1100,448,463,177
14,CONSTANŢA,"MUNICIPIUL CONSTANŢA",60419,CONSTANŢA,"ŞCOALA GIMNAZIALA NR.6 ”NICOLAE TITULESCU”",163,"Alegeri Prezidentiale",1,1030,642,567,74,1,632,10,1100,458,467,165
14,CONSTANŢA,"MUNICIPIUL CONSTANŢA",60419,CONSTANŢA,"GRĂDINIŢA CU PROGRAM PRELUNGIT ”NOROCEL”(GRĂDINIŢA NR.13)",164,"Alegeri Prezidentiale",1,887,553,474,77,2,544,9,1000,447,371,173
14,CONSTANŢA,"MUNICIPIUL CONSTANŢA",60419,CONSTANŢA,"GRĂDINIŢA CU PROGRAM PRELUNGIT ”NOROCEL”(GRĂDINIŢA NR.13)",165,"Alegeri Prezidentiale",1,991,605,561,44,0,591,14,1100,495,417,174
14,CONSTANŢA,"MUNICIPIUL CONSTANŢA",60419,CONSTANŢA,"PALATUL COPIILOR",166,"Alegeri Prezidentiale",1,741,411,387,24,0,402,9,800,389,301,101
14,CONSTANŢA,"MUNICIPIUL CONSTANŢA",60419,CONSTANŢA,"PALATUL COPIILOR",167,"Alegeri Prezidentiale",1,595,323,289,34,0,314,9,700,377,236,78
14,CONSTANŢA,"MUNICIPIUL CONSTANŢA",60419,CONSTANŢA,"SCOALA GIMNAZIALA ”SPECTRUM” (ŞCOALA NR.27)",168,"Alegeri Prezidentiale",1,1361,926,794,132,0,907,19,1499,573,649,258
14,CONSTANŢA,"MUNICIPIUL CONSTANŢA",60419,CONSTANŢA,"SCOALA GIMNAZIALA ”SPECTRUM” (ŞCOALA NR.27)",169,"Alegeri Prezidentiale",1,1558,901,803,98,0,887,14,1700,799,660,227
14,CONSTANŢA,"MUNICIPIUL CONSTANŢA",60419,CONSTANŢA,"COLEGIUL TEHNIC ”TOMIS”",170,"Alegeri Prezidentiale",1,987,617,587,30,0,603,14,1100,483,450,153
14,CONSTANŢA,"MUNICIPIUL CONSTANŢA",60419,CONSTANŢA,"COLEGIUL TEHNIC ”TOMIS”",171,"Alegeri Prezidentiale",1,960,594,536,57,1,585,9,1100,506,436,149
14,CONSTANŢA,"MUNICIPIUL CONSTANŢA",60419,CONSTANŢA,"COLEGIUL TEHNIC ”TOMIS”",172,"Alegeri Prezidentiale",1,653,481,349,131,1,474,7,700,219,346,128
14,CONSTANŢA,"MUNICIPIUL CONSTANŢA",60419,CONSTANŢA,"COLEGIUL TEHNIC ”TOMIS”",173,"Alegeri Prezidentiale",1,1028,655,612,42,1,644,11,1108,453,452,192
14,CONSTANŢA,"MUNICIPIUL CONSTANŢA",60419,CONSTANŢA,"ŞCOALA GIMNAZIALA NR.30 ”GHEORGHE ŢIŢEICA”",174,"Alegeri Prezidentiale",1,1258,618,575,43,0,611,7,1400,782,455,156
14,CONSTANŢA,"MUNICIPIUL CONSTANŢA",60419,CONSTANŢA,"ŞCOALA GIMNAZIALA NR.30 ”GHEORGHE ŢIŢEICA”",175,"Alegeri Prezidentiale",1,865,548,489,58,1,537,11,1000,452,393,144
14,CONSTANŢA,"MUNICIPIUL CONSTANŢA",60419,CONSTANŢA,"ŞCOALA GIMNAZIALA NR.30 ”GHEORGHE ŢIŢEICA”",176,"Alegeri Prezidentiale",1,850,473,445,28,0,464,9,900,427,344,120
14,CONSTANŢA,"MUNICIPIUL CONSTANŢA",60419,CONSTANŢA,"CENTRUL JUDEŢEAN DE RESURSE ŞI ASISTENŢĂ EDUCAŢIONALĂ",177,"Alegeri Prezidentiale",1,1194,682,606,76,0,673,9,1300,618,504,169
14,CONSTANŢA,"MUNICIPIUL CONSTANŢA",60419,CONSTANŢA,"CENTRUL JUDEŢEAN DE RESURSE ŞI ASISTENŢĂ EDUCAŢIONALĂ",178,"Alegeri Prezidentiale",1,941,610,541,69,0,596,14,1000,390,443,153
14,CONSTANŢA,"MUNICIPIUL CONSTANŢA",60419,CONSTANŢA,"CENTRUL JUDEŢEAN DE RESURSE ŞI ASISTENŢĂ EDUCAŢIONALĂ",179,"Alegeri Prezidentiale",1,1042,570,534,36,0,564,6,1100,530,402,162
14,CONSTANŢA,"MUNICIPIUL CONSTANŢA",60419,CONSTANŢA,"CĂMINUL DE PENSIONARI",180,"Alegeri Prezidentiale",1,1144,820,625,195,0,802,18,1300,480,542,260
14,CONSTANŢA,"MUNICIPIUL CONSTANŢA",60419,CONSTANŢA,"CĂMINUL DE PENSIONARI",181,"Alegeri Prezidentiale",1,1638,983,810,172,1,957,26,1800,817,690,267
14,CONSTANŢA,"MUNICIPIUL CONSTANŢA",60419,CONSTANŢA,"COLEGIUL TEHNIC ENERGETIC",182,"Alegeri Prezidentiale",1,1235,767,670,97,0,747,20,1400,633,572,175
14,CONSTANŢA,"MUNICIPIUL CONSTANŢA",60419,CONSTANŢA,"COLEGIUL TEHNIC ENERGETIC",183,"Alegeri Prezidentiale",1,708,561,345,216,0,550,11,800,239,419,131
14,CONSTANŢA,"MUNICIPIUL CONSTANŢA",60419,CONSTANŢA,"COLEGIUL TEHNIC ENERGETIC",184,"Alegeri Prezidentiale",1,1276,733,653,80,0,719,14,1400,667,538,181
14,CONSTANŢA,"MUNICIPIUL CONSTANŢA",60419,CONSTANŢA,"COLEGIUL TEHNIC ENERGETIC",185,"Alegeri Prezidentiale",1,1651,932,893,39,0,921,11,1792,860,685,236
14,CONSTANŢA,"MUNICIPIUL CONSTANŢA",60419,CONSTANŢA,"ŞCOALA GIMNAZIALA NR. 3 ”CIPRIAN PORUMBESCU”",186,"Alegeri Prezidentiale",1,1347,819,758,61,0,801,18,1500,681,556,245
14,CONSTANŢA,"MUNICIPIUL CONSTANŢA",60419,CONSTANŢA,"ŞCOALA GIMNAZIALA NR. 3 ”CIPRIAN PORUMBESCU”",187,"Alegeri Prezidentiale",1,1179,685,591,94,0,675,10,1300,615,480,195
14,CONSTANŢA,"MUNICIPIUL CONSTANŢA",60419,CONSTANŢA,"ŞCOALA GIMNAZIALA NR. 3 ”CIPRIAN PORUMBESCU”",188,"Alegeri Prezidentiale",1,1081,603,570,33,0,593,10,1200,597,412,181
14,CONSTANŢA,"MUNICIPIUL CONSTANŢA",60419,CONSTANŢA,"GRĂDINIŢA CU PROGRAM PRELUNGIT NR.45",189,"Alegeri Prezidentiale",1,870,580,460,120,0,574,6,1000,420,443,131
14,CONSTANŢA,"MUNICIPIUL CONSTANŢA",60419,CONSTANŢA,"UNIVERSITATEA ”OVIDIUS”",190,"Alegeri Prezidentiale",1,1743,966,890,76,0,951,15,1900,934,702,249
14,CONSTANŢA,"MUNICIPIUL CONSTANŢA",60419,CONSTANŢA,"UNIVERSITATEA ”OVIDIUS”",191,"Alegeri Prezidentiale",1,1043,629,507,122,0,617,12,1092,463,486,131
14,CONSTANŢA,"MUNICIPIUL CONSTANŢA",60419,CONSTANŢA,"UNIVERSITATEA ”OVIDIUS”",192,"Alegeri Prezidentiale",2,1108,703,519,134,50,690,13,1200,497,527,163
14,CONSTANŢA,"MUNICIPIUL CONSTANŢA",60419,CONSTANŢA,"UNIVERSITATEA ”OVIDIUS”",193,"Alegeri Prezidentiale",1,258,317,135,182,0,313,4,600,283,269,44
14,CONSTANŢA,"MUNICIPIUL CONSTANŢA",60419,CONSTANŢA,"ŞCOALA GIMNAZIALA NR. 43 ”FERDINAND”",194,"Alegeri Prezidentiale",1,668,513,397,116,0,503,10,700,187,403,100
14,CONSTANŢA,"MUNICIPIUL CONSTANŢA",60419,CONSTANŢA,"ŞCOALA GIMNAZIALA NR.5 ”NICOLAE IORGA”",195,"Alegeri Prezidentiale",1,1421,824,729,47,48,810,14,1600,776,533,277
14,CONSTANŢA,"MUNICIPIUL CONSTANŢA",60419,CONSTANŢA,"ŞCOALA GIMNAZIALA NR.5 ”NICOLAE IORGA”",196,"Alegeri Prezidentiale",1,753,537,401,81,55,526,11,800,263,377,149
14,CONSTANŢA,"MUNICIPIUL CONSTANŢA",60419,CONSTANŢA,"ŞCOALA GIMNAZIALA NR.5 ”NICOLAE IORGA”",197,"Alegeri Prezidentiale",1,495,313,249,34,30,309,4,500,187,214,95
14,CONSTANŢA,"MUNICIPIUL CONSTANŢA",60419,CONSTANŢA,"ANEXĂ LA COLEGIUL NAŢIONAL ”MIRCEA CEL BĂTRÂN”",198,"Alegeri Prezidentiale",1,601,473,338,69,66,462,11,700,227,323,139
14,CONSTANŢA,"MUNICIPIUL CONSTANŢA",60419,CONSTANŢA,"ANEXĂ LA COLEGIUL NAŢIONAL ”MIRCEA CEL BĂTRÂN”",199,"Alegeri Prezidentiale",1,593,424,326,19,79,415,9,700,276,291,124
14,CONSTANŢA,"MUNICIPIUL CONSTANŢA",60419,CONSTANŢA,"GRĂDINIŢA CU PROGRAM PRELUNGIT NR. 8 (TOMIS II)",200,"Alegeri Prezidentiale",1,763,563,444,93,26,543,20,800,237,364,179
14,CONSTANŢA,"MUNICIPIUL CONSTANŢA",60419,CONSTANŢA,"ATELIER ŞCOALĂ",201,"Alegeri Prezidentiale",1,716,448,402,46,0,436,12,800,352,292,144
14,CONSTANŢA,"MUNICIPIUL CONSTANŢA",60419,CONSTANŢA,"GRĂDINIŢA CU PROGRAM PRELUNGIT NR.6",202,"Alegeri Prezidentiale",1,749,487,417,70,0,481,6,800,313,322,159
14,CONSTANŢA,"MUNICIPIUL CONSTANŢA",60419,CONSTANŢA,"ŞCOALA GIMNAZIALA NR. 11 ”DR.CONSTANTIN ANGELESCU”",203,"Alegeri Prezidentiale",1,1227,760,695,65,0,747,13,1300,540,522,225
14,CONSTANŢA,"MUNICIPIUL CONSTANŢA",60419,CONSTANŢA,"ŞCOALA GIMNAZIALA NR. 11 ”DR.CONSTANTIN ANGELESCU”",204,"Alegeri Prezidentiale",1,1477,865,780,85,0,848,17,1600,735,550,298
14,CONSTANŢA,"MUNICIPIUL CONSTANŢA",60419,CONSTANŢA,"LICEUL TEHNOLOGIC DE ELECTROTEHNICA SI TELECOMUNICAȚII",205,"Alegeri Prezidentiale",1,1258,814,749,65,0,799,15,1400,586,577,222
14,CONSTANŢA,"MUNICIPIUL CONSTANŢA",60419,CONSTANŢA,"UNIVERSITATEA ”ANDREI ŞAGUNA”",206,"Alegeri Prezidentiale",1,775,517,440,75,2,511,6,900,383,379,132
14,CONSTANŢA,"MUNICIPIUL CONSTANŢA",60419,CONSTANŢA,"CARTIER TOMIS PLUS",207,"Alegeri Prezidentiale",1,2158,1476,1208,268,0,1450,26,2200,724,1203,247
14,CONSTANŢA,"MUNICIPIUL CONSTANŢA",60419,MAMAIA,"HOTEL VENUS",208,"Alegeri Prezidentiale",1,316,298,140,158,0,287,11,400,102,213,74
14,CONSTANŢA,"MUNICIPIUL CONSTANŢA",60419,CONSTANŢA,"ȘCOALA GIMNAZIALA NR. 23 ”CONSTANTIN BRÂNCOVEANU”",209,"Alegeri Prezidentiale",1,1052,743,559,184,0,732,11,1200,457,543,189
14,CONSTANŢA,"MUNICIPIUL CONSTANŢA",60419,CONSTANŢA,"CAMPUS SOCIAL ”HENRI COANDĂ”",210,"Alegeri Prezidentiale",1,1719,830,778,52,0,819,11,1900,1070,320,499
14,CONSTANŢA,"MUNICIPIUL MANGALIA",60482,MANGALIA,"CASA MUNICIPALĂ DE CULTURĂ",211,"Alegeri Prezidentiale",1,1474,1005,746,259,0,979,26,1600,595,520,459
14,CONSTANŢA,"MUNICIPIUL MANGALIA",60482,MANGALIA,"GRUP ȘCOLAR ECONOMIC",212,"Alegeri Prezidentiale",1,1385,775,693,81,1,757,18,1500,725,499,258
14,CONSTANŢA,"MUNICIPIUL MANGALIA",60482,MANGALIA,"LICEUL TEHNOLOGIC ”ION BĂNESCU” MANGALIA",213,"Alegeri Prezidentiale",1,1115,632,551,81,0,621,11,1200,568,486,135
14,CONSTANŢA,"MUNICIPIUL MANGALIA",60482,MANGALIA,"GRUP ȘCOLAR INDUSTRIAL ”ION BĂNESCU”",214,"Alegeri Prezidentiale",1,1435,750,694,54,2,736,14,1600,850,512,224
14,CONSTANŢA,"MUNICIPIUL MANGALIA",60482,MANGALIA,"BAZA SPOTIVĂ PESCĂRUȘ",215,"Alegeri Prezidentiale",1,1152,604,554,49,1,590,13,1300,696,377,213
14,CONSTANŢA,"MUNICIPIUL MANGALIA",60482,MANGALIA,"ȘCOALA GENERALĂ NR.3",216,"Alegeri Prezidentiale",1,1603,873,806,67,0,855,18,1800,927,577,278
14,CONSTANŢA,"MUNICIPIUL MANGALIA",60482,MANGALIA,"ȘCOALA GENERALĂ NR.3",217,"Alegeri Prezidentiale",1,1561,755,721,33,1,738,17,1700,945,478,260
14,CONSTANŢA,"MUNICIPIUL MANGALIA",60482,MANGALIA,"GRĂDINIȚA NR.3",218,"Alegeri Prezidentiale",1,1597,835,782,52,1,818,17,1800,965,500,318
14,CONSTANŢA,"MUNICIPIUL MANGALIA",60482,MANGALIA,"ȘCOALA GENERALĂ NR.1",219,"Alegeri Prezidentiale",1,1147,596,542,54,0,585,11,1300,704,398,187
14,CONSTANŢA,"MUNICIPIUL MANGALIA",60482,MANGALIA,"ȘCOALA GENERALĂ NR.1",220,"Alegeri Prezidentiale",1,1361,639,615,24,0,623,16,1500,861,443,180
14,CONSTANŢA,"MUNICIPIUL MANGALIA",60482,MANGALIA,"ȘCOALA GENERALĂ NR.2",221,"Alegeri Prezidentiale",1,1423,716,671,45,0,698,18,1600,884,448,250
14,CONSTANŢA,"MUNICIPIUL MANGALIA",60482,MANGALIA,"ȘCOALA GENERALĂ NR.2",222,"Alegeri Prezidentiale",1,1651,783,758,25,0,757,26,1800,1017,487,270
14,CONSTANŢA,"MUNICIPIUL MANGALIA",60482,MANGALIA,"SEDIU S.C. ECO GOLD S.A.",223,"Alegeri Prezidentiale",1,1954,1156,1093,62,1,1132,24,2100,944,772,360
14,CONSTANŢA,"MUNICIPIUL MANGALIA",60482,MANGALIA,"GRĂDINIȚA NR. 4",224,"Alegeri Prezidentiale",1,1244,659,623,34,2,647,12,1400,741,435,212
14,CONSTANŢA,"MUNICIPIUL MANGALIA",60482,MANGALIA,"FUNDAȚIA PENTRU TINERET MANGALIA",225,"Alegeri Prezidentiale",1,1188,474,437,36,1,469,5,1300,826,261,208
14,CONSTANŢA,"MUNICIPIUL MANGALIA",60482,MANGALIA,"FUNDATIA PENTRU TINERET",226,"Alegeri Prezidentiale",1,1391,754,692,61,1,727,27,1500,746,466,261
14,CONSTANŢA,"MUNICIPIUL MANGALIA",60482,MANGALIA,"ȘCOALA GENERALĂ NR.5",227,"Alegeri Prezidentiale",1,1174,656,595,59,2,641,15,1300,644,441,200
14,CONSTANŢA,"MUNICIPIUL MANGALIA",60482,MANGALIA,"ȘCOALA GENERALĂ NR.5",228,"Alegeri Prezidentiale",1,1229,695,628,67,0,687,8,1400,705,459,228
14,CONSTANŢA,"MUNICIPIUL MANGALIA",60482,MANGALIA,"FUNDAȚIA PENTRU TINERET",229,"Alegeri Prezidentiale",1,1225,654,582,72,0,641,13,1300,646,393,248
14,CONSTANŢA,"MUNICIPIUL MANGALIA",60482,MANGALIA,"HOTEL MANGALIA",230,"Alegeri Prezidentiale",1,1254,877,645,232,0,854,23,1400,523,508,346
14,CONSTANŢA,"MUNICIPIUL MANGALIA",60482,MANGALIA,"CLUB SPITAL MANGALIA",231,"Alegeri Prezidentiale",1,891,554,424,45,85,538,16,1000,446,303,235
14,CONSTANŢA,"MUNICIPIUL MANGALIA",60482,MANGALIA,"GRĂDINIȚA CALLATIS",232,"Alegeri Prezidentiale",1,1134,567,532,35,0,558,9,1200,633,381,177
14,CONSTANŢA,"MUNICIPIUL MANGALIA",60482,MANGALIA,"LICEUL CALLATIS",233,"Alegeri Prezidentiale",1,1169,648,579,69,0,631,17,1300,652,378,253
14,CONSTANŢA,"MUNICIPIUL MANGALIA",60482,MANGALIA,"LICEUL CALLATIS",234,"Alegeri Prezidentiale",1,1063,523,478,45,0,518,5,1200,677,342,176
14,CONSTANŢA,"MUNICIPIUL MANGALIA",60482,NEPTUN,"GRADINITA NR. 5 NEPTUN",235,"Alegeri Prezidentiale",1,1347,662,608,54,0,649,13,1500,838,429,220
14,CONSTANŢA,"MUNICIPIUL MANGALIA",60482,NEPTUN,"GRĂDINIȚA NR. 5 NEPTUN",236,"Alegeri Prezidentiale",1,492,188,162,26,0,184,4,500,312,134,50
14,CONSTANŢA,"MUNICIPIUL MEDGIDIA",60847,MEDGIDIA,"CASA DE CULTURĂ ”I.N.ROMAN”",237,"Alegeri Prezidentiale",1,840,457,417,38,2,446,11,900,443,250,196
14,CONSTANŢA,"MUNICIPIUL MEDGIDIA",60847,MEDGIDIA,"GRĂDINIŢA NR.1 -BILINGVĂ ROMANO-TURCA",238,"Alegeri Prezidentiale",1,752,363,333,29,1,357,6,800,437,189,168
14,CONSTANŢA,"MUNICIPIUL MEDGIDIA",60847,MEDGIDIA,"GRADINITA NR.1",239,"Alegeri Prezidentiale",1,843,325,305,20,0,318,7,892,567,186,132
14,CONSTANŢA,"MUNICIPIUL MEDGIDIA",60847,MEDGIDIA,"ŞCOALA ”MIHAIL SADOVEANU”",240,"Alegeri Prezidentiale",1,924,317,300,17,0,312,5,1000,683,190,122
14,CONSTANŢA,"MUNICIPIUL MEDGIDIA",60847,MEDGIDIA,"ŞCOALA ”MIHAIL SADOVEANU”",241,"Alegeri Prezidentiale",1,1467,242,226,16,0,231,11,1600,1358,92,139
14,CONSTANŢA,"MUNICIPIUL MEDGIDIA",60847,MEDGIDIA,"ŞCOALA GIMNAZIALĂ ”MIHAIL SADOVEANU”",242,"Alegeri Prezidentiale",1,1121,282,264,17,1,271,11,1200,918,151,120
14,CONSTANŢA,"MUNICIPIUL MEDGIDIA",60847,MEDGIDIA,"GRĂDINIŢA NR.8",243,"Alegeri Prezidentiale",1,1377,518,494,24,0,509,9,1500,982,275,234
14,CONSTANŢA,"MUNICIPIUL MEDGIDIA",60847,MEDGIDIA,"LICEUL TEHNOLOGIC ”DRAGOMIR HURMUZESCU”",244,"Alegeri Prezidentiale",1,1274,433,421,10,2,427,6,1400,967,261,166
14,CONSTANŢA,"MUNICIPIUL MEDGIDIA",60847,MEDGIDIA,"ŞCOALA ”CONSTANTIN BRÂNCUŞI”",245,"Alegeri Prezidentiale",1,1013,429,412,17,0,421,8,1092,663,243,178
14,CONSTANŢA,"MUNICIPIUL MEDGIDIA",60847,MEDGIDIA,"ŞCOALA ”CONSTANTIN BRÂNCUŞI”",246,"Alegeri Prezidentiale",1,995,426,400,26,0,422,4,1100,674,227,195
14,CONSTANŢA,"MUNICIPIUL MEDGIDIA",60847,MEDGIDIA,"LICEUL TEORETIC ”NICOLAE BĂLCESCU”",247,"Alegeri Prezidentiale",1,835,355,337,18,0,352,3,906,551,183,169
14,CONSTANŢA,"MUNICIPIUL MEDGIDIA",60847,MEDGIDIA,"LICEUL TEORETIC ”NICOLAE BĂLCESCU”",248,"Alegeri Prezidentiale",1,776,355,341,14,0,350,5,900,545,197,153
14,CONSTANŢA,"MUNICIPIUL MEDGIDIA",60847,MEDGIDIA,"SCOALA ”MIRCEA DRAGOMIRESCU”",249,"Alegeri Prezidentiale",1,825,389,377,12,0,383,6,899,510,191,192
14,CONSTANŢA,"MUNICIPIUL MEDGIDIA",60847,MEDGIDIA,"ŞCOALA ”MIRCEA DRAGOMIRESCU”",250,"Alegeri Prezidentiale",1,795,370,343,27,0,367,3,908,538,175,192
14,CONSTANŢA,"MUNICIPIUL MEDGIDIA",60847,MEDGIDIA,"ŞCOALA GIMNAZIALĂ ”MIRCEA DRAGOMIRESCU”",251,"Alegeri Prezidentiale",1,1226,550,530,20,0,537,13,1300,750,342,195
14,CONSTANŢA,"MUNICIPIUL MEDGIDIA",60847,MEDGIDIA,"LICEUL TEORETIC ”NICOLAE BĂLCESCU” MEDGIDIA",252,"Alegeri Prezidentiale",2,896,415,399,16,0,407,8,1000,585,214,193
14,CONSTANŢA,"MUNICIPIUL MEDGIDIA",60847,MEDGIDIA,"ŞCOALA GIMNAZIALĂ ”CONSTANTIN BRÂNCUŞI” MEDGIDIA",253,"Alegeri Prezidentiale",1,762,380,368,12,0,374,6,800,420,213,161
14,CONSTANŢA,"MUNICIPIUL MEDGIDIA",60847,MEDGIDIA,"COLEGIUL ”KEMAL ATATURK”",254,"Alegeri Prezidentiale",1,958,414,392,22,0,411,3,1100,686,242,169
14,CONSTANŢA,"MUNICIPIUL MEDGIDIA",60847,MEDGIDIA,"HOTEL ”STADION”",255,"Alegeri Prezidentiale",1,873,439,421,16,2,429,10,1000,561,233,196
14,CONSTANŢA,"MUNICIPIUL MEDGIDIA",60847,MEDGIDIA,"HOTEL ”STADION”",256,"Alegeri Prezidentiale",1,903,455,430,25,0,445,10,1000,545,234,211
14,CONSTANŢA,"MUNICIPIUL MEDGIDIA",60847,MEDGIDIA,"HOTEL ”STADION”",257,"Alegeri Prezidentiale",1,1047,497,471,26,0,491,6,1200,703,249,242
14,CONSTANŢA,"MUNICIPIUL MEDGIDIA",60847,MEDGIDIA,"ANEXA - COLEGIUL ”KEMAL ATATURK”",258,"Alegeri Prezidentiale",1,924,364,341,22,1,352,12,1000,636,163,189
14,CONSTANŢA,"MUNICIPIUL MEDGIDIA",60847,MEDGIDIA,"ANEXA - COLEGIUL ”KEMAL ATATURK”",259,"Alegeri Prezidentiale",1,757,339,329,10,0,332,7,800,461,182,150
14,CONSTANŢA,"MUNICIPIUL MEDGIDIA",60847,MEDGIDIA,"ŞCOALA ”LUCIAN GRIGORESCU”",260,"Alegeri Prezidentiale",1,1058,515,478,37,0,505,10,1200,685,289,216
14,CONSTANŢA,"MUNICIPIUL MEDGIDIA",60847,MEDGIDIA,"ŞCOALA ”LUCIAN GRIGORESCU”",261,"Alegeri Prezidentiale",1,609,324,306,18,0,315,9,700,376,173,142
14,CONSTANŢA,"MUNICIPIUL MEDGIDIA",60847,MEDGIDIA,"ŞCOALA GIMNAZIALĂ ”I.L.CARAGIALE” MEDGIDIA",262,"Alegeri Prezidentiale",1,689,279,245,34,0,266,13,800,521,149,117
14,CONSTANŢA,"MUNICIPIUL MEDGIDIA",60847,MEDGIDIA,"ŞCOALA ”I.L.CARAGIALE”",263,"Alegeri Prezidentiale",1,983,519,499,20,0,509,10,1100,581,289,220
14,CONSTANŢA,"MUNICIPIUL MEDGIDIA",60847,MEDGIDIA,"SCOALA ”I.L.CARAGIALE”",264,"Alegeri Prezidentiale",1,1034,414,396,18,0,409,5,1100,686,239,170
14,CONSTANŢA,"MUNICIPIUL MEDGIDIA",60847,MEDGIDIA,"SCOALA ”I.L.CARAGIALE”",265,"Alegeri Prezidentiale",1,1044,485,474,10,1,480,5,1100,615,248,232
14,CONSTANŢA,"MUNICIPIUL MEDGIDIA",60847,MEDGIDIA,"COLEGIUL TEHNIC ”NICOLAE TITULESCU”",266,"Alegeri Prezidentiale",1,1006,434,409,25,0,426,8,1100,666,211,215
14,CONSTANŢA,"MUNICIPIUL MEDGIDIA",60847,MEDGIDIA,"COLEGIUL TEHNIC ”NICOLAE TITULESCU”",267,"Alegeri Prezidentiale",1,1248,634,619,15,0,620,14,1400,766,361,259
14,CONSTANŢA,"MUNICIPIUL MEDGIDIA",60847,MEDGIDIA,"ŞCOALA ”SPIRU HARET”",268,"Alegeri Prezidentiale",1,1047,463,432,31,0,454,9,1200,737,230,224
14,CONSTANŢA,"MUNICIPIUL MEDGIDIA",60847,MEDGIDIA,"ŞCOALA ”SPIRU HARET”",269,"Alegeri Prezidentiale",1,1201,458,448,10,0,444,14,1300,842,238,206
14,CONSTANŢA,"MUNICIPIUL MEDGIDIA",60847,MEDGIDIA,"ŞCOALA ”SPIRU HARET”",270,"Alegeri Prezidentiale",1,1236,525,513,12,0,516,9,1400,875,305,211
14,CONSTANŢA,"MUNICIPIUL MEDGIDIA",60847,MEDGIDIA,"GRADINIŢA NR.7",271,"Alegeri Prezidentiale",1,1329,701,661,40,0,682,19,1500,799,413,269
14,CONSTANŢA,"MUNICIPIUL MEDGIDIA",60847,"VALEA DACILOR","ŞCOALA ”IULIU PRODAN”",272,"Alegeri Prezidentiale",1,1248,533,498,35,0,526,7,1400,867,344,182
14,CONSTANŢA,"MUNICIPIUL MEDGIDIA",60847,"REMUS OPREANU","S.C. ”MAXICOMP” SRL",273,"Alegeri Prezidentiale",1,290,135,116,19,0,134,1,300,165,100,34
14,CONSTANŢA,"ORAŞ CERNAVODĂ",60776,CERNAVODĂ,"ŞCOALA GIMNAZIALĂ NR. 1",274,"Alegeri Prezidentiale",1,1737,700,675,25,0,688,12,1900,1200,453,235
14,CONSTANŢA,"ORAŞ CERNAVODĂ",60776,CERNAVODĂ,"ŞCOALA GIMNAZIALĂ NR. 1",275,"Alegeri Prezidentiale",1,1354,577,535,42,0,575,2,1500,923,357,218
14,CONSTANŢA,"ORAŞ CERNAVODĂ",60776,CERNAVODĂ,"GRĂDINIŢA CU PROGRAM PRELUNGIT ”PANSELUŢA”",276,"Alegeri Prezidentiale",1,1591,614,594,20,0,606,8,1800,1186,394,212
14,CONSTANŢA,"ORAŞ CERNAVODĂ",60776,CERNAVODĂ,"ŞCOALA GIMNAZIALĂ NR. 2",277,"Alegeri Prezidentiale",1,1409,626,591,35,0,614,12,1500,874,386,228
14,CONSTANŢA,"ORAŞ CERNAVODĂ",60776,CERNAVODĂ,"LICEUL TEORETIC ANGHEL SALIGNY",278,"Alegeri Prezidentiale",1,1564,854,727,127,0,839,15,1700,846,531,308
14,CONSTANŢA,"ORAŞ CERNAVODĂ",60776,CERNAVODĂ,"LICEUL TEORETIC ANGHEL SALIGNY",279,"Alegeri Prezidentiale",1,1519,850,732,118,0,834,16,1700,850,558,276
14,CONSTANŢA,"ORAŞ CERNAVODĂ",60776,CERNAVODĂ,"GRĂDINIŢA CU PROGRAM PRELUNGIT NR. 4",280,"Alegeri Prezidentiale",1,1413,626,598,28,0,614,12,1600,974,380,234
14,CONSTANŢA,"ORAŞ CERNAVODĂ",60776,CERNAVODĂ,"CREŞA DIN STRADA TUDOR VLADIMIRESCU",281,"Alegeri Prezidentiale",1,1004,462,446,16,0,457,5,1100,638,260,197
14,CONSTANŢA,"ORAŞ CERNAVODĂ",60776,CERNAVODĂ,"LICEUL TEHNOLOGIC AXIOPOLIS CERNAVODĂ",282,"Alegeri Prezidentiale",1,1458,626,595,31,0,611,15,1600,974,415,196
14,CONSTANŢA,"ORAŞ CERNAVODĂ",60776,CERNAVODĂ,"LICEUL TEHNOLOGIC AXIOPOLIS CERNAVODĂ",283,"Alegeri Prezidentiale",1,1182,573,508,65,0,554,19,1300,727,420,134
14,CONSTANŢA,"ORAŞ CERNAVODĂ",60776,CERNAVODĂ,"ŞCOALA GIMNAZIALĂ MIRCEA ELIADE",284,"Alegeri Prezidentiale",1,1118,639,536,103,0,623,16,1200,561,422,201
14,CONSTANŢA,"ORAŞ EFORIE",60455,"EFORIE SUD","LICEUL CARMEN SILVA EFORIE SUD",285,"Alegeri Prezidentiale",1,1452,857,744,113,0,838,19,1600,743,630,208
14,CONSTANŢA,"ORAŞ EFORIE",60455,"EFORIE SUD","SEDIUL POLITIEI LOCALE EFORIE SUD",286,"Alegeri Prezidentiale",1,1557,838,690,148,0,824,14,1700,862,581,243
14,CONSTANŢA,"ORAŞ EFORIE",60455,"EFORIE SUD","GRĂDINIȚA DE COPII EFORIE SUD",287,"Alegeri Prezidentiale",1,989,559,463,78,18,547,12,1100,541,421,126
14,CONSTANŢA,"ORAŞ EFORIE",60455,"EFORIE NORD","HOTEL ”TRAIAN” EFORIE NORD",288,"Alegeri Prezidentiale",1,1379,725,636,86,3,709,16,1500,775,558,151
14,CONSTANŢA,"ORAŞ EFORIE",60455,"EFORIE NORD","SALA DE SPORT EFORIE NORD",289,"Alegeri Prezidentiale",1,1537,907,747,160,0,892,15,1700,793,698,194
14,CONSTANŢA,"ORAŞ EFORIE",60455,"EFORIE NORD","ȘCOALA GENERALĂ EFORIE NORD",290,"Alegeri Prezidentiale",1,1610,947,829,116,2,933,14,1800,853,738,195
14,CONSTANŢA,"ORAŞ EFORIE",60455,"EFORIE NORD","ȘCOALA GENERALĂ EFORIE NORD",291,"Alegeri Prezidentiale",1,719,486,329,120,37,477,9,800,314,366,111
14,CONSTANŢA,"ORAŞ HÂRŞOVA",60801,HÂRŞOVA,"CASA DE CULTURA",292,"Alegeri Prezidentiale",1,778,362,333,29,0,358,4,900,538,204,154
14,CONSTANŢA,"ORAŞ HÂRŞOVA",60801,HÂRŞOVA,"LICEUL TEORETIC ”IOAN COTOVU”",293,"Alegeri Prezidentiale",1,1319,555,515,40,0,547,8,1500,945,316,231
14,CONSTANŢA,"ORAŞ HÂRŞOVA",60801,HÂRŞOVA,"CENTRUL PERMANENT PENTRU PERSOANE ABUZATE",294,"Alegeri Prezidentiale",1,1217,480,454,26,0,470,10,1300,820,270,200
14,CONSTANŢA,"ORAŞ HÂRŞOVA",60801,HÂRŞOVA,"ŞCOALA PORT HÂRŞOVA",295,"Alegeri Prezidentiale",1,1186,410,390,20,0,401,9,1300,890,259,142
14,CONSTANŢA,"ORAŞ HÂRŞOVA",60801,HÂRŞOVA,"ŞCOALA GIMNAZIALĂ NR. 1",296,"Alegeri Prezidentiale",1,1152,433,406,27,0,425,8,1300,867,241,184
14,CONSTANŢA,"ORAŞ HÂRŞOVA",60801,HÂRŞOVA,"LICEUL TEORETIC ”IOAN COTOVU”",297,"Alegeri Prezidentiale",1,1408,604,556,47,1,596,8,1500,896,337,259
14,CONSTANŢA,"ORAŞ HÂRŞOVA",60801,HÂRŞOVA,"GRADINIŢA VAROŞ",298,"Alegeri Prezidentiale",1,1292,466,446,20,0,462,4,1400,934,269,193
14,CONSTANŢA,"ORAŞ HÂRŞOVA",60801,"VADU OII","ŞCOALA PRIMARĂ VADU OII",299,"Alegeri Prezidentiale",1,306,126,119,7,0,125,1,400,274,67,58
14,CONSTANŢA,"ORAŞ MURFATLAR",62360,MURFATLAR,"LICEUL TEORETIC MURFATLAR",300,"Alegeri Prezidentiale",1,1398,645,592,53,0,635,10,1500,855,420,215
14,CONSTANŢA,"ORAŞ MURFATLAR",62360,MURFATLAR,"LICEUL TEORETIC MURFATLAR",301,"Alegeri Prezidentiale",1,1175,629,576,53,0,616,13,1300,671,413,203
14,CONSTANŢA,"ORAŞ MURFATLAR",62360,MURFATLAR,"SALA DE SPORT",302,"Alegeri Prezidentiale",1,1195,602,547,55,0,591,11,1300,698,400,191
14,CONSTANŢA,"ORAŞ MURFATLAR",62360,MURFATLAR,"ȘCOALA GENERALĂ NR.2 MURFATLAR",303,"Alegeri Prezidentiale",1,1763,867,814,53,0,859,8,1900,1033,619,240
14,CONSTANŢA,"ORAŞ MURFATLAR",62360,MURFATLAR,"CLUB TINERET MURFATLAR",304,"Alegeri Prezidentiale",1,1471,777,723,54,0,759,18,1600,823,529,230
14,CONSTANŢA,"ORAŞ MURFATLAR",62360,MURFATLAR,"S.C.U.G S.A. MURFATLAR",305,"Alegeri Prezidentiale",1,1009,520,467,53,0,512,8,1100,580,365,147
14,CONSTANŢA,"ORAŞ MURFATLAR",62360,SIMINOC,"CĂMIN CULTURAL SIMINOC",306,"Alegeri Prezidentiale",1,1015,557,513,44,0,552,5,1100,543,424,128
14,CONSTANŢA,"ORAŞ NĂVODARI",60507,NĂVODARI,"GRĂDINIȚA ”PEȘTIȘORUL DE AUR”",307,"Alegeri Prezidentiale",1,1549,772,716,56,0,755,17,1692,920,548,207
14,CONSTANŢA,"ORAŞ NĂVODARI",60507,NĂVODARI,"LICEUL TEHNOLOGIC „LAZĂR EDELEANU”",308,"Alegeri Prezidentiale",1,1363,742,682,60,0,725,17,1500,758,542,183
14,CONSTANŢA,"ORAŞ NĂVODARI",60507,NĂVODARI,"LICEUL TEHNOLOGIC „LAZĂR EDELEANU”",309,"Alegeri Prezidentiale",1,1226,656,563,92,1,635,21,1300,644,474,161
14,CONSTANŢA,"ORAŞ NĂVODARI",60507,NĂVODARI,"LICEUL TEHNOLOGIC „LAZĂR EDELEANU”",310,"Alegeri Prezidentiale",1,1773,889,829,60,0,868,21,2000,1111,611,257
14,CONSTANŢA,"ORAŞ NĂVODARI",60507,NĂVODARI,"LICEUL TEHNOLOGIC „LAZĂR EDELEANU”",311,"Alegeri Prezidentiale",1,1585,813,754,59,0,798,15,1700,887,580,218
14,CONSTANŢA,"ORAŞ NĂVODARI",60507,NĂVODARI,"ŞCOALA GIMNAZIALĂ „GEORGE ENESCU”",312,"Alegeri Prezidentiale",1,1694,833,791,41,1,827,6,1900,1067,593,234
14,CONSTANŢA,"ORAŞ NĂVODARI",60507,NĂVODARI,"ŞCOALA GIMNAZIALĂ „GEORGE ENESCU”",313,"Alegeri Prezidentiale",1,1665,952,856,96,0,940,12,1800,848,705,235
14,CONSTANŢA,"ORAŞ NĂVODARI",60507,NĂVODARI,"ŞCOALA GIMNAZIALĂ „GEORGE ENESCU”",314,"Alegeri Prezidentiale",1,1733,981,934,47,0,959,22,1900,919,672,287
14,CONSTANŢA,"ORAŞ NĂVODARI",60507,NĂVODARI,"ŞCOALA GIMNAZIALĂ „GRIGORE MOISIL”",315,"Alegeri Prezidentiale",1,1675,852,752,100,0,837,15,1800,948,580,257
14,CONSTANŢA,"ORAŞ NĂVODARI",60507,NĂVODARI,"ŞCOALA GIMNAZIALĂ „GRIGORE MOISIL”",316,"Alegeri Prezidentiale",1,1454,733,686,47,0,718,15,1600,867,539,179
14,CONSTANŢA,"ORAŞ NĂVODARI",60507,NĂVODARI,"ŞCOALA GIMNAZIALĂ „GRIGORE MOISIL”",317,"Alegeri Prezidentiale",1,1364,630,600,30,0,618,12,1500,870,423,195
14,CONSTANŢA,"ORAŞ NĂVODARI",60507,NĂVODARI,"GRĂDINIȚA CU PROGRAM PRELUNGIT „VESELIEI”",318,"Alegeri Prezidentiale",1,1697,823,784,39,0,797,26,1900,1077,581,216
14,CONSTANŢA,"ORAŞ NĂVODARI",60507,NĂVODARI,"CLUBUL SINDICATULUI „PETROCHIMISTUL”",319,"Alegeri Prezidentiale",1,1421,758,690,67,1,742,16,1600,842,531,211
14,CONSTANŢA,"ORAŞ NĂVODARI",60507,NĂVODARI,"ŞCOALA GIMNAZIALĂ „TUDOR ARGHEZI”",320,"Alegeri Prezidentiale",1,1223,664,609,55,0,649,15,1300,636,493,156
14,CONSTANŢA,"ORAŞ NĂVODARI",60507,NĂVODARI,"ŞCOALA GIMNAZIALĂ „TUDOR ARGHEZI”",321,"Alegeri Prezidentiale",1,1073,502,402,100,0,493,9,1200,698,347,146
14,CONSTANŢA,"ORAŞ NĂVODARI",60507,NĂVODARI,"CASA CĂSĂTORIILOR",322,"Alegeri Prezidentiale",1,1497,805,683,122,0,788,17,1600,795,560,228
14,CONSTANŢA,"ORAŞ NĂVODARI",60507,NĂVODARI,"CASA DE CULTURĂ",323,"Alegeri Prezidentiale",1,1505,854,763,91,0,840,14,1708,854,634,206
14,CONSTANŢA,"ORAŞ NĂVODARI",60507,NĂVODARI,"CASA DE CULTURĂ",324,"Alegeri Prezidentiale",1,1772,971,845,126,0,959,12,1900,929,690,269
14,CONSTANŢA,"ORAŞ NĂVODARI",60507,NĂVODARI,"CREȘA NR. 20 NĂVODARI",325,"Alegeri Prezidentiale",1,1870,813,655,158,0,796,17,1901,1088,562,234
14,CONSTANŢA,"ORAŞ NĂVODARI",60507,NĂVODARI,"ȘCOALA GIMNAZIALĂ ”GEORGE ENESCU”",326,"Alegeri Prezidentiale",1,439,236,178,58,0,233,3,500,264,176,57
14,CONSTANŢA,"ORAŞ NĂVODARI",60507,NĂVODARI,"CLĂDIRE SEDIU ADMINISTRATIV „COLOANA AUTO”",327,"Alegeri Prezidentiale",1,1921,949,877,72,0,933,16,2000,1051,665,268
14,CONSTANŢA,"ORAŞ NĂVODARI",60507,NĂVODARI,"ȘCOALA PRIMARĂ NR.1 PENINSULA NĂVODARI",328,"Alegeri Prezidentiale",1,546,205,187,18,0,203,2,600,395,132,71
14,CONSTANŢA,"ORAŞ NĂVODARI",60507,NĂVODARI,"DISPENSARUL NR.2",329,"Alegeri Prezidentiale",1,996,535,464,71,0,531,4,1100,565,364,167
14,CONSTANŢA,"ORAŞ NĂVODARI",60507,NĂVODARI,"DISPENSARUL NR.1",330,"Alegeri Prezidentiale",1,1780,1046,918,128,0,1023,23,2000,954,717,306
14,CONSTANŢA,"ORAŞ NEGRU VODĂ",62397,"NEGRU VODĂ","CASA DE CULTURĂ",331,"Alegeri Prezidentiale",1,1243,538,505,30,3,534,4,1400,862,350,184
14,CONSTANŢA,"ORAŞ NEGRU VODĂ",62397,"NEGRU VODĂ","ŞCOALA GENERALĂ",332,"Alegeri Prezidentiale",1,1107,488,432,56,0,465,23,1200,712,269,196
14,CONSTANŢA,"ORAŞ NEGRU VODĂ",62397,"NEGRU VODĂ","CĂMIN CULTURAL",333,"Alegeri Prezidentiale",1,1234,518,465,44,9,512,6,1400,882,292,220
14,CONSTANŢA,"ORAŞ NEGRU VODĂ",62397,"NEGRU VODĂ","SEDIU ADMINISTRATIV",334,"Alegeri Prezidentiale",1,133,86,71,15,0,83,3,200,114,61,22
14,CONSTANŢA,"ORAŞ NEGRU VODĂ",62397,DARABANI,"SEDIU ADMINISTRATIV AL PRIMARIEI",335,"Alegeri Prezidentiale",1,608,195,182,13,0,191,4,700,505,130,61
14,CONSTANŢA,"ORAŞ NEGRU VODĂ",62397,VÂLCELELE,"SCOALA GENERALĂ CLASELE I-IV",336,"Alegeri Prezidentiale",1,198,62,45,17,0,60,2,200,138,40,20
14,CONSTANŢA,"ORAŞ OVIDIU",60687,OVIDIU,"LICEUL TEORETIC OVIDIU",337,"Alegeri Prezidentiale",1,1903,1008,878,130,0,1000,8,1992,984,699,301
14,CONSTANŢA,"ORAŞ OVIDIU",60687,OVIDIU,"LICEUL TEORETIC OVIDIU",338,"Alegeri Prezidentiale",1,1899,934,864,70,0,925,9,1900,966,688,237
14,CONSTANŢA,"ORAŞ OVIDIU",60687,OVIDIU,"ŞCOALA NR. 2 OVIDIU",339,"Alegeri Prezidentiale",1,1696,997,893,93,11,984,13,1900,903,758,226
14,CONSTANŢA,"ORAŞ OVIDIU",60687,OVIDIU,"ŞCOALA NR. 2 OVIDIU",340,"Alegeri Prezidentiale",1,1761,890,823,64,3,872,18,1900,1010,686,186
14,CONSTANŢA,"ORAŞ OVIDIU",60687,OVIDIU,"ŞCOALA NR. 2 OVIDIU",341,"Alegeri Prezidentiale",1,1850,987,909,78,0,971,16,2000,1013,739,232
14,CONSTANŢA,"ORAŞ OVIDIU",60687,OVIDIU,"CENTRUL CULTURAL OVIDIU",342,"Alegeri Prezidentiale",1,1827,1007,916,91,0,986,21,1992,985,716,270
14,CONSTANŢA,"ORAŞ OVIDIU",60687,POIANA,"CENTRUL CULTURAL ”GABRIEL COTABIȚĂ” POIANA",343,"Alegeri Prezidentiale",1,902,556,447,109,0,548,8,1000,444,438,110
14,CONSTANŢA,"ORAŞ OVIDIU",60687,CULMEA,"SCOALA GENERALA DIN SATUL CULMEA",344,"Alegeri Prezidentiale",1,1049,454,411,43,0,445,9,1200,746,350,95
14,CONSTANŢA,"ORAŞ TECHIRGHIOL",60534,TECHIRGHIOL,"SALA DE SPORT",345,"Alegeri Prezidentiale",1,1807,1353,901,433,19,1319,34,2000,647,881,438
14,CONSTANŢA,"ORAŞ TECHIRGHIOL",60534,TECHIRGHIOL,"GRĂDINIȚA NR.1",346,"Alegeri Prezidentiale",1,1687,977,855,122,0,962,15,1900,923,733,229
14,CONSTANŢA,"ORAŞ TECHIRGHIOL",60534,TECHIRGHIOL,"GRĂDINIȚA NR.2",347,"Alegeri Prezidentiale",1,1899,1002,902,100,0,978,24,2100,1098,729,249
14,CONSTANŢA,"ORAŞ TECHIRGHIOL",60534,TECHIRGHIOL,"LICEUL ”EMIL RACOVIȚĂ”",348,"Alegeri Prezidentiale",1,1393,827,679,148,0,809,18,1500,673,598,211
14,CONSTANŢA,"23 AUGUST",60598,"23 AUGUST","ŞCOALA CU CLASELE I-VIII, LOCALITATEA 23 AUGUST",349,"Alegeri Prezidentiale",1,1290,678,590,88,0,673,5,1400,722,496,177
14,CONSTANŢA,"23 AUGUST",60598,"23 AUGUST","ŞCOALA CU CLASELE I-VIII, LOCALITATEA 23 AUGUST",350,"Alegeri Prezidentiale",1,1261,622,576,46,0,611,11,1400,778,470,141
14,CONSTANŢA,"23 AUGUST",60598,DULCEŞTI,"ŞCOALA CU CLASELE I-VIII, LOCALITATEA DULCEŞTI",351,"Alegeri Prezidentiale",1,1140,610,540,70,0,604,6,1300,690,490,114
14,CONSTANŢA,"23 AUGUST",60598,MOŞNENI,"ŞCOALA CU CLASELE I-VIII, LOCALITATEA MOŞNENI",352,"Alegeri Prezidentiale",1,1054,436,401,35,0,430,6,1200,764,324,106
14,CONSTANŢA,ADAMCLISI,60883,ADAMCLISI,"LICEUL TEHNOLOGIC ”JEAN DINU”",353,"Alegeri Prezidentiale",1,943,579,496,74,9,568,11,1000,421,372,196
14,CONSTANŢA,ADAMCLISI,60883,ZORILE,"ŞCOALA ZORILE",354,"Alegeri Prezidentiale",1,482,283,251,27,5,280,3,500,217,169,111
14,CONSTANŢA,ADAMCLISI,60883,URLUIA,"ȘCOALA GENERALĂ URLUIA",355,"Alegeri Prezidentiale",1,289,178,145,28,5,175,3,300,122,138,37
14,CONSTANŢA,ADAMCLISI,60883,ABRUD,"ȘCOALA GENERALĂ ABRUD",356,"Alegeri Prezidentiale",1,107,73,59,14,0,73,0,200,127,45,28
14,CONSTANŢA,AGIGEA,60570,AGIGEA,"SCOALA ION BORCEA- LABORATORUL DE ISTORIE",357,"Alegeri Prezidentiale",1,1495,953,801,150,2,936,17,1600,647,689,247
14,CONSTANŢA,AGIGEA,60570,AGIGEA,"SCOALA ION BORCEA- LABORATORUL DE CHIMIE",358,"Alegeri Prezidentiale",1,900,630,523,107,0,613,17,1000,370,468,145
14,CONSTANŢA,AGIGEA,60570,AGIGEA,"GRADINITA AGIGEA-GRUPA FLUTURASILOR",359,"Alegeri Prezidentiale",1,1290,761,690,71,0,748,13,1393,632,520,228
14,CONSTANŢA,AGIGEA,60570,AGIGEA,"GRADINITA AGIGEA-GRUPA RATUSTELOR",360,"Alegeri Prezidentiale",1,1058,631,577,54,0,620,11,1200,569,468,152
14,CONSTANŢA,AGIGEA,60570,AGIGEA,"GRĂDINIŢA ”RIŢA GĂRGĂRIŢA” AGIGEA",361,"Alegeri Prezidentiale",1,523,377,249,71,57,367,10,596,219,267,100
14,CONSTANŢA,AGIGEA,60570,LAZU,"GRADINITA LAZU",362,"Alegeri Prezidentiale",1,1677,1191,964,227,0,1163,28,1800,609,887,276
14,CONSTANŢA,ALBEŞTI,60945,ALBEŞTI,"ȘCOALA GIMNAZIALĂ”ION CREANGĂ” ALBEȘTI",363,"Alegeri Prezidentiale",1,1268,686,595,91,0,681,5,1408,722,540,141
14,CONSTANŢA,ALBEŞTI,60945,ARSA,"ȘCOALA PRIMARĂ NR. 2 ARSA",364,"Alegeri Prezidentiale",1,520,234,215,19,0,229,5,600,366,169,60
14,CONSTANŢA,ALBEŞTI,60945,"COTU VĂII","SCOALA GIMNAZIALĂ NR. 1 COTU-VAII",365,"Alegeri Prezidentiale",1,897,367,325,42,0,357,10,1000,633,267,90
14,CONSTANŢA,ALBEŞTI,60945,COROANA,"SCOALA PRIMARĂ COROANA",366,"Alegeri Prezidentiale",1,91,55,43,12,0,55,0,100,45,34,21
14,CONSTANŢA,ALBEŞTI,60945,VÂRTOP,"ȘCOALA PRIMARĂ NR.3 VÎRTOP",367,"Alegeri Prezidentiale",1,222,110,95,15,0,108,2,300,190,88,20
14,CONSTANŢA,ALIMAN,61005,ALIMAN,"SCOALA GIMNAZIALA ”DAN SPATARU” ALIMAN",368,"Alegeri Prezidentiale",1,653,332,289,42,1,329,3,700,368,266,63
14,CONSTANŢA,ALIMAN,61005,DUNĂRENI,"SCOALA GIMNAZIALA NR. 1 DUNARENI",369,"Alegeri Prezidentiale",1,1111,499,482,17,0,494,5,1200,701,397,97
14,CONSTANŢA,ALIMAN,61005,VLAHII,"SCOALA PRIMARA NR.2 VLAHII",370,"Alegeri Prezidentiale",1,411,184,168,16,0,184,0,500,316,139,45
14,CONSTANŢA,AMZACEA,63198,AMZACEA,"ȘCOALA AMZACEA",371,"Alegeri Prezidentiale",1,1184,537,495,42,0,534,3,1292,755,399,135
14,CONSTANŢA,AMZACEA,63198,"GENERAL SCĂRIŞOREANU","ȘCOALA GENERALĂ GENERAL SCĂRIȘOREANU",372,"Alegeri Prezidentiale",1,783,289,232,57,0,282,7,900,611,192,90
14,CONSTANŢA,AMZACEA,63198,CASICEA,"ȘCOALA GENERALĂ CASICEA",373,"Alegeri Prezidentiale",1,351,117,105,12,0,116,1,400,283,73,43
14,CONSTANŢA,BĂNEASA,63171,BĂNEASA,"ȘCOALA GENERALĂ NR 1 BĂNEASA",374,"Alegeri Prezidentiale",1,1015,522,459,48,15,513,9,1100,578,320,193
14,CONSTANŢA,BĂNEASA,63171,BĂNEASA,"LICEUL TEORETIC BĂNEASA",375,"Alegeri Prezidentiale",2,1717,980,888,63,29,970,10,1900,920,592,378
14,CONSTANŢA,BĂNEASA,63171,NEGURENI,"ȘCOALA GENERALĂ NEGURENI",376,"Alegeri Prezidentiale",1,561,323,289,33,1,314,9,600,277,195,119
14,CONSTANŢA,BĂNEASA,63171,FĂUREI,"ȘCOALA GENERALĂ FĂUREI",377,"Alegeri Prezidentiale",1,1023,319,299,20,0,308,11,1100,781,94,214
14,CONSTANŢA,BĂRĂGANU,63294,BĂRĂGANU,"ȘCOALA GIMNAZIALĂ ”EMIL GÂRLEANU” BĂRĂGANU",378,"Alegeri Prezidentiale",1,928,400,365,35,0,400,0,1000,600,203,197
14,CONSTANŢA,BĂRĂGANU,63294,LANURILE,"ȘCOALA GIMNAZIALĂ ”EMIL GÂRLEANU” BĂRĂGANU - ȘCOALA PRIMARĂ NR. 1 LANURILE",379,"Alegeri Prezidentiale",2,756,347,298,46,3,339,8,800,453,250,89
14,CONSTANŢA,CASTELU,61121,CASTELU,"CĂMINUL CULTURAL",380,"Alegeri Prezidentiale",1,1147,481,455,26,0,468,13,1300,819,277,191
14,CONSTANŢA,CASTELU,61121,CASTELU,"CĂMINUL CULTURAL",381,"Alegeri Prezidentiale",1,1373,518,484,34,0,509,9,1500,982,288,221
14,CONSTANŢA,CASTELU,61121,NISIPARI,"ŞCOALA GIMNAZIALĂ „IULIU VALAORI” NISIPARI",382,"Alegeri Prezidentiale",1,1554,633,587,46,0,624,9,1700,1067,465,159
14,CONSTANŢA,CERCHEZU,61167,CERCHEZU,"CĂMINUL CULTURAL CERCHEZU",383,"Alegeri Prezidentiale",1,404,266,223,33,10,263,3,497,231,114,149
14,CONSTANŢA,CERCHEZU,61167,CĂSCIOARELE,"CĂMINUL CULTURAL CĂSCIOARELE",384,"Alegeri Prezidentiale",1,223,153,133,20,0,151,2,300,147,99,52
14,CONSTANŢA,CERCHEZU,61167,VIROAGA,"CĂMINUL CULTURAL VIROAGA",385,"Alegeri Prezidentiale",1,381,242,207,33,2,238,4,399,156,174,64
14,CONSTANŢA,CERCHEZU,61167,MĂGURA,"CASA AGRONOMULUI MĂGURA",386,"Alegeri Prezidentiale",1,70,58,43,13,2,56,2,100,42,29,27
14,CONSTANŢA,CHIRNOGENI,61210,CHIRNOGENI,"ȘCOALA GIMNAZIALĂ NR.1 CHIRNOGENI",387,"Alegeri Prezidentiale",1,1498,647,603,44,0,631,16,1600,953,403,228
14,CONSTANŢA,CHIRNOGENI,61210,PLOPENI,"ȘCOALA GIMNAZIALĂ NR.2 PLOPENI",388,"Alegeri Prezidentiale",1,867,350,303,45,2,348,2,1000,650,238,110
14,CONSTANŢA,CHIRNOGENI,61210,CREDINŢA,"ŞCOALA PRIMARĂ NR.3 CREDINŢA",389,"Alegeri Prezidentiale",1,250,122,104,18,0,122,0,300,178,97,25
14,CONSTANŢA,CIOBANU,61256,CIOBANU,"LICEUL TEHNOLOGIC CIOBANU -SALA CLASA 1",390,"Alegeri Prezidentiale",1,1249,692,647,45,0,689,3,1400,708,260,429
14,CONSTANŢA,CIOBANU,61256,CIOBANU,"LICEUL TEHNOLOGIC CIOBANU -SALA CLASA 2",391,"Alegeri Prezidentiale",1,1293,671,640,31,0,660,11,1408,737,234,426
14,CONSTANŢA,CIOBANU,61256,MIORIŢA,"SCOALA GENERALA MIORIȚA",392,"Alegeri Prezidentiale",1,255,159,124,35,0,158,1,302,143,47,111
14,CONSTANŢA,CIOCÂRLIA,61283,CIOCÂRLIA,"CĂMIN CULTURAL SAT CIOCÎRLIA",393,"Alegeri Prezidentiale",1,1259,728,643,83,2,716,12,1400,672,453,263
14,CONSTANŢA,CIOCÂRLIA,61283,"CIOCÂRLIA DE SUS","CĂMIN CULTURAL SAT CIOCÎRLIA DE SUS",394,"Alegeri Prezidentiale",1,1193,605,532,73,0,600,5,1300,695,428,172
14,CONSTANŢA,COBADIN,61318,COBADIN,"CĂMIN CULTURAL COBADIN",395,"Alegeri Prezidentiale",1,1906,787,706,81,0,782,5,2000,1213,544,238
14,CONSTANŢA,COBADIN,61318,COBADIN,"ȘCOALA TĂTARĂ COBADIN",396,"Alegeri Prezidentiale",1,1787,760,693,67,0,752,8,2000,1240,512,240
14,CONSTANŢA,COBADIN,61318,COBADIN,"SCOALA ROMANA",397,"Alegeri Prezidentiale",1,1722,657,616,41,0,648,9,1900,1243,440,208
14,CONSTANŢA,COBADIN,61318,CONACU,"ȘCOALA GENERALĂ CONACU",398,"Alegeri Prezidentiale",1,293,128,108,20,0,127,1,300,172,103,24
14,CONSTANŢA,COBADIN,61318,NEGREŞTI,"CĂMIN CULTURAL NEGREȘTI",399,"Alegeri Prezidentiale",1,365,198,151,47,0,194,4,400,202,108,86
14,CONSTANŢA,COBADIN,61318,VIIŞOARA,"GRĂDINIȚA VIIȘOARA",400,"Alegeri Prezidentiale",1,1290,545,484,61,0,541,4,1400,855,376,165
14,CONSTANŢA,COGEALAC,61372,COGEALAC,"GRĂDINIȚA CU ORAR NORMAL COGEALAC",401,"Alegeri Prezidentiale",1,1575,588,550,38,0,576,12,1700,1112,283,293
14,CONSTANŢA,COGEALAC,61372,COGEALAC,"SCOALA GIMNAZIALA ” CRISTEA CARAMAN” COGEALAC",402,"Alegeri Prezidentiale",1,1303,538,477,61,0,526,12,1400,862,269,257
14,CONSTANŢA,COGEALAC,61372,TARIVERDE,"ȘCOALA GIMNAZIALA NUMARUL 2 TARIVERDE",403,"Alegeri Prezidentiale",1,843,351,302,49,0,349,2,900,549,249,100
14,CONSTANŢA,COGEALAC,61372,"RÂMNICU DE JOS","ȘCOALA GIMNAZIALA NUMARUL 1 RÂMNICU DE JOS",404,"Alegeri Prezidentiale",1,675,248,220,28,0,245,3,700,452,173,72
14,CONSTANŢA,COMANA,61452,COMANA,"SCOALA CU CLASELE I-VIII COMANA",405,"Alegeri Prezidentiale",1,808,367,332,35,0,363,4,900,533,257,106
14,CONSTANŢA,COMANA,61452,TĂTARU,"ȘCOALA GENERALĂ”NEGIP HAGI FAZAL” TĂTARU",406,"Alegeri Prezidentiale",1,535,211,194,17,0,209,2,600,389,128,81
14,CONSTANŢA,COMANA,61452,PELINU,"ŞCOALA CU CLS. I - IV PELINU",407,"Alegeri Prezidentiale",1,227,115,95,20,0,112,3,300,185,73,39
14,CONSTANŢA,CORBU,61513,CORBU,"ȘCOALA GIMNAZIALĂ ”GHEORGHE LAZĂR”",408,"Alegeri Prezidentiale",1,1466,814,690,123,1,793,21,1600,786,580,213
14,CONSTANŢA,CORBU,61513,CORBU,"GRĂDINIȚA CU PROGRAM NORMAL NR. 1",409,"Alegeri Prezidentiale",1,1407,655,585,70,0,643,12,1500,845,493,150
14,CONSTANŢA,CORBU,61513,CORBU,"CĂMIN CULTURAL CORBU DE SUS",410,"Alegeri Prezidentiale",1,1690,787,724,63,0,778,9,1900,1113,572,206
14,CONSTANŢA,CORBU,61513,VADU,"SCOALA PRIMARA VADU",411,"Alegeri Prezidentiale",1,539,292,234,55,3,286,6,600,308,237,49
14,CONSTANŢA,COSTINEŞTI,63286,COSTINEŞTI,"ŞCOALA GIMNAZIALĂ ”MIHAI EMINESCU” COSTINEŞTI",412,"Alegeri Prezidentiale",1,957,628,488,140,0,618,10,1100,472,425,193
14,CONSTANŢA,COSTINEŞTI,63286,SCHITU,"ŞCOALA PRIMARA” ION CREANGA” SCHITU",413,"Alegeri Prezidentiale",1,1775,984,870,114,0,966,18,2000,1016,713,253
14,CONSTANŢA,CRUCEA,61559,CRUCEA,"CAMIN CULTURAL CRUCEA",414,"Alegeri Prezidentiale",1,896,331,296,35,0,324,7,1000,669,223,101
14,CONSTANŢA,CRUCEA,61559,GĂLBIORI,"CAMIN CULTURALGĂLBIORI",415,"Alegeri Prezidentiale",1,253,146,125,21,0,144,2,303,157,117,27
14,CONSTANŢA,CRUCEA,61559,BĂLTĂGEŞTI,"ŞCOALA PRIMARĂ NR.1 BĂLTĂGEŞTI",416,"Alegeri Prezidentiale",1,313,129,115,14,0,126,3,400,271,86,40
14,CONSTANŢA,CRUCEA,61559,CRIŞAN,"GRĂDINIŢA CRIŞAN",417,"Alegeri Prezidentiale",1,282,141,128,13,0,139,2,300,159,112,27
14,CONSTANŢA,CRUCEA,61559,STUPINA,"ŞCOALA PRIMARĂ NR.4 STUPINA",418,"Alegeri Prezidentiale",1,549,171,161,10,0,165,6,600,429,83,82
14,CONSTANŢA,CRUCEA,61559,ŞIRIU,"ŞCOALA PRIMARĂ NR.3 ŞIRIU",419,"Alegeri Prezidentiale",1,170,79,68,11,0,78,1,200,121,64,14
14,CONSTANŢA,CUMPĂNA,61620,CUMPĂNA,"LICEUL TEHNOLOGIC ”NICOLAE DUMITRESCU”",420,"Alegeri Prezidentiale",1,1489,934,744,189,1,928,6,1592,658,653,275
14,CONSTANŢA,CUMPĂNA,61620,CUMPĂNA,"LICEUL TEHNOLOGIC ”NICOLAE DUMITRESCU”",421,"Alegeri Prezidentiale",1,1897,1079,1003,76,0,1056,23,1900,821,751,305
14,CONSTANŢA,CUMPĂNA,61620,CUMPĂNA,"LICEUL TEHNOLOGIC ”NICOLAE DUMITRESCU”",422,"Alegeri Prezidentiale",1,1591,883,823,60,0,862,21,1800,917,617,245
14,CONSTANŢA,CUMPĂNA,61620,CUMPĂNA,"SALA DE SPORT 1",423,"Alegeri Prezidentiale",1,1604,941,873,68,0,922,19,1800,859,652,270
14,CONSTANŢA,CUMPĂNA,61620,CUMPĂNA,"SALA DE SPORT 1",424,"Alegeri Prezidentiale",1,1979,1063,959,104,0,1034,29,2000,937,748,286
14,CONSTANŢA,CUMPĂNA,61620,CUMPĂNA,"GRĂDINIȚA ”FLORILOR”",425,"Alegeri Prezidentiale",1,1647,980,880,100,0,969,11,1800,820,666,303
14,CONSTANŢA,CUMPĂNA,61620,CUMPĂNA,"ANEXA LICEULUI TEHNOLOGIC ”NICOLAE DUMITRESCU”",426,"Alegeri Prezidentiale",1,1757,1047,922,124,1,1022,25,1900,853,717,305
14,CONSTANŢA,"CUZA VODĂ",63300,"CUZA VODĂ","ȘCOALA GIMNAZIALĂ NR. 1",427,"Alegeri Prezidentiale",1,1514,539,502,37,0,534,5,1700,1161,327,207
14,CONSTANŢA,"CUZA VODĂ",63300,"CUZA VODĂ","ŞCOALA GIMNAZIALĂ NR. 1",428,"Alegeri Prezidentiale",1,1652,597,575,22,0,588,9,1800,1203,313,275
14,CONSTANŢA,DELENI,61675,DELENI,"LICEUL NICOLAE ISTRATOIU",429,"Alegeri Prezidentiale",1,316,172,148,21,3,168,4,400,228,93,75
14,CONSTANŢA,DELENI,61675,PIETRENI,"FOST SEDIU C.A.P. PIETRENI",430,"Alegeri Prezidentiale",1,696,394,362,29,3,389,5,800,406,159,230
14,CONSTANŢA,DELENI,61675,ŞIPOTELE,"SCOALA GENERALA ȘIPOTELE",431,"Alegeri Prezidentiale",1,419,252,201,45,6,250,2,500,248,124,126
14,CONSTANŢA,DELENI,61675,PETROŞANI,"FOST SEDIU C.A.P. PETROŞANI",432,"Alegeri Prezidentiale",1,453,255,229,23,3,254,1,491,236,139,115
14,CONSTANŢA,DOBROMIR,61737,DOBROMIR,"CĂMINUL CULTURAL DOBROMIR -",433,"Alegeri Prezidentiale",1,727,335,326,9,0,328,7,800,465,81,247
14,CONSTANŢA,DOBROMIR,61737,"DOBROMIRU DIN DEAL","ȘCOALA GEN CU CLS. I - IV DOBROMIR DEAL",434,"Alegeri Prezidentiale",1,264,161,137,24,0,161,0,300,139,122,39
14,CONSTANŢA,DOBROMIR,61737,LESPEZI,"ȘCOALA GEN CU CLS. I - IV LESPEZI",435,"Alegeri Prezidentiale",1,392,239,225,14,0,236,3,400,161,92,144
14,CONSTANŢA,DOBROMIR,61737,VĂLENI,"ȘCOALA GEN CU CLS. I - IV VĂLENI",436,"Alegeri Prezidentiale",1,638,316,302,14,0,314,2,700,384,81,233
14,CONSTANŢA,DOBROMIR,61737,PĂDURENI,"ȘCOALA GEN CU CLS. I - IV PĂDURENI",437,"Alegeri Prezidentiale",1,121,70,51,19,0,70,0,200,130,26,44
14,CONSTANŢA,DOBROMIR,61737,CETATEA,"SCOALA GENERALA SAT CETATEA",438,"Alegeri Prezidentiale",1,174,119,106,13,0,119,0,201,82,99,20
14,CONSTANŢA,DUMBRĂVENI,63161,DUMBRĂVENI,"CĂMINUL CULTURAL DUMBRĂVENI",439,"Alegeri Prezidentiale",1,374,236,169,58,9,234,2,400,164,115,119
14,CONSTANŢA,DUMBRĂVENI,63161,FURNICA,"GRĂDINIȚA DE COPII FURNICA",440,"Alegeri Prezidentiale",1,55,62,38,23,1,62,0,101,39,16,46
14,CONSTANŢA,FÂNTÂNELE,63334,FÂNTÂNELE,"ȘCOALA GIMNAZIALA NR.1 FÂNTÂNELE",441,"Alegeri Prezidentiale",1,1318,584,543,41,0,573,11,1400,816,329,244
14,CONSTANŢA,GÂRLICIU,61808,GÂRLICIU,"CENTRUL CULTURAL DUNĂREA VECHE DIN COMUNA GÂRLICIU",442,"Alegeri Prezidentiale",1,1293,557,513,44,0,554,3,1400,843,340,214
14,CONSTANŢA,GHINDĂREŞTI,61826,GHINDĂREŞTI,"SCOALA GIMNAZIALA ”SA ESENIN” GHINDARESTI",443,"Alegeri Prezidentiale",1,1139,389,362,27,0,385,4,1300,911,291,94
14,CONSTANŢA,GHINDĂREŞTI,61826,GHINDĂREŞTI,"SCOALA GIMNAZIALA ”SA ESENIN” GHINDARESTI",444,"Alegeri Prezidentiale",1,1092,338,311,27,0,331,7,1200,862,261,70
14,CONSTANŢA,GRĂDINA,63326,GRĂDINA,"GRĂDINIȚA P+M GRĂDINA",445,"Alegeri Prezidentiale",1,579,405,352,49,4,403,2,600,195,149,254
14,CONSTANŢA,GRĂDINA,63326,CHEIA,"GRADINITA CU PROGRAM NORMAL CHEIA",446,"Alegeri Prezidentiale",1,297,226,194,29,3,224,2,300,74,103,121
14,CONSTANŢA,HORIA,63278,HORIA,"CĂMIN CULTURAL HORIA",447,"Alegeri Prezidentiale",1,698,324,283,33,8,323,1,800,476,183,140
14,CONSTANŢA,HORIA,63278,TICHILEŞTI,"CĂMINUL CULTURAL TICHILEȘTI",448,"Alegeri Prezidentiale",1,267,128,112,16,0,126,2,300,172,71,55
14,CONSTANŢA,INDEPENDENŢA,61871,INDEPENDENŢA,"LICEUL TEHNOLOGIC",449,"Alegeri Prezidentiale",1,971,401,375,26,0,401,0,1097,696,256,145
14,CONSTANŢA,INDEPENDENŢA,61871,"MOVILA VERDE","SCOALA GENERALĂ",450,"Alegeri Prezidentiale",1,505,232,210,22,0,229,3,600,368,177,52
14,CONSTANŢA,INDEPENDENŢA,61871,OLTENI,"SCOALA GENERALĂ",451,"Alegeri Prezidentiale",1,304,156,132,24,0,156,0,400,244,102,54
14,CONSTANŢA,INDEPENDENŢA,61871,TUFANI,"SCOALA GENERALĂ",452,"Alegeri Prezidentiale",1,253,116,106,10,0,114,2,301,185,87,27
14,CONSTANŢA,INDEPENDENŢA,61871,"FÂNTÂNA MARE","CĂMIN CULTURAL",453,"Alegeri Prezidentiale",1,293,131,124,7,0,129,2,300,169,83,46
14,CONSTANŢA,"ION CORVIN",61951,"ION CORVIN","ŞCOALA GIMNAZIALĂ NR.1 ION CORVIN, LOC. ION CORVIN",454,"Alegeri Prezidentiale",1,488,234,181,46,7,229,5,500,266,135,94
14,CONSTANŢA,"ION CORVIN",61951,VIILE,"CĂMIN CULTURAL VIILE",455,"Alegeri Prezidentiale",1,779,381,360,18,3,375,6,900,519,223,152
14,CONSTANŢA,"ION CORVIN",61951,RARIŞTEA,"GRĂDINIȚA CU PROGRAM NORMAL RARIȘTEA, LOC. RARIȘTEA",456,"Alegeri Prezidentiale",1,187,114,86,28,0,113,1,200,86,75,38
14,CONSTANŢA,"ION CORVIN",61951,CRÂNGU,"ŞCOALA CRÎNGU",457,"Alegeri Prezidentiale",1,85,47,36,11,0,47,0,100,53,21,26
14,CONSTANŢA,ISTRIA,62020,ISTRIA,"ȘCOALA GIMNAZIALĂ NR. 1 ISTRIA",458,"Alegeri Prezidentiale",2,1091,460,406,54,0,449,11,1200,740,259,190
14,CONSTANŢA,ISTRIA,62020,NUNTAŞI,"ȘCOALA GIMNAZIALĂ NR. 2 NUNTAȘI",459,"Alegeri Prezidentiale",1,863,419,367,52,0,410,9,900,481,291,119
14,CONSTANŢA,LIMANU,60632,LIMANU,"SCOALA GENERALĂ CU CLS. I – VIII LIMANU",460,"Alegeri Prezidentiale",1,1384,726,654,72,0,716,10,1500,774,515,201
14,CONSTANŢA,LIMANU,60632,LIMANU,"SCOALA GENERALĂ CU CLS. I – VIII LIMANU",461,"Alegeri Prezidentiale",1,1420,659,616,43,0,651,8,1600,941,421,230
14,CONSTANŢA,LIMANU,60632,"2 MAI","SCOALA GENERALĂ CU CLS. I – VIII 2MAI",462,"Alegeri Prezidentiale",1,1276,815,683,130,2,803,12,1400,585,555,248
14,CONSTANŢA,LIMANU,60632,"2 MAI","SCOALA GENERALĂ CU CLS. I – VIII 2MAI",463,"Alegeri Prezidentiale",1,1437,834,731,103,0,819,15,1600,766,575,244
14,CONSTANŢA,LIPNIŢA,62057,LIPNIŢA,"CAMIN CULTURAL LIPNITA",464,"Alegeri Prezidentiale",1,757,356,303,53,0,347,9,800,444,253,94
14,CONSTANŢA,LIPNIŢA,62057,COSLUGEA,"ȘCOALA CU CLASELE I - VIII COSLUGEA",465,"Alegeri Prezidentiale",1,609,235,211,24,0,231,4,700,465,152,79
14,CONSTANŢA,LIPNIŢA,62057,CANLIA,"CĂMINUL CULTURAL CANLIA",466,"Alegeri Prezidentiale",1,420,229,195,34,0,228,1,500,271,150,78
14,CONSTANŢA,LIPNIŢA,62057,CARVĂN,"ȘCOALA GENERALĂ CARVĂN",467,"Alegeri Prezidentiale",1,338,102,87,15,0,102,0,400,298,62,40
14,CONSTANŢA,LIPNIŢA,62057,IZVOARELE,"ȘCOALA GENERALĂ CU CLASELE I - IV IZVOARELE",468,"Alegeri Prezidentiale",1,94,64,41,23,0,63,1,100,36,51,12
14,CONSTANŢA,LIPNIŢA,62057,GORUNI,"ȘCOALA GENERALĂ CU CLASELE I - IV GORUNI",469,"Alegeri Prezidentiale",1,81,45,29,16,0,44,1,100,55,30,14
14,CONSTANŢA,LIPNIŢA,62057,CUIUGIUC,"ȘCOALA GENERALĂ CU CLASELE I - IV CUIUGIUC",470,"Alegeri Prezidentiale",1,150,69,55,14,0,68,1,200,131,48,20
14,CONSTANŢA,LUMINA,63152,LUMINA,"ȘCOALA VECHE LUMINA",471,"Alegeri Prezidentiale",1,2002,1072,956,116,0,1050,22,2100,1028,778,272
14,CONSTANŢA,LUMINA,63152,LUMINA,"ȘCOALA NOUĂ LUMINA",472,"Alegeri Prezidentiale",1,2082,1081,954,126,1,1059,22,2300,1219,797,262
14,CONSTANŢA,LUMINA,63152,LUMINA,"GRĂDINIȚA LUMINA",473,"Alegeri Prezidentiale",1,1972,1045,949,96,0,1033,12,2200,1155,785,248
14,CONSTANŢA,LUMINA,63152,LUMINA,"CĂMINUL CULTURAL LUMINA",474,"Alegeri Prezidentiale",1,2001,1171,941,230,0,1146,25,2100,929,811,335
14,CONSTANŢA,LUMINA,63152,OITUZ,"ȘCOALA OITUZ",475,"Alegeri Prezidentiale",1,692,370,322,48,0,365,5,800,430,328,37
14,CONSTANŢA,LUMINA,63152,SIBIOARA,"ȘCOALA SIBIOARA",476,"Alegeri Prezidentiale",1,357,217,169,48,0,214,3,399,182,151,63
14,CONSTANŢA,MERENI,62137,MERENI,"SCOALA GIMNAZIALA NICHITA STANESCU",477,"Alegeri Prezidentiale",1,1115,454,411,43,0,448,6,1192,738,315,133
14,CONSTANŢA,MERENI,62137,OSMANCEA,"ŞCOALA CU CLASELE I - VIII",478,"Alegeri Prezidentiale",1,473,237,213,24,0,237,0,500,263,119,118
14,CONSTANŢA,MERENI,62137,CIOBĂNIŢA,"ŞCOALA CU CLASELE I -IV",479,"Alegeri Prezidentiale",1,220,123,99,24,0,123,0,300,177,85,38
14,CONSTANŢA,"MIHAI VITEAZU",62253,"MIHAI VITEAZU","LICEUL TEHNOLOGIC ” MIHAI VITEAZUL”",480,"Alegeri Prezidentiale",1,1573,585,555,30,0,576,9,1700,1115,398,178
14,CONSTANŢA,"MIHAI VITEAZU",62253,SINOIE,"SCOALA CU CLASELE I-VII SINOE",481,"Alegeri Prezidentiale",1,1182,519,489,30,0,516,3,1300,781,411,105
14,CONSTANŢA,"MIHAIL KOGĂLNICEANU",62191,"MIHAIL KOGĂLNICEANU","GRĂDINIŢA DOMINO",482,"Alegeri Prezidentiale",1,1406,657,600,56,1,652,5,1500,843,528,124
14,CONSTANŢA,"MIHAIL KOGĂLNICEANU",62191,"MIHAIL KOGĂLNICEANU","GRĂDINIŢA PINOCHIO",483,"Alegeri Prezidentiale",1,1157,631,574,57,0,625,6,1300,669,509,116
14,CONSTANŢA,"MIHAIL KOGĂLNICEANU",62191,"MIHAIL KOGĂLNICEANU","ŞCOALA GENERALĂ NR.2",484,"Alegeri Prezidentiale",1,1248,681,624,54,3,672,9,1400,719,498,174
14,CONSTANŢA,"MIHAIL KOGĂLNICEANU",62191,"MIHAIL KOGĂLNICEANU","LICEUL TEORETIC MIHAIL KOGĂLNICEANU",485,"Alegeri Prezidentiale",1,1416,644,555,89,0,640,4,1600,956,451,189
14,CONSTANŢA,"MIHAIL KOGĂLNICEANU",62191,"MIHAIL KOGĂLNICEANU","GRĂDINIŢA PITICOT",486,"Alegeri Prezidentiale",1,779,427,343,84,0,420,7,900,473,313,107
14,CONSTANŢA,"MIHAIL KOGĂLNICEANU",62191,"MIHAIL KOGĂLNICEANU","GRĂDINIŢA PITICOT",487,"Alegeri Prezidentiale",1,782,409,368,41,0,400,9,900,491,256,144
14,CONSTANŢA,"MIHAIL KOGĂLNICEANU",62191,"MIHAIL KOGĂLNICEANU","ŞCOALA GENERALĂ CERES",488,"Alegeri Prezidentiale",1,370,183,155,28,0,180,3,400,217,163,17
14,CONSTANŢA,"MIHAIL KOGĂLNICEANU",62191,PIATRA,"UNITATEA AGRICOLĂ SIBIOARA, CENTRUL PENTRU TINERET",489,"Alegeri Prezidentiale",1,231,248,153,95,0,246,2,300,52,215,31
14,CONSTANŢA,"MIHAIL KOGĂLNICEANU",62191,PIATRA,"CĂMINUL CULTURAL",490,"Alegeri Prezidentiale",1,704,386,333,53,0,381,5,800,414,329,52
14,CONSTANŢA,"MIHAIL KOGĂLNICEANU",62191,"PALAZU MIC","ŞCOALA GENERALĂ",491,"Alegeri Prezidentiale",1,266,175,130,45,0,175,0,300,125,154,21
14,CONSTANŢA,"MIRCEA VODĂ",62280,"MIRCEA VODĂ","ŞCOALA GIMNAZIALĂ NR.1 MIRCEA VODĂ",492,"Alegeri Prezidentiale",1,1673,702,643,59,0,692,10,1808,1106,428,264
14,CONSTANŢA,"MIRCEA VODĂ",62280,"SATU NOU","ȘCOALA GIMNAZIALĂ NR.2 SATU NOU",493,"Alegeri Prezidentiale",1,1032,437,408,28,1,429,8,1100,663,243,186
14,CONSTANŢA,"MIRCEA VODĂ",62280,"SATU NOU","ȘCOALA GIMNAZIALĂ NR.2 SATU NOU",494,"Alegeri Prezidentiale",1,1290,554,532,22,0,545,9,1400,846,324,221
14,CONSTANŢA,"NICOLAE BĂLCESCU",62440,"NICOLAE BĂLCESCU","LICEUL ”I.C. BRĂTIANU” NICOLAE BĂLCESCU",495,"Alegeri Prezidentiale",1,1327,580,521,59,0,569,11,1500,920,378,191
14,CONSTANŢA,"NICOLAE BĂLCESCU",62440,"NICOLAE BĂLCESCU","LICEUL ”I.C. BRĂTIANU” NICOLAE BĂLCESCU",496,"Alegeri Prezidentiale",1,1467,641,591,50,0,634,7,1600,959,410,224
14,CONSTANŢA,"NICOLAE BĂLCESCU",62440,DOROBANŢU,"ȘCOALA GENERALĂ DOROBANȚU",497,"Alegeri Prezidentiale",1,1529,647,591,56,0,636,11,1700,1053,423,213
14,CONSTANŢA,OLTINA,62486,OLTINA,"ȘCOALA GIMNAZIALĂ NR. 1 OLTINA",498,"Alegeri Prezidentiale",1,1398,682,607,65,10,675,7,1500,818,436,239
14,CONSTANŢA,OLTINA,62486,RĂZOARELE,"ȘCOALA GIMNAZIALĂ NR. 2 RĂZOARELE",499,"Alegeri Prezidentiale",1,500,270,250,18,2,269,1,600,330,186,83
14,CONSTANŢA,OLTINA,62486,"SATU NOU","ȘCOALA CU CLS. I - IV SATU NOU",500,"Alegeri Prezidentiale",1,156,102,75,24,3,102,0,200,98,64,38
14,CONSTANŢA,OSTROV,62538,OSTROV,"CĂMIN CULTURAL OSTROV",501,"Alegeri Prezidentiale",1,936,479,409,68,2,474,5,1000,521,304,170
14,CONSTANŢA,OSTROV,62538,OSTROV,"CĂMIN CULTURAL OSTROV",502,"Alegeri Prezidentiale",1,1122,554,509,44,1,548,6,1200,646,369,179
14,CONSTANŢA,OSTROV,62538,ALMĂLĂU,"CĂMIN CULTURAL ALMĂLĂU",503,"Alegeri Prezidentiale",1,669,324,290,34,0,319,5,700,376,181,138
14,CONSTANŢA,OSTROV,62538,ESECHIOI,"ȘCOALA GENERALĂ ESECHIOI",504,"Alegeri Prezidentiale",1,198,133,115,18,0,130,3,200,67,59,71
14,CONSTANŢA,OSTROV,62538,GÂRLIŢA,"CĂMIN CULTURAL GÎRLIȚA",505,"Alegeri Prezidentiale",1,237,153,146,7,0,152,1,300,147,79,73
14,CONSTANŢA,OSTROV,62538,GALIŢA,"CĂMIN CULTURAL GALIȚA",506,"Alegeri Prezidentiale",1,565,229,206,23,0,228,1,600,371,147,81
14,CONSTANŢA,OSTROV,62538,BUGEAC,"CAMIN CULTURAL BUGEAC",507,"Alegeri Prezidentiale",1,153,100,77,23,0,100,0,200,100,59,41
14,CONSTANŢA,PANTELIMON,62609,PANTELIMON,"ȘCOALA GIMNAZIALĂ NR.1 PANTELIMON",508,"Alegeri Prezidentiale",1,587,336,277,51,8,327,9,601,265,209,118
14,CONSTANŢA,PANTELIMON,62609,"PANTELIMON DE JOS","ȘCOALA CU CLS. I - IV PANTELIMON DE JOS",509,"Alegeri Prezidentiale",1,224,124,105,19,0,123,1,300,176,86,37
14,CONSTANŢA,PANTELIMON,62609,RUNCU,"ȘCOALA CU CLS. I - IV RUNCU",510,"Alegeri Prezidentiale",1,346,177,156,16,5,174,3,400,223,126,48
14,CONSTANŢA,PANTELIMON,62609,NISTOREŞTI,"ȘCOALA CU CLS. I - IV NISTOREȘTI",511,"Alegeri Prezidentiale",1,233,109,92,15,2,109,0,300,191,79,30
14,CONSTANŢA,PECINEAGA,62672,PECINEAGA,"CĂMIN CULTURAL PECINEAGA",512,"Alegeri Prezidentiale",1,1310,625,568,57,0,614,11,1400,775,440,174
14,CONSTANŢA,PECINEAGA,62672,PECINEAGA,"ŞCOALA GIMNAZIALĂ NR.1 PECINEAGA",513,"Alegeri Prezidentiale",1,1379,586,540,46,0,576,10,1499,913,410,166
14,CONSTANŢA,PEŞTERA,62707,PEŞTERA,"CĂMIN CULTURAL PEŞTERA",514,"Alegeri Prezidentiale",1,1534,588,540,48,0,585,3,1700,1112,305,280
14,CONSTANŢA,PEŞTERA,62707,"IVRINEZU MARE","CAMIN CULTURAL IVRINEZU MARE",515,"Alegeri Prezidentiale",1,717,315,286,29,0,312,3,800,485,207,105
14,CONSTANŢA,PEŞTERA,62707,"IZVORU MARE","SCOALA PRIMARA NR.3",516,"Alegeri Prezidentiale",1,593,191,171,20,0,190,1,700,509,129,61
14,CONSTANŢA,"POARTA ALBĂ",62761,"POARTA ALBĂ","CENTRU PENTRU TINERET",517,"Alegeri Prezidentiale",1,1547,954,726,58,170,942,12,1700,746,581,361
14,CONSTANŢA,"POARTA ALBĂ",62761,"POARTA ALBĂ","CENTRU PENTRU TINERET",518,"Alegeri Prezidentiale",1,1433,838,594,38,206,824,14,1600,762,457,367
14,CONSTANŢA,"POARTA ALBĂ",62761,"POARTA ALBĂ","LICEUL AGRICOL POARTA ALBĂ",519,"Alegeri Prezidentiale",1,999,770,479,59,232,758,12,1100,330,386,372
14,CONSTANŢA,"POARTA ALBĂ",62761,NAZARCEA,"GRĂDINIŢA CU PROGRAM NORMAL NAZARCEA",520,"Alegeri Prezidentiale",1,424,232,210,22,0,232,0,500,268,187,45
14,CONSTANŢA,RASOVA,62798,RASOVA,"SCOALA GIMNAZIALA NR.2 RASOVA",521,"Alegeri Prezidentiale",1,1086,332,309,23,0,330,2,1200,868,239,91
14,CONSTANŢA,RASOVA,62798,RASOVA,"SCOALA GIMNAZIALA NR.2 RASOVA",522,"Alegeri Prezidentiale",1,919,288,277,11,0,287,1,1000,712,206,81
14,CONSTANŢA,RASOVA,62798,COCHIRLENI,"SCOALA GIMNAZIALA COCHIRLENI",523,"Alegeri Prezidentiale",1,918,359,330,29,0,354,5,1000,641,247,107
14,CONSTANŢA,SALIGNY,63318,FĂCLIA,"SCOALA PRIMARA NR 2 FACLIA",524,"Alegeri Prezidentiale",1,711,350,314,36,0,349,1,800,450,175,174
14,CONSTANŢA,SALIGNY,63318,SALIGNY,"ȘCOALA GIMNAZIALA NR 1 SALIGNY",525,"Alegeri Prezidentiale",1,705,407,346,61,0,405,2,800,393,183,222
14,CONSTANŢA,SALIGNY,63318,"ŞTEFAN CEL MARE","ȘCOALA PRIMARA NR 3 STEFAN CEL MARE",526,"Alegeri Prezidentiale",1,456,260,211,49,0,258,2,500,240,133,125
14,CONSTANŢA,SARAIU,62823,SARAIU,"ȘCOALA GIMNAZIALĂ ”NICOLAE MARALOI” SARAIU",527,"Alegeri Prezidentiale",1,597,358,295,36,27,352,6,701,343,147,205
14,CONSTANŢA,SARAIU,62823,DULGHERU,"ȘCOALA PRIMARĂ NR. 1 DULGHERU",528,"Alegeri Prezidentiale",1,442,216,194,14,8,214,2,500,284,105,109
14,CONSTANŢA,SĂCELE,62878,SĂCELE,"ȘCOALA GIMNAZIALĂ ”A.GHENCEA”",529,"Alegeri Prezidentiale",1,1894,980,896,79,5,971,9,2000,1020,671,300
14,CONSTANŢA,SEIMENI,62903,"SEIMENII MICI","SCOALA CU CLS. I-IV SEIMENII MICI",530,"Alegeri Prezidentiale",1,722,272,259,13,0,268,4,800,528,140,128
14,CONSTANŢA,SEIMENI,62903,SEIMENI,"ŞCOALA CU CLS I-VIII SEIMENI",531,"Alegeri Prezidentiale",1,454,200,164,36,0,193,7,500,300,125,68
14,CONSTANŢA,SEIMENI,62903,DUNĂREA,"GRĂDINIŢA SAT DUNĂREA",532,"Alegeri Prezidentiale",1,552,235,192,43,0,234,1,600,365,146,88
14,CONSTANŢA,SILIŞTEA,62949,SILIŞTEA,"SCOALA GIMNAZIALA NR. 1",533,"Alegeri Prezidentiale",1,544,264,230,34,0,263,1,600,336,166,97
14,CONSTANŢA,SILIŞTEA,62949,"ŢEPEŞ VODĂ","CAMIN CULTURAL",534,"Alegeri Prezidentiale",1,619,293,271,19,3,289,4,700,407,182,107
14,CONSTANŢA,TÂRGUŞOR,62985,TÂRGUŞOR,"CONSILIULUI LOCAL TÎRGUȘOR",535,"Alegeri Prezidentiale",1,1068,523,451,72,0,511,12,1200,677,305,206
14,CONSTANŢA,TÂRGUŞOR,62985,MIREASA,"ȘCOALA PRIMARĂ NR.2 MIREASA",536,"Alegeri Prezidentiale",1,258,126,95,31,0,125,1,300,174,65,60
14,CONSTANŢA,TOPALU,63045,TOPALU,"ȘCOALA GENERALĂ TOPALU",537,"Alegeri Prezidentiale",1,1415,708,624,84,0,702,6,1600,892,454,248
14,CONSTANŢA,TOPRAISAR,63072,TOPRAISAR,"LICEUL TEHNOLOGIC TOPRAISAR",538,"Alegeri Prezidentiale",1,1387,684,590,93,1,669,15,1500,816,423,246
14,CONSTANŢA,TOPRAISAR,63072,TOPRAISAR,"ȘCOALA VECHE TOPRAISAR",539,"Alegeri Prezidentiale",1,1550,780,698,80,2,769,11,1700,920,541,228
14,CONSTANŢA,TOPRAISAR,63072,BIRUINŢA,"ȘCOALA I-VIII BIRUINȚA",540,"Alegeri Prezidentiale",1,648,271,257,14,0,267,4,700,429,171,96
14,CONSTANŢA,TOPRAISAR,63072,MOVILIŢA,"ȘCOALA I-VIII MOVILIȚA",541,"Alegeri Prezidentiale",1,934,504,440,63,1,498,6,1000,496,386,112
14,CONSTANŢA,TOPRAISAR,63072,POTÂRNICHEA,"ȘCOALA I-IV POTÂRNICHEA",542,"Alegeri Prezidentiale",1,392,213,167,46,0,210,3,400,187,129,81
14,CONSTANŢA,TORTOMAN,63189,TORTOMAN,"CĂMINUL CULTURAL TORTOMAN",543,"Alegeri Prezidentiale",1,1457,595,574,20,1,586,9,1600,1005,376,210
14,CONSTANŢA,TUZLA,60721,TUZLA,"GRADINITA VECHE",544,"Alegeri Prezidentiale",1,1162,678,553,125,0,671,7,1300,622,460,211
14,CONSTANŢA,TUZLA,60721,TUZLA,"ŞCOALA MICĂ TUZLA",545,"Alegeri Prezidentiale",1,1741,895,819,75,1,883,12,1900,1005,658,225
14,CONSTANŢA,TUZLA,60721,TUZLA,"ŞCOALA MARE TUZLA",546,"Alegeri Prezidentiale",1,1726,947,879,68,0,929,18,1900,953,679,250
14,CONSTANŢA,TUZLA,60721,TUZLA,"GRĂDINIŢĂ NOUĂ",547,"Alegeri Prezidentiale",1,1367,768,704,64,0,763,5,1500,732,566,197
14,CONSTANŢA,"VALU LUI TRAIAN",63125,"VALU LUI TRAIAN","SALA DE SPORT",548,"Alegeri Prezidentiale",1,1670,985,890,95,0,967,18,1800,815,740,227
14,CONSTANŢA,"VALU LUI TRAIAN",63125,"VALU LUI TRAIAN","ŞCOALA GIMNAZIALĂ NR.1",549,"Alegeri Prezidentiale",1,1609,993,817,176,0,981,12,1800,807,720,261
14,CONSTANŢA,"VALU LUI TRAIAN",63125,"VALU LUI TRAIAN","GRĂDINIŢA CU PROGRAM PRELUNGIT NR.3",550,"Alegeri Prezidentiale",1,1861,1195,986,209,0,1181,14,2000,805,940,241
14,CONSTANŢA,"VALU LUI TRAIAN",63125,"VALU LUI TRAIAN","PIAŢA AGROALIMENTARĂ-CENTRUL TRANSFRONTALIER DE AFACERI",551,"Alegeri Prezidentiale",1,1358,783,698,85,0,768,15,1500,717,559,209
14,CONSTANŢA,"VALU LUI TRAIAN",63125,"VALU LUI TRAIAN","CLĂDIRE VESTIARE TEREN FOTBAL (STADION)",552,"Alegeri Prezidentiale",1,1657,827,758,69,0,816,11,1800,973,632,184
14,CONSTANŢA,"VALU LUI TRAIAN",63125,"VALU LUI TRAIAN","ŞCOALA GIMNAZIALĂ ”VICEAMIRAL IOAN MURGESCU”",553,"Alegeri Prezidentiale",1,1711,1102,855,107,140,1084,18,1900,798,727,357
14,CONSTANŢA,"VALU LUI TRAIAN",63125,"VALU LUI TRAIAN","GRĂDINIŢA CU PROGRAM NORMAL NR.2",554,"Alegeri Prezidentiale",1,1660,1061,826,94,141,1048,13,1792,731,689,359
14,CONSTANŢA,"VALU LUI TRAIAN",63125,"VALU LUI TRAIAN","CENTRU DE TINERET",555,"Alegeri Prezidentiale",1,1460,881,777,104,0,866,15,1600,719,641,225
14,CONSTANŢA,VULTURU,63170,VULTURU,"CAMIN CULTURAL VULTURU",556,"Alegeri Prezidentiale",1,582,288,267,21,0,286,2,600,312,100,186
15,COVASNA,"MUNICIPIUL SFÂNTU GHEORGHE",63394,"SFÂNTU GHEORGHE","CASA DE CULTURĂ ”KÓNYA ÁDÁM”",1,"Alegeri Prezidentiale",1,1191,164,150,14,0,154,10,1195,1031,111,43
15,COVASNA,"MUNICIPIUL SFÂNTU GHEORGHE",63394,"SFÂNTU GHEORGHE","COLEGIUL NAȚIONAL ”SZÉKELY MIKÓ”",2,"Alegeri Prezidentiale",1,619,176,153,22,1,156,20,700,524,124,32
15,COVASNA,"MUNICIPIUL SFÂNTU GHEORGHE",63394,"SFÂNTU GHEORGHE","LICEUL TEORETIC ”MIKES KELEMEN”",3,"Alegeri Prezidentiale",1,1334,289,261,28,0,258,31,1400,1111,179,79
15,COVASNA,"MUNICIPIUL SFÂNTU GHEORGHE",63394,"SFÂNTU GHEORGHE","LICEUL TEORETIC ”MIKES KELEMEN”",4,"Alegeri Prezidentiale",1,635,166,148,18,0,152,14,708,542,106,46
15,COVASNA,"MUNICIPIUL SFÂNTU GHEORGHE",63394,"SFÂNTU GHEORGHE","LICEUL TEORETIC ”SZÉKELY MIKÓ”",5,"Alegeri Prezidentiale",1,726,264,200,64,0,244,20,800,536,191,53
15,COVASNA,"MUNICIPIUL SFÂNTU GHEORGHE",63394,"SFÂNTU GHEORGHE","DIRECŢIA FINANŢE PUBLICE MUNICIPALE",6,"Alegeri Prezidentiale",1,721,251,191,60,0,233,18,800,549,167,66
15,COVASNA,"MUNICIPIUL SFÂNTU GHEORGHE",63394,"SFÂNTU GHEORGHE","LICEUL TEHNOLOGIC ECONOMIC, ADMINISTRATIV ”BERDE ÁRON”",7,"Alegeri Prezidentiale",1,676,210,172,38,0,202,8,698,488,153,49
15,COVASNA,"MUNICIPIUL SFÂNTU GHEORGHE",63394,"SFÂNTU GHEORGHE","LICEUL TEHNOLOGIC ECONOMIC, ADMINISTRATIV ”BERDE ÁRON”",8,"Alegeri Prezidentiale",1,1598,482,469,13,0,451,31,1700,1218,329,122
15,COVASNA,"MUNICIPIUL SFÂNTU GHEORGHE",63394,"SFÂNTU GHEORGHE","LICEUL TEHNOLOGIC ECONOMIC, ADMINISTRATIV ”BERDE ÁRON”",9,"Alegeri Prezidentiale",1,976,291,276,15,0,275,16,1000,709,220,55
15,COVASNA,"MUNICIPIUL SFÂNTU GHEORGHE",63394,"SFÂNTU GHEORGHE","GRĂDINIŢA CU PROGRAM PRELUNGIT ”GULLIVER”",10,"Alegeri Prezidentiale",1,1411,349,329,19,1,318,31,1500,1151,247,71
15,COVASNA,"MUNICIPIUL SFÂNTU GHEORGHE",63394,"SFÂNTU GHEORGHE","GRĂDINIŢA CU PROGRAM PRELUNGIT ”GULLIVER”",11,"Alegeri Prezidentiale",1,1006,253,233,20,0,223,30,1100,847,165,58
15,COVASNA,"MUNICIPIUL SFÂNTU GHEORGHE",63394,"SFÂNTU GHEORGHE","GRĂDINIŢA CU PROGRAM PRELUNGIT ”GULLIVER”",12,"Alegeri Prezidentiale",1,1013,254,236,18,0,220,34,1100,846,166,54
15,COVASNA,"MUNICIPIUL SFÂNTU GHEORGHE",63394,"SFÂNTU GHEORGHE","GRĂDINIŢA CU PROGRAM PRELUNGIT ”GULLIVER”",13,"Alegeri Prezidentiale",1,1343,278,264,14,0,247,31,1400,1122,185,62
15,COVASNA,"MUNICIPIUL SFÂNTU GHEORGHE",63394,"SFÂNTU GHEORGHE","COLEGIUL NAŢIONAL ”MIHAI VITEAZUL”",14,"Alegeri Prezidentiale",1,962,266,235,31,0,237,29,1000,734,190,47
15,COVASNA,"MUNICIPIUL SFÂNTU GHEORGHE",63394,"SFÂNTU GHEORGHE","COLEGIUL NAŢIONAL ”MIHAI VITEAZUL”",15,"Alegeri Prezidentiale",1,896,189,171,18,0,177,12,1000,811,136,41
15,COVASNA,"MUNICIPIUL SFÂNTU GHEORGHE",63394,"SFÂNTU GHEORGHE","COLEGIUL NAŢIONAL ”MIHAI VITEAZUL”",16,"Alegeri Prezidentiale",1,866,184,171,13,0,173,11,900,716,140,33
15,COVASNA,"MUNICIPIUL SFÂNTU GHEORGHE",63394,"SFÂNTU GHEORGHE","SALA DE SPORT",17,"Alegeri Prezidentiale",1,1551,481,459,22,0,445,36,1600,1119,340,105
15,COVASNA,"MUNICIPIUL SFÂNTU GHEORGHE",63394,"SFÂNTU GHEORGHE","GRADINIŢA CU PROGRAM PRELUNGIT ”HÓFEHÉRKE”",18,"Alegeri Prezidentiale",1,801,226,204,22,0,195,31,900,674,138,57
15,COVASNA,"MUNICIPIUL SFÂNTU GHEORGHE",63394,"SFÂNTU GHEORGHE","ŞCOALA GIMNAZIALĂ ”VÁRADI JÓZSEF”",19,"Alegeri Prezidentiale",1,547,202,164,38,0,182,20,600,398,140,42
15,COVASNA,"MUNICIPIUL SFÂNTU GHEORGHE",63394,"SFÂNTU GHEORGHE","ŞCOALA GIMNAZIALĂ ”VÁRADI JÓZSEF”",20,"Alegeri Prezidentiale",1,1264,458,349,23,86,415,43,1400,942,323,92
15,COVASNA,"MUNICIPIUL SFÂNTU GHEORGHE",63394,"SFÂNTU GHEORGHE","LICEUL DE ARTE ”PLUGOR SÁNDOR”",21,"Alegeri Prezidentiale",1,734,229,201,23,5,205,24,800,571,137,68
15,COVASNA,"MUNICIPIUL SFÂNTU GHEORGHE",63394,"SFÂNTU GHEORGHE","LICEUL DE ARTE ”PLUGOR SÁNDOR”",22,"Alegeri Prezidentiale",1,1167,183,158,25,0,167,16,1200,1017,116,51
15,COVASNA,"MUNICIPIUL SFÂNTU GHEORGHE",63394,"SFÂNTU GHEORGHE","ŞCOALA AJUTĂTOARE",23,"Alegeri Prezidentiale",1,695,162,150,12,0,139,23,800,638,108,31
15,COVASNA,"MUNICIPIUL SFÂNTU GHEORGHE",63394,"SFÂNTU GHEORGHE","GRĂDINIŢA CU PROGRAM PRELUNGIT ”ÁRVÁCSKA”",24,"Alegeri Prezidentiale",1,1264,322,307,15,0,298,24,1300,978,198,100
15,COVASNA,"MUNICIPIUL SFÂNTU GHEORGHE",63394,"SFÂNTU GHEORGHE","GRĂDINIŢA CU PROGRAM PRELUNGIT ”ÁRVÁCSKA”",25,"Alegeri Prezidentiale",1,854,187,162,25,0,176,11,908,721,131,45
15,COVASNA,"MUNICIPIUL SFÂNTU GHEORGHE",63394,"SFÂNTU GHEORGHE","ŞCOALA GIMNAZIALĂ ”GÖDRI FERENC”",26,"Alegeri Prezidentiale",1,1344,297,280,17,0,284,13,1400,1103,219,65
15,COVASNA,"MUNICIPIUL SFÂNTU GHEORGHE",63394,"SFÂNTU GHEORGHE","ŞCOALA GIMNAZIALĂ ”GÖDRI FERENC”",27,"Alegeri Prezidentiale",1,898,192,183,9,0,187,5,1000,808,151,36
15,COVASNA,"MUNICIPIUL SFÂNTU GHEORGHE",63394,"SFÂNTU GHEORGHE","CĂMINUL ”ZATHURECZKY BERTA”",28,"Alegeri Prezidentiale",1,1280,295,283,12,0,268,27,1300,1005,214,54
15,COVASNA,"MUNICIPIUL SFÂNTU GHEORGHE",63394,"SFÂNTU GHEORGHE","CĂMINUL ”ZATHURECZKY BERTA”",29,"Alegeri Prezidentiale",1,1688,506,456,37,13,466,40,1700,1194,362,104
15,COVASNA,"MUNICIPIUL SFÂNTU GHEORGHE",63394,"SFÂNTU GHEORGHE","GRĂDINIȚA CU PROGRAM PRELUNGIT ”PINOCCHIO”",30,"Alegeri Prezidentiale",1,660,191,181,10,0,181,10,700,509,144,37
15,COVASNA,"MUNICIPIUL SFÂNTU GHEORGHE",63394,"SFÂNTU GHEORGHE","GRĂDINIŢA CU PROGRAM PRELUNGIT ”PINOCCHIO”",31,"Alegeri Prezidentiale",1,1702,469,452,17,0,447,22,1800,1331,341,106
15,COVASNA,"MUNICIPIUL SFÂNTU GHEORGHE",63394,"SFÂNTU GHEORGHE","GRĂDINIŢA CU PROGRAM PRELUNGIT ”PINOCCHIO”",32,"Alegeri Prezidentiale",1,1230,345,330,15,0,323,22,1300,955,237,86
15,COVASNA,"MUNICIPIUL SFÂNTU GHEORGHE",63394,"SFÂNTU GHEORGHE","ȘCOALA GIMNAZIALĂ ”NICOLAE COLAN”",33,"Alegeri Prezidentiale",1,1143,348,329,18,1,326,22,1200,852,237,89
15,COVASNA,"MUNICIPIUL SFÂNTU GHEORGHE",63394,"SFÂNTU GHEORGHE","ŞCOALA GIMNAZIALĂ ”NICOLAE COLAN”",34,"Alegeri Prezidentiale",1,1128,327,314,13,0,302,25,1200,873,213,89
15,COVASNA,"MUNICIPIUL SFÂNTU GHEORGHE",63394,"SFÂNTU GHEORGHE","ŞCOALA GIMNAZIALĂ ”NICOLAE COLAN”",35,"Alegeri Prezidentiale",1,1079,300,280,20,0,281,19,1100,800,217,64
15,COVASNA,"MUNICIPIUL SFÂNTU GHEORGHE",63394,"SFÂNTU GHEORGHE","ŞCOALA GIMNAZIALĂ ”NICOLAE COLAN”",36,"Alegeri Prezidentiale",1,1179,350,330,20,0,327,23,1200,850,240,87
15,COVASNA,"MUNICIPIUL SFÂNTU GHEORGHE",63394,"SFÂNTU GHEORGHE","GRĂDINIŢA CU PROGRAM PRELUNGIT ”BENEDEK ELEK”",37,"Alegeri Prezidentiale",1,1584,518,487,31,0,481,37,1600,1082,348,133
15,COVASNA,"MUNICIPIUL SFÂNTU GHEORGHE",63394,"SFÂNTU GHEORGHE","LICEUL TEHNOLOGIC ”PUSKÁS TIVADAR”",38,"Alegeri Prezidentiale",1,1212,338,310,28,0,322,16,1300,962,244,78
15,COVASNA,"MUNICIPIUL SFÂNTU GHEORGHE",63394,"SFÂNTU GHEORGHE","LICEUL TEHNOLOGIC ”PUSKÁS TIVADAR”",39,"Alegeri Prezidentiale",1,1456,485,448,37,0,448,37,1500,1015,337,111
15,COVASNA,"MUNICIPIUL SFÂNTU GHEORGHE",63394,"SFÂNTU GHEORGHE","LICEUL TEHNOLOGIC ”PUSKÁS TIVADAR”",40,"Alegeri Prezidentiale",1,1355,430,412,18,0,404,26,1400,970,298,106
15,COVASNA,"MUNICIPIUL SFÂNTU GHEORGHE",63394,"SFÂNTU GHEORGHE","ŞTRAND MUNICIPAL SFÂNTU GHEORGHE",41,"Alegeri Prezidentiale",1,1214,423,387,36,0,391,32,1300,877,264,127
15,COVASNA,"MUNICIPIUL SFÂNTU GHEORGHE",63394,"SFÂNTU GHEORGHE","ŞTRAND MUNICIPAL SFÂNTU GHEORGHE",42,"Alegeri Prezidentiale",1,1328,378,348,30,0,359,19,1400,1022,275,84
15,COVASNA,"MUNICIPIUL SFÂNTU GHEORGHE",63394,"SFÂNTU GHEORGHE","ŞCOALA GIMNAZIALĂ ”ADY ENDRE”",43,"Alegeri Prezidentiale",1,784,312,245,66,1,298,14,792,480,217,81
15,COVASNA,"MUNICIPIUL SFÂNTU GHEORGHE",63394,"SFÂNTU GHEORGHE","ŞCOALA GIMNAZIALĂ ”ADY ENDRE”",44,"Alegeri Prezidentiale",1,843,251,227,24,0,240,11,900,649,173,67
15,COVASNA,"MUNICIPIUL SFÂNTU GHEORGHE",63394,"SFÂNTU GHEORGHE","ŞCOALA GIMNAZIALĂ ”ADY ENDRE”",45,"Alegeri Prezidentiale",1,1289,400,382,18,0,385,15,1292,892,280,105
15,COVASNA,"MUNICIPIUL SFÂNTU GHEORGHE",63394,"SFÂNTU GHEORGHE","GRĂDINIŢA CU PROGRAM PRELUNGIT ”NAPSUGÁR”",46,"Alegeri Prezidentiale",1,1093,360,316,44,0,348,12,1100,740,275,73
15,COVASNA,"MUNICIPIUL SFÂNTU GHEORGHE",63394,"SFÂNTU GHEORGHE","GRĂDINIŢA CU PROGRAM PRELUNGIT ”NAPSUGÁR”",47,"Alegeri Prezidentiale",1,1141,372,348,23,1,358,14,1200,828,236,122
15,COVASNA,"MUNICIPIUL SFÂNTU GHEORGHE",63394,"SFÂNTU GHEORGHE","FOSTA ŞCOALA GENERALĂ CÂMPUL FRUMOS",48,"Alegeri Prezidentiale",1,331,121,113,8,0,120,1,400,279,71,49
15,COVASNA,"MUNICIPIUL SFÂNTU GHEORGHE",63394,CHILIENI,"CĂMIN CULTURAL",49,"Alegeri Prezidentiale",1,739,165,144,21,0,149,16,800,635,122,27
15,COVASNA,"MUNICIPIUL SFÂNTU GHEORGHE",63394,COŞENI,"CĂMIN CULTURAL",50,"Alegeri Prezidentiale",1,404,105,88,17,0,104,1,500,395,88,16
15,COVASNA,"MUNICIPIUL TÂRGU SECUIESC",63740,"TÂRGU SECUIESC","CASA MUNICIPALĂ DE CULTURĂ ”VIGADÓ” TÂRGU SECUIESC",51,"Alegeri Prezidentiale",1,1344,262,236,26,0,234,28,1400,1138,180,54
15,COVASNA,"MUNICIPIUL TÂRGU SECUIESC",63740,"TÂRGU SECUIESC","LICEUL TEORETIC ”NAGY MÓZES” TÂRGU SECUIESC",52,"Alegeri Prezidentiale",1,1108,140,126,14,0,125,15,1200,1060,100,25
15,COVASNA,"MUNICIPIUL TÂRGU SECUIESC",63740,"TÂRGU SECUIESC","LICEUL PEDAGOGIC ”BOD PÉTER” TÂRGU SECUIESC",53,"Alegeri Prezidentiale",1,1204,242,221,21,0,218,24,1300,1058,161,57
15,COVASNA,"MUNICIPIUL TÂRGU SECUIESC",63740,"TÂRGU SECUIESC","LICEUL VOCAŢIONAL REFORMAT TÂRGU SECUIESC",54,"Alegeri Prezidentiale",1,1197,232,211,21,0,211,21,1300,1068,177,34
15,COVASNA,"MUNICIPIUL TÂRGU SECUIESC",63740,"TÂRGU SECUIESC","GRĂDINIŢA CU PROGRAM NORMAL ”BENEDEK ELEK” TÂRGU SECUIESC",55,"Alegeri Prezidentiale",1,1344,273,237,36,0,257,16,1400,1127,197,60
15,COVASNA,"MUNICIPIUL TÂRGU SECUIESC",63740,"TÂRGU SECUIESC","ŞCOALA GIMNAZIALĂ ”PETŐFI SÁNDOR” TÂRGU SECUIESC",56,"Alegeri Prezidentiale",1,1267,243,218,25,0,227,16,1300,1057,171,56
15,COVASNA,"MUNICIPIUL TÂRGU SECUIESC",63740,"TÂRGU SECUIESC","GRĂDINIŢA CU PROGRAM PRELUNGIT ”CSIPKERÓZSIKA” TÂRGU SECUIESC",57,"Alegeri Prezidentiale",1,1362,250,238,12,0,226,24,1400,1150,165,61
15,COVASNA,"MUNICIPIUL TÂRGU SECUIESC",63740,"TÂRGU SECUIESC","ŞCOALA GIMNAZIALĂ ”TUROCZI MÓZES” TÂRGU SECUIESC",58,"Alegeri Prezidentiale",1,1323,250,228,22,0,235,15,1400,1150,180,55
15,COVASNA,"MUNICIPIUL TÂRGU SECUIESC",63740,"TÂRGU SECUIESC","GRĂDINIŢA CU PROGRAM PRELUNGIT ”MANÓCSKA” TÂRGU SECUIESC",59,"Alegeri Prezidentiale",1,1338,286,271,15,0,272,14,1400,1114,222,50
15,COVASNA,"MUNICIPIUL TÂRGU SECUIESC",63740,"TÂRGU SECUIESC","GRĂDINIŢA CU PROGRAM NORMAL NR. 3 TÂRGU SECUIESC",60,"Alegeri Prezidentiale",1,879,185,169,16,0,165,20,900,715,125,40
15,COVASNA,"MUNICIPIUL TÂRGU SECUIESC",63740,"TÂRGU SECUIESC","LICEUL TEHNOLOGIC ”GÁBOR ÁRON” TÂRGU SECUIESC",61,"Alegeri Prezidentiale",1,1150,235,205,30,0,226,9,1300,1065,174,52
15,COVASNA,"MUNICIPIUL TÂRGU SECUIESC",63740,"TÂRGU SECUIESC","ŞCOALA GIMNAZIALĂ ”MOLNÁR JOZSIÁS” TÂRGU SECUIESC",62,"Alegeri Prezidentiale",1,1198,222,210,10,2,206,16,1300,1078,149,57
15,COVASNA,"MUNICIPIUL TÂRGU SECUIESC",63740,"TÂRGU SECUIESC","ŞCOALA PRIMARĂ RUSENI, TÂRGU SECUIESC",63,"Alegeri Prezidentiale",1,541,108,99,9,0,95,13,600,492,76,19
15,COVASNA,"MUNICIPIUL TÂRGU SECUIESC",63740,LUNGA,"CĂMINUL CULTURAL TINOASA",64,"Alegeri Prezidentiale",1,320,66,56,10,0,62,4,398,332,52,10
15,COVASNA,"MUNICIPIUL TÂRGU SECUIESC",63740,LUNGA,"CĂMINUL CULTURAL LUNGA",65,"Alegeri Prezidentiale",1,983,141,130,11,0,129,12,1000,859,105,24
15,COVASNA,"ORAŞ BARAOLT",63447,BIBORŢENI,"CĂMINUL CULTURAL BIBORŢENI",66,"Alegeri Prezidentiale",1,578,138,127,11,0,116,22,608,470,80,36
15,COVASNA,"ORAŞ BARAOLT",63447,BODOŞ,"ȘCOALA PRIMARĂ ”BUDAI JÓZSEF” BODOȘ",67,"Alegeri Prezidentiale",1,348,64,46,18,0,58,6,400,336,36,22
15,COVASNA,"ORAŞ BARAOLT",63447,CĂPENI,"CĂMINUL CULTURAL CĂPENI",68,"Alegeri Prezidentiale",1,864,136,119,17,0,130,6,900,764,95,35
15,COVASNA,"ORAŞ BARAOLT",63447,"RACOŞUL DE SUS","CĂMIN CULTURAL RACOŞUL DE SUS",69,"Alegeri Prezidentiale",1,737,131,122,9,0,124,7,800,669,95,29
15,COVASNA,"ORAŞ BARAOLT",63447,BARAOLT,"PRIMĂRIA ORAŞULUI BARAOLT",70,"Alegeri Prezidentiale",1,1102,184,160,24,0,166,18,1200,1016,107,59
15,COVASNA,"ORAŞ BARAOLT",63447,BARAOLT,"CASA DE CULTURĂ BARAOLT",71,"Alegeri Prezidentiale",1,1172,203,177,14,12,179,24,1300,1097,130,49
15,COVASNA,"ORAŞ BARAOLT",63447,BARAOLT,"ŞCOALA GIMNAZIALĂ GAÁL MÓZES BARAOLT",72,"Alegeri Prezidentiale",1,1227,222,209,13,0,198,24,1300,1078,156,42
15,COVASNA,"ORAŞ BARAOLT",63447,BARAOLT,"GRĂDINIŢA CU PROGRAM PRELUNGIT ”CIMBORA”",73,"Alegeri Prezidentiale",1,1198,246,230,16,0,227,19,1300,1054,164,63
15,COVASNA,"ORAŞ BARAOLT",63447,MICLOŞOARA,"GRĂDINIŢA CU PROGRAM NORMAL MICLOŞOARA",74,"Alegeri Prezidentiale",1,356,108,88,20,0,106,2,400,292,94,12
15,COVASNA,"ORAŞ COVASNA",63526,CHIURUŞ,"CASA DE CULTURĂ-CHIURUŞ",75,"Alegeri Prezidentiale",1,404,109,93,16,0,96,13,500,391,75,21
15,COVASNA,"ORAŞ COVASNA",63526,COVASNA,"GRĂDINIŢA CU PROGRAM PRELUNGIT NR.1 COVASNA",76,"Alegeri Prezidentiale",1,1310,302,265,23,14,268,34,1492,1190,203,65
15,COVASNA,"ORAŞ COVASNA",63526,COVASNA,"CLUBUL ORĂȘENESC- COVASNA",77,"Alegeri Prezidentiale",1,1322,870,280,590,0,845,25,1800,930,532,313
15,COVASNA,"ORAŞ COVASNA",63526,COVASNA,"LICEUL ”KŐRÖSI CSOMA SÁNDOR” -CORP A- COVASNA",78,"Alegeri Prezidentiale",1,1133,510,297,213,0,483,27,1500,990,340,143
15,COVASNA,"ORAŞ COVASNA",63526,COVASNA,"LICEUL ”KŐRÖSI CSOMA SÁNDOR” -CORP B- COVASNA",79,"Alegeri Prezidentiale",1,1199,403,270,133,0,366,37,1500,1097,275,91
15,COVASNA,"ORAŞ COVASNA",63526,COVASNA,"GRĂDINIŢA CU PROGRAM PRELUNGIT NR. 2 COVASNA",80,"Alegeri Prezidentiale",1,1532,402,367,35,0,374,28,1600,1198,291,83
15,COVASNA,"ORAŞ COVASNA",63526,COVASNA,"ȘCOALA GIMNAZIALĂ ”AVRAM IANCU”- COVASNA -PRI.",81,"Alegeri Prezidentiale",1,1259,492,408,84,0,469,23,1700,1208,317,152
15,COVASNA,"ORAŞ COVASNA",63526,COVASNA,"ȘCOALA GIMNAZIALĂ ”AVRAM IANCU”-COVASNA- GIM",82,"Alegeri Prezidentiale",1,1098,779,462,315,2,754,25,1700,921,478,276
15,COVASNA,"ORAŞ ÎNTORSURA BUZĂULUI",63580,"ÎNTORSURA BUZĂULUI","ŞCOALA GIMNAZIALĂ ”MIHAIL SADOVEANU” ÎNTORSURA BUZĂULUI",83,"Alegeri Prezidentiale",1,1131,577,523,24,30,567,10,1400,823,413,154
15,COVASNA,"ORAŞ ÎNTORSURA BUZĂULUI",63580,"ÎNTORSURA BUZĂULUI","ŞCOALA GIMNAZIALĂ ”MIHAIL SADOVEANU” ÎNTORSURA BUZĂULUI",84,"Alegeri Prezidentiale",1,1175,610,554,56,0,598,12,1200,590,477,121
15,COVASNA,"ORAŞ ÎNTORSURA BUZĂULUI",63580,"ÎNTORSURA BUZĂULUI","CASA DE CULTURĂ ÎNTORSURA BUZĂULUI",85,"Alegeri Prezidentiale",1,955,416,387,28,1,412,4,1100,684,313,99
15,COVASNA,"ORAŞ ÎNTORSURA BUZĂULUI",63580,"ÎNTORSURA BUZĂULUI","CENTRUL CULTURAL ÎNTORSURA BUZĂULUI",86,"Alegeri Prezidentiale",1,1205,586,546,40,0,577,9,1300,714,422,155
15,COVASNA,"ORAŞ ÎNTORSURA BUZĂULUI",63580,"ÎNTORSURA BUZĂULUI","ȘCOALA PRIMARĂ ÎNTORSURA BUZĂULUI",87,"Alegeri Prezidentiale",1,764,373,353,20,0,369,4,800,427,241,128
15,COVASNA,"ORAŞ ÎNTORSURA BUZĂULUI",63580,BRĂDET,"ȘCOALA GIMNAZIALĂ ”GHEORGHE ZAHARIA” BRĂDET",88,"Alegeri Prezidentiale",1,963,432,393,39,0,429,3,1000,568,316,113
15,COVASNA,"ORAŞ ÎNTORSURA BUZĂULUI",63580,FLOROAIA,"CĂMIN CULTURAL FLOROAIA",89,"Alegeri Prezidentiale",1,1177,533,504,29,0,528,5,1200,667,427,101
15,COVASNA,"AITA MARE",63777,"AITA MARE","SEDIUL PRIMĂRIEI COMUNEI AITA MARE",90,"Alegeri Prezidentiale",1,721,165,134,31,0,159,6,800,635,129,30
15,COVASNA,"AITA MARE",63777,"AITA MEDIE","CASA CANTORIALĂ AITA MEDIE",91,"Alegeri Prezidentiale",1,634,121,105,16,0,115,6,700,579,99,16
15,COVASNA,ARCUŞ,65113,ARCUŞ,"SEDIUL CONSILIULUI LOCAL ARCUŞ",92,"Alegeri Prezidentiale",1,1314,298,270,27,1,268,30,1400,1102,228,40
15,COVASNA,BARCANI,63633,BARCANI,"CĂMINUL CULTURAL BARCANI",93,"Alegeri Prezidentiale",1,977,509,467,41,1,504,5,1100,591,351,153
15,COVASNA,BARCANI,63633,BARCANI,"CĂMINUL CULTURAL BARCANI",94,"Alegeri Prezidentiale",1,1004,439,424,15,0,433,6,1100,661,279,154
15,COVASNA,BARCANI,63633,LĂDĂUŢI,"ŞCOALA GIMNAZIALĂ LĂDĂUŢI",95,"Alegeri Prezidentiale",1,541,228,198,30,0,226,2,600,372,156,70
15,COVASNA,BARCANI,63633,SĂRĂMAŞ,"ŞCOALA GIMNAZIALĂ SĂRĂMAŞ",96,"Alegeri Prezidentiale",1,568,255,225,30,0,252,3,600,345,192,60
15,COVASNA,BĂŢANI,63802,"BĂŢANII MARI","CLĂDIRE PRIMARIEI CĂMINUL CULTURAL BAŢANII MARI",97,"Alegeri Prezidentiale",1,1645,258,237,21,0,231,27,1700,1442,160,71
15,COVASNA,BĂŢANI,63802,"BĂŢANII MICI","CĂMINUL CULTURAL BAŢANII MICI",98,"Alegeri Prezidentiale",1,449,75,62,13,0,66,9,500,425,48,18
15,COVASNA,BĂŢANI,63802,HERCULIAN,"SEDIUL DE DEPLASARE AL PRIMARIEI ÎN SATUL HERCULIAN",99,"Alegeri Prezidentiale",1,890,134,120,14,0,121,13,1000,866,68,53
15,COVASNA,BĂŢANI,63802,"AITA SEACĂ","SEDIUL DE DEPLASARE AL PRIMARIEI ÎN AITA SEACĂ",100,"Alegeri Prezidentiale",1,562,76,62,14,0,70,6,700,624,50,20
15,COVASNA,BELIN,63866,BELIN,"ŞCOALA GIMNAZIALĂ ”BÖLÖNI FARKAS SÁNDOR”",101,"Alegeri Prezidentiale",1,1064,270,228,42,0,265,5,1200,930,196,69
15,COVASNA,BELIN,63866,BELIN-VALE,"CENTRUL MULTIFUNCŢIONAL BELIN VALE",102,"Alegeri Prezidentiale",1,1101,200,185,15,0,194,6,1200,1000,140,54
15,COVASNA,BIXAD,65121,BIXAD,"CĂMINUL CULTURAL BIXAD",103,"Alegeri Prezidentiale",1,1412,253,218,35,0,243,10,1500,1247,160,83
15,COVASNA,BODOC,63893,BODOC,"CĂMINUL CULTURAL DIN BODOC",104,"Alegeri Prezidentiale",1,948,236,216,20,0,216,20,1000,764,156,60
15,COVASNA,BODOC,63893,ZĂLAN,"ŞCOALA PRIMARĂ ”DÁVID JÓZSEF” ZĂLAN",105,"Alegeri Prezidentiale",1,526,93,78,15,0,88,5,600,507,65,23
15,COVASNA,BODOC,63893,OLTENI,"IMOBILUL PRIMĂRIEI DIN OLTENI",106,"Alegeri Prezidentiale",1,527,93,76,17,0,81,12,600,507,56,25
15,COVASNA,"BOROŞNEU MARE",63937,"BOROŞNEU MARE","CONSILIUL LOCAL BOROSNEU MARE",107,"Alegeri Prezidentiale",1,1250,107,91,16,0,104,3,1300,1193,65,39
15,COVASNA,"BOROŞNEU MARE",63937,"BOROŞNEU MIC","ŞCOALA PRIMARĂ BOROŞNEU MIC",108,"Alegeri Prezidentiale",1,356,65,53,12,0,65,0,400,335,43,22
15,COVASNA,"BOROŞNEU MARE",63937,"DOBOLII DE SUS","SCOLA PRIMARĂ DOBOLII DE SUS",109,"Alegeri Prezidentiale",1,188,57,44,13,0,53,4,300,243,32,21
15,COVASNA,"BOROŞNEU MARE",63937,LEŢ,"ŞCOALA PRIMARĂ LEŢ",110,"Alegeri Prezidentiale",1,521,70,59,11,0,70,0,600,530,53,17
15,COVASNA,"BOROŞNEU MARE",63937,ŢUFALĂU,"CĂMINUL CULTURAL ŢUFALAU",111,"Alegeri Prezidentiale",1,178,53,36,17,0,48,5,300,247,34,14
15,COVASNA,BRATEŞ,64005,BRATEŞ,"SALA DE FESTIVITĂŢI A CONSILIULUI LOCAL BRATEŞ",112,"Alegeri Prezidentiale",1,456,87,65,22,0,80,7,600,513,48,32
15,COVASNA,BRATEŞ,64005,TELECHIA,"ȘCOALA PRIMARĂ ” HORVÁTH KÁROLY” TELECHIA",113,"Alegeri Prezidentiale",1,453,63,46,17,0,54,9,500,437,46,8
15,COVASNA,BRATEŞ,64005,PACHIA,"ȘCOALA PRIMARĂ ” VIDA ANDRÁS” PACHIA",114,"Alegeri Prezidentiale",1,270,80,70,10,0,73,7,300,220,59,14
15,COVASNA,BRĂDUŢ,64041,BRĂDUŢ,"CLUBUL CĂMINULUI CULTURAL BRĂDUŢ",115,"Alegeri Prezidentiale",1,710,113,105,8,0,102,11,800,687,35,67
15,COVASNA,BRĂDUŢ,64041,TĂLIŞOARA,"CĂMINUL CULTURAL TĂLIŞOARA",116,"Alegeri Prezidentiale",1,609,102,93,9,0,90,12,700,598,51,39
15,COVASNA,BRĂDUŢ,64041,DOBOŞENI,"CLUBUL CĂMINULUI CULTURAL DOBOŞENI",117,"Alegeri Prezidentiale",1,1440,214,208,6,0,200,14,1500,1286,114,86
15,COVASNA,BRĂDUŢ,64041,FILIA,"CLUBUL CĂMINULUI CULTURAL FILIA",118,"Alegeri Prezidentiale",1,969,192,183,9,0,175,17,1100,908,96,79
15,COVASNA,BREŢCU,64096,BREŢCU,"CENTRUL CULTURAL BREŢCU",119,"Alegeri Prezidentiale",1,1156,246,234,12,0,239,7,1300,1054,162,77
15,COVASNA,BREŢCU,64096,BREŢCU,"CENTRUL CULTURAL BREŢCU",120,"Alegeri Prezidentiale",1,869,189,158,30,1,178,11,1000,811,99,79
15,COVASNA,BREŢCU,64096,MĂRTĂNUŞ,"ŞCOALA PRIMARĂ MĂRTĂNUŞ",121,"Alegeri Prezidentiale",1,610,150,126,24,0,140,10,700,550,110,30
15,COVASNA,BREŢCU,64096,OITUZ,"ŞCOALA GIMNAZIALĂ OITUZ",122,"Alegeri Prezidentiale",1,256,89,76,13,0,81,8,300,211,59,22
15,COVASNA,CATALINA,64130,CATALINA,"CĂMINUL CULTURAL CATALINA",123,"Alegeri Prezidentiale",1,1108,156,149,7,0,148,8,1200,1044,126,22
15,COVASNA,CATALINA,64130,IMENI,"SCOALA PRIMARA IMENI",124,"Alegeri Prezidentiale",1,247,57,47,10,0,55,2,300,243,42,13
15,COVASNA,CATALINA,64130,HĂTUICA,"CĂMINUL CULTURAL HĂTIUCA",125,"Alegeri Prezidentiale",1,382,93,81,12,0,91,2,500,407,64,27
15,COVASNA,CATALINA,64130,MĂRTINENI,"CASA COMUNALA MĂRTINENI",126,"Alegeri Prezidentiale",1,495,104,90,14,0,100,4,600,496,78,22
15,COVASNA,CATALINA,64130,MĂRCUŞA,"CĂMINUL CULTURAL MĂRCUŞA",127,"Alegeri Prezidentiale",1,511,79,70,9,0,75,4,600,521,38,37
15,COVASNA,CERNAT,64194,CERNAT,"CASA MULTIFUNCȚIONALĂ ”CONACUL FARKAS”",128,"Alegeri Prezidentiale",1,654,91,79,12,0,87,4,700,609,68,19
15,COVASNA,CERNAT,64194,CERNAT,"ŞCOALA GIMNAZIALĂ ”VÉGH ANTAL” CERNAT",129,"Alegeri Prezidentiale",1,1185,142,136,6,0,135,7,1300,1158,100,35
15,COVASNA,CERNAT,64194,CERNAT,"ŞCOALA GIMNAZIALĂ ”BOD PÉTER” CERNAT",130,"Alegeri Prezidentiale",1,887,157,147,10,0,142,15,1000,843,87,55
15,COVASNA,CERNAT,64194,ALBIŞ,"CLĂDIREA CONSILIULUI LOCAL CERNAT, ALBIŞ",131,"Alegeri Prezidentiale",1,338,50,39,11,0,49,1,400,350,34,15
15,COVASNA,CERNAT,64194,ICAFALĂU,"CASA MULTIFUNCȚIONALĂ ICAFĂLĂU",132,"Alegeri Prezidentiale",1,214,42,32,10,0,35,7,300,258,18,17
15,COVASNA,CHICHIŞ,64238,CHICHIŞ,"CĂMINUL CULTURAL CHICHIŞ",133,"Alegeri Prezidentiale",1,864,311,272,39,0,298,13,1000,689,231,67
15,COVASNA,CHICHIŞ,64238,BĂCEL,"ŞCOALA GIMNAZIALĂ BĂCEL",134,"Alegeri Prezidentiale",1,434,196,152,44,0,190,6,500,304,124,66
15,COVASNA,COMANDĂU,63553,COMANDĂU,"SEDIUL PRIMARIEI COMANDĂU",135,"Alegeri Prezidentiale",1,811,293,249,44,0,277,16,1000,707,213,64
15,COVASNA,DALNIC,65147,DALNIC,"CĂMINUL CULTURAL DALNIC",136,"Alegeri Prezidentiale",1,746,104,89,15,0,98,6,900,796,68,30
15,COVASNA,DOBÂRLĂU,64265,DOBÂRLĂU,"CĂMINUL CULTURAL DOBÂRLĂU",137,"Alegeri Prezidentiale",1,886,441,389,51,1,430,11,1040,599,279,151
15,COVASNA,DOBÂRLĂU,64265,"VALEA DOBÂRLĂULUI","ŞCOALA PRIMARĂ VALEA DOBÂRLĂULUI",138,"Alegeri Prezidentiale",1,249,132,115,17,0,131,1,300,168,97,34
15,COVASNA,DOBÂRLĂU,64265,MĂRCUŞ,"ŞCOALA PRIMARĂ MĂRCUŞ",139,"Alegeri Prezidentiale",1,331,217,164,53,0,215,2,400,183,171,44
15,COVASNA,DOBÂRLĂU,64265,"LUNCA MĂRCUŞULUI","ŞCOALA PRIMARĂ LUNCA MĂRCUŞULUI",140,"Alegeri Prezidentiale",1,293,161,128,33,0,161,0,400,239,126,35
15,COVASNA,ESTELNIC,65154,ESTELNIC,"CĂMINUL CULTURAL ESTELNIC",141,"Alegeri Prezidentiale",1,674,159,131,28,0,146,13,800,641,99,47
15,COVASNA,ESTELNIC,65154,"VALEA SCURTĂ","CĂMINUL CULTURAL VALEA SCURTĂ",142,"Alegeri Prezidentiale",1,206,70,57,13,0,62,8,300,230,42,20
15,COVASNA,GHELINŢA,64318,GHELINŢA,"ŞCOALA GIMNAZIALĂ ”JANCSÓ BENEDEK” GHELINŢA",143,"Alegeri Prezidentiale",1,1458,172,159,13,0,161,11,1500,1328,119,42
15,COVASNA,GHELINŢA,64318,GHELINŢA,"ŞCOALA GIMNAZIALĂ ”JANCSÓ BENEDEK” GHELINŢA",144,"Alegeri Prezidentiale",1,1392,108,101,7,0,102,6,1400,1292,64,38
15,COVASNA,GHELINŢA,64318,GHELINŢA,"ŞCOALA PRIMARĂ NR.2 GHELINŢA",145,"Alegeri Prezidentiale",1,1078,170,154,16,0,156,14,1100,930,119,37
15,COVASNA,GHELINŢA,64318,HARALE,"ŞCOALA PRIMARĂ HARALE",146,"Alegeri Prezidentiale",1,196,31,21,10,0,31,0,300,269,24,7
15,COVASNA,GHIDFALĂU,64345,GHIDFALĂU,"CĂMINUL CULTURAL DIN SATUL GHIDFALĂU",147,"Alegeri Prezidentiale",1,917,129,116,13,0,114,15,1000,871,76,38
15,COVASNA,GHIDFALĂU,64345,ANGHELUŞ,"CLĂDIRE AFLATĂ ÎN DOMENIUL PUBLIC AL COMUNEI GHIDFALĂU, SAT ANGHELUŞ",148,"Alegeri Prezidentiale",1,544,94,82,12,0,90,4,600,506,82,8
15,COVASNA,GHIDFALĂU,64345,ZOLTAN,"CLĂDIREA POPICĂRIEI ZOLTAN",149,"Alegeri Prezidentiale",1,351,112,99,13,0,107,5,400,288,77,30
15,COVASNA,GHIDFALĂU,64345,FOTOŞ,"CĂMINUL CULTURAL DIN SATUL FOTOŞ",150,"Alegeri Prezidentiale",1,302,58,44,14,0,48,10,400,342,37,11
15,COVASNA,HĂGHIG,64390,HĂGHIG,"CĂMINUL CULTURAL HĂGHIG",151,"Alegeri Prezidentiale",1,1375,505,407,74,24,489,16,1500,995,356,133
15,COVASNA,HĂGHIG,64390,IARĂŞ,"CENTRUL DE ZI PENTRU COPII IARĂȘ",152,"Alegeri Prezidentiale",1,363,146,118,28,0,144,2,400,254,71,73
15,COVASNA,ILIENI,64425,ILIENI,"CĂMINUL CULTURAL ILIENI",153,"Alegeri Prezidentiale",1,858,213,191,22,0,200,13,1000,787,169,31
15,COVASNA,ILIENI,64425,SÂNCRAIU,"GRĂDINIŢA CU PROGRAM NORMAL SÂNCRAIU",154,"Alegeri Prezidentiale",1,361,106,89,17,0,95,11,400,294,69,26
15,COVASNA,ILIENI,64425,"DOBOLII DE JOS","ŞCOALA PRIMARĂ ”BODA-POPOVICI” DOBOLII DE JOS",155,"Alegeri Prezidentiale",1,434,166,136,30,0,160,6,500,334,133,27
15,COVASNA,LEMNIA,64461,LEMNIA,"SEDIUL PRIMĂRIEI LEMNIA",156,"Alegeri Prezidentiale",1,711,112,94,18,0,95,17,800,688,79,16
15,COVASNA,LEMNIA,64461,LEMNIA,"ŞCOALA PRIMARĂ NR.2 LEMNIA DE SUS",157,"Alegeri Prezidentiale",1,840,103,91,12,0,102,1,900,797,70,32
15,COVASNA,MALNAŞ,64504,MALNAŞ,"SEDIUL PRIMĂRIEI",158,"Alegeri Prezidentiale",1,416,95,82,13,0,87,8,500,405,48,39
15,COVASNA,MALNAŞ,64504,MALNAŞ-BĂI,"ŞCOALA PRIMARĂ MALNAŞ BĂI",159,"Alegeri Prezidentiale",1,362,82,62,20,0,75,7,400,318,60,15
15,COVASNA,MALNAŞ,64504,"VALEA ZĂLANULUI","ŞCOALA PRIMARĂ VALEA ZĂLANULUI",160,"Alegeri Prezidentiale",1,101,29,15,14,0,29,0,200,171,19,10
15,COVASNA,MERENI,65105,MERENI,"CĂMINUL CULTURAL MERENI",161,"Alegeri Prezidentiale",1,717,169,155,14,0,147,22,800,631,116,31
15,COVASNA,MERENI,65105,LUTOASA,"CĂMINUL CULTURAL LUTOASA",162,"Alegeri Prezidentiale",1,347,56,45,11,0,52,4,400,344,41,11
15,COVASNA,MICFALĂU,65139,MICFALĂU,"CĂMINUL CULTURAL MICFALĂU",163,"Alegeri Prezidentiale",1,1480,216,198,18,0,204,12,1600,1384,145,59
15,COVASNA,MOACŞA,64568,MOACŞA,"ŞCOALA GIMNAZIALĂ ”ORBAN BALAZS” MOACŞA",164,"Alegeri Prezidentiale",1,557,100,79,21,0,94,6,700,600,72,22
15,COVASNA,MOACŞA,64568,MOACŞA,"CLĂDIREA FOSTEI ŞCOLI GENERALE CU CLASELE I-IV ERESTEGHIN",165,"Alegeri Prezidentiale",1,177,34,25,9,0,32,2,300,266,25,7
15,COVASNA,MOACŞA,64568,PĂDURENI,"CĂMINUL CULTURAL PĂDURENI",166,"Alegeri Prezidentiale",1,267,56,43,13,0,51,5,300,244,32,19
15,COVASNA,OJDULA,64602,OJDULA,"CĂMINUL CULTURAL ”ZSÖGÖN ZOLTÁN” OJDULA CLUBUL TINERETULUI",167,"Alegeri Prezidentiale",1,1390,146,136,10,0,139,7,1400,1254,109,30
15,COVASNA,OJDULA,64602,OJDULA,"CĂMINUL CULTURAL ”ZSÖGÖN ZOLTÁN” OJDULA SALA MARE",168,"Alegeri Prezidentiale",1,1348,290,266,24,0,275,15,1400,1110,181,94
15,COVASNA,OJDULA,64602,HILIB,"CĂMINUL CULTURAL HILIB",169,"Alegeri Prezidentiale",1,213,65,49,16,0,62,3,300,235,34,28
15,COVASNA,OZUN,64639,OZUN,"CĂMINUL CULTURAL OZUN",170,"Alegeri Prezidentiale",1,932,214,179,35,0,200,14,1000,786,170,30
15,COVASNA,OZUN,64639,OZUN,"CLĂDIREA ȘCOLII NOI „TATRANGI SÁNDOR”",171,"Alegeri Prezidentiale",1,1247,325,272,52,1,314,11,1300,975,249,65
15,COVASNA,OZUN,64639,SÂNTIONLUNCA,"ŞCOALA PRIMARĂ ”BERDE MOZSA” SÎNTIONLUNCA",172,"Alegeri Prezidentiale",1,610,131,102,29,0,128,3,700,569,105,23
15,COVASNA,OZUN,64639,LISNĂU,"CLĂDIREA ȘCOLII GENERALE",173,"Alegeri Prezidentiale",1,433,131,96,35,0,130,1,500,369,98,32
15,COVASNA,OZUN,64639,BICFALĂU,"ȘCOALA PRIMARĂ BICFALĂU",174,"Alegeri Prezidentiale",1,281,80,57,23,0,77,3,400,320,53,24
15,COVASNA,OZUN,64639,MĂGHERUŞ,"CLĂDIREA ȘCOLII ELEMENTARE",175,"Alegeri Prezidentiale",1,92,34,17,17,0,32,2,100,66,29,3
15,COVASNA,OZUN,64639,"LUNCA OZUNULUI","CLĂDIRE ADMINISTRATIVĂ (FOSTUL SEDIU AL ŞCOLII) LUNCA OZUNULUI",176,"Alegeri Prezidentiale",1,151,93,68,25,0,93,0,200,107,69,24
15,COVASNA,POIAN,64719,POIAN,"ȘCOALA GIMNAZIALĂ ”TREFÁN LEONÁRD” POIAN",177,"Alegeri Prezidentiale",1,1005,138,124,14,0,129,9,1100,962,92,37
15,COVASNA,POIAN,64719,BELANI,"ŞCOALA PRIMARĂ ”TUZSON JÁNOS” BELANI",178,"Alegeri Prezidentiale",1,385,82,73,9,0,73,9,500,418,62,11
15,COVASNA,RECI,64773,RECI,"CĂMINUL CULTURAL RECI",179,"Alegeri Prezidentiale",1,1178,194,153,35,6,161,33,1300,1106,133,28
15,COVASNA,RECI,64773,ANINOASA,"ŞCOALA PRIMARĂ-ANINOASA",180,"Alegeri Prezidentiale",1,339,81,66,15,0,74,7,400,319,43,31
15,COVASNA,RECI,64773,BITA,"ŞCOALA PRIMARĂ BITA",181,"Alegeri Prezidentiale",1,231,55,38,17,0,55,0,300,245,46,9
15,COVASNA,RECI,64773,SACIOVA,"CĂMINUL CULTURAL SACIOVA",182,"Alegeri Prezidentiale",1,108,44,21,23,0,41,3,200,156,34,7
15,COVASNA,SÂNZIENI,64826,SÂNZIENI,"BIROUL IFOTURISM",183,"Alegeri Prezidentiale",1,1219,181,168,13,0,173,8,1300,1119,121,52
15,COVASNA,SÂNZIENI,64826,SÂNZIENI,"CLUBUL CĂMINULUI CULTURAL SÂNZIENI",184,"Alegeri Prezidentiale",1,988,125,119,6,0,114,11,1100,975,87,27
15,COVASNA,SÂNZIENI,64826,"CAŞINU MIC","CĂMINUL CULTURAL CASINU MIC",185,"Alegeri Prezidentiale",1,224,41,33,8,0,40,1,300,259,27,13
15,COVASNA,SÂNZIENI,64826,PETRICENI,"CĂMINUL CULTURAL PETRICENI",186,"Alegeri Prezidentiale",1,736,81,71,10,0,80,1,800,719,48,32
15,COVASNA,SÂNZIENI,64826,"VALEA SEACĂ","GRĂDINIȚA DE COPII (PARTER)",187,"Alegeri Prezidentiale",1,504,100,85,15,0,86,14,600,500,50,36
15,COVASNA,"SITA BUZĂULUI",63688,"SITA BUZĂULUI","PRIMĂRIA SITA BUZĂULUI",188,"Alegeri Prezidentiale",1,1226,646,589,56,1,632,14,1300,654,437,195
15,COVASNA,"SITA BUZĂULUI",63688,"SITA BUZĂULUI","ŞCOALA GIMNAZIALĂ NR.2 SITA BUZĂULUI",189,"Alegeri Prezidentiale",1,822,363,338,25,0,362,1,900,537,279,83
15,COVASNA,"SITA BUZĂULUI",63688,"SITA BUZĂULUI","ŞCOALA GIMNAZIALĂ NR.3 SITA BUZĂULUI",190,"Alegeri Prezidentiale",1,867,393,364,29,0,390,3,900,507,290,100
15,COVASNA,"SITA BUZĂULUI",63688,ZĂBRĂTĂU,"ŞCOALA GIMNAZIALĂ ZĂBRĂTĂU",191,"Alegeri Prezidentiale",1,432,233,187,46,0,226,7,500,267,184,42
15,COVASNA,"SITA BUZĂULUI",63688,CRASNA,"GRĂDINIȚA CU PROGRAM NORMAL CRASNA",192,"Alegeri Prezidentiale",1,463,225,203,22,0,223,2,500,275,178,45
15,COVASNA,TURIA,64871,TURIA,"CĂMINUL CULTURAL TURIA",193,"Alegeri Prezidentiale",1,1003,125,110,15,0,123,2,1100,975,67,56
15,COVASNA,TURIA,64871,TURIA,"ŞCOALA PRIMARĂ ”JÓKAI MÓR” TURIA",194,"Alegeri Prezidentiale",1,677,91,75,16,0,88,3,800,709,54,34
15,COVASNA,TURIA,64871,TURIA,"ŞCOALA PRIMARĂ NR.3 TURIA",195,"Alegeri Prezidentiale",1,1211,177,149,28,0,160,17,1300,1123,92,68
15,COVASNA,TURIA,64871,ALUNGENI,"ŞCOALA PRIMARĂ ”REMÉNYIK SÁNDOR” ALUNGENI",196,"Alegeri Prezidentiale",1,242,58,49,9,0,50,8,300,242,35,15
15,COVASNA,"VALEA CRIŞULUI",64906,"VALEA CRIŞULUI","PRIMĂRIA COMUNEI VALEA CRIŞULUI",197,"Alegeri Prezidentiale",1,1420,143,117,26,0,126,17,1499,1356,106,20
15,COVASNA,"VALEA CRIŞULUI",64906,CALNIC,"ŞCOALA PRIMARĂ ”DR. BEDŐ ALBERT” CALNIC",198,"Alegeri Prezidentiale",1,424,81,71,10,0,79,2,500,419,63,16
15,COVASNA,"VALEA MARE",65099,"VALEA MARE","CLĂDIREA CĂMINULUI CULTURAL VALEA MARE",199,"Alegeri Prezidentiale",1,932,368,345,23,0,366,2,1000,632,238,128
15,COVASNA,VÂLCELE,64942,ARACI,"SEDIUL PRIMĂRIEI ÎN SATUL ARACI-CORPUL A",200,"Alegeri Prezidentiale",1,921,233,199,34,0,231,2,1000,767,169,62
15,COVASNA,VÂLCELE,64942,ARACI,"SEDIUL PRIMĂRIEI ÎN SATUL ARACI-CORPUL B",201,"Alegeri Prezidentiale",1,600,161,143,18,0,159,2,700,539,106,53
15,COVASNA,VÂLCELE,64942,ARIUŞD,"ŞCOALA PRIMARĂ ARIUŞD",202,"Alegeri Prezidentiale",1,365,203,148,55,0,199,4,400,197,154,45
15,COVASNA,VÂLCELE,64942,HETEA,"ŞCOALA PRIMARĂ HETEA",203,"Alegeri Prezidentiale",1,257,93,81,12,0,92,1,297,204,57,35
15,COVASNA,VÂLCELE,64942,VÂLCELE,"ŞCOALA GIMNAZIALĂ VÂLCELE",204,"Alegeri Prezidentiale",1,1022,397,333,59,5,388,9,1200,803,254,134
15,COVASNA,VÂRGHIŞ,64997,VÂRGHIŞ,"CĂMINUL CULTURAL VÎRGHIŞ",205,"Alegeri Prezidentiale",1,1497,210,202,7,1,196,14,1600,1390,110,86
15,COVASNA,ZAGON,65011,ZAGON,"CĂMINUL CULTURAL NR.1 ZAGON",206,"Alegeri Prezidentiale",1,1643,336,312,24,0,312,24,1700,1364,241,71
15,COVASNA,ZAGON,65011,ZAGON,"ŞCOALA PRIMARĂ ”GEORGE COŞBUC” ZAGON",207,"Alegeri Prezidentiale",1,1540,499,469,30,0,491,8,1600,1101,357,134
15,COVASNA,ZAGON,65011,PĂPĂUŢI,"CĂMINUL CULTURAL PĂPĂUŢI",208,"Alegeri Prezidentiale",1,1033,329,298,31,0,323,6,1100,771,264,59
15,COVASNA,ZĂBALA,65048,ZĂBALA,"CĂMINUL CULTURAL ZĂBALA",209,"Alegeri Prezidentiale",1,1273,160,134,26,0,151,9,1300,1140,113,38
15,COVASNA,ZĂBALA,65048,ZĂBALA,"CLUBUL NR. 2 ZĂBALA",210,"Alegeri Prezidentiale",1,827,210,180,30,0,199,11,900,690,126,73
15,COVASNA,ZĂBALA,65048,ZĂBALA,"CĂMINUL CULTURAL ZĂBALA (PAVA)",211,"Alegeri Prezidentiale",1,688,84,66,18,0,75,9,800,716,54,21
15,COVASNA,ZĂBALA,65048,TAMAŞFALĂU,"CĂMINUL CULTURAL TAMAŞFALĂU",212,"Alegeri Prezidentiale",1,416,76,60,16,0,64,12,500,424,57,7
15,COVASNA,ZĂBALA,65048,SURCEA,"CĂMINUL CULTURAL SURCEA",213,"Alegeri Prezidentiale",1,497,77,67,10,0,72,5,600,523,61,11
15,COVASNA,ZĂBALA,65048,PETENI,"CĂMINUL CULTURAL PETENI",214,"Alegeri Prezidentiale",1,125,41,31,10,0,36,5,200,159,17,19
16,DÂMBOVIŢA,"MUNICIPIUL TÂRGOVIŞTE",65342,TÂRGOVIŞTE,"CASA CORPULUI DIDACTIC",1,"Alegeri Prezidentiale",1,1497,798,711,87,0,778,20,1627,829,501,277
16,DÂMBOVIŢA,"MUNICIPIUL TÂRGOVIŞTE",65342,TÂRGOVIŞTE,"CASA CORPULUI DIDACTIC",2,"Alegeri Prezidentiale",1,1552,868,803,65,0,850,18,1690,822,520,330
16,DÂMBOVIŢA,"MUNICIPIUL TÂRGOVIŞTE",65342,TÂRGOVIŞTE,"GRĂDINIȚA NR. 2",3,"Alegeri Prezidentiale",1,1500,684,659,24,1,675,9,1622,938,394,281
16,DÂMBOVIŢA,"MUNICIPIUL TÂRGOVIŞTE",65342,TÂRGOVIŞTE,"ȘCOALA ”RADU CEL MARE”",4,"Alegeri Prezidentiale",1,1177,566,475,91,0,553,13,1270,704,335,218
16,DÂMBOVIŢA,"MUNICIPIUL TÂRGOVIŞTE",65342,TÂRGOVIŞTE,"ȘCOALA ”RADU CEL MARE”",5,"Alegeri Prezidentiale",1,1275,595,547,48,0,574,21,1380,785,336,238
16,DÂMBOVIŢA,"MUNICIPIUL TÂRGOVIŞTE",65342,TÂRGOVIŞTE,"ȘCOALA ”RADU CEL MARE”",6,"Alegeri Prezidentiale",1,1295,573,521,52,0,563,10,1410,837,328,235
16,DÂMBOVIŢA,"MUNICIPIUL TÂRGOVIŞTE",65342,TÂRGOVIŞTE,"ȘCOALA ”RADU CEL MARE”",7,"Alegeri Prezidentiale",1,1364,702,654,47,1,686,16,1480,778,409,277
16,DÂMBOVIŢA,"MUNICIPIUL TÂRGOVIŞTE",65342,TÂRGOVIŞTE,"LICEUL TEHNOLOGIC ”SPIRU HARET”",8,"Alegeri Prezidentiale",1,1150,521,485,36,0,510,11,1250,729,306,204
16,DÂMBOVIŢA,"MUNICIPIUL TÂRGOVIŞTE",65342,TÂRGOVIŞTE,"LICEUL TEHNOLOGIC ”SPIRU HARET”",9,"Alegeri Prezidentiale",1,976,472,455,17,0,456,16,1050,578,268,188
16,DÂMBOVIŢA,"MUNICIPIUL TÂRGOVIŞTE",65342,TÂRGOVIŞTE,"LICEUL TEHNOLOGIC ”SPIRU HARET”",10,"Alegeri Prezidentiale",1,1271,630,603,27,0,620,10,1380,750,438,182
16,DÂMBOVIŢA,"MUNICIPIUL TÂRGOVIŞTE",65342,TÂRGOVIŞTE,"LICEUL DE ARTE ”BĂLAȘA DOAMNA”",11,"Alegeri Prezidentiale",1,1083,544,478,66,0,531,13,1170,626,324,207
16,DÂMBOVIŢA,"MUNICIPIUL TÂRGOVIŞTE",65342,TÂRGOVIŞTE,"LICEUL TEORETIC ”PETRU CERCEL”",12,"Alegeri Prezidentiale",1,1751,869,790,79,0,849,20,1900,1031,547,302
16,DÂMBOVIŢA,"MUNICIPIUL TÂRGOVIŞTE",65342,TÂRGOVIŞTE,"COLEGIUL NAȚIONAL ”CONSTANTIN CARABELLA”",13,"Alegeri Prezidentiale",1,1130,620,565,55,0,605,15,1220,600,367,238
16,DÂMBOVIŢA,"MUNICIPIUL TÂRGOVIŞTE",65342,TÂRGOVIŞTE,"CLUBUL SPORTIV ȘCOLAR",14,"Alegeri Prezidentiale",1,892,471,434,37,0,464,7,960,489,288,176
16,DÂMBOVIŢA,"MUNICIPIUL TÂRGOVIŞTE",65342,TÂRGOVIŞTE,"CLUBUL SPORTIV ȘCOLAR",15,"Alegeri Prezidentiale",1,863,450,389,61,0,442,8,930,480,280,162
16,DÂMBOVIŢA,"MUNICIPIUL TÂRGOVIŞTE",65342,TÂRGOVIŞTE,"CLUBUL SPORTIV ȘCOLAR",16,"Alegeri Prezidentiale",1,1413,669,622,46,1,649,20,1540,871,391,258
16,DÂMBOVIŢA,"MUNICIPIUL TÂRGOVIŞTE",65342,TÂRGOVIŞTE,"ȘCOALA ”TUDOR VLADIMIRESCU”",17,"Alegeri Prezidentiale",1,1421,609,559,50,0,595,14,1540,931,388,207
16,DÂMBOVIŢA,"MUNICIPIUL TÂRGOVIŞTE",65342,TÂRGOVIŞTE,"ȘCOALA ”TUDOR VLADIMIRESCU”",18,"Alegeri Prezidentiale",1,1190,630,574,56,0,622,8,1290,660,381,241
16,DÂMBOVIŢA,"MUNICIPIUL TÂRGOVIŞTE",65342,TÂRGOVIŞTE,"LICEUL TEHNOLOGIC ”CONSTANTIN BRÂNCOVEANU”",19,"Alegeri Prezidentiale",1,814,453,349,104,0,440,13,870,417,270,170
16,DÂMBOVIŢA,"MUNICIPIUL TÂRGOVIŞTE",65342,TÂRGOVIŞTE,"LICEUL TEHNOLOGIC ”CONSTANTIN BRÂNCOVEANU”",20,"Alegeri Prezidentiale",1,886,340,300,40,0,333,7,950,610,212,121
16,DÂMBOVIŢA,"MUNICIPIUL TÂRGOVIŞTE",65342,TÂRGOVIŞTE,"LICEUL TEHNOLOGIC ”CONSTANTIN BRÂNCOVEANU”",21,"Alegeri Prezidentiale",1,1430,625,592,33,0,610,15,1560,935,356,254
16,DÂMBOVIŢA,"MUNICIPIUL TÂRGOVIŞTE",65342,TÂRGOVIŞTE,"LICEUL TEHNOLOGIC ”CONSTANTIN BRÂNCOVEANU”",22,"Alegeri Prezidentiale",1,802,320,301,19,0,311,9,860,540,196,115
16,DÂMBOVIŢA,"MUNICIPIUL TÂRGOVIŞTE",65342,TÂRGOVIŞTE,"LICEUL TEHNOLOGIC ”CONSTANTIN BRÂNCOVEANU”",23,"Alegeri Prezidentiale",1,721,272,251,21,0,261,11,770,498,167,94
16,DÂMBOVIŢA,"MUNICIPIUL TÂRGOVIŞTE",65342,TÂRGOVIŞTE,"CANTINA DE AJUTOR SOCIAL",24,"Alegeri Prezidentiale",1,1003,634,431,43,160,624,10,1400,766,319,305
16,DÂMBOVIŢA,"MUNICIPIUL TÂRGOVIŞTE",65342,TÂRGOVIŞTE,"ȘCOALA ”PAUL BANICĂ”",25,"Alegeri Prezidentiale",1,1126,514,476,38,0,509,5,1220,706,310,199
16,DÂMBOVIŢA,"MUNICIPIUL TÂRGOVIŞTE",65342,TÂRGOVIŞTE,"ȘCOALA ”PAUL BANICĂ”",26,"Alegeri Prezidentiale",1,1054,480,416,64,0,473,7,1140,660,312,161
16,DÂMBOVIŢA,"MUNICIPIUL TÂRGOVIŞTE",65342,TÂRGOVIŞTE,"LICEUL TEORETIC ”ION HELIADE RĂDULESCU”",27,"Alegeri Prezidentiale",1,910,513,448,65,0,500,13,980,467,301,199
16,DÂMBOVIŢA,"MUNICIPIUL TÂRGOVIŞTE",65342,TÂRGOVIŞTE,"LICEUL TEORETIC ”ION HELIADE RĂDULESCU”",28,"Alegeri Prezidentiale",1,1123,599,536,63,0,583,16,1210,611,342,241
16,DÂMBOVIŢA,"MUNICIPIUL TÂRGOVIŞTE",65342,TÂRGOVIŞTE,"BIROURI PRIMĂRIE - SERVICIUL TAXE ȘI IMPOZITE, BLOC E4",29,"Alegeri Prezidentiale",1,832,480,428,51,1,469,11,890,410,296,173
16,DÂMBOVIŢA,"MUNICIPIUL TÂRGOVIŞTE",65342,TÂRGOVIŞTE,"BIROURI PRIMĂRIE - SERVICIUL TAXE ȘI IMPOZITE (PUNCT TERMIC)",30,"Alegeri Prezidentiale",1,851,504,436,68,0,492,12,920,416,313,179
16,DÂMBOVIŢA,"MUNICIPIUL TÂRGOVIŞTE",65342,TÂRGOVIŞTE,"BIROURI PRIMĂRIE - CORP B (SALA CĂSĂTORII)",31,"Alegeri Prezidentiale",1,1079,657,559,97,1,644,13,1160,503,465,179
16,DÂMBOVIŢA,"MUNICIPIUL TÂRGOVIŞTE",65342,TÂRGOVIŞTE,"COLEGIUL ECONOMIC ”ION GHICA”",32,"Alegeri Prezidentiale",1,1002,608,541,67,0,594,14,1080,472,360,234
16,DÂMBOVIŢA,"MUNICIPIUL TÂRGOVIŞTE",65342,TÂRGOVIŞTE,"COLEGIUL ECONOMIC ”ION GHICA”",33,"Alegeri Prezidentiale",1,1191,683,606,77,0,675,8,1290,607,412,263
16,DÂMBOVIŢA,"MUNICIPIUL TÂRGOVIŞTE",65342,TÂRGOVIŞTE,"COLEGIUL NAȚIONAL ”IENĂCHIȚĂ VĂCĂRESCU”",34,"Alegeri Prezidentiale",1,1540,847,750,95,2,828,19,1680,833,558,270
16,DÂMBOVIŢA,"MUNICIPIUL TÂRGOVIŞTE",65342,TÂRGOVIŞTE,"ȘCOALA ”ION ALEXANDRU BRĂTESCU-VOINEȘTI”",35,"Alegeri Prezidentiale",1,1090,611,529,82,0,600,11,1180,569,370,230
16,DÂMBOVIŢA,"MUNICIPIUL TÂRGOVIŞTE",65342,TÂRGOVIŞTE,"ȘCOALA ”ION ALEXANDRU BRĂTESCU-VOINEȘTI”",36,"Alegeri Prezidentiale",1,895,508,448,60,0,493,15,970,462,306,187
16,DÂMBOVIŢA,"MUNICIPIUL TÂRGOVIŞTE",65342,TÂRGOVIŞTE,"ȘCOALA ”ION ALEXANDRU BRĂTESCU-VOINEȘTI”",37,"Alegeri Prezidentiale",1,885,302,276,26,0,292,10,950,648,177,115
16,DÂMBOVIŢA,"MUNICIPIUL TÂRGOVIŞTE",65342,TÂRGOVIŞTE,"LICEUL ”VOIEVOUL MIRCEA”",38,"Alegeri Prezidentiale",1,1530,785,631,94,60,761,24,1660,875,457,304
16,DÂMBOVIŢA,"MUNICIPIUL TÂRGOVIŞTE",65342,TÂRGOVIŞTE,"ȘCOALA ”CORESI”",39,"Alegeri Prezidentiale",1,1168,665,558,97,10,650,15,1280,615,410,240
16,DÂMBOVIŢA,"MUNICIPIUL TÂRGOVIŞTE",65342,TÂRGOVIŞTE,"LICEUL TEHNOLOGIC DE TRANSPORTURI AUTO",40,"Alegeri Prezidentiale",1,1521,738,659,79,0,714,24,1660,922,482,232
16,DÂMBOVIŢA,"MUNICIPIUL TÂRGOVIŞTE",65342,TÂRGOVIŞTE,"LICEUL TEHNOLOGIC DE TRANSPORTURI AUTO",41,"Alegeri Prezidentiale",1,1783,546,481,65,0,532,14,1940,1394,332,200
16,DÂMBOVIŢA,"MUNICIPIUL TÂRGOVIŞTE",65342,TÂRGOVIŞTE,"LICEUL TEHNOLOGIC DE TRANSPORTURI AUTO",42,"Alegeri Prezidentiale",1,1332,636,609,27,0,617,19,1450,814,377,240
16,DÂMBOVIŢA,"MUNICIPIUL TÂRGOVIŞTE",65342,TÂRGOVIŞTE,"LICEUL TEHNOLOGIC DE TRANSPORTURI AUTO",43,"Alegeri Prezidentiale",1,1380,642,624,18,0,626,16,1510,868,408,218
16,DÂMBOVIŢA,"MUNICIPIUL TÂRGOVIŞTE",65342,TÂRGOVIŞTE,"LICEUL TEHNOLOGIC DE TRANSPORTURI AUTO",44,"Alegeri Prezidentiale",1,1304,546,528,18,0,537,9,1430,884,322,215
16,DÂMBOVIŢA,"MUNICIPIUL TÂRGOVIŞTE",65342,TÂRGOVIŞTE,"LICEUL TEHNOLOGIC ”NICOLAE CIORĂNESCU”",45,"Alegeri Prezidentiale",1,1313,505,489,16,0,492,13,1430,925,309,183
16,DÂMBOVIŢA,"MUNICIPIUL TÂRGOVIŞTE",65342,TÂRGOVIŞTE,"LICEUL TEHNOLOGIC ”NICOLAE CIORĂNESCU”",46,"Alegeri Prezidentiale",1,1176,629,599,30,0,614,15,1280,651,356,258
16,DÂMBOVIŢA,"MUNICIPIUL TÂRGOVIŞTE",65342,TÂRGOVIŞTE,"LICEUL TEHNOLOGIC ”NICOLAE CIORĂNESCU”",47,"Alegeri Prezidentiale",1,814,385,346,39,0,376,9,890,505,226,150
16,DÂMBOVIŢA,"MUNICIPIUL TÂRGOVIŞTE",65342,TÂRGOVIŞTE,"LICEUL TEHNOLOGIC ”NICOLAE CIORĂNESCU”",48,"Alegeri Prezidentiale",1,800,392,342,50,0,384,8,870,478,236,148
16,DÂMBOVIŢA,"MUNICIPIUL TÂRGOVIŞTE",65342,TÂRGOVIŞTE,"LICEUL TEHNOLOGIC ”NICOLAE CIORĂNESCU”",49,"Alegeri Prezidentiale",1,1349,497,462,33,2,491,6,1470,973,267,224
16,DÂMBOVIŢA,"MUNICIPIUL TÂRGOVIŞTE",65342,TÂRGOVIŞTE,"LICEUL TEHNOLOGIC ”NICOLAE CIORĂNESCU”",50,"Alegeri Prezidentiale",1,1188,538,476,60,2,523,15,1300,762,330,193
16,DÂMBOVIŢA,"MUNICIPIUL TÂRGOVIŞTE",65342,TÂRGOVIŞTE,"COLEGIUL NAȚIONAL ”CONSTANTIN CANTACUZINO”",51,"Alegeri Prezidentiale",1,1304,567,479,88,0,562,5,1430,863,339,223
16,DÂMBOVIŢA,"MUNICIPIUL TÂRGOVIŞTE",65342,TÂRGOVIŞTE,"COLEGIUL NAȚIONAL ”CONSTANTIN CANTACUZINO”",52,"Alegeri Prezidentiale",1,1450,707,649,57,1,693,14,1580,873,423,270
16,DÂMBOVIŢA,"MUNICIPIUL TÂRGOVIŞTE",65342,TÂRGOVIŞTE,"COLEGIUL NAȚIONAL ”CONSTANTIN CANTACUZINO”",53,"Alegeri Prezidentiale",1,710,341,312,29,0,332,9,770,429,195,137
16,DÂMBOVIŢA,"MUNICIPIUL TÂRGOVIŞTE",65342,TÂRGOVIŞTE,"COLEGIUL NAȚIONAL ”CONSTANTIN CANTACUZINO”",54,"Alegeri Prezidentiale",1,825,391,364,27,0,383,8,900,509,231,152
16,DÂMBOVIŢA,"MUNICIPIUL TÂRGOVIŞTE",65342,TÂRGOVIŞTE,"ȘCOALA ”GRIGORE ALEXANDRESCU”",55,"Alegeri Prezidentiale",1,1381,587,528,59,0,581,6,1520,933,361,220
16,DÂMBOVIŢA,"MUNICIPIUL TÂRGOVIŞTE",65342,TÂRGOVIŞTE,"ȘCOALA ”GRIGORE ALEXANDRESCU”",56,"Alegeri Prezidentiale",1,1292,563,524,38,1,550,13,1410,847,326,224
16,DÂMBOVIŢA,"MUNICIPIUL TÂRGOVIŞTE",65342,TÂRGOVIŞTE,"ȘCOALA ”GRIGORE ALEXANDRESCU”",57,"Alegeri Prezidentiale",1,794,346,330,16,0,343,3,860,514,207,136
16,DÂMBOVIŢA,"MUNICIPIUL TÂRGOVIŞTE",65342,TÂRGOVIŞTE,"ȘCOALA ”GRIGORE ALEXANDRESCU”",58,"Alegeri Prezidentiale",1,750,322,312,10,0,315,7,820,498,191,124
16,DÂMBOVIŢA,"MUNICIPIUL TÂRGOVIŞTE",65342,TÂRGOVIŞTE,"ȘCOALA ”SMARANDA GHEORGHIU”",59,"Alegeri Prezidentiale",1,1541,800,728,72,0,773,27,1680,880,505,268
16,DÂMBOVIŢA,"MUNICIPIUL TÂRGOVIŞTE",65342,TÂRGOVIŞTE,"ȘCOALA ”SMARANDA GHEORGHIU”",60,"Alegeri Prezidentiale",1,1589,775,686,89,0,757,18,1740,965,459,298
16,DÂMBOVIŢA,"MUNICIPIUL TÂRGOVIŞTE",65342,TÂRGOVIŞTE,"ȘCOALA ”SMARANDA GHEORGHIU”",61,"Alegeri Prezidentiale",1,1341,619,584,35,0,601,18,1460,841,389,212
16,DÂMBOVIŢA,"MUNICIPIUL TÂRGOVIŞTE",65342,TÂRGOVIŞTE,"ȘCOALA ”SMARANDA GHEORGHIU”",62,"Alegeri Prezidentiale",1,767,341,308,33,0,337,4,830,489,185,152
16,DÂMBOVIŢA,"MUNICIPIUL TÂRGOVIŞTE",65342,TÂRGOVIŞTE,"ȘCOALA ”SMARANDA GHEORGHIU”",63,"Alegeri Prezidentiale",1,1144,471,449,22,0,456,15,1250,779,219,237
16,DÂMBOVIŢA,"MUNICIPIUL TÂRGOVIŞTE",65342,TÂRGOVIŞTE,"CĂMINUL CULTURAL ”MATEI VOIEVOD”",64,"Alegeri Prezidentiale",1,1465,755,710,45,0,750,5,1600,845,537,213
16,DÂMBOVIŢA,"MUNICIPIUL TÂRGOVIŞTE",65342,TÂRGOVIŞTE,"GRĂDINIȚA ”PRISEACA”",65,"Alegeri Prezidentiale",1,1048,505,490,15,0,493,12,1140,635,306,187
16,DÂMBOVIŢA,"MUNICIPIUL MORENI",65841,MORENI,"ŞCOALA GIMNAZIALĂ NR.2",66,"Alegeri Prezidentiale",1,1087,454,428,26,0,449,5,1190,736,293,156
16,DÂMBOVIŢA,"MUNICIPIUL MORENI",65841,MORENI,"CLUB CRISTIAN ( UZINA AUTOMECANICĂ MORENI )",67,"Alegeri Prezidentiale",1,698,323,299,24,0,316,7,760,437,226,90
16,DÂMBOVIŢA,"MUNICIPIUL MORENI",65841,MORENI,"GRĂDINIŢA CU PROGRAM NORMAL NR.7 ŢUICANI",68,"Alegeri Prezidentiale",1,410,170,160,10,0,167,3,439,269,106,61
16,DÂMBOVIŢA,"MUNICIPIUL MORENI",65841,MORENI,"GRĂDINIŢA CU PROGRAM NORMAL NR.2",69,"Alegeri Prezidentiale",1,730,410,372,38,0,398,12,790,380,239,159
16,DÂMBOVIŢA,"MUNICIPIUL MORENI",65841,MORENI,"CLUB FLACĂRA NR.2",70,"Alegeri Prezidentiale",1,793,403,365,38,0,390,13,860,457,251,139
16,DÂMBOVIŢA,"MUNICIPIUL MORENI",65841,MORENI,"GRĂDINIŢA CU PROGRAM NORMAL TISA",71,"Alegeri Prezidentiale",1,503,307,281,26,0,296,11,540,233,171,125
16,DÂMBOVIŢA,"MUNICIPIUL MORENI",65841,MORENI,"ŞCOALA GIMNAZIALĂ NR.3",72,"Alegeri Prezidentiale",1,1256,628,588,39,1,616,12,1370,742,351,265
16,DÂMBOVIŢA,"MUNICIPIUL MORENI",65841,MORENI,"ŞCOALA GIMNAZIALĂ NR.3",73,"Alegeri Prezidentiale",1,788,375,323,52,0,368,7,860,485,257,111
16,DÂMBOVIŢA,"MUNICIPIUL MORENI",65841,MORENI,"ŞCOALA GIMNAZIALĂ NR.3",74,"Alegeri Prezidentiale",1,735,333,313,20,0,322,11,800,467,198,124
16,DÂMBOVIŢA,"MUNICIPIUL MORENI",65841,MORENI,"ŞCOALA GIMNAZIALĂ NR.3",75,"Alegeri Prezidentiale",1,937,483,449,17,17,477,6,1020,537,310,167
16,DÂMBOVIŢA,"MUNICIPIUL MORENI",65841,MORENI,"ŞCOALA GIMNAZIALĂ NR.3",76,"Alegeri Prezidentiale",1,971,450,438,12,0,442,8,1060,610,281,161
16,DÂMBOVIŢA,"MUNICIPIUL MORENI",65841,MORENI,"ŞCOALA GIMNAZIALĂ NR.4",77,"Alegeri Prezidentiale",1,983,452,427,25,0,438,14,1070,618,285,153
16,DÂMBOVIŢA,"MUNICIPIUL MORENI",65841,MORENI,"ŞCOALA GIMNAZIALĂ NR.4",78,"Alegeri Prezidentiale",1,658,280,264,16,0,274,6,710,430,194,80
16,DÂMBOVIŢA,"MUNICIPIUL MORENI",65841,MORENI,"ŞCOALA GIMNAZIALĂ NR.4",79,"Alegeri Prezidentiale",1,868,410,372,38,0,397,13,940,530,252,145
16,DÂMBOVIŢA,"MUNICIPIUL MORENI",65841,MORENI,"ŞCOALA GIMNAZIALĂ NR.4",80,"Alegeri Prezidentiale",1,909,451,416,35,0,430,21,990,539,282,148
16,DÂMBOVIŢA,"MUNICIPIUL MORENI",65841,MORENI,"ŞCOALA GIMNAZIALĂ NR.4",81,"Alegeri Prezidentiale",1,837,370,353,17,0,362,8,910,540,239,123
16,DÂMBOVIŢA,"MUNICIPIUL MORENI",65841,MORENI,"SALA DE SPORT",82,"Alegeri Prezidentiale",1,736,344,317,27,0,333,11,800,456,189,144
16,DÂMBOVIŢA,"MUNICIPIUL MORENI",65841,MORENI,"SALA DE SPORT",83,"Alegeri Prezidentiale",2,654,301,276,25,0,291,10,710,409,186,105
16,DÂMBOVIŢA,"MUNICIPIUL MORENI",65841,MORENI,"LICEUL TEORETIC ”ION LUCA CARAGIALE”",84,"Alegeri Prezidentiale",1,716,374,320,27,27,369,5,780,406,229,140
16,DÂMBOVIŢA,"MUNICIPIUL MORENI",65841,MORENI,"LICEUL TEHNOLOGIC DE PETROL",85,"Alegeri Prezidentiale",2,1400,601,559,42,0,592,9,1571,970,399,193
16,DÂMBOVIŢA,"ORAŞ FIENI",65609,COSTEŞTI,"GRĂDINIȚA ”PINOCHIO” COSTEȘTI",86,"Alegeri Prezidentiale",1,645,316,291,23,2,311,5,700,384,167,144
16,DÂMBOVIŢA,"ORAŞ FIENI",65609,BEREVOEŞTI,"GRĂDINIȚA ”PITICII” BEREVOIEȘTI",87,"Alegeri Prezidentiale",1,553,288,263,25,0,284,4,600,312,146,138
16,DÂMBOVIŢA,"ORAŞ FIENI",65609,FIENI,"ȘCOALA GENERALĂ ”DIACONU CORESI” FIENI",88,"Alegeri Prezidentiale",1,1566,798,719,78,1,788,10,1710,912,532,256
16,DÂMBOVIŢA,"ORAŞ FIENI",65609,FIENI,"GRUP ŞCOLAR INDUSTRIAL ”INGINER AUREL RAINU” FIENI",89,"Alegeri Prezidentiale",1,1482,607,569,30,8,591,16,1620,1013,362,229
16,DÂMBOVIŢA,"ORAŞ FIENI",65609,FIENI,"GRUP ȘCOLAR INDUSTRIAL ”INGINER AUREL RAINU” FIENI",90,"Alegeri Prezidentiale",1,1519,740,680,59,1,724,16,1670,930,510,214
16,DÂMBOVIŢA,"ORAŞ FIENI",65609,FIENI,"GRĂDINIŢA ”DUMBRAVA MINUNATĂ” FIENI",91,"Alegeri Prezidentiale",1,601,244,224,20,0,238,6,650,406,141,97
16,DÂMBOVIŢA,"ORAŞ GĂEŞTI",65681,GĂEŞTI,"ȘCOALA GIMNAZIALĂ NR.1",92,"Alegeri Prezidentiale",1,912,534,473,60,1,526,8,1010,476,265,261
16,DÂMBOVIŢA,"ORAŞ GĂEŞTI",65681,GĂEŞTI,"ȘCOALA GIMNAZIALĂ NR.1",93,"Alegeri Prezidentiale",1,880,685,441,26,218,672,13,1270,585,231,441
16,DÂMBOVIŢA,"ORAŞ GĂEŞTI",65681,GĂEŞTI,"LICEUL TEHNOLOGIC ” DOCTOR CONSTANTIN ANGELESCU”",94,"Alegeri Prezidentiale",1,1235,679,618,60,1,665,14,1360,681,334,331
16,DÂMBOVIŢA,"ORAŞ GĂEŞTI",65681,GĂEŞTI,"COLEGIUL NAȚIONAL ” VLADIMIR STREINU”",95,"Alegeri Prezidentiale",1,1471,834,746,88,0,821,13,1620,786,450,371
16,DÂMBOVIŢA,"ORAŞ GĂEŞTI",65681,GĂEŞTI,"ȘCOALA GIMNAZIALĂ ”ȘERBAN CIOCULESCU”",96,"Alegeri Prezidentiale",1,1333,658,602,56,0,645,13,1470,812,367,278
16,DÂMBOVIŢA,"ORAŞ GĂEŞTI",65681,GĂEŞTI,"ȘCOALA GIMNAZIALĂ ”ȘERBAN CIOCULESCU”",97,"Alegeri Prezidentiale",1,846,412,360,51,1,407,5,930,518,236,171
16,DÂMBOVIŢA,"ORAŞ GĂEŞTI",65681,GĂEŞTI,"ȘCOALA GIMNAZIALĂ ”ȘERBAN CIOCULESCU”",98,"Alegeri Prezidentiale",1,1220,565,536,29,0,548,17,1350,785,301,247
16,DÂMBOVIŢA,"ORAŞ GĂEŞTI",65681,GĂEŞTI,"ȘCOALA GIMNAZIALĂ ”ȘERBAN CIOCULESCU”",99,"Alegeri Prezidentiale",1,1335,636,612,23,1,623,13,1470,834,327,296
16,DÂMBOVIŢA,"ORAŞ GĂEŞTI",65681,GĂEŞTI,"ȘCOALA GIMNAZIALĂ ”RADU CEL MARE”",100,"Alegeri Prezidentiale",1,668,427,328,98,1,419,8,740,313,233,186
16,DÂMBOVIŢA,"ORAŞ GĂEŞTI",65681,GĂEŞTI,"ȘCOALA GIMNAZIALĂ ”RADU CEL MARE”",101,"Alegeri Prezidentiale",1,1148,612,552,60,0,591,21,1260,648,352,239
16,DÂMBOVIŢA,"ORAŞ GĂEŞTI",65681,GĂEŞTI,"ȘCOALA GIMNAZIALĂ ”RADU CEL MARE”",102,"Alegeri Prezidentiale",1,1579,883,784,58,41,873,10,1740,857,480,393
16,DÂMBOVIŢA,"ORAŞ PUCIOASA",65921,PUCIOASA,"ȘCOALA GENERALĂ NR.2 PUCIOASA",103,"Alegeri Prezidentiale",1,1274,652,613,39,0,640,12,1400,748,452,188
16,DÂMBOVIŢA,"ORAŞ PUCIOASA",65921,DIACONEŞTI,"GRĂDINIȚA DIACONEȘTI NR.9",104,"Alegeri Prezidentiale",1,840,425,391,34,0,421,4,930,505,284,137
16,DÂMBOVIŢA,"ORAŞ PUCIOASA",65921,PUCIOASA,"ȘCOALA GIMNAZIALĂ ”MIHAI VITEAZUL” PUCIOASA",105,"Alegeri Prezidentiale",1,1024,660,481,179,0,646,14,1130,470,399,247
16,DÂMBOVIŢA,"ORAŞ PUCIOASA",65921,PUCIOASA,"ȘCOALA GIMNAZIALĂ ”MIHAI VITEAZUL” PUCIOASA",106,"Alegeri Prezidentiale",1,1167,641,480,161,0,631,10,1280,639,422,209
16,DÂMBOVIŢA,"ORAŞ PUCIOASA",65921,PUCIOASA,"GRĂDINIȚA NR. 1 PUCIOASA",107,"Alegeri Prezidentiale",1,865,487,403,84,0,477,10,950,463,292,185
16,DÂMBOVIŢA,"ORAŞ PUCIOASA",65921,PUCIOASA,"ȘCOALA GIMNAZIALĂ ”DONICI ELENA CANTACUZINO” PUCIOASA",108,"Alegeri Prezidentiale",1,1302,719,554,65,100,705,14,1430,711,450,255
16,DÂMBOVIŢA,"ORAŞ PUCIOASA",65921,PUCIOASA,"COLEGIUL NAȚIONAL ”NICOLAE TITULESCU” PUCIOASA",109,"Alegeri Prezidentiale",1,1146,572,524,48,0,562,10,1260,688,370,192
16,DÂMBOVIŢA,"ORAŞ PUCIOASA",65921,PUCIOASA,"GRĂDINIȚA NR.2 PUCIOASA",110,"Alegeri Prezidentiale",1,1124,560,516,39,5,550,10,1230,670,364,186
16,DÂMBOVIŢA,"ORAŞ PUCIOASA",65921,PUCIOASA,"GRĂDINIȚA NR. 3 PUCIOASA",111,"Alegeri Prezidentiale",1,1131,533,484,49,0,525,8,1250,717,344,181
16,DÂMBOVIŢA,"ORAŞ PUCIOASA",65921,PUCIOASA,"ȘCOALA GIMNAZIALĂ NR. 3 PUCIOASA",112,"Alegeri Prezidentiale",1,1237,550,508,42,0,541,9,1360,810,358,183
16,DÂMBOVIŢA,"ORAŞ PUCIOASA",65921,GLODENI,"ȘCOALA GIMNAZIALĂ NR. 5 GLODENI",113,"Alegeri Prezidentiale",1,1036,489,466,23,0,480,9,1140,651,342,138
16,DÂMBOVIŢA,"ORAŞ PUCIOASA",65921,MALURILE,"ȘCOALA GIMNAZIALĂ MALURI",114,"Alegeri Prezidentiale",1,100,64,47,17,0,64,0,110,46,31,33
16,DÂMBOVIŢA,"ORAŞ PUCIOASA",65921,PUCIOASA-SAT,"ȘCOALA GIMNAZIALĂ PUCIOASA-SAT",115,"Alegeri Prezidentiale",1,355,194,184,10,0,192,2,390,196,126,66
16,DÂMBOVIŢA,"ORAŞ RĂCARI",68627,RĂCARI,"LICEUL TEORETIC ”ION GHICA” RĂCARI",116,"Alegeri Prezidentiale",1,848,507,410,77,20,502,5,930,423,303,199
16,DÂMBOVIŢA,"ORAŞ RĂCARI",68627,RĂCARI,"LICEUL TEORETIC” ION GHICA” RACARI",117,"Alegeri Prezidentiale",1,815,613,444,150,19,598,15,900,287,364,234
16,DÂMBOVIŢA,"ORAŞ RĂCARI",68627,GHERGANI,"ȘCOALA GENERALĂ GHERGANI",118,"Alegeri Prezidentiale",1,601,421,267,76,78,416,5,660,239,274,142
16,DÂMBOVIŢA,"ORAŞ RĂCARI",68627,MAVRODIN,"GRĂDINIȚA MAVRODIN",119,"Alegeri Prezidentiale",1,792,437,344,83,10,431,6,870,433,259,172
16,DÂMBOVIŢA,"ORAŞ RĂCARI",68627,GHIMPAŢI,"CĂMINUL CULTURAL GHIMPAȚI",120,"Alegeri Prezidentiale",1,640,474,355,106,13,466,8,700,226,303,163
16,DÂMBOVIŢA,"ORAŞ RĂCARI",68627,COLACU,"ȘCOALA GENERALĂ COLACU",121,"Alegeri Prezidentiale",1,691,424,307,78,39,421,3,760,336,232,189
16,DÂMBOVIŢA,"ORAŞ RĂCARI",68627,SĂBIEŞTI,"GRĂDINIȚA SĂBIEȘTI",122,"Alegeri Prezidentiale",1,626,416,292,83,41,411,5,690,274,211,200
16,DÂMBOVIŢA,"ORAŞ TITU",66081,TITU,"ȘCOALA GIMNAZIALA NR. 2 TITU",123,"Alegeri Prezidentiale",1,1251,658,566,92,0,647,11,970,312,336,311
16,DÂMBOVIŢA,"ORAŞ TITU",66081,TITU,"ȘCOALA GIMNAZIALA NR. 2 TITU",124,"Alegeri Prezidentiale",1,1035,546,512,34,0,532,14,1140,594,254,278
16,DÂMBOVIŢA,"ORAŞ TITU",66081,TITU,"ȘCOALA SĂLCUȚA",125,"Alegeri Prezidentiale",2,1110,624,562,62,0,609,15,1220,596,334,275
16,DÂMBOVIŢA,"ORAŞ TITU",66081,TITU,"ȘCOALA GIMNAZIALA PICTOR NICOLAE GRIGORESCU",126,"Alegeri Prezidentiale",1,1312,815,709,106,0,799,16,1450,635,433,366
16,DÂMBOVIŢA,"ORAŞ TITU",66081,TITU,"LICEUL TEORETIC IANCU C.VISARION",127,"Alegeri Prezidentiale",1,1143,592,553,39,0,578,14,1260,668,299,279
16,DÂMBOVIŢA,"ORAŞ TITU",66081,TITU,"LICEUL TEORETIC IANCU .C.VISARION",128,"Alegeri Prezidentiale",1,1271,595,557,38,0,588,7,1400,805,295,293
16,DÂMBOVIŢA,"ORAŞ TITU",66081,TITU,"LICEUL TEORETIC IANCU .C.VISARION",129,"Alegeri Prezidentiale",1,1258,781,710,71,0,756,25,1380,599,441,315
16,DÂMBOVIŢA,ANINOASA,65379,ANINOASA,"ŞCOALA GIMNAZIALĂ ANINOASA",130,"Alegeri Prezidentiale",1,993,605,525,80,0,583,22,1090,485,297,286
16,DÂMBOVIŢA,ANINOASA,65379,ANINOASA,"ŞCOALA GIMNAZIALĂ ANINOASA",131,"Alegeri Prezidentiale",1,984,575,518,57,0,567,8,1080,505,292,275
16,DÂMBOVIŢA,ANINOASA,65379,VIFORÂTA,"ŞCOALA GIMNAZIALĂ ANINOASA",132,"Alegeri Prezidentiale",1,1026,638,546,72,20,627,11,1130,492,323,304
16,DÂMBOVIŢA,ANINOASA,65379,VIFORÂTA,"ŞCOALA GIMNAZIALĂ ANINOASA",133,"Alegeri Prezidentiale",1,987,586,529,57,0,569,17,1080,494,296,273
16,DÂMBOVIŢA,ANINOASA,65379,SĂTENI,"ŞCOALA GIMNAZIALĂ ANINOASA",134,"Alegeri Prezidentiale",1,1286,662,609,53,0,649,13,1420,758,370,279
16,DÂMBOVIŢA,BĂLENI,66198,BĂLENI-ROMÂNI,"ŞCOALA PROFESIONALĂ BĂLENI",135,"Alegeri Prezidentiale",1,1551,772,730,42,0,762,10,1702,930,435,327
16,DÂMBOVIŢA,BĂLENI,66198,BĂLENI-ROMÂNI,"LICEUL TEHNOLOGIC UDREA BĂLEANU",136,"Alegeri Prezidentiale",1,1481,609,581,28,0,600,9,1630,1021,311,289
16,DÂMBOVIŢA,BĂLENI,66198,BĂLENI-SÂRBI,"LICEUL TEHNOLOGIC UDREA BĂLEANU",137,"Alegeri Prezidentiale",1,922,405,379,26,0,396,9,1010,605,233,163
16,DÂMBOVIŢA,BĂLENI,66198,BĂLENI-SÂRBI,"GĂDINIȚA CU PROGRAM NORMAL BĂLENI",138,"Alegeri Prezidentiale",1,1395,653,635,18,0,647,6,1530,877,395,252
16,DÂMBOVIŢA,BĂLENI,66198,BĂLENI-SÂRBI,"GRĂDINIȚA CU PROGRAM NORMAL BĂLENI",139,"Alegeri Prezidentiale",1,1403,680,666,14,0,673,7,1540,860,357,316
16,DÂMBOVIŢA,BĂRBULEŢU,66223,"GURA BĂRBULEŢULUI","ŞCOALA GIMNAZIALĂ CU CLASELE I-VIII GURA BĂRBULEȚULUI",140,"Alegeri Prezidentiale",1,464,367,250,117,0,363,4,510,143,171,192
16,DÂMBOVIŢA,BĂRBULEŢU,66223,BĂRBULEŢU,"AFTER SCHOOL BĂRBULEŢU",141,"Alegeri Prezidentiale",1,1336,640,585,55,0,632,8,1470,830,357,275
16,DÂMBOVIŢA,BEZDEAD,66330,BEZDEAD,"ŞCOALA GIMNAZIALĂ ”GRIGORE RĂDULESCU” BEZDEAD",142,"Alegeri Prezidentiale",1,1514,799,705,91,3,785,14,1670,871,542,243
16,DÂMBOVIŢA,BEZDEAD,66330,BEZDEAD,"ŞCOALA GIMNAZIALĂ ”VASILE VOICULESCU” BEZDEAD",143,"Alegeri Prezidentiale",1,1366,590,548,38,4,584,6,1510,920,405,179
16,DÂMBOVIŢA,BEZDEAD,66330,MĂGURA,"GRĂDINIŢA MĂGURA",144,"Alegeri Prezidentiale",1,839,417,364,47,6,411,6,920,503,285,126
16,DÂMBOVIŢA,BILCIUREŞTI,66401,BILCIUREŞTI,"CĂMINUL CULTURAL",145,"Alegeri Prezidentiale",1,1472,958,771,177,10,936,22,1620,662,407,529
16,DÂMBOVIŢA,BRANIŞTEA,66152,BRANIŞTEA,"ŞCOALA ”SPIRU HARET” BRANIŞTEA, CLASELE I-IV, SALA DE CLASA NR. 1",146,"Alegeri Prezidentiale",1,1191,615,554,61,0,599,16,1310,695,244,355
16,DÂMBOVIŢA,BRANIŞTEA,66152,BRANIŞTEA,"ŞCOALA ”SPIRU HARET” BRANIŞTEA, CLASELE I-IV, SALA DE CLASA NR. 2",147,"Alegeri Prezidentiale",1,1103,571,511,60,0,559,12,1220,649,207,352
16,DÂMBOVIŢA,BRANIŞTEA,66152,DÂMBOVICIOARA,"ŞCOALA ”SPIRU HARET” BRANIŞTEA, CLASELE I-IV, SALA DE CLASA NR. 1",148,"Alegeri Prezidentiale",1,876,440,394,46,0,431,9,970,530,157,274
16,DÂMBOVIŢA,BRANIŞTEA,66152,SĂVEŞTI,"CLĂDIREA ADMINISTRATIVĂ A CONSILIULUI LOCAL BRANIŞTEA",149,"Alegeri Prezidentiale",1,135,84,71,13,0,82,2,150,66,18,64
16,DÂMBOVIŢA,BRĂNEŞTI,66009,BRĂNEŞTI,"CENTRUL DE CULTURĂ ŞI TRADIŢIE POPULARĂ BRĂNEŞTI",150,"Alegeri Prezidentiale",1,1279,697,640,56,1,690,7,1410,713,400,290
16,DÂMBOVIŢA,BRĂNEŞTI,66009,BRĂNEŞTI,"ŞCOALA GIMNAZIALĂ BRĂNEŞTI",151,"Alegeri Prezidentiale",1,1452,708,657,51,0,700,8,1600,892,422,278
16,DÂMBOVIŢA,BRĂNEŞTI,66009,BRĂNEŞTI,"GRĂDINIŢA CU PROGRAM NORMAL PRIBOIU",152,"Alegeri Prezidentiale",1,806,434,409,25,0,428,6,890,456,286,142
16,DÂMBOVIŢA,BREZOAELE,101341,BREZOAELE,"ȘCOALA GIMNAZIALĂ BREZOAELE",153,"Alegeri Prezidentiale",1,1095,845,692,152,1,837,8,1210,365,331,506
16,DÂMBOVIŢA,BREZOAELE,101341,BREZOAIA,"ȘCOALA GIMNAZIALĂ BREZOAIA",154,"Alegeri Prezidentiale",1,789,511,434,77,0,500,11,870,359,271,229
16,DÂMBOVIŢA,BREZOAELE,101341,BREZOAIA,"ȘCOALA GIMNAZIALĂ BREZOAIA",155,"Alegeri Prezidentiale",1,985,646,555,87,4,640,6,1080,434,282,358
16,DÂMBOVIŢA,BUCIUMENI,66438,BUCIUMENI,"GRĂDINIṬA CU PROGRAM NORMAL",156,"Alegeri Prezidentiale",1,1496,754,708,46,0,748,6,1650,896,525,223
16,DÂMBOVIŢA,BUCIUMENI,66438,"DEALU MARE","ṢCOALA GENERALĂ",157,"Alegeri Prezidentiale",1,1173,608,581,27,0,602,6,1290,682,381,221
16,DÂMBOVIŢA,BUCIUMENI,66438,"VALEA LEURZII","ṢCOALA PRIMARĂ ṢI GRĂDINIṬA CU PROGRAM NORMAL",158,"Alegeri Prezidentiale",1,1026,453,433,20,0,450,3,1130,677,231,219
16,DÂMBOVIŢA,BUCŞANI,66474,BUCŞANI,"ȘCOALA GIMNAZIALĂ ”DORA DALLES” BUCȘANI",159,"Alegeri Prezidentiale",1,1492,790,721,69,0,782,8,1640,850,431,351
16,DÂMBOVIŢA,BUCŞANI,66474,BUCŞANI,"ȘCOALA GIMNAZIALĂ ”DORA DALLES” BUCȘANI",160,"Alegeri Prezidentiale",1,1478,787,739,48,0,779,8,1630,843,423,356
16,DÂMBOVIŢA,BUCŞANI,66474,HĂBENI,"ȘCOALA GENERALĂ HĂBENI",161,"Alegeri Prezidentiale",1,1111,586,558,28,0,581,5,1220,634,321,260
16,DÂMBOVIŢA,BUCŞANI,66474,RACOVIŢA,"ȘCOALA GENERALĂ RACOVIȚA",162,"Alegeri Prezidentiale",1,1043,558,493,65,0,548,10,1150,592,258,290
16,DÂMBOVIŢA,BUCŞANI,66474,RĂŢOAIA,"ȘCOALA GENERALĂ RĂȚOAIA",163,"Alegeri Prezidentiale",1,387,288,255,33,0,284,4,430,142,160,124
16,DÂMBOVIŢA,BUTIMANU,101564,BUTIMANU,"ȘCOALA GIMNAZIALĂ BUTIMANU",164,"Alegeri Prezidentiale",1,1420,942,765,177,0,925,17,1560,618,672,253
16,DÂMBOVIŢA,BUTIMANU,101564,LUCIANCA,"ȘCOALA GIMNAZIALĂ LUCIANCA",165,"Alegeri Prezidentiale",1,406,318,221,97,0,315,3,450,132,178,137
16,DÂMBOVIŢA,CÂNDEŞTI,66526,CÂNDEŞTI-VALE,"CĂMIN CULTURAL CÎNDEȘTI VALE",166,"Alegeri Prezidentiale",1,993,678,579,97,2,672,6,1090,412,332,340
16,DÂMBOVIŢA,CÂNDEŞTI,66526,DRAGODĂNEŞTI,"CĂMINUL CULTURAL DRAGODĂNEȘTI",167,"Alegeri Prezidentiale",1,640,409,359,44,6,400,9,740,331,176,224
16,DÂMBOVIŢA,CÂNDEŞTI,66526,CÂNDEŞTI-DEAL,"CĂMIN CULTURAL CÎNDEȘTI DEAL",168,"Alegeri Prezidentiale",1,172,150,114,34,2,149,1,190,40,74,75
16,DÂMBOVIŢA,CÂNDEŞTI,66526,"VALEA MARE","ȘCOALA CU CLASELE I-IV VALEA MARE",169,"Alegeri Prezidentiale",1,101,100,73,27,0,97,3,110,10,38,59
16,DÂMBOVIŢA,CÂNDEŞTI,66526,DRAGODĂNEŞTI,"ȘCOALA CU CLASELE I-IV STURZENI",170,"Alegeri Prezidentiale",1,413,279,223,54,2,274,5,420,141,120,154
16,DÂMBOVIŢA,CIOCĂNEŞTI,101840,CIOCĂNEŞTI,"ȘCOALA CU CLASELE I-VIII CIOCĂNEȘTI",171,"Alegeri Prezidentiale",1,746,423,346,77,0,418,5,820,397,257,161
16,DÂMBOVIŢA,CIOCĂNEŞTI,101840,CIOCĂNEŞTI,"ȘCOALA CU CLASELE I - VIII CIOCĂNEȘTI",172,"Alegeri Prezidentiale",1,913,500,394,104,2,491,9,1000,500,294,197
16,DÂMBOVIŢA,CIOCĂNEŞTI,101840,DECINDEA,"GRĂDINIȚA DE COPII",173,"Alegeri Prezidentiale",1,380,249,203,46,0,247,2,420,171,153,94
16,DÂMBOVIŢA,CIOCĂNEŞTI,101840,URZICEANCA,"ȘCOALA CU CLASELE I-VIII URZICEANCA",174,"Alegeri Prezidentiale",1,1156,755,624,131,0,747,8,1270,515,331,416
16,DÂMBOVIŢA,CIOCĂNEŞTI,101840,VIZUREŞTI,"ȘCOALA CU CLASELE I-VIII VIZUREȘTI",175,"Alegeri Prezidentiale",1,848,494,413,81,0,489,5,930,436,188,301
16,DÂMBOVIŢA,COBIA,66580,MĂNĂSTIREA,"ŞCOALA MĂNĂSTIREA",176,"Alegeri Prezidentiale",1,412,243,213,18,12,236,7,450,207,96,140
16,DÂMBOVIŢA,COBIA,66580,GHERGHIŢEŞTI,"ȘCOALA GHERGHIȚEȘTI",177,"Alegeri Prezidentiale",1,915,607,521,65,21,600,7,1010,403,245,355
16,DÂMBOVIŢA,COBIA,66580,MISLEA,"GRĂDINIŢA MISLEA",178,"Alegeri Prezidentiale",1,648,391,332,52,7,387,4,710,319,170,217
16,DÂMBOVIŢA,COBIA,66580,FRASIN-DEAL,"ŞCOALA FRASIN DEAL",179,"Alegeri Prezidentiale",1,559,367,312,47,8,360,7,610,243,133,227
16,DÂMBOVIŢA,COJASCA,66697,COJASCA,"ŞCOALA GIMNAZIALĂ COJASCA",180,"Alegeri Prezidentiale",1,910,596,474,122,0,589,7,1000,404,264,325
16,DÂMBOVIŢA,COJASCA,66697,COJASCA,"ŞCOALA GIMNAZIALĂ COJASCA",181,"Alegeri Prezidentiale",1,656,397,305,92,0,389,8,720,323,191,198
16,DÂMBOVIŢA,COJASCA,66697,IAZU,"ŞCOALA CU CLASELE I-IV IAZU",182,"Alegeri Prezidentiale",1,1364,635,601,34,0,628,7,1500,865,232,396
16,DÂMBOVIŢA,COJASCA,66697,IAZU,"ŞCOALA CU CLASELE I-IV IAZU",183,"Alegeri Prezidentiale",1,754,360,350,10,0,349,11,830,470,115,234
16,DÂMBOVIŢA,COJASCA,66697,FÂNTÂNELE,"ŞCOALA GIMNAZIALĂ FÎNTÎNELE",184,"Alegeri Prezidentiale",1,1013,307,251,56,0,302,5,1120,813,23,279
16,DÂMBOVIŢA,COJASCA,66697,FÂNTÂNELE,"ŞCOALA GIMNAZIALĂ FÎNTÎNELE",185,"Alegeri Prezidentiale",1,908,275,233,42,0,267,8,1000,725,22,245
16,DÂMBOVIŢA,COMIŞANI,66731,LAZURI,"CAMINUL CULTURAL",186,"Alegeri Prezidentiale",1,1528,889,791,98,0,872,17,1680,791,470,402
16,DÂMBOVIŢA,COMIŞANI,66731,COMIŞANI,"CAMINUL CULTURAL COMISANI",187,"Alegeri Prezidentiale",1,1347,723,671,52,0,716,7,1480,757,349,367
16,DÂMBOVIŢA,COMIŞANI,66731,COMIŞANI,"SCOALA GENERALA I-IV COMISANI(STR.HELESTEULUI NR.2)",188,"Alegeri Prezidentiale",1,1449,723,659,64,0,712,11,1600,877,347,365
16,DÂMBOVIŢA,CONŢEŞTI,66768,CONŢEŞTI,"ŞCOALA CU CLASELE I-IV CONŢEŞTI, LOCALITATEA CONŢEŞTI, STRADA PRIMĂRIEI, NR. 444",189,"Alegeri Prezidentiale",1,719,376,286,90,0,372,4,790,414,190,182
16,DÂMBOVIŢA,CONŢEŞTI,66768,CONŢEŞTI,"ŞCOALA CONŢEŞTI, LOCALITATEA CONŢEŞTI, STRADA GĂRII, NR. 192",190,"Alegeri Prezidentiale",1,442,246,171,75,0,243,3,490,244,119,124
16,DÂMBOVIŢA,CONŢEŞTI,66768,BOTENI,"ŞCOALA CU CLASELE I-IV BOTENI, LOCALITATEA BOTENI, STRADA AEROPORTULUI, NR. 308G",191,"Alegeri Prezidentiale",1,713,312,254,58,0,309,3,780,468,140,169
16,DÂMBOVIŢA,CONŢEŞTI,66768,BĂLTENI,"CĂMIN CULTURAL BĂLTENI, LOCALITATEA BĂLTENI, STRADA EROILOR, NR. 66",192,"Alegeri Prezidentiale",1,678,264,239,25,0,256,8,740,476,61,195
16,DÂMBOVIŢA,CONŢEŞTI,66768,BĂLTENI,"GRĂDINIŢA BĂLTENI, LOCALITATEA BĂLTENI, STRADA EROILOR, NR. 235",193,"Alegeri Prezidentiale",1,800,394,313,81,0,391,3,880,486,190,201
16,DÂMBOVIŢA,"CORBII MARI",66857,"CORBII MARI","ŞCOALA GIMNAZIALĂ CORBII MARI",194,"Alegeri Prezidentiale",1,1381,787,644,143,0,777,10,1520,733,278,499
16,DÂMBOVIŢA,"CORBII MARI",66857,"VADU STANCHII","ŞCOALA PRIMARĂ VADU STANCHII",195,"Alegeri Prezidentiale",1,364,238,184,54,0,234,4,400,162,72,162
16,DÂMBOVIŢA,"CORBII MARI",66857,PETREŞTI,"ŞCOALA GIMNAZIALĂ PETREŞTI",196,"Alegeri Prezidentiale",1,560,337,259,78,0,332,5,620,283,120,212
16,DÂMBOVIŢA,"CORBII MARI",66857,GROZĂVEŞTI,"ŞCOALA GIMNAZIALĂ GROZĂVEŞTI I",197,"Alegeri Prezidentiale",1,630,281,260,21,0,275,6,690,409,110,165
16,DÂMBOVIŢA,"CORBII MARI",66857,GROZĂVEŞTI,"ŞCOALA PRIMARĂ NR. 2 GROZĂVEŞTI",198,"Alegeri Prezidentiale",1,1000,514,442,72,0,505,9,1100,586,198,307
16,DÂMBOVIŢA,"CORBII MARI",66857,UNGURENI,"GRĂDINIŢA CU PROGRAM NORMAL UNGURENI",199,"Alegeri Prezidentiale",1,869,523,476,47,0,513,10,960,437,203,310
16,DÂMBOVIŢA,"CORBII MARI",66857,UNGURENI,"GRĂDINIŢA NR. 1 UNGURENI",200,"Alegeri Prezidentiale",1,640,437,353,84,0,431,6,700,263,204,227
16,DÂMBOVIŢA,"CORBII MARI",66857,"SATU NOU","ŞCOALA PRIMARĂ SATU NOU",201,"Alegeri Prezidentiale",1,385,242,209,33,0,241,1,420,178,116,125
16,DÂMBOVIŢA,"CORBII MARI",66857,BĂRĂCENI,"GRĂDINIŢA CU PROGRAM NORMAL BĂRĂCENI",202,"Alegeri Prezidentiale",1,386,248,205,43,0,246,2,420,172,89,157
16,DÂMBOVIŢA,CORNĂŢELU,66955,CORNĂŢELU,"ŞCOALA CU CLASELE I - VIII CORNĂŢELU",203,"Alegeri Prezidentiale",1,294,251,152,97,2,248,3,320,69,100,148
16,DÂMBOVIŢA,CORNĂŢELU,66955,BOLOVANI,"ŞCOALA CU CLASELE I - IV BOLOVANI",204,"Alegeri Prezidentiale",1,502,432,270,160,2,427,5,550,118,207,220
16,DÂMBOVIŢA,CORNĂŢELU,66955,ALUNIŞU,"ŞCOALA CU CLASELE I - IV ALUNIŞU",205,"Alegeri Prezidentiale",1,256,143,110,33,0,140,3,280,137,72,68
16,DÂMBOVIŢA,CORNEŞTI,67014,BUJOREANCA,"ŞCOALA PRIMARĂ BUJOREANCA",206,"Alegeri Prezidentiale",1,361,226,150,76,0,224,2,400,174,138,86
16,DÂMBOVIŢA,CORNEŞTI,67014,CĂTUNU,"ŞCOALA GIMNAZIALĂ CĂTUNU",207,"Alegeri Prezidentiale",1,680,481,330,151,0,476,5,750,269,300,176
16,DÂMBOVIŢA,CORNEŞTI,67014,CORNEŞTI,"ŞCOALA GIMNAZIALĂ CORNEŞTI",208,"Alegeri Prezidentiale",1,1321,681,542,139,0,668,13,1450,769,443,225
16,DÂMBOVIŢA,CORNEŞTI,67014,CRIVĂŢU,"ŞCOALA PRIMARĂ CRIVĂŢU",209,"Alegeri Prezidentiale",1,212,166,119,47,0,163,3,230,64,68,95
16,DÂMBOVIŢA,CORNEŞTI,67014,FRASINU,"ŞCOALA GIMNAZIALĂ FRASINU",210,"Alegeri Prezidentiale",1,500,260,206,54,0,258,2,550,290,178,80
16,DÂMBOVIŢA,CORNEŞTI,67014,IBRIANU,"ŞCOALA PRIMARĂ IBRIANU",211,"Alegeri Prezidentiale",1,608,332,271,61,0,327,5,670,338,173,154
16,DÂMBOVIŢA,CORNEŞTI,67014,POSTÂRNACU,"ŞCOALA PRIMARĂ”GRIGORE STĂNESCU ” POSTÎRNACU",212,"Alegeri Prezidentiale",1,694,340,280,60,0,336,4,770,430,237,99
16,DÂMBOVIŢA,CORNEŞTI,67014,UNGURENI,"ŞCOALA PRIMARĂ UNGURENI",213,"Alegeri Prezidentiale",1,682,385,318,67,0,383,2,750,365,244,139
16,DÂMBOVIŢA,"COSTEŞTII DIN VALE",67121,"COSTEŞTII DIN VALE","GRĂDINIȚA CU PROGRAM NORMAL NR. 1 COSTEȘTII DIN VALE",214,"Alegeri Prezidentiale",1,428,218,192,26,0,215,3,470,252,63,152
16,DÂMBOVIŢA,"COSTEŞTII DIN VALE",67121,"COSTEŞTII DIN VALE","ȘCOALA GIMNAZIALĂ COSTEȘTII DIN VALE",215,"Alegeri Prezidentiale",1,1249,482,453,29,0,471,11,1380,898,134,337
16,DÂMBOVIŢA,"COSTEŞTII DIN VALE",67121,TOMŞANI,"ȘCOALA GIMNAZIALĂ TOMȘANI",216,"Alegeri Prezidentiale",1,1042,518,465,53,0,509,9,1150,632,173,336
16,DÂMBOVIŢA,CRÂNGURILE,67167,BĂDULEŞTI,"ŞCOALA GENERALĂ BĂDULEŞTI",217,"Alegeri Prezidentiale",1,1142,735,609,126,0,721,14,1260,525,322,399
16,DÂMBOVIŢA,CRÂNGURILE,67167,PĂTROAIA-VALE,"ŞCOALA GIMNAZIALĂ PĂTROAIA VALE",218,"Alegeri Prezidentiale",1,903,539,441,98,0,528,11,990,451,213,315
16,DÂMBOVIŢA,CRÂNGURILE,67167,VOIA,"ŞCOALA PRIMARĂ VOIA",219,"Alegeri Prezidentiale",1,578,269,244,25,0,265,4,640,371,16,249
16,DÂMBOVIŢA,CREVEDIA,102286,CREVEDIA,"ŞCOALA GENERALĂ CREVEDIA",220,"Alegeri Prezidentiale",2,1253,808,568,240,0,796,12,1380,572,468,328
16,DÂMBOVIŢA,CREVEDIA,102286,CREVEDIA,"CĂMIN CULTURAL",221,"Alegeri Prezidentiale",1,637,544,318,226,0,532,12,700,156,306,226
16,DÂMBOVIŢA,CREVEDIA,102286,DÂRZA,"ŞCOALA GIMNAZIALĂ DÂRZA",222,"Alegeri Prezidentiale",1,1425,1170,718,452,0,1152,18,1570,400,792,360
16,DÂMBOVIŢA,CREVEDIA,102286,SAMURCAŞI,"GRĂDINIŢA CU PROGRAM NORMAL",223,"Alegeri Prezidentiale",1,1232,1071,609,462,0,1060,11,1360,289,686,374
16,DÂMBOVIŢA,CREVEDIA,102286,COCANI,"ŞCOALA CU CLASELE I-IV",224,"Alegeri Prezidentiale",1,371,284,181,103,0,280,4,410,126,139,141
16,DÂMBOVIŢA,DĂRMĂNEŞTI,67256,DĂRMĂNEŞTI,"ȘCOALA DĂRMĂNEȘTI",225,"Alegeri Prezidentiale",1,1373,632,586,46,0,624,8,1510,878,432,192
16,DÂMBOVIŢA,DĂRMĂNEŞTI,67256,DĂRMĂNEŞTI,"CĂMIN CULTURAL",226,"Alegeri Prezidentiale",1,1591,828,747,81,0,818,10,1750,922,538,280
16,DÂMBOVIŢA,DĂRMĂNEŞTI,67256,"MĂRGINENII DE SUS","ȘCOALA MĂRGINENII DE SUS",227,"Alegeri Prezidentiale",1,870,493,432,61,0,484,9,960,467,302,182
16,DÂMBOVIŢA,DOBRA,67292,DOBRA,"ȘCOALA PREOT PANAIT GEORGESCU",228,"Alegeri Prezidentiale",1,1437,850,765,83,2,835,15,1580,723,396,439
16,DÂMBOVIŢA,DOBRA,67292,MĂRCEŞTI,"ȘCOALA ÎNVĂȚĂTOR IULIAN RUSU",229,"Alegeri Prezidentiale",1,1530,820,749,71,0,808,12,1680,860,401,407
16,DÂMBOVIŢA,DOICEŞTI,65413,DOICEŞTI,"ȘCOALA GIMNAZIALĂ NR.3 DOICEȘTI",230,"Alegeri Prezidentiale",1,1546,634,600,34,0,622,12,1700,1066,371,251
16,DÂMBOVIŢA,DOICEŞTI,65413,DOICEŞTI,"GRĂDINIŢA CU PROGRAM NORMAL NR.2",231,"Alegeri Prezidentiale",1,1520,737,693,44,0,727,10,1670,933,394,333
16,DÂMBOVIŢA,DOICEŞTI,65413,DOICEŞTI,"GRĂDINIȚA CU PROGRAM NORMAL NR. 3 DOICEȘTI",232,"Alegeri Prezidentiale",1,855,386,355,31,0,378,8,940,554,231,147
16,DÂMBOVIŢA,DRAGODANA,67327,DRAGODANA,"ȘCOALA DRAGODANA",233,"Alegeri Prezidentiale",1,1311,683,593,90,0,671,12,1440,757,327,344
16,DÂMBOVIŢA,DRAGODANA,67327,BURDUCA,"ȘCOALA BURDUCA",234,"Alegeri Prezidentiale",1,1004,569,497,72,0,560,9,1110,541,249,311
16,DÂMBOVIŢA,DRAGODANA,67327,"PICIOR DE MUNTE","GRĂDINIȚA PICIOR DE MUNTE",235,"Alegeri Prezidentiale",1,1405,674,633,39,2,662,12,1540,866,329,333
16,DÂMBOVIŢA,DRAGODANA,67327,"PICIOR DE MUNTE","ȘCOALA NR.2 PICIOR DE MUNTE - BOBOCI",236,"Alegeri Prezidentiale",1,1073,569,523,46,0,560,9,1180,611,264,296
16,DÂMBOVIŢA,DRAGODANA,67327,"PICIOR DE MUNTE","ȘCOALA NR.2 PICIOR DE MUNTE - BOBOCI",237,"Alegeri Prezidentiale",1,704,384,339,45,0,380,4,770,386,218,162
16,DÂMBOVIŢA,DRAGOMIREŞTI,67407,DRAGOMIREŞTI,"ŞCOALA GIMNAZIALĂ DRAGOMIREŞTI",238,"Alegeri Prezidentiale",1,1773,915,861,54,0,899,16,1950,1035,541,358
16,DÂMBOVIŢA,DRAGOMIREŞTI,67407,DECINDENI,"ŞCOALA GIMNAZIALĂ DECINDENI –DRAGOMIREŞTI",239,"Alegeri Prezidentiale",1,1035,594,571,23,0,587,7,1140,546,328,259
16,DÂMBOVIŢA,DRAGOMIREŞTI,67407,DECINDENI,"ŞCOALA GIMNAZIALĂ DECINDENI-DRAGOMIREŞTI",240,"Alegeri Prezidentiale",1,1012,546,525,21,0,535,11,1120,574,320,215
16,DÂMBOVIŢA,DRAGOMIREŞTI,67407,RÂNCĂCIOV,"ŞCOALA GIMNAZIALĂ RȊNCĂCIOV-DRAGOMIREŞTI",241,"Alegeri Prezidentiale",1,838,400,357,43,0,390,10,920,520,226,164
16,DÂMBOVIŢA,DRAGOMIREŞTI,67407,RÂNCĂCIOV,"ŞCOALA GIMNAZIALĂ RȊNCĂCIOV-DRAGOMIREŞTI",242,"Alegeri Prezidentiale",1,767,363,337,26,0,358,5,840,477,225,133
16,DÂMBOVIŢA,DRAGOMIREŞTI,67407,UNGURENI,"ŞCOALA GIMNAZIALĂ UNGURENI-DRAGOMIREŞTI",243,"Alegeri Prezidentiale",1,1089,449,424,25,0,443,6,1200,751,270,173
16,DÂMBOVIŢA,DRAGOMIREŞTI,67407,MOGOŞEŞTI,"CĂMINUL CULTURAL MOGOŞEŞTI",244,"Alegeri Prezidentiale",1,484,297,264,33,0,293,4,530,233,139,154
16,DÂMBOVIŢA,DRAGOMIREŞTI,67407,GEANGOEŞTI,"GRĂDINIŢA GEANGOEŞTI-DRAGOMIREŞTI",245,"Alegeri Prezidentiale",1,281,154,129,25,0,149,5,326,172,83,66
16,DÂMBOVIŢA,FINTA,67470,"FINTA MARE","ŞCOALA GENERALĂ FINTA",246,"Alegeri Prezidentiale",1,1015,483,434,49,0,479,4,1120,637,356,123
16,DÂMBOVIŢA,FINTA,67470,BECHINEŞTI,"ŞCOALA BECHINEŞTI",247,"Alegeri Prezidentiale",1,612,316,269,47,0,312,4,680,364,207,105
16,DÂMBOVIŢA,FINTA,67470,GHEBOAIA,"CĂMIN CULTURAL GHEBOAIA",248,"Alegeri Prezidentiale",1,918,474,444,30,0,471,3,1010,536,299,172
16,DÂMBOVIŢA,FINTA,67470,GHEBOAIA,"CĂMIN CULTURAL GHEBOAIA",249,"Alegeri Prezidentiale",1,800,372,333,39,0,366,6,880,508,265,101
16,DÂMBOVIŢA,GLODENI,67522,GLODENI,"ȘCOALA ”BUICĂ IONESCU”",250,"Alegeri Prezidentiale",1,1618,765,737,28,0,757,8,1780,1015,457,300
16,DÂMBOVIŢA,GLODENI,67522,GLODENI,"ȘCOALA ”BUICĂ IONESCU”",251,"Alegeri Prezidentiale",1,1149,551,521,29,1,546,5,1260,709,369,177
16,DÂMBOVIŢA,GLODENI,67522,LĂCULEŢE,"GRĂDINȚA LĂCULEȚE",252,"Alegeri Prezidentiale",1,703,355,330,25,0,346,9,770,415,218,128
16,DÂMBOVIŢA,"GURA FOII",65707,"GURA FOII","ŞCOALA GIMNAZIALĂ GURA FOII",253,"Alegeri Prezidentiale",1,1213,716,624,92,0,705,11,1340,624,299,406
16,DÂMBOVIŢA,"GURA FOII",65707,"GURA FOII","GRĂDINIŢA BUMBUIA",254,"Alegeri Prezidentiale",1,367,250,221,29,0,247,3,400,150,88,159
16,DÂMBOVIŢA,"GURA FOII",65707,"GURA FOII","SALA DE FESTIVITĂŢI FĂGETU",255,"Alegeri Prezidentiale",1,297,233,191,42,0,228,5,330,97,99,129
16,DÂMBOVIŢA,"GURA OCNIŢEI",67595,"GURA OCNIŢEI","ȘCOALA CU CLASELE. I-VIII GURA OCNIȚEI",256,"Alegeri Prezidentiale",1,1373,627,562,60,5,613,14,1510,883,312,301
16,DÂMBOVIŢA,"GURA OCNIŢEI",67595,"GURA OCNIŢEI","ȘCOALA CU CLASELE. I-VIII GURA OCNIȚEI",257,"Alegeri Prezidentiale",1,1516,836,729,83,24,804,32,1670,834,424,380
16,DÂMBOVIŢA,"GURA OCNIŢEI",67595,ADÂNCA,"ȘCOALA CU CLASELE. I-VIII ADÂNCA",258,"Alegeri Prezidentiale",1,1528,822,736,86,0,806,16,1680,858,422,384
16,DÂMBOVIŢA,"GURA OCNIŢEI",67595,SĂCUENI,"ȘCOALA CU CLASELE. I-VIII SĂCUENI",259,"Alegeri Prezidentiale",1,1522,910,824,86,0,886,24,1670,760,528,358
16,DÂMBOVIŢA,"GURA ŞUŢII",67648,"GURA ŞUŢII","ȘCOALA GIMNAZIALӐ GURA ȘUȚII",260,"Alegeri Prezidentiale",1,892,514,443,41,30,508,6,980,466,187,321
16,DÂMBOVIŢA,"GURA ŞUŢII",67648,"GURA ŞUŢII","ȘCOALA GIMNAZIALӐ GURA ȘUȚII",261,"Alegeri Prezidentiale",1,888,521,450,41,30,514,7,980,459,131,383
16,DÂMBOVIŢA,"GURA ŞUŢII",67648,"GURA ŞUŢII","GRӐDINIȚA CU PROGRAM NORMAL GURA ȘUȚII,CORPUL B",262,"Alegeri Prezidentiale",1,997,601,528,42,31,592,9,1100,499,187,405
16,DÂMBOVIŢA,"GURA ŞUŢII",67648,SPERIEŢENI,"ȘCOALA GIMNAZIALӐ SPERIEȚENI",263,"Alegeri Prezidentiale",1,1477,682,603,43,36,677,5,1630,948,312,365
16,DÂMBOVIŢA,HULUBEŞTI,67675,HULUBEŞTI,"ȘCOALA GIMNAZIALĂ NR. 1 HULUBEȘTI",264,"Alegeri Prezidentiale",1,677,390,336,54,0,388,2,740,350,195,193
16,DÂMBOVIŢA,HULUBEŞTI,67675,MĂGURA,"GRĂDINIŢA CU PROGRAM NORMAL MĂGURA",265,"Alegeri Prezidentiale",1,538,346,294,52,0,337,9,590,244,152,185
16,DÂMBOVIŢA,HULUBEŞTI,67675,"BUTOIU DE JOS","ŞCOALA GIMNAZIALĂ BUTOIU DE JOS",266,"Alegeri Prezidentiale",1,775,333,304,29,0,327,6,850,517,124,203
16,DÂMBOVIŢA,HULUBEŞTI,67675,"BUTOIU DE SUS","GRĂDINIŢA CU PROGRAM NORMAL BUTOIU DE SUS",267,"Alegeri Prezidentiale",1,636,338,311,27,0,334,4,700,362,129,205
16,DÂMBOVIŢA,"I. L. CARAGIALE",67737,GHIRDOVENI,"ȘCOALA GIMNAZIALĂ NR. 1 GHIRDOVENI",268,"Alegeri Prezidentiale",1,1491,754,692,62,0,732,22,1640,886,412,320
16,DÂMBOVIŢA,"I. L. CARAGIALE",67737,GHIRDOVENI,"ȘCOALA GIMNAZIALĂ NR. 2 GHIRDOVENI",269,"Alegeri Prezidentiale",1,1208,622,573,49,0,603,19,1330,708,268,335
16,DÂMBOVIŢA,"I. L. CARAGIALE",67737,"I. L. CARAGIALE","GRĂDINIȚA CU PROGRAM NORMAL I.L. CARAGIALE",270,"Alegeri Prezidentiale",1,669,577,336,46,195,564,13,1040,463,211,353
16,DÂMBOVIŢA,"I. L. CARAGIALE",67737,"I. L. CARAGIALE","CĂMINUL CULTURAL I.L.CARAGIALE",271,"Alegeri Prezidentiale",2,1467,808,573,24,211,791,17,1610,802,222,569
16,DÂMBOVIŢA,"I. L. CARAGIALE",67737,MIJA,"ȘCOALA PRIMARĂ MIJA",272,"Alegeri Prezidentiale",1,633,300,282,18,0,293,7,700,400,146,147
16,DÂMBOVIŢA,IEDERA,65869,"IEDERA DE JOS","ȘCOALA GIMNAZIALĂ IEDERA DE JOS",273,"Alegeri Prezidentiale",1,1218,613,553,60,0,599,14,1340,727,376,223
16,DÂMBOVIŢA,IEDERA,65869,COLIBAŞI,"GRĂDINIȚA CU PROGRAM NORMAL COLIBAȘI",274,"Alegeri Prezidentiale",1,439,248,217,31,0,243,5,488,240,126,117
16,DÂMBOVIŢA,IEDERA,65869,"CRICOVU DULCE","GRĂDINIȚA CU PROGRAM NORMAL CRICOVU DULCE",275,"Alegeri Prezidentiale",1,325,175,149,26,0,169,6,360,185,95,74
16,DÂMBOVIŢA,IEDERA,65869,"IEDERA DE SUS","ȘCOALA CU CLASELE I-IV IEDERA DE SUS",276,"Alegeri Prezidentiale",1,1196,589,562,27,0,581,8,1320,731,318,263
16,DÂMBOVIŢA,LUCIENI,67773,LUCIENI,"ŞCOALA LUCIENI",277,"Alegeri Prezidentiale",1,976,474,450,24,0,467,7,1070,596,295,172
16,DÂMBOVIŢA,LUCIENI,67773,LUCIENI,"ŞCOALA LUCIENI",278,"Alegeri Prezidentiale",1,1065,457,431,26,0,455,2,1170,713,287,168
16,DÂMBOVIŢA,LUCIENI,67773,OLTENI,"ŞCOALA OLTENI",279,"Alegeri Prezidentiale",1,450,237,204,33,0,237,0,500,263,154,83
16,DÂMBOVIŢA,LUDEŞTI,67835,TELEŞTI,"ȘCOALA GIMNAZIALĂ TELEȘTI",280,"Alegeri Prezidentiale",1,1387,630,575,55,0,627,3,1530,900,246,381
16,DÂMBOVIŢA,LUDEŞTI,67835,POTOCELU,"ȘCOALA PRIMARĂ POTOCELU",281,"Alegeri Prezidentiale",2,953,359,347,12,0,354,5,1050,691,80,274
16,DÂMBOVIŢA,LUDEŞTI,67835,"SCHEIU DE JOS","ȘCOALA GIMNAZIALA SCHEIU DE JOS",282,"Alegeri Prezidentiale",1,832,412,375,37,0,406,6,920,508,201,205
16,DÂMBOVIŢA,LUDEŞTI,67835,"SCHEIU DE SUS","ȘCOALA PRIMARĂ SCHEIU DE SUS",283,"Alegeri Prezidentiale",1,793,388,370,18,0,383,5,870,482,156,227
16,DÂMBOVIŢA,LUNGULEŢU,67906,LUNGULEŢU,"ŞCOALA GIMNAZIALĂ NR. 2 LUNGULEŢU",284,"Alegeri Prezidentiale",1,909,348,348,0,0,345,3,1000,652,197,148
16,DÂMBOVIŢA,LUNGULEŢU,67906,LUNGULEŢU,"ŞCOALA GIMNAZIALĂ NR. 2 LUNGULEŢU",285,"Alegeri Prezidentiale",1,981,493,409,84,0,483,10,1080,587,273,210
16,DÂMBOVIŢA,LUNGULEŢU,67906,LUNGULEŢU,"ŞCOALA GIMNAZIALĂ NR. 1 LUNGULEŢU",286,"Alegeri Prezidentiale",1,1419,642,592,50,0,635,7,1560,918,273,362
16,DÂMBOVIŢA,LUNGULEŢU,67906,SERDANU,"ŞCOALA GIMNAZIALĂ SERDANU",287,"Alegeri Prezidentiale",1,1032,506,424,82,0,498,8,1140,634,224,274
16,DÂMBOVIŢA,"MALU CU FLORI",67942,"MALU CU FLORI","ȘCOALA GIMNAZIALĂ MALU CU FLORI, NR. 139BIS",288,"Alegeri Prezidentiale",1,1161,698,603,88,7,676,22,1280,582,339,337
16,DÂMBOVIŢA,"MALU CU FLORI",67942,"MALU CU FLORI","ȘCOALA GENERALĂ CU CLASELE I-IV MICLOȘANII MICI",289,"Alegeri Prezidentiale",1,745,429,367,45,17,414,15,820,391,182,232
16,DÂMBOVIŢA,MĂNEŞTI,68002,MĂNEŞTI,"ȘCOALA GIMNAZIALĂ MĂNEȘTI",290,"Alegeri Prezidentiale",1,1105,566,534,32,0,556,10,1218,652,270,286
16,DÂMBOVIŢA,MĂNEŞTI,68002,DRĂGĂEŞTI-UNGURENI,"ŞCOALA GIMNAZIALĂ DRĂGĂEŞTI-UNGURENI",291,"Alegeri Prezidentiale",1,1078,635,581,54,0,626,9,1190,555,333,293
16,DÂMBOVIŢA,MĂNEŞTI,68002,DRĂGĂEŞTI-PĂMÂNTENI,"ŞCOALA GIMNAZIALĂ DRĂGĂEŞTI-PĂMÂNTENI",292,"Alegeri Prezidentiale",1,1807,904,861,43,0,896,8,1990,1086,327,569
16,DÂMBOVIŢA,MĂTĂSARU,68048,MĂTĂSARU,"ŞCOALA GENERALĂ MĂTĂSARU",293,"Alegeri Prezidentiale",1,828,408,376,32,0,403,5,910,502,135,268
16,DÂMBOVIŢA,MĂTĂSARU,68048,"ODAIA TURCULUI","ŞCOALA PRIMARĂ ODAIA TURCULUI",294,"Alegeri Prezidentiale",1,895,479,416,63,0,476,3,982,503,173,303
16,DÂMBOVIŢA,MĂTĂSARU,68048,TEŢCOIU,"GRĂDINIŢA TEŢCOIU",295,"Alegeri Prezidentiale",1,1097,447,392,55,0,443,4,1210,763,179,264
16,DÂMBOVIŢA,MĂTĂSARU,68048,POROINICA,"ŞCOALA GENERALĂ POROINICA",296,"Alegeri Prezidentiale",1,641,308,266,42,0,305,3,710,402,104,201
16,DÂMBOVIŢA,MĂTĂSARU,68048,"PUŢU CU SALCIE","ŞCOALA PRIMARĂ PUŢU CU SALCIE",297,"Alegeri Prezidentiale",1,768,326,291,35,0,323,3,840,514,123,200
16,DÂMBOVIŢA,MOGOŞANI,68128,MOGOŞANI,"ȘCOALA GENERALĂ MOGOȘANI",298,"Alegeri Prezidentiale",2,1371,738,679,59,0,730,8,1510,772,405,325
16,DÂMBOVIŢA,MOGOŞANI,68128,COJOCARU,"ȘCOALA COJOCARU",299,"Alegeri Prezidentiale",1,655,354,326,28,0,348,6,720,366,164,184
16,DÂMBOVIŢA,MOGOŞANI,68128,MERII,"ȘCOALA MERII",300,"Alegeri Prezidentiale",1,788,469,437,32,0,458,11,860,391,259,199
16,DÂMBOVIŢA,MOGOŞANI,68128,ZĂVOIU,"ȘCOALA ZĂVOIU",301,"Alegeri Prezidentiale",1,743,454,403,51,0,450,4,820,366,273,177
16,DÂMBOVIŢA,MOROENI,68182,LUNCA,"SCOALA VECHE-GRADINITA",302,"Alegeri Prezidentiale",1,980,535,495,40,0,525,10,1080,545,305,220
16,DÂMBOVIŢA,MOROENI,68182,MOROENI,"SCOALA ”ION CIORANESCU”",303,"Alegeri Prezidentiale",1,1202,590,534,54,2,585,5,1320,730,332,253
16,DÂMBOVIŢA,MOROENI,68182,PUCHENI,"PANAIT PETRE",304,"Alegeri Prezidentiale",1,483,318,261,54,3,316,2,530,212,191,125
16,DÂMBOVIŢA,MOROENI,68182,GLOD,"SCOALA GLOD",305,"Alegeri Prezidentiale",1,1373,776,722,22,32,761,15,1510,734,310,451
16,DÂMBOVIŢA,MOROENI,68182,MUŞCEL,"SCOALA MUSCEL",306,"Alegeri Prezidentiale",1,65,44,33,11,0,43,1,70,26,23,20
16,DÂMBOVIŢA,MORTENI,68253,MORTENI,"GRĂDINIȚA MORTENI CENTRU",307,"Alegeri Prezidentiale",1,1167,782,700,82,0,774,8,1280,498,239,535
16,DÂMBOVIŢA,MORTENI,68253,NEAJLOVU,"GRĂDINIȚA MORTENI CENTRU",308,"Alegeri Prezidentiale",1,1121,707,653,54,0,697,10,1230,523,239,458
16,DÂMBOVIŢA,MOŢĂIENI,65645,MOŢĂIENI,"CĂMIN CULTURAL MOŢĂIENI",309,"Alegeri Prezidentiale",1,1376,745,657,86,2,743,2,1518,773,540,203
16,DÂMBOVIŢA,MOŢĂIENI,65645,CUCUTENI,"ŞCOALA CUCUTENI",310,"Alegeri Prezidentiale",1,364,177,156,20,1,173,4,400,223,123,50
16,DÂMBOVIŢA,NICULEŞTI,104387,NICULEŞTI,"ȘCOALA CU CLASELE I - VIII NICULEȘTI",311,"Alegeri Prezidentiale",1,1018,561,490,71,0,554,7,1120,559,218,336
16,DÂMBOVIŢA,NICULEŞTI,104387,NICULEŞTI,"ȘCOALA CU CLASELE I - VIII NICULEȘTI",312,"Alegeri Prezidentiale",1,814,504,415,89,0,499,5,900,396,208,291
16,DÂMBOVIŢA,NICULEŞTI,104387,MOVILA,"ȘCOALA CU CLASELE I-IV MOVILA",313,"Alegeri Prezidentiale",1,478,362,235,127,0,357,5,530,168,197,160
16,DÂMBOVIŢA,NICULEŞTI,104387,CIOCĂNARI,"ȘCOALA CU CLASELE I-VIII CIOCĂNARI",314,"Alegeri Prezidentiale",1,982,465,398,67,0,459,6,1080,615,280,179
16,DÂMBOVIŢA,NUCET,68280,NUCET,"ȘCOALA GIMNAZIALĂ ” NUCET ”",315,"Alegeri Prezidentiale",1,958,552,504,44,4,545,7,1050,498,137,408
16,DÂMBOVIŢA,NUCET,68280,NUCET,"ȘCOALA GIMNAZIALĂ ”NUCET”",316,"Alegeri Prezidentiale",1,875,503,443,52,8,496,7,960,457,183,313
16,DÂMBOVIŢA,NUCET,68280,CAZACI,"ȘCOALA GIMNAZIALĂ ” CAZACI ”",317,"Alegeri Prezidentiale",1,1190,689,623,55,11,678,11,1310,621,279,399
16,DÂMBOVIŢA,NUCET,68280,ILFOVENI,"ȘCOALA PRIMARĂ ” ILFOVENI ”",318,"Alegeri Prezidentiale",1,443,268,211,55,2,257,11,490,222,125,132
16,DÂMBOVIŢA,OCNIŢA,68324,OCNIŢA,"GRĂDINIȚA CU PROGRAM NORMAL NR 1 OCNIȚA",319,"Alegeri Prezidentiale",1,1219,582,542,40,0,572,10,1330,748,358,214
16,DÂMBOVIŢA,OCNIŢA,68324,OCNIŢA,"ȘCOALA GIMNAZIALĂ OCNIȚA",320,"Alegeri Prezidentiale",1,1364,625,592,33,0,612,13,1500,875,396,216
16,DÂMBOVIŢA,OCNIŢA,68324,OCNIŢA,"GRADINIȚA CU PROGRAM NORMAL NR 2 FUNDU OCNEI",321,"Alegeri Prezidentiale",1,986,444,412,32,0,434,10,1080,636,276,158
16,DÂMBOVIŢA,ODOBEŞTI,68342,ODOBEŞTI,"ȘCOALA GIMNAZIALĂ ODOBEȘTI",322,"Alegeri Prezidentiale",1,1283,834,726,108,0,819,15,1410,576,393,426
16,DÂMBOVIŢA,ODOBEŞTI,68342,BRÂNCOVEANU,"GRĂDINIȚA BRÂNCOVEANU",323,"Alegeri Prezidentiale",1,524,341,310,31,0,337,4,580,239,125,212
16,DÂMBOVIŢA,ODOBEŞTI,68342,MIULEŞTI,"ȘCOALA PRIMARĂ MIULEȘTI",324,"Alegeri Prezidentiale",1,431,264,237,27,0,260,4,480,216,85,175
16,DÂMBOVIŢA,ODOBEŞTI,68342,CROVU,"ȘCOALA GIMNAZIALĂ CROVU",325,"Alegeri Prezidentiale",1,1077,652,585,67,0,645,7,1180,528,223,422
16,DÂMBOVIŢA,ODOBEŞTI,68342,ZIDURILE,"ȘCOALA PRIMARĂ ZIDURILE",326,"Alegeri Prezidentiale",1,661,428,381,47,0,421,7,730,302,208,213
16,DÂMBOVIŢA,PERŞINARI,179935,PERŞINARI,"ŞCOALA GIMNAZIALĂ PERŞINARI",327,"Alegeri Prezidentiale",1,1143,468,424,44,0,456,12,1260,792,214,242
16,DÂMBOVIŢA,PERŞINARI,179935,PERŞINARI,"ŞCOALA GIMNAZIALĂ PERȘINARI",328,"Alegeri Prezidentiale",1,1152,491,465,26,0,482,9,1270,779,224,258
16,DÂMBOVIŢA,PETREŞTI,65752,"PUNTEA DE GRECI","CĂMIN CULTURAL",329,"Alegeri Prezidentiale",1,588,384,344,40,0,383,1,650,266,236,147
16,DÂMBOVIŢA,PETREŞTI,65752,PETREŞTI,"ȘCOALA GIMNAZIALĂ PETREŞTI",330,"Alegeri Prezidentiale",1,1148,616,541,74,1,612,4,1260,644,357,255
16,DÂMBOVIŢA,PETREŞTI,65752,GRECI,"ȘCOALA GIMNAZIALĂ GRECI",331,"Alegeri Prezidentiale",1,1260,719,643,76,0,711,8,1390,671,413,298
16,DÂMBOVIŢA,PETREŞTI,65752,IONEŞTI,"GRADINITA IONESTI",332,"Alegeri Prezidentiale",1,1504,1003,868,135,0,985,18,1660,657,592,393
16,DÂMBOVIŢA,PETREŞTI,65752,POTLOGENI-DEAL,"GRADINITA POTLOGENI DEAL",333,"Alegeri Prezidentiale",1,150,115,100,15,0,114,1,170,55,89,25
16,DÂMBOVIŢA,PIETRARI,179908,PIETRARI,"CAMINUL CULTURAL PIETRARI",334,"Alegeri Prezidentiale",1,1452,757,689,68,0,746,11,1600,843,401,345
16,DÂMBOVIŢA,PIETRARI,179908,VALEA,"SCOALA VALEA   DC138",335,"Alegeri Prezidentiale",1,528,269,248,21,0,265,4,580,311,102,163
16,DÂMBOVIŢA,PIETROŞIŢA,68404,PIETROŞIŢA,"GRĂDINIŢA PIETROŞIŢA,NR.327 B",336,"Alegeri Prezidentiale",1,894,479,437,41,1,469,10,980,501,258,211
16,DÂMBOVIŢA,PIETROŞIŢA,68404,PIETROŞIŢA,"GRĂDINIŢA PIETROŞIŢA,NR 327 B",337,"Alegeri Prezidentiale",1,899,487,446,41,0,480,7,990,503,248,232
16,DÂMBOVIŢA,PIETROŞIŢA,68404,"DEALU FRUMOS","CAMINUL CULTURAL DEALU FRUMOS ,NR.309",338,"Alegeri Prezidentiale",1,847,488,426,62,0,485,3,930,442,300,185
16,DÂMBOVIŢA,POIANA,68431,POIANA,"ȘCOALA NR.1 POIANA, SAT POIANA",339,"Alegeri Prezidentiale",1,1158,661,601,60,0,647,14,1280,619,253,394
16,DÂMBOVIŢA,POIANA,68431,POIANA,"ȘCOALA NR.1 POIANA",340,"Alegeri Prezidentiale",1,780,469,411,58,0,463,6,850,381,194,269
16,DÂMBOVIŢA,POIANA,68431,POIANA,"ȘCOALA NR.2 POIANA",341,"Alegeri Prezidentiale",1,883,457,396,61,0,450,7,970,513,226,224
16,DÂMBOVIŢA,POTLOGI,68468,POTLOGI,"ŞCOALA POTLOGI",342,"Alegeri Prezidentiale",1,1260,645,528,117,0,639,6,1390,745,292,347
16,DÂMBOVIŢA,POTLOGI,68468,POTLOGI,"ŞCOALA POTLOGI",343,"Alegeri Prezidentiale",1,1189,578,518,60,0,569,9,1310,732,267,302
16,DÂMBOVIŢA,POTLOGI,68468,PITARU,"ŞCOALA PITARU",344,"Alegeri Prezidentiale",1,685,350,289,61,0,341,9,750,400,121,220
16,DÂMBOVIŢA,POTLOGI,68468,VLĂSCENI,"ŞCOALA VLĂSCENI",345,"Alegeri Prezidentiale",1,562,320,211,109,0,312,8,620,300,147,165
16,DÂMBOVIŢA,POTLOGI,68468,ROMÂNEŞTI,"ŞCOALA ROMÂNEŞTI",346,"Alegeri Prezidentiale",1,1364,313,277,36,0,303,10,1500,1187,85,218
16,DÂMBOVIŢA,POTLOGI,68468,ROMÂNEŞTI,"ŞCOALA ROMÂNEŞTI",347,"Alegeri Prezidentiale",1,1643,457,399,58,0,449,8,1810,1353,162,287
16,DÂMBOVIŢA,PRODULEŞTI,68529,PRODULEŞTI,"CĂMIN CULTURAL",348,"Alegeri Prezidentiale",1,1466,834,736,90,8,824,10,1610,776,382,442
16,DÂMBOVIŢA,PRODULEŞTI,68529,BROŞTENI,"ȘCOALA PRIMARĂ BROȘTENI",349,"Alegeri Prezidentiale",1,536,324,281,38,5,316,8,590,266,156,160
16,DÂMBOVIŢA,PRODULEŞTI,68529,"COSTEŞTII DIN DEAL","ȘCOALA PRIMARĂ COSTEȘTII DIN DEAL",350,"Alegeri Prezidentiale",1,753,530,444,75,11,521,9,830,300,178,343
16,DÂMBOVIŢA,PUCHENI,68565,PUCHENI,"ȘCOALA GIMNAZIALĂ „ NICOLAE VLAD „",351,"Alegeri Prezidentiale",1,1279,658,601,54,3,649,9,1410,752,298,351
16,DÂMBOVIŢA,PUCHENI,68565,"VALEA LARGĂ","SCOALA VALEA LARGA",352,"Alegeri Prezidentiale",1,216,117,104,13,0,114,3,240,123,62,52
16,DÂMBOVIŢA,RACIU,179891,RACIU,"ȘCOALA GIMNAZIALĂ RACIU",353,"Alegeri Prezidentiale",1,1220,650,612,38,0,644,6,1340,690,385,259
16,DÂMBOVIŢA,RACIU,179891,"ŞUŢA SEACĂ","ȘCOALA GIMNAZIALĂ ȘUȚA SEACĂ - RACIU",354,"Alegeri Prezidentiale",1,720,388,358,30,0,384,4,790,402,237,147
16,DÂMBOVIŢA,RACIU,179891,SILIŞTEA,"ȘCOALA PRIMARĂ SILIȘTEA - RACIU",355,"Alegeri Prezidentiale",1,753,404,385,19,0,395,9,830,426,174,221
16,DÂMBOVIŢA,RĂSCĂEŢI,179926,RĂSCĂEŢI,"ŞCOALA PRIMARĂ DRĂGHINEASCA",356,"Alegeri Prezidentiale",1,820,607,545,47,15,602,5,900,293,164,438
16,DÂMBOVIŢA,RĂSCĂEŢI,179926,RĂSCĂEŢI,"ŞCOALA GIMNAZIALĂ RĂSCĂEŢI",357,"Alegeri Prezidentiale",1,995,662,557,70,35,651,11,1100,438,220,431
16,DÂMBOVIŢA,RĂZVAD,65431,RĂZVAD,"BIBLIOTECA COMUNALĂ",358,"Alegeri Prezidentiale",1,1448,992,845,146,1,976,16,1590,598,509,467
16,DÂMBOVIŢA,RĂZVAD,65431,RĂZVAD,"ȘCOALA GIMNAZIALĂ RĂZVAD",359,"Alegeri Prezidentiale",1,1072,688,601,85,2,679,9,1180,492,347,332
16,DÂMBOVIŢA,RĂZVAD,65431,RĂZVAD,"CENTRUL EDUCATIV PENTRU COPII SĂRACI RĂZVAD",360,"Alegeri Prezidentiale",1,1138,754,603,150,1,739,15,1250,496,376,363
16,DÂMBOVIŢA,RĂZVAD,65431,"VALEA VOIEVOZILOR","GRĂDINIȚA CU PROGRAM NORMAL VALEA VOIEVOZILOR",361,"Alegeri Prezidentiale",2,1427,939,755,183,1,915,24,1570,631,515,400
16,DÂMBOVIŢA,RĂZVAD,65431,"VALEA VOIEVOZILOR","GRĂDINIȚA CU PROGRAM NORMAL VALEA VOIEVOZILOR",362,"Alegeri Prezidentiale",1,1247,827,682,145,0,798,29,1370,543,466,332
16,DÂMBOVIŢA,RĂZVAD,65431,GORGOTA,"ȘCOALA GIMNAZIALĂ GORGOTA",363,"Alegeri Prezidentiale",1,1057,570,513,57,0,561,9,1160,590,242,319
16,DÂMBOVIŢA,"RÂU ALB",179917,"RÂU ALB DE JOS","ȘCOALA GIMNAZIALĂ RÂU ALB DE JOS",364,"Alegeri Prezidentiale",1,1184,696,609,86,1,686,10,1300,604,306,380
16,DÂMBOVIŢA,RUNCU,68716,RUNCU,"GRÃDINIŢA CU PROGRAM NORMAL RUNCU",365,"Alegeri Prezidentiale",1,1161,556,506,50,0,545,11,1280,724,332,213
16,DÂMBOVIŢA,RUNCU,68716,RUNCU,"ŞCOALA GIMNAZIALÃ ”CONSTANTIN SECÃREANU” RUNCU",366,"Alegeri Prezidentiale",1,1058,470,434,35,1,466,4,1160,690,280,186
16,DÂMBOVIŢA,RUNCU,68716,BĂDENI,"GRÃDINIŢA CU PROGRAM NORMAL BÃDENI",367,"Alegeri Prezidentiale",1,809,325,300,24,1,318,7,890,565,172,146
16,DÂMBOVIŢA,RUNCU,68716,BREBU,"GRÃDINIŢA CU PROGRAM NORMAL BREBU",368,"Alegeri Prezidentiale",1,528,272,249,23,0,268,4,580,308,142,126
16,DÂMBOVIŢA,SĂLCIOARA,68789,BĂNEŞTI,"ȘCOALA GENERALĂ BĂNEȘTI",369,"Alegeri Prezidentiale",1,336,183,146,37,0,180,3,370,187,93,87
16,DÂMBOVIŢA,SĂLCIOARA,68789,"PODU RIZII","ȘCOALA GENERALĂ PODU-RIZII",370,"Alegeri Prezidentiale",1,583,363,318,45,0,358,5,640,277,120,238
16,DÂMBOVIŢA,SĂLCIOARA,68789,"MIRCEA VODĂ","ȘCOALA GENERALĂ MIRCEA-VODĂ SALA 1",371,"Alegeri Prezidentiale",1,909,429,370,59,0,421,8,1000,571,220,201
16,DÂMBOVIŢA,SĂLCIOARA,68789,GHINEŞTI,"ȘCOALA GENERALĂ GHINEȘTI SALA1",372,"Alegeri Prezidentiale",1,997,426,382,44,0,420,6,1100,674,194,226
16,DÂMBOVIŢA,SĂLCIOARA,68789,"CUZA VODĂ","ȘCOALA GENERALĂ CUZA-VODĂ",373,"Alegeri Prezidentiale",1,313,184,130,54,0,182,2,350,166,81,101
16,DÂMBOVIŢA,"SLOBOZIA MOARĂ",105142,"SLOBOZIA MOARĂ","ȘCOALA GIMNAZIALĂ SLOBOZIA MOARĂ",374,"Alegeri Prezidentiale",1,848,551,454,97,0,545,6,930,379,203,342
16,DÂMBOVIŢA,"SLOBOZIA MOARĂ",105142,"SLOBOZIA MOARĂ","ȘCOALA GIMNAZIALĂ SLOBOZIA MOARĂ",375,"Alegeri Prezidentiale",1,831,480,430,49,1,470,10,920,440,188,282
16,DÂMBOVIŢA,ŞELARU,68887,ŞELARU,"ȘCOALA GIMNAZIALĂ ȘELARU",376,"Alegeri Prezidentiale",1,691,443,322,121,0,435,8,760,317,144,291
16,DÂMBOVIŢA,ŞELARU,68887,FIERBINŢI,"ȘCOALA GIMNAZIALĂ FIERBINȚI",377,"Alegeri Prezidentiale",1,1219,589,515,74,0,581,8,1340,751,242,339
16,DÂMBOVIŢA,ŞELARU,68887,GLOGOVEANU,"GRĂDINIȚA CU PROGRAM NORMAL",378,"Alegeri Prezidentiale",1,571,335,263,72,0,333,2,620,285,134,199
16,DÂMBOVIŢA,ŞOTÂNGA,65477,TEIŞ,"ȘCOALA GIMNAZIALĂ ”TEIUL DOAMNEI” - CORP B",379,"Alegeri Prezidentiale",1,856,439,402,37,0,428,11,940,501,261,167
16,DÂMBOVIŢA,ŞOTÂNGA,65477,TEIŞ,"CĂMIN CULTURAL TEIŞ",380,"Alegeri Prezidentiale",1,1252,671,627,44,0,651,20,1380,709,350,301
16,DÂMBOVIŢA,ŞOTÂNGA,65477,ŞOTÂNGA,"ȘCOALA GIMNAZIALĂ ”PROFESOR ILIE POPESCU”",381,"Alegeri Prezidentiale",1,1528,753,709,44,0,736,17,1680,927,334,402
16,DÂMBOVIŢA,ŞOTÂNGA,65477,ŞOTÂNGA,"CĂMIN CULTURAL ŞOTÂNGA",382,"Alegeri Prezidentiale",1,1139,542,513,29,0,530,12,1250,708,242,288
16,DÂMBOVIŢA,ŞOTÂNGA,65477,ŞOTÂNGA,"ȘCOALA GIMNAZIALĂ NR. 2",383,"Alegeri Prezidentiale",1,1114,511,482,29,0,505,6,1230,719,197,308
16,DÂMBOVIŢA,TĂRTĂŞEŞTI,105534,TĂRTĂŞEŞTI,"ŞCOALA GIMNAZIALĂ TĂRTĂŞEŞTI",384,"Alegeri Prezidentiale",1,863,599,386,212,1,594,5,950,351,332,262
16,DÂMBOVIŢA,TĂRTĂŞEŞTI,105534,BÂLDANA,"ŞCOALA GIMNAZIALĂ BÂLDANA - TĂRTĂŞEŞTI,",385,"Alegeri Prezidentiale",1,1415,820,636,184,0,800,20,1560,740,410,390
16,DÂMBOVIŢA,TĂRTĂŞEŞTI,105534,GULIA,"SCOALA GIMNAZIALĂ GULIA- TĂRTĂŞEŞTI,",386,"Alegeri Prezidentiale",1,951,899,563,336,0,881,18,1050,151,416,465
16,DÂMBOVIŢA,TĂRTĂŞEŞTI,105534,TĂRTĂŞEŞTI,"LICEUL TEHNOLOGIC TĂRTĂŞEŞTI,",387,"Alegeri Prezidentiale",1,960,663,426,237,0,654,9,1060,397,372,282
16,DÂMBOVIŢA,TĂTĂRANI,68921,TĂTĂRANI,"SALA DE FESTIVITĂŢI A PRIMĂRIEI TĂTĂRANI",388,"Alegeri Prezidentiale",1,877,542,487,55,0,532,10,960,418,242,290
16,DÂMBOVIŢA,TĂTĂRANI,68921,GHEBOIENI,"GRĂDINIŢA DE COPII GHEBOIENI",389,"Alegeri Prezidentiale",1,1249,623,570,53,0,610,13,1370,747,318,292
16,DÂMBOVIŢA,TĂTĂRANI,68921,CĂPRIORU,"CĂMIN CULTURAL SAT CĂPRIORU",390,"Alegeri Prezidentiale",1,1359,755,713,42,0,741,14,1500,745,300,441
16,DÂMBOVIŢA,TĂTĂRANI,68921,PRIBOIU,"CĂMIN CULTURAL",391,"Alegeri Prezidentiale",1,749,530,472,58,0,516,14,820,290,157,359
16,DÂMBOVIŢA,ULIEŞTI,68976,ULIEŞTI,"ŞCOALA GIMNAZIALĂ ULIEŞTI",392,"Alegeri Prezidentiale",1,1043,644,531,113,0,639,5,1150,506,356,283
16,DÂMBOVIŢA,ULIEŞTI,68976,CROITORI,"ŞCOALA CROITORI",393,"Alegeri Prezidentiale",1,698,322,279,43,0,319,3,770,448,194,125
16,DÂMBOVIŢA,ULIEŞTI,68976,JUGURENI,"ŞCOALA GIMNAZIALĂ JUGURENI",394,"Alegeri Prezidentiale",1,1263,811,696,115,0,806,5,1390,579,438,368
16,DÂMBOVIŢA,ULIEŞTI,68976,"HANU LUI PALĂ","ŞCOALA PRIMARĂ HANU LUI PALĂ",395,"Alegeri Prezidentiale",1,264,175,143,32,0,172,3,290,115,107,65
16,DÂMBOVIŢA,ULMI,65501,ULMI,"SCOALA GIMNAZIALA ULMI",396,"Alegeri Prezidentiale",1,1116,598,482,116,0,593,5,1230,632,348,245
16,DÂMBOVIŢA,ULMI,65501,DUMBRAVA,"GRADINITA DUMBRAVA",397,"Alegeri Prezidentiale",1,963,549,471,78,0,537,12,1060,511,354,183
16,DÂMBOVIŢA,ULMI,65501,VIIŞOARA,"SCOALA GIMNAZIALA ION CONSTANTINESCU VIISOARA",398,"Alegeri Prezidentiale",1,1134,656,590,66,0,649,7,1250,594,397,252
16,DÂMBOVIŢA,ULMI,65501,MATRACA,"GRADINITA MATRACA",399,"Alegeri Prezidentiale",1,599,338,302,36,0,336,2,660,322,189,147
16,DÂMBOVIŢA,"VALEA LUNGĂ",69063,"VALEA LUNGĂ-CRICOV","CAMINUL CULTURAL VALEA LUNGA CRICOV",400,"Alegeri Prezidentiale",1,1029,566,492,74,0,560,6,1130,564,295,265
16,DÂMBOVIŢA,"VALEA LUNGĂ",69063,"VALEA MARE","GRĂDINIȚA DE COPII VALEA MARE",401,"Alegeri Prezidentiale",1,439,233,207,26,0,230,3,480,247,147,83
16,DÂMBOVIŢA,"VALEA LUNGĂ",69063,"VALEA LUNGĂ-OGREA","CENTRU DE ASISTENȚĂ DUPĂ PROGRAM ȘCOLAR",402,"Alegeri Prezidentiale",1,1093,613,551,62,0,606,7,1200,587,368,238
16,DÂMBOVIŢA,"VALEA LUNGĂ",69063,"VALEA LUNGĂ-GORGOTA","ŞCOALA GIMNAZIALĂ ION HARALMBIE VALEA LUNGĂ GORGOTA",403,"Alegeri Prezidentiale",1,1030,546,482,64,0,535,11,1130,584,348,187
16,DÂMBOVIŢA,"VALEA LUNGĂ",69063,"ŞTUBEIE TISA","GRADINIŢA CU PROGRAM NORMAL ŞTUBEIE TISA",404,"Alegeri Prezidentiale",1,360,200,179,21,0,198,2,390,190,111,87
16,DÂMBOVIŢA,"VALEA MARE",69170,"VALEA MARE","ŞCOALA GIMNAZIALĂ VALEA MARE",405,"Alegeri Prezidentiale",1,1200,786,667,118,1,773,13,1320,534,292,481
16,DÂMBOVIŢA,"VALEA MARE",69170,"VALEA CASELOR","GRĂDINIŢA CU PROGRAM NORMAL VALEA CASELOR",406,"Alegeri Prezidentiale",1,590,385,344,41,0,373,12,650,265,128,245
16,DÂMBOVIŢA,VĂCĂREŞTI,69250,VĂCĂREŞTI,"ȘCOALA GIMNAZIALĂ ”IANCU VĂCĂRESCU” - VĂCĂREȘTI",407,"Alegeri Prezidentiale",1,1438,697,646,51,0,692,5,1590,893,444,248
16,DÂMBOVIŢA,VĂCĂREŞTI,69250,VĂCĂREŞTI,"ȘCOALA GIMNAZIALĂ ”IANCU VĂCĂRESCU” - VĂCĂREȘTI",408,"Alegeri Prezidentiale",1,1131,487,440,47,0,478,9,1240,753,299,179
16,DÂMBOVIŢA,VĂCĂREŞTI,69250,BUNGETU,"ȘCOALA GIMNAZIALĂ BUNGETU",409,"Alegeri Prezidentiale",1,1128,574,524,50,0,563,11,1240,666,328,235
16,DÂMBOVIŢA,VĂCĂREŞTI,69250,"BRĂTEŞTII DE JOS","GRĂDINIȚA CU PROGRAM NORMAL BRĂTEȘTII DE JOS",410,"Alegeri Prezidentiale",1,558,276,246,30,0,271,5,620,344,138,133
16,DÂMBOVIŢA,VĂLENI-DÂMBOVIŢA,69303,VĂLENI-DÂMBOVIŢA,"SCOALA GENERALA VALENI DIMBOVITA, PARTER SALA A DOUA",411,"Alegeri Prezidentiale",1,925,410,382,28,0,410,0,1020,610,246,164
16,DÂMBOVIŢA,VĂLENI-DÂMBOVIŢA,69303,VĂLENI-DÂMBOVIŢA,"SCOALA GENERALA VALENI DIMBOVITA, PARTER SALA PATRU",412,"Alegeri Prezidentiale",1,961,491,443,48,0,490,1,1060,569,252,238
16,DÂMBOVIŢA,VĂLENI-DÂMBOVIŢA,69303,MESTEACĂN,"SCOALA NOUA GENERALA MESTEACAN",413,"Alegeri Prezidentiale",1,225,120,101,19,0,119,1,251,131,63,56
16,DÂMBOVIŢA,VÂRFURI,69447,ŞUVIŢA,"CĂMINUL CULTURAL",414,"Alegeri Prezidentiale",1,1504,659,593,65,1,651,8,1660,1001,429,222
16,DÂMBOVIŢA,VIŞINA,69330,VIŞINA,"CĂMIN CULTURAL",415,"Alegeri Prezidentiale",1,1342,782,699,83,0,761,21,1480,698,308,453
16,DÂMBOVIŢA,VIŞINA,69330,VIŞINA,"GRĂDINIŢA NR. 1 VISINA",416,"Alegeri Prezidentiale",1,938,553,488,65,0,538,15,1030,477,232,306
16,DÂMBOVIŢA,VIŞINA,69330,BROŞTENI,"GRĂDINIŢA BROŞTENI",417,"Alegeri Prezidentiale",1,925,455,413,42,0,450,5,1020,565,181,269
16,DÂMBOVIŢA,VIŞINEŞTI,69394,VIŞINEŞTI,"ȘCOALA GIMNAZIALĂ VIȘINEȘTI",418,"Alegeri Prezidentiale",1,775,423,358,65,0,418,5,850,427,246,172
16,DÂMBOVIŢA,VIŞINEŞTI,69394,URSEIU,"ȘCOALA URSEIU",419,"Alegeri Prezidentiale",1,546,290,256,34,0,282,8,600,310,136,146
16,DÂMBOVIŢA,VIŞINEŞTI,69394,SULTANU,"CĂMIN CULTURAL SULTANU",420,"Alegeri Prezidentiale",1,249,167,111,56,0,165,2,270,103,70,95
16,DÂMBOVIŢA,VLĂDENI,179711,VLĂDENI,"ȘCOALA GIMNAZIALĂ ”STAN ȘTEFAN”",421,"Alegeri Prezidentiale",1,1296,640,584,56,0,631,9,1430,790,392,239
16,DÂMBOVIŢA,VLĂDENI,179711,VLĂDENI,"CĂMIN CULTURAL",422,"Alegeri Prezidentiale",1,1005,459,426,33,0,448,11,1110,651,312,136
16,DÂMBOVIŢA,VOINEŞTI,69526,GEMENEA-BRĂTULEŞTI,"CĂMINUL CULTURAL",423,"Alegeri Prezidentiale",1,960,573,516,57,0,566,7,1050,477,256,310
16,DÂMBOVIŢA,VOINEŞTI,69526,ONCEŞTI,"GRĂDINIŢA DE COPII",424,"Alegeri Prezidentiale",1,720,433,375,58,0,421,12,790,357,196,225
16,DÂMBOVIŢA,VOINEŞTI,69526,VOINEŞTI,"ŞCOALA CU CLASELE I-VIII",425,"Alegeri Prezidentiale",1,1335,889,773,116,0,864,25,1470,581,339,525
16,DÂMBOVIŢA,VOINEŞTI,69526,SUDULENI,"ŞCOALA CU CLASELE I-VIII",426,"Alegeri Prezidentiale",1,1318,682,616,66,0,668,14,1450,768,295,373
16,DÂMBOVIŢA,VOINEŞTI,69526,MANGA,"GRĂDINIŢA MANGA",427,"Alegeri Prezidentiale",1,646,328,284,44,0,320,8,710,382,128,192
16,DÂMBOVIŢA,VULCANA-BĂI,69615,VULCANA-BĂI,"GRĂDINIŢA DE COPII „ALBĂ CA ZĂPADA”",428,"Alegeri Prezidentiale",1,1288,695,624,68,3,679,16,1420,725,422,257
16,DÂMBOVIŢA,VULCANA-BĂI,69615,"VULCANA DE SUS","GRĂDINIŢA DE COPII „PARADISUL COPIILOR”",429,"Alegeri Prezidentiale",1,1168,498,450,40,8,492,6,1290,792,341,151
16,DÂMBOVIŢA,VULCANA-PANDELE,179640,VULCANA-PANDELE,"CĂMINUL CULTURAL ”IZVOR DE APĂ VIE”",430,"Alegeri Prezidentiale",1,1270,652,605,47,0,645,7,1400,748,316,329
16,DÂMBOVIŢA,VULCANA-PANDELE,179640,VULCANA-PANDELE,"GRĂDINIȚA CU PROGRAM NORMAL, VULCANA-PANDELE",431,"Alegeri Prezidentiale",1,1225,433,398,35,0,421,12,1350,917,194,227
16,DÂMBOVIŢA,VULCANA-PANDELE,179640,"GURA VULCANEI","ȘCOALA GIMNAZIALĂ GURA VULCANEI",432,"Alegeri Prezidentiale",1,904,404,385,19,0,395,9,990,586,247,148
16,DÂMBOVIŢA,VULCANA-PANDELE,179640,"GURA VULCANEI","ȘCOALA GIMNAZIALĂ GURA VULCANEI",433,"Alegeri Prezidentiale",1,809,358,335,23,0,350,8,890,532,225,125
17,DOLJ,"MUNICIPIUL CRAIOVA",69900,CRAIOVA,"COLEGIUL NAŢIONAL ”ELENA CUZA”",1,"Alegeri Prezidentiale",1,1212,721,593,128,0,702,19,1270,549,446,256
17,DOLJ,"MUNICIPIUL CRAIOVA",69900,CRAIOVA,"CASA DE CULTURA A STUDENŢILOR",2,"Alegeri Prezidentiale",1,1485,729,652,77,0,714,15,1600,871,443,271
17,DOLJ,"MUNICIPIUL CRAIOVA",69900,CRAIOVA,"PRIMARIA CRAIOVA- DIRECŢIA DE ASISTENŢĂ ŞI PROTECŢIE SOCIALĂ",3,"Alegeri Prezidentiale",1,1344,759,599,160,0,737,22,1400,641,530,207
17,DOLJ,"MUNICIPIUL CRAIOVA",69900,CRAIOVA,"LICEUL CU PROGRAM SPORTIV ”PETRACHE TRIŞCU”",4,"Alegeri Prezidentiale",1,1739,940,907,32,1,914,26,1804,864,576,338
17,DOLJ,"MUNICIPIUL CRAIOVA",69900,CRAIOVA,"LICEUL CU PROGRAM SPORTIV ”PETRACHE TRIȘCU”",5,"Alegeri Prezidentiale",1,1730,956,900,56,0,931,25,1800,844,609,322
17,DOLJ,"MUNICIPIUL CRAIOVA",69900,CRAIOVA,"LICEUL TEORETIC ”TRAIAN VUIA”",6,"Alegeri Prezidentiale",1,1219,683,640,43,0,662,21,1300,617,429,233
17,DOLJ,"MUNICIPIUL CRAIOVA",69900,CRAIOVA,"LICEUL TEORETIC ”TRAIAN VUIA”",7,"Alegeri Prezidentiale",1,1039,544,511,33,0,531,13,1100,556,298,233
17,DOLJ,"MUNICIPIUL CRAIOVA",69900,CRAIOVA,"UNIVERSITATEA DIN CRAIOVA",8,"Alegeri Prezidentiale",1,1723,988,846,142,0,967,21,1800,812,641,326
17,DOLJ,"MUNICIPIUL CRAIOVA",69900,CRAIOVA,"UNIVERSITATEA DIN CRAIOVA",9,"Alegeri Prezidentiale",1,983,613,506,107,0,600,13,1103,490,367,233
17,DOLJ,"MUNICIPIUL CRAIOVA",69900,CRAIOVA,"UNIVERSITATEA DIN CRAIOVA",10,"Alegeri Prezidentiale",1,1011,678,539,139,0,665,13,1100,422,444,221
17,DOLJ,"MUNICIPIUL CRAIOVA",69900,CRAIOVA,"ŞCOALA GIMNAZIALĂ NR.22 ”MIRCEA ELIADE”",11,"Alegeri Prezidentiale",1,1194,646,587,59,0,634,12,1300,654,381,253
17,DOLJ,"MUNICIPIUL CRAIOVA",69900,CRAIOVA,"ŞCOALA GIMNAZIALĂ ”MIRCEA ELIADE”",12,"Alegeri Prezidentiale",1,1514,866,814,52,0,847,19,1600,734,515,332
17,DOLJ,"MUNICIPIUL CRAIOVA",69900,CRAIOVA,"GRADINIŢA CU PROGRAM PRELUNGIT ”DUMBRAVA MINUNATA” ( FOSTĂ NR.37)",13,"Alegeri Prezidentiale",1,1796,963,910,53,0,944,19,1900,937,578,366
17,DOLJ,"MUNICIPIUL CRAIOVA",69900,CRAIOVA,"GRADINIŢA CU PROGRAM PRELUNGIT ”DUMBRAVA MINUNATA”(FOSTĂ NR.37)",14,"Alegeri Prezidentiale",1,1732,947,710,129,108,935,12,1800,853,605,330
17,DOLJ,"MUNICIPIUL CRAIOVA",69900,CRAIOVA,"ŞCOALA GIMNAZIALĂ ”MIHAI EMINESCU”(FOSTA NR.37",15,"Alegeri Prezidentiale",1,1233,644,582,62,0,633,11,1300,656,406,227
17,DOLJ,"MUNICIPIUL CRAIOVA",69900,CRAIOVA,"ŞCOALA GIMNAZIALĂ ”MIHAI EMINESCU”(FOSTA NR.37)",16,"Alegeri Prezidentiale",1,1358,733,617,116,0,725,8,1400,667,445,280
17,DOLJ,"MUNICIPIUL CRAIOVA",69900,CRAIOVA,"ŞCOALA GIMNAZIALĂ ”MIHAI EMINESCU”(FOSTA NR. 37)",17,"Alegeri Prezidentiale",1,1235,593,521,72,0,585,8,1300,707,366,219
17,DOLJ,"MUNICIPIUL CRAIOVA",69900,CRAIOVA,"GRADINIŢA CU PROGRAM NORMAL ”PRICHINDEL”(FOSTA NR. 55) – STRUCTURĂ A ŞCOLII GIMNAZIALE ”MIHAI EMINESCU” (FOSTA NR.37))",18,"Alegeri Prezidentiale",1,1000,535,452,83,0,524,11,1100,565,291,233
17,DOLJ,"MUNICIPIUL CRAIOVA",69900,CRAIOVA,"GRADINIŢA CU PROGRAM NORMAL ”PRICHINDEL”(FOSTA NR. 55) – STRUCTURĂ A ŞCOLII GIMNAZIALE ”MIHAI EMINESCU” (FOSTA NR.37)",19,"Alegeri Prezidentiale",1,1309,577,521,56,0,570,7,1400,823,348,222
17,DOLJ,"MUNICIPIUL CRAIOVA",69900,CRAIOVA,"LICEUL TEORETIC ”HENRI COANDĂ”",20,"Alegeri Prezidentiale",1,1593,821,654,166,1,802,19,1700,879,543,259
17,DOLJ,"MUNICIPIUL CRAIOVA",69900,CRAIOVA,"LICEUL TEORETIC ”HENRI COANDĂ”",21,"Alegeri Prezidentiale",1,1400,726,647,79,0,714,12,1500,774,446,268
17,DOLJ,"MUNICIPIUL CRAIOVA",69900,CRAIOVA,"LICEUL TEORETIC ”HENRI COANDĂ”",22,"Alegeri Prezidentiale",1,1506,762,723,39,0,741,21,1600,838,488,253
17,DOLJ,"MUNICIPIUL CRAIOVA",69900,CRAIOVA,"LICEUL TEHNOLOGIC UCECOM „SPIRU HARET”",23,"Alegeri Prezidentiale",1,1723,941,823,118,0,917,24,1800,859,579,338
17,DOLJ,"MUNICIPIUL CRAIOVA",69900,CRAIOVA,"LICEUL ”VOLTAIRE”",24,"Alegeri Prezidentiale",1,1813,826,768,58,0,807,19,1900,1074,519,288
17,DOLJ,"MUNICIPIUL CRAIOVA",69900,CRAIOVA,"LICEUL ”VOLTAIRE”",25,"Alegeri Prezidentiale",1,1765,673,633,40,0,659,14,1800,1127,401,258
17,DOLJ,"MUNICIPIUL CRAIOVA",69900,CRAIOVA,"GRADINIŢA DE COPII CU PROGRAM PRELUNGIT ”ELENA FARAGO”(FOSTA NR.41)",26,"Alegeri Prezidentiale",1,906,493,406,87,0,483,10,1000,507,307,176
17,DOLJ,"MUNICIPIUL CRAIOVA",69900,CRAIOVA,"GRADINIŢA DE COPII CU PROGRAM PRELUNGIT ”ELENA FARAGO”(FOSTA NR. 41)",27,"Alegeri Prezidentiale",1,1309,593,538,55,0,582,11,1400,807,347,235
17,DOLJ,"MUNICIPIUL CRAIOVA",69900,CRAIOVA,"ŞCOALA GIMNAZIALĂ „NICOLAE ROMANESCU”",28,"Alegeri Prezidentiale",1,1540,844,757,87,0,823,21,1600,756,536,287
17,DOLJ,"MUNICIPIUL CRAIOVA",69900,CRAIOVA,"GRADINIŢA CU PROGRAM PRELUNGIT ”ION CREANGA” (FOSTA NR. 42)",29,"Alegeri Prezidentiale",1,1336,647,589,58,0,633,14,1400,753,381,252
17,DOLJ,"MUNICIPIUL CRAIOVA",69900,CRAIOVA,"ŞCOALA GIMNAZIALĂ ”NICOLAE ROMANESCU” (FOSTA NR. 29)",30,"Alegeri Prezidentiale",1,1480,777,618,159,0,761,16,1600,823,504,257
17,DOLJ,"MUNICIPIUL CRAIOVA",69900,CRAIOVA,"ŞCOALA GIMNAZIALĂ ”NICOLAE ROMANESCU” (FOSTA NR. 29)",31,"Alegeri Prezidentiale",1,1278,711,656,53,2,706,5,1400,689,411,295
17,DOLJ,"MUNICIPIUL CRAIOVA",69900,CRAIOVA,"ŞCOALA GIMNAZIALĂ ”NICOLAE ROMANESCU” (FOSTA NR. 29)",32,"Alegeri Prezidentiale",1,1224,606,491,51,64,590,16,1300,694,321,269
17,DOLJ,"MUNICIPIUL CRAIOVA",69900,CRAIOVA,"UNIVERSITATEA DE MEDICINĂ ŞI FARMACIE, (SEDIUL VECHI)",33,"Alegeri Prezidentiale",1,1047,605,462,63,80,598,7,1200,595,368,230
17,DOLJ,"MUNICIPIUL CRAIOVA",69900,CRAIOVA,"UNIVERSITATEA DE MEDICINĂ ŞI FARMACIE, (SEDIUL VECHI)",34,"Alegeri Prezidentiale",1,1132,689,553,53,83,672,17,1200,511,429,243
17,DOLJ,"MUNICIPIUL CRAIOVA",69900,CRAIOVA,"LICEUL TEHNOLOGIC DE TRANSPORTURI AUTO",35,"Alegeri Prezidentiale",1,1865,799,745,54,0,771,28,1900,1101,463,308
17,DOLJ,"MUNICIPIUL CRAIOVA",69900,CRAIOVA,"LICEUL TEHNOLOGIC DE TRANSPORTURI AUTO",36,"Alegeri Prezidentiale",1,1824,694,643,49,2,677,17,1900,1206,385,292
17,DOLJ,"MUNICIPIUL CRAIOVA",69900,CRAIOVA,"LICEUL TEHNOLOGIC DE TRANSPORTURI AUTO",37,"Alegeri Prezidentiale",1,1569,831,608,34,189,813,18,1700,869,374,439
17,DOLJ,"MUNICIPIUL CRAIOVA",69900,CRAIOVA,"LICEUL TEHNOLOGIC DE TRANSPORTURI AUTO",38,"Alegeri Prezidentiale",1,1740,767,733,34,0,753,14,1800,1033,439,314
17,DOLJ,"MUNICIPIUL CRAIOVA",69900,CRAIOVA,"LICEUL TEHNOLOGIC DE TRANSPORTURI AUTO, (FOSTA ȘCOALĂ CU CLASELE I-VIII NR.25 FĂCĂI)",39,"Alegeri Prezidentiale",1,1183,496,400,49,47,488,8,1300,804,289,199
17,DOLJ,"MUNICIPIUL CRAIOVA",69900,CRAIOVA,"DIRECȚIA DE ASISTENȚĂ SOCIALĂ CRAIOVA CENTRUL DE ZI PENTRU PERSOANE VÂRSTNICE ”CLUBUL SENIORILOR”",40,"Alegeri Prezidentiale",1,878,412,391,21,0,406,6,1000,588,235,171
17,DOLJ,"MUNICIPIUL CRAIOVA",69900,CRAIOVA,"ȘCOALA GIMNAZIALA ”GHEORGHE BIBESCU” (FOSTA NR. 36)",41,"Alegeri Prezidentiale",1,1348,728,628,100,0,706,22,1400,672,436,270
17,DOLJ,"MUNICIPIUL CRAIOVA",69900,CRAIOVA,"ȘCOALA GIMNAZIALA ”GHEORGHE BIBESCU” (FOSTA NR. 36)",42,"Alegeri Prezidentiale",1,1635,807,713,94,0,785,22,1700,893,481,304
17,DOLJ,"MUNICIPIUL CRAIOVA",69900,CRAIOVA,"ȘCOALA GIMNAZIALA ”GHEORGHE BIBESCU” (FOSTA NR. 36)",43,"Alegeri Prezidentiale",1,1701,848,785,63,0,829,19,1800,952,537,292
17,DOLJ,"MUNICIPIUL CRAIOVA",69900,CRAIOVA,"ȘCOALA GIMNAZIALA ”GHEORGHE BIBESCU” (FOSTA NR. 36)",44,"Alegeri Prezidentiale",1,1524,672,653,19,0,658,14,1600,928,418,240
17,DOLJ,"MUNICIPIUL CRAIOVA",69900,CRAIOVA,"COLEGIUL NAȚIONAL ECONOMIC ”GHEORGHE CHIȚU”",45,"Alegeri Prezidentiale",1,1447,755,655,100,0,744,11,1500,745,479,265
17,DOLJ,"MUNICIPIUL CRAIOVA",69900,CRAIOVA,"COLEGIUL NAȚIONAL ECONOMIC ”GHEORGHE CHIȚU”",46,"Alegeri Prezidentiale",1,1365,716,581,55,80,704,12,1500,784,439,265
17,DOLJ,"MUNICIPIUL CRAIOVA",69900,CRAIOVA,"COLEGIUL NAŢIONAL ECONOMIC ”GHEORGHE CHIŢU”",47,"Alegeri Prezidentiale",1,1614,750,714,36,0,734,16,1700,950,454,280
17,DOLJ,"MUNICIPIUL CRAIOVA",69900,CRAIOVA,"UNIVERSITATEA DE MEDICINA SI FARMACIE, (SEDIUL NOU)",48,"Alegeri Prezidentiale",1,1581,1160,732,345,83,1132,28,1700,540,758,374
17,DOLJ,"MUNICIPIUL CRAIOVA",69900,CRAIOVA,"ŞCOALA GIMNAZIALĂ ”SFÂNTUL DUMITRU” (FOSTA NR. 18)",49,"Alegeri Prezidentiale",2,1133,691,615,76,0,676,15,1192,501,414,262
17,DOLJ,"MUNICIPIUL CRAIOVA",69900,CRAIOVA,"LICEUL DE ARTE ”MARIN SORESCU”",50,"Alegeri Prezidentiale",1,1453,989,763,65,161,962,27,1600,611,551,411
17,DOLJ,"MUNICIPIUL CRAIOVA",69900,CRAIOVA,"LICEUL DE ARTE ”MARIN SORESCU”",51,"Alegeri Prezidentiale",1,1370,768,684,84,0,749,19,1503,735,492,257
17,DOLJ,"MUNICIPIUL CRAIOVA",69900,CRAIOVA,"COLEGIUL NATIONAL ”FRAŢII BUZEŞTI”",52,"Alegeri Prezidentiale",1,1903,1059,963,61,35,1043,16,2115,1056,632,411
17,DOLJ,"MUNICIPIUL CRAIOVA",69900,CRAIOVA,"COLEGIUL NATIONAL ”FRAŢII BUZEŞTI”",53,"Alegeri Prezidentiale",1,1775,929,841,87,1,915,14,1900,971,538,377
17,DOLJ,"MUNICIPIUL CRAIOVA",69900,CRAIOVA,"ŞCOALA GIMNAZIALĂ ”LASCĂR CATARGIU” (FOSTA NR. 19)",54,"Alegeri Prezidentiale",2,1972,909,806,103,0,890,19,2100,1191,441,449
17,DOLJ,"MUNICIPIUL CRAIOVA",69900,CRAIOVA,"ŞCOALA GIMNAZIALĂ ”LASCĂR CATARGIU” (FOSTA NR. 19)",55,"Alegeri Prezidentiale",1,1758,784,726,58,0,761,23,1800,1016,422,339
17,DOLJ,"MUNICIPIUL CRAIOVA",69900,CRAIOVA,"ŞCOALA GIMNAZIALĂ ”LASCĂR CATARGIU” (FOSTA NR. 19)",56,"Alegeri Prezidentiale",1,1796,717,685,32,0,710,7,1900,1183,410,300
17,DOLJ,"MUNICIPIUL CRAIOVA",69900,CRAIOVA,"ŞCOALA GIMNAZIALĂ ”LASCĂR CATARGIU” (FOSTA NR. 19)",57,"Alegeri Prezidentiale",1,1834,864,816,48,0,848,16,1900,1036,459,389
17,DOLJ,"MUNICIPIUL CRAIOVA",69900,CRAIOVA,"ŞCOALA GIMNAZIALA NR. 26 MOFLENI – STRUCTURĂ A ŞCOLII GIMNAZIALE ”ANTON PAN” (FOSTA NR.13 BUCOVĂŢ)",58,"Alegeri Prezidentiale",1,1335,468,438,29,1,460,8,1404,936,247,213
17,DOLJ,"MUNICIPIUL CRAIOVA",69900,CRAIOVA,"S.C. PENTRU LUCRARI DE DRUMURI ŞI PODURI DOLJ S.A",59,"Alegeri Prezidentiale",1,1909,579,465,114,0,570,9,2000,1421,233,337
17,DOLJ,"MUNICIPIUL CRAIOVA",69900,CRAIOVA,"ŞCOALA GIMNAZIALĂ ”ANTON PAN” (FOSTA NR.13 BUCOVĂŢ)",60,"Alegeri Prezidentiale",1,1923,644,587,57,0,638,6,2000,1356,353,285
17,DOLJ,"MUNICIPIUL CRAIOVA",69900,CRAIOVA,"COLEGIUL NAŢIONAL ”CAROL I”",61,"Alegeri Prezidentiale",1,945,592,479,112,1,581,11,1000,408,374,207
17,DOLJ,"MUNICIPIUL CRAIOVA",69900,CRAIOVA,"COLEGIUL NAȚIONAL ”CAROL I”",62,"Alegeri Prezidentiale",1,1288,596,569,27,0,584,12,1400,804,399,185
17,DOLJ,"MUNICIPIUL CRAIOVA",69900,CRAIOVA,"FACULTATEA DE AGRONOMIE",63,"Alegeri Prezidentiale",1,1936,933,789,144,0,916,17,2000,1067,563,353
17,DOLJ,"MUNICIPIUL CRAIOVA",69900,CRAIOVA,"FACULTATEA DE AGRONOMIE",64,"Alegeri Prezidentiale",1,1806,1024,896,128,0,996,28,1900,876,649,347
17,DOLJ,"MUNICIPIUL CRAIOVA",69900,CRAIOVA,"GRADINIŢA CU PROGRAM PRELUNGIT ”PARADISUL COPIILOR” (FOSTA NR. 24)",65,"Alegeri Prezidentiale",1,1175,519,476,43,0,503,16,1300,781,320,183
17,DOLJ,"MUNICIPIUL CRAIOVA",69900,CRAIOVA,"GRADINIŢA CU PROGRAM PRELUNGIT ”PARADISUL COPIILOR”, (FOSTA NR. 24)",66,"Alegeri Prezidentiale",1,964,534,469,65,0,520,14,1000,466,327,193
17,DOLJ,"MUNICIPIUL CRAIOVA",69900,CRAIOVA,"COLEGIUL TEHNIC DE INDUSTRIE ALIMENTARĂ",67,"Alegeri Prezidentiale",1,1884,1036,855,181,0,1020,16,2000,964,696,324
17,DOLJ,"MUNICIPIUL CRAIOVA",69900,CRAIOVA,"COLEGIUL TEHNIC DE INDUSTRIE ALIMENTARĂ",68,"Alegeri Prezidentiale",1,1832,728,708,20,0,710,18,1900,1172,399,311
17,DOLJ,"MUNICIPIUL CRAIOVA",69900,CRAIOVA,"COLEGIUL TEHNIC DE INDUSTRIE ALIMENTARĂ",69,"Alegeri Prezidentiale",1,1724,740,693,47,0,724,16,1800,1060,428,296
17,DOLJ,"MUNICIPIUL CRAIOVA",69900,CRAIOVA,"ŞCOALA GIMNAZIALĂ ”ION CREANGĂ” (FOSTA NR.16)",70,"Alegeri Prezidentiale",1,1696,708,663,44,1,701,7,1800,1092,414,287
17,DOLJ,"MUNICIPIUL CRAIOVA",69900,CRAIOVA,"ŞCOALA GIMNAZIALĂ ”ION CREANGĂ” (FOSTA NR.16)",71,"Alegeri Prezidentiale",1,1842,755,730,25,0,739,16,1900,1145,446,293
17,DOLJ,"MUNICIPIUL CRAIOVA",69900,CRAIOVA,"ŞCOALA GIMNAZIALĂ ”ION CREANGĂ” (FOSTA NR.16)",72,"Alegeri Prezidentiale",1,1803,681,663,18,0,664,17,1900,1219,384,280
17,DOLJ,"MUNICIPIUL CRAIOVA",69900,CRAIOVA,"GRĂDINITA CU PROGRAM NORMAL ”CASA CU PITICI” (FOSTA NR. 15) – STRUCTURĂ A ŞCOLII GIMNAZIALE ”ION CREANGA” (FOSTĂ NR.16)",73,"Alegeri Prezidentiale",1,1710,748,694,54,0,739,9,1800,1052,481,258
17,DOLJ,"MUNICIPIUL CRAIOVA",69900,CRAIOVA,"RAT S.R.L.",74,"Alegeri Prezidentiale",1,1645,772,731,41,0,755,17,1700,928,459,296
17,DOLJ,"MUNICIPIUL CRAIOVA",69900,CRAIOVA,"ȘCOALA GIMNAZIALĂ ”ELENA FARAGO” (FOSTA SCOALA GIMNAZIALA NR.34)",75,"Alegeri Prezidentiale",1,1496,764,690,74,0,747,17,1599,835,442,305
17,DOLJ,"MUNICIPIUL CRAIOVA",69900,CRAIOVA,"ȘCOALA GIMNAZIALĂ ”ELENA FARAGO” (FOSTA SCOALA GIMNAZIALA NR.34)",76,"Alegeri Prezidentiale",1,1540,697,637,49,11,686,11,1600,903,417,269
17,DOLJ,"MUNICIPIUL CRAIOVA",69900,CRAIOVA,"ȘCOALA GIMNAZIALĂ ”ELENA FARAGO” (FOSTA SCOALA GIMNAZIALA NR.34)",77,"Alegeri Prezidentiale",1,1526,683,642,41,0,664,19,1600,917,415,249
17,DOLJ,"MUNICIPIUL CRAIOVA",69900,CRAIOVA,"ȘCOALA GIMNAZIALĂ ”ELENA FARAGO” (FOSTA SCOALA GIMNAZIALA NR.34)",78,"Alegeri Prezidentiale",1,1745,835,805,30,0,816,19,1800,965,497,319
17,DOLJ,"MUNICIPIUL CRAIOVA",69900,CRAIOVA,"ȘCOALA GIMNAZIALĂ ”ELENA FARAGO” (FOSTA SCOALA GIMNAZIALA NR.33)",79,"Alegeri Prezidentiale",1,1768,824,724,100,0,804,20,1800,976,498,306
17,DOLJ,"MUNICIPIUL CRAIOVA",69900,CRAIOVA,"ȘCOALA GIMNAZIALĂ ”ELENA FARAGO” (FOSTA SCOALA GIMNAZIALA NR.33)",80,"Alegeri Prezidentiale",1,1710,817,769,48,0,806,11,1800,983,488,318
17,DOLJ,"MUNICIPIUL CRAIOVA",69900,CRAIOVA,"ȘCOALA GIMNAZIALĂ ”ELENA FARAGO” (FOSTA SCOALA GIMNAZIALA NR.33)",81,"Alegeri Prezidentiale",1,1641,737,711,26,0,725,12,1700,963,419,306
17,DOLJ,"MUNICIPIUL CRAIOVA",69900,CRAIOVA,"GRADINIŢA CU PROGRAM PRELUNGIT ”PITICOT” (FOSTA NR.45)",82,"Alegeri Prezidentiale",1,1651,758,738,20,0,747,11,1700,942,412,335
17,DOLJ,"MUNICIPIUL CRAIOVA",69900,CRAIOVA,"GRADINIŢA CU PROGRAM PRELUNGIT ”PITICOT” (FOSTA NR.45)",83,"Alegeri Prezidentiale",1,1218,599,566,33,0,590,9,1300,701,350,240
17,DOLJ,"MUNICIPIUL CRAIOVA",69900,CRAIOVA,"GRADINIŢA CU PROGRAM PRELUNGIT ”PITICOT” (FOSTA NR.45)",84,"Alegeri Prezidentiale",1,1059,515,479,36,0,508,7,1100,585,258,250
17,DOLJ,"MUNICIPIUL CRAIOVA",69900,CRAIOVA,"GRADINIŢA CU PROGRAM PRELUNGIT ”FLOAREA SOARELUI” (FOSTA NR.51)",85,"Alegeri Prezidentiale",1,1246,668,642,26,0,646,22,1300,632,375,271
17,DOLJ,"MUNICIPIUL CRAIOVA",69900,CRAIOVA,"GRADINIŢA CU PROGRAM PRELUNGIT ”FLOAREA SOARELUI” (FOSTA NR.51)",86,"Alegeri Prezidentiale",1,1332,566,522,44,0,553,13,1400,834,316,237
17,DOLJ,"MUNICIPIUL CRAIOVA",69900,CRAIOVA,"GRADINIŢA CU PROGRAM PRELUNGIT ”FLOAREA SOARELUI” (FOSTA NR.51)",87,"Alegeri Prezidentiale",1,1296,632,580,52,0,617,15,1400,768,336,281
17,DOLJ,"MUNICIPIUL CRAIOVA",69900,CRAIOVA,"ŞCOALA GIMNAZIALĂ ”ALEXANDRU MACEDONSKI” (FOSTA NR.32)",88,"Alegeri Prezidentiale",1,1620,808,703,105,0,794,14,1700,892,458,336
17,DOLJ,"MUNICIPIUL CRAIOVA",69900,CRAIOVA,"ŞCOALA GIMNAZIALĂ ”ALEXANDRU MACEDONSKI” (FOSTA NR.32)",89,"Alegeri Prezidentiale",1,1664,827,742,84,1,812,15,1700,873,485,327
17,DOLJ,"MUNICIPIUL CRAIOVA",69900,CRAIOVA,"ŞCOALA GIMNAZIALĂ ”ALEXANDRU MACEDONSKI” (FOSTA NR.32)",90,"Alegeri Prezidentiale",1,1816,770,706,64,0,755,15,1900,1130,447,308
17,DOLJ,"MUNICIPIUL CRAIOVA",69900,CRAIOVA,"ŞCOALA GIMNAZIALĂ ”ALEXANDRU MACEDONSKI” (FOSTA NR.32)",91,"Alegeri Prezidentiale",1,1696,790,747,43,0,776,14,1800,1010,472,304
17,DOLJ,"MUNICIPIUL CRAIOVA",69900,CRAIOVA,"GRĂDINIŢA CU PROGRAM PRELUNGIT ”FLOARE ALBASTRA” (FOSTA NR.40)",92,"Alegeri Prezidentiale",1,1288,622,572,50,0,605,17,1400,778,378,227
17,DOLJ,"MUNICIPIUL CRAIOVA",69900,CRAIOVA,"GRĂDINIŢA CU PROGRAM PRELUNGIT ”FLOARE ALBASTRA” (FOSTA NR.40)",93,"Alegeri Prezidentiale",1,1539,699,639,60,0,683,16,1600,901,394,289
17,DOLJ,"MUNICIPIUL CRAIOVA",69900,CRAIOVA,"ŞCOALA GIMNAZIALĂ ”MIHAI VITEAZU” (FOSTA NR.30)",94,"Alegeri Prezidentiale",1,1375,664,555,109,0,649,15,1500,836,379,270
17,DOLJ,"MUNICIPIUL CRAIOVA",69900,CRAIOVA,"ŞCOALA GIMNAZIALĂ ”MIHAI VITEAZU” (FOSTA NR.30)",95,"Alegeri Prezidentiale",1,1546,643,605,38,0,631,12,1600,957,369,262
17,DOLJ,"MUNICIPIUL CRAIOVA",69900,CRAIOVA,"ŞCOALA GIMNAZIALĂ ”MIHAI VITEAZU” (FOSTA NR.30)",96,"Alegeri Prezidentiale",1,1468,666,632,34,0,656,10,1500,834,377,279
17,DOLJ,"MUNICIPIUL CRAIOVA",69900,CRAIOVA,"ŞCOALA GIMNAZIALĂ ”MIHAI VITEAZU” (FOSTA NR.30)",97,"Alegeri Prezidentiale",1,1369,615,589,26,0,601,14,1500,885,363,238
17,DOLJ,"MUNICIPIUL CRAIOVA",69900,CRAIOVA,"ŞCOALA GIMNAZIALĂ ”MIHAI VITEAZU” (FOSTA NR.30)",98,"Alegeri Prezidentiale",1,1407,618,605,12,1,610,8,1500,882,341,269
17,DOLJ,"MUNICIPIUL CRAIOVA",69900,CRAIOVA,"LICEUL TEHNOLOGIC ”GEORGE BIBESCU”",99,"Alegeri Prezidentiale",1,1282,607,509,98,0,589,18,1400,793,360,229
17,DOLJ,"MUNICIPIUL CRAIOVA",69900,CRAIOVA,"LICEUL TEHNOLOGIC ”GEORGE BIBESCU”",100,"Alegeri Prezidentiale",1,1166,515,488,27,0,505,10,1200,685,299,206
17,DOLJ,"MUNICIPIUL CRAIOVA",69900,CRAIOVA,"GRADINIŢA CU PROGRAM PRELUNGIT ”PHOENIX” (FOSTA NR.52)",101,"Alegeri Prezidentiale",1,1185,573,507,65,1,566,7,1300,727,322,244
17,DOLJ,"MUNICIPIUL CRAIOVA",69900,CRAIOVA,"GRADINITA CU PROGRAM PRELUNGIT ”PHOENIX” (FOSTA NR. 52)",102,"Alegeri Prezidentiale",1,1147,545,496,49,0,537,8,1200,655,343,194
17,DOLJ,"MUNICIPIUL CRAIOVA",69900,CRAIOVA,"COLEGIUL TEHNIC ”COSTIN D. NENITESCU”",103,"Alegeri Prezidentiale",1,1853,958,877,81,0,939,19,1900,942,572,367
17,DOLJ,"MUNICIPIUL CRAIOVA",69900,CRAIOVA,"COLEGIUL TEHNIC ”COSTIN D. NENIŢESCU”",104,"Alegeri Prezidentiale",1,1808,850,776,74,0,836,14,1900,1050,516,320
17,DOLJ,"MUNICIPIUL CRAIOVA",69900,CRAIOVA,"COLEGIUL TEHNIC ”COSTIN D. NENIŢESCU”",105,"Alegeri Prezidentiale",1,1514,666,633,33,0,644,22,1600,934,387,257
17,DOLJ,"MUNICIPIUL CRAIOVA",69900,CRAIOVA,"COLEGIUL TEHNIC ”COSTIN D. NENIŢESCU”",106,"Alegeri Prezidentiale",1,1548,768,725,43,0,741,27,1600,832,451,290
17,DOLJ,"MUNICIPIUL CRAIOVA",69900,CRAIOVA,"COLEGIUL TEHNIC ”COSTIN D. NENIŢESCU”",107,"Alegeri Prezidentiale",1,1653,750,720,30,0,731,19,1700,950,472,259
17,DOLJ,"MUNICIPIUL CRAIOVA",69900,CRAIOVA,"ŞCOALA GIMNAZIALĂ ”DECEBAL” (FOSTA NR. 12)",108,"Alegeri Prezidentiale",1,1442,736,645,91,0,727,9,1500,764,466,261
17,DOLJ,"MUNICIPIUL CRAIOVA",69900,CRAIOVA,"ŞCOALA GIMNAZIALĂ ”DECEBAL” (FOSTA NR. 12)",109,"Alegeri Prezidentiale",1,1396,748,717,31,0,731,17,1500,752,456,275
17,DOLJ,"MUNICIPIUL CRAIOVA",69900,CRAIOVA,"ŞCOALA GIMNAZIALĂ ”DECEBAL” (FOSTA NR. 12)",110,"Alegeri Prezidentiale",1,1466,758,723,35,0,744,14,1500,742,469,275
17,DOLJ,"MUNICIPIUL CRAIOVA",69900,CRAIOVA,"COLEGIUL TEHNIC ENERGETIC",111,"Alegeri Prezidentiale",1,1574,831,773,58,0,817,14,1600,769,544,273
17,DOLJ,"MUNICIPIUL CRAIOVA",69900,CRAIOVA,"COLEGIUL TEHNIC ENERGETIC",112,"Alegeri Prezidentiale",1,1481,747,648,76,23,733,14,1600,853,446,287
17,DOLJ,"MUNICIPIUL CRAIOVA",69900,CRAIOVA,"COLEGIUL TEHNIC ENERGETIC",113,"Alegeri Prezidentiale",1,1331,688,632,56,0,668,20,1400,712,405,263
17,DOLJ,"MUNICIPIUL CRAIOVA",69900,CRAIOVA,"COLEGIUL NAŢIONAL PEDAGOGIC ”ŞTEFAN VELOVAN”",114,"Alegeri Prezidentiale",1,1861,930,826,104,0,910,20,2000,1070,596,314
17,DOLJ,"MUNICIPIUL CRAIOVA",69900,CRAIOVA,"COLEGIUL NAŢIONAL PEDAGOGIC ”ŞTEFAN VELOVAN”",115,"Alegeri Prezidentiale",1,1708,871,795,76,0,849,22,1800,929,559,290
17,DOLJ,"MUNICIPIUL CRAIOVA",69900,CRAIOVA,"GRĂDINIŢA CU PROGRAM PRELUNGIT ”CASUTA CU POVESTI” (FOSTA NR.43)",116,"Alegeri Prezidentiale",1,1639,750,703,47,0,733,17,1700,950,455,278
17,DOLJ,"MUNICIPIUL CRAIOVA",69900,CRAIOVA,"GRADINITA CU PROGRAM PRELUNGIT ”CASUTA CU POVESTI” (FOSTA NR. 43)",117,"Alegeri Prezidentiale",1,1501,804,736,68,0,792,12,1600,796,494,298
17,DOLJ,"MUNICIPIUL CRAIOVA",69900,CRAIOVA,"GRĂDINIŢA CU PROGRAM PRELUNGIT ”VOINICEII” (FOSTA NR.32)",118,"Alegeri Prezidentiale",1,1452,747,712,35,0,732,15,1500,753,448,284
17,DOLJ,"MUNICIPIUL CRAIOVA",69900,CRAIOVA,"GRĂDINIŢA CU PROGRAM PRELUNGIT ”VOINICEII” (FOSTA NR.32)",119,"Alegeri Prezidentiale",1,1314,710,633,76,1,688,22,1400,690,429,259
17,DOLJ,"MUNICIPIUL CRAIOVA",69900,CRAIOVA,"ŞCOALA GIMNAZIALĂ ”SFÂNTU GHEORGHE” (FOSTA NR.24)",120,"Alegeri Prezidentiale",1,1732,945,832,112,1,912,33,1800,855,579,333
17,DOLJ,"MUNICIPIUL CRAIOVA",69900,CRAIOVA,"ŞCOALA GIMNAZIALĂ ”SFÂNTU GHEORGHE” (FOSTA NR.24)",121,"Alegeri Prezidentiale",1,1599,891,791,100,0,869,22,1700,809,505,364
17,DOLJ,"MUNICIPIUL CRAIOVA",69900,CRAIOVA,"ŞCOALA GIMNAZIALĂ ”SFÂNTU GHEORGHE” (FOSTA NR.24)",122,"Alegeri Prezidentiale",1,1582,812,748,64,0,797,15,1700,888,471,326
17,DOLJ,"MUNICIPIUL CRAIOVA",69900,CRAIOVA,"LICEUL TEHNOLOGIC TRANSPORTURI CĂI FERATE",123,"Alegeri Prezidentiale",1,907,516,452,62,2,504,12,1100,584,337,167
17,DOLJ,"MUNICIPIUL CRAIOVA",69900,CRAIOVA,"LICEUL TEHNOLOGIC TRANSPORTURI CĂI FERATE",124,"Alegeri Prezidentiale",1,1012,663,503,25,135,646,17,1200,537,374,272
17,DOLJ,"MUNICIPIUL CRAIOVA",69900,CRAIOVA,"COLEGIUL NAȚIONAL ”NICOLAE TITULESCU”",125,"Alegeri Prezidentiale",1,1684,1001,886,115,0,977,24,1801,800,584,393
17,DOLJ,"MUNICIPIUL CRAIOVA",69900,CRAIOVA,"ŞCOALA GIMNAZIALĂ ”TRAIAN” (FOSTA NR. 2)",126,"Alegeri Prezidentiale",1,972,557,511,44,2,547,10,1100,543,365,182
17,DOLJ,"MUNICIPIUL CRAIOVA",69900,CRAIOVA,"ŞCOALA GIMNAZIALĂ ”TRAIAN” (FOSTA NR.2)",127,"Alegeri Prezidentiale",1,1190,729,645,83,1,714,15,1300,571,493,221
17,DOLJ,"MUNICIPIUL CRAIOVA",69900,CRAIOVA,"GRĂDINIŢA CU PROGRAM PRELUNGIT ”TUDOR VLADIMIRESCU” (FOSTA NR.21)",128,"Alegeri Prezidentiale",1,1707,969,888,81,0,938,31,1800,831,577,361
17,DOLJ,"MUNICIPIUL CRAIOVA",69900,CRAIOVA,"ŞCOALA GIMNAZIALĂ „SF. GHEORGHE” (FOSTA SCOALA CU CLASELE I - VIII NR.23)",129,"Alegeri Prezidentiale",1,1706,950,888,62,0,926,24,1800,850,573,353
17,DOLJ,"MUNICIPIUL CRAIOVA",69900,CRAIOVA,"ŞCOALA GIMNAZIALĂ „SF. GHEORGHE” (FOSTA SCOALA CU CLASELE I - VIII NR.23)",130,"Alegeri Prezidentiale",1,1713,889,848,41,0,867,22,1800,911,512,355
17,DOLJ,"MUNICIPIUL CRAIOVA",69900,CRAIOVA,"ŞCOALA GIMNAZIALĂ „SF. GHEORGHE” (FOSTA SCOALA CU CLASELE I - VIII NR.23)",131,"Alegeri Prezidentiale",1,1647,897,819,78,0,871,26,1700,803,562,309
17,DOLJ,"MUNICIPIUL CRAIOVA",69900,CRAIOVA,"DIRECȚIA DE SĂNĂTATE PUBLICĂ DOLJ",132,"Alegeri Prezidentiale",1,1213,646,606,40,0,629,17,1300,654,356,273
17,DOLJ,"MUNICIPIUL CRAIOVA",69900,CRAIOVA,"DIRECȚIA DE SĂNĂTATE PUBLICĂ DOLJ",133,"Alegeri Prezidentiale",1,1678,903,834,69,0,888,15,1800,897,581,307
17,DOLJ,"MUNICIPIUL CRAIOVA",69900,CRAIOVA,"ŞCOALA GIMNAZIALĂ ”ION ŢUCULESCU” (FOSTA NR. 14)",134,"Alegeri Prezidentiale",1,1906,1045,852,103,90,1019,26,2000,955,572,447
17,DOLJ,"MUNICIPIUL CRAIOVA",69900,CRAIOVA,"ŞCOALA GIMNAZIALĂ ”ION ŢUCULESCU” (FOSTA NR. 14)",135,"Alegeri Prezidentiale",2,1958,1043,934,109,0,1020,23,2000,957,659,361
17,DOLJ,"MUNICIPIUL CRAIOVA",69900,CRAIOVA,"GRĂDINIȚA CU PROGRAM NORMAL” ÎNGERAȘII” (FOSTĂ NR.5)",136,"Alegeri Prezidentiale",1,1664,794,751,42,1,784,10,1800,1006,486,298
17,DOLJ,"MUNICIPIUL CRAIOVA",69900,CRAIOVA,"GRADINITA CU PROGRAM NORMAL NR.35 – STRUCTURĂ A SCOLII GIMNAZIALE ”ION ŢUCULESCU” (FOSTĂ NR.14)",137,"Alegeri Prezidentiale",1,1014,549,483,66,0,532,17,1100,551,343,189
17,DOLJ,"MUNICIPIUL CRAIOVA",69900,CRAIOVA,"GRĂDINIŢA CU PROGRAM NORMAL NR.16-STRUCTURĂ A ŞCOLII GIMNAZIALE ”ION ŢUCULESCU” (FOSTA NR.14)",138,"Alegeri Prezidentiale",1,1489,775,742,33,0,759,16,1600,825,469,290
17,DOLJ,"MUNICIPIUL CRAIOVA",69900,CRAIOVA,"GRĂDINIȚA CU PROGRAM NORMAL ”ÎNGERAȘII” ( FOSTA NR. 5)",139,"Alegeri Prezidentiale",1,1729,822,791,31,0,798,24,1800,978,468,330
17,DOLJ,"MUNICIPIUL CRAIOVA",69900,CRAIOVA,"SUCURSALA REGIONALĂ CF CRAIOVA",140,"Alegeri Prezidentiale",1,1230,832,649,183,0,815,17,1300,468,464,351
17,DOLJ,"MUNICIPIUL CRAIOVA",69900,CRAIOVA,"SUCURSALA REGIONALĂ CF CRAIOVA",141,"Alegeri Prezidentiale",1,1536,869,755,113,1,850,19,1600,731,475,375
17,DOLJ,"MUNICIPIUL CRAIOVA",69900,CRAIOVA,"GRĂDINIŢA CU PROGRAM PRELUNGIT ”SF. LUCIA” (FOSTA NR.50)",142,"Alegeri Prezidentiale",1,959,546,507,39,0,532,14,1000,454,345,187
17,DOLJ,"MUNICIPIUL CRAIOVA",69900,CRAIOVA,"GRĂDINIŢA CU PROGRAM PRELUNGIT ”SF. LUCIA” (FOSTA NR.50)",143,"Alegeri Prezidentiale",1,941,540,511,29,0,528,12,1000,460,325,203
17,DOLJ,"MUNICIPIUL CRAIOVA",69900,CRAIOVA,"GRĂDINIŢA CU PROGRAM PRELUNGIT ”PETRACHE POENARU” (FOSTA SCOALA CU CLASELE I VIII NR.9 PETRACHE POENARU)",144,"Alegeri Prezidentiale",1,1592,1176,830,38,308,1153,23,1700,524,556,597
17,DOLJ,"MUNICIPIUL CRAIOVA",69900,CRAIOVA,"GRĂDINIŢA CU PROGRAM PRELUNGIT ”PETRACHE POENARU” (FOSTA SCOALA CU CLASELE I VIII NR.9 PETRACHE POENARU)",145,"Alegeri Prezidentiale",1,1170,950,612,70,268,932,18,1300,350,448,484
17,DOLJ,"MUNICIPIUL CRAIOVA",69900,CRAIOVA,"ŞCOALA GIMNAZIALĂ ”GHEORGHE ŢIŢEICA” (FOSTA NR. 21)",146,"Alegeri Prezidentiale",1,1453,886,744,142,0,869,17,1500,614,557,312
17,DOLJ,"MUNICIPIUL CRAIOVA",69900,CRAIOVA,"ŞCOALA GIMNAZIALĂ ”GHEORGHE ŢIŢEICA” (FOSTA NR. 21)",147,"Alegeri Prezidentiale",1,1419,792,724,68,0,768,24,1500,708,465,303
17,DOLJ,"MUNICIPIUL CRAIOVA",69900,CRAIOVA,"GRĂDINIŢA CU PROGRAM PRELUNGIT ”PINOCHIO”",148,"Alegeri Prezidentiale",1,1158,637,553,84,0,621,16,1200,563,409,212
17,DOLJ,"MUNICIPIUL CRAIOVA",69900,CRAIOVA,"PRIMĂRIA MUNICIPIULUI CRAIOVA, (FOSTA ŞCOALA CU CLASELE I-VIII NR.35 „I.D. SÎRBU”)”",149,"Alegeri Prezidentiale",1,1114,653,572,81,0,639,14,1200,547,398,241
17,DOLJ,"MUNICIPIUL CRAIOVA",69900,CRAIOVA,"PRIMĂRIA MUNICIPIULUI CRAIOVA, (FOSTA ŞCOALA CU CLASELE I-VIII NR.35 „I.D. SÎRBU”)",150,"Alegeri Prezidentiale",1,1037,584,526,58,0,573,11,1100,516,344,229
17,DOLJ,"MUNICIPIUL CRAIOVA",69900,CRAIOVA,"PRIMĂRIA MUNICIPIULUI CRAIOVA, (FOSTA ŞCOALA CU CLASELE I-VIII NR.35 „I.D. SÎRBU”)",151,"Alegeri Prezidentiale",1,1212,657,622,35,0,651,6,1300,643,414,237
17,DOLJ,"MUNICIPIUL CRAIOVA",69900,CRAIOVA,"LICEUL ”MATEI BASARAB”",152,"Alegeri Prezidentiale",1,963,523,495,28,0,509,14,1000,477,301,208
17,DOLJ,"MUNICIPIUL CRAIOVA",69900,CRAIOVA,"LICEUL ”MATEI BASARAB”",153,"Alegeri Prezidentiale",1,929,439,411,28,0,429,10,1000,561,260,169
17,DOLJ,"MUNICIPIUL CRAIOVA",69900,CRAIOVA,"LICEUL TEORETIC ”TUDOR ARGHEZI”",154,"Alegeri Prezidentiale",1,1283,827,633,194,0,803,24,1400,573,472,331
17,DOLJ,"MUNICIPIUL CRAIOVA",69900,CRAIOVA,"LICEUL TEORETIC ”TUDOR ARGHEZI”",155,"Alegeri Prezidentiale",1,1348,735,673,61,1,715,20,1400,665,416,299
17,DOLJ,"MUNICIPIUL CRAIOVA",69900,CRAIOVA,"LICEUL TEORETIC ”TUDOR ARGHEZI”",156,"Alegeri Prezidentiale",1,1408,676,651,25,0,668,8,1500,824,408,260
17,DOLJ,"MUNICIPIUL CRAIOVA",69900,CRAIOVA,"ŞCOALA GIMNAZIALĂ ”NICOLAE BĂLCESCU” (FOSTA NR.39)",157,"Alegeri Prezidentiale",1,1449,780,746,34,0,762,18,1500,720,454,308
17,DOLJ,"MUNICIPIUL CRAIOVA",69900,CRAIOVA,"ŞCOALA GIMNAZIALĂ ”NICOLAE BĂLCESCU” (FOSTA NR.39)",158,"Alegeri Prezidentiale",1,1283,673,628,45,0,656,17,1400,727,396,260
17,DOLJ,"MUNICIPIUL CRAIOVA",69900,CRAIOVA,"ŞCOALA GIMNAZIALĂ ”NICOLAE BĂLCESCU” (FOSTA NR.39)",159,"Alegeri Prezidentiale",1,1473,781,703,78,0,761,20,1600,819,485,276
17,DOLJ,"MUNICIPIUL CRAIOVA",69900,CRAIOVA,"ŞCOALA GIMNAZIALĂ ”NICOLAE BĂLCESCU” (FOSTA NR.39)",160,"Alegeri Prezidentiale",1,1455,831,701,130,0,811,20,1500,669,519,292
17,DOLJ,"MUNICIPIUL CRAIOVA",69900,CRAIOVA,"GRĂDINIŢA CU PROGRAM NORMAL NR.14 ”LUCEAFĂRUL” – STRUCTURĂ A ŞCOLII GIMNAZIALE ”NICOLAE BĂLCESCU” (FOSTA NR.39)",161,"Alegeri Prezidentiale",1,1478,822,759,63,0,794,28,1600,778,502,292
17,DOLJ,"MUNICIPIUL CRAIOVA",69900,CRAIOVA,"FACULTATEA DE MECANICĂ",162,"Alegeri Prezidentiale",1,1063,875,582,194,99,853,22,1300,425,558,295
17,DOLJ,"MUNICIPIUL CRAIOVA",69900,CRAIOVA,"LICEUL TEHNOLOGIC AUTO",163,"Alegeri Prezidentiale",1,1672,777,737,40,0,759,18,1700,923,491,268
17,DOLJ,"MUNICIPIUL CRAIOVA",69900,CRAIOVA,"LICEUL TEHNOLOGIC AUTO",164,"Alegeri Prezidentiale",1,1355,689,620,69,0,673,16,1400,711,439,234
17,DOLJ,"MUNICIPIUL CRAIOVA",69900,CRAIOVA,"PUNCTUL TERMIC NR.1 LĂPUȘ (LÂNGĂ BL.23 - BLD. DECEBAL NR.66B)",165,"Alegeri Prezidentiale",1,1213,610,568,42,0,579,31,1300,690,356,223
17,DOLJ,"MUNICIPIUL CRAIOVA",69900,CRAIOVA,"PUNCTUL TERMIC NR.2 LĂPUȘ (LÂNGĂ BL. 59 - BLD. DECEBAL NR.55B)",166,"Alegeri Prezidentiale",1,1502,833,784,49,0,819,14,1600,767,502,317
17,DOLJ,"MUNICIPIUL CRAIOVA",69900,CRAIOVA,"PRIMĂRIA MUNICIPIULUI CRAIOVA DIRECŢIA DE ASISTENŢĂ ŞI PROTECŢIE SOCIALĂ",167,"Alegeri Prezidentiale",3,1451,744,654,90,0,722,22,1500,756,438,284
17,DOLJ,"MUNICIPIUL CRAIOVA",69900,CRAIOVA,"PRIMĂRIA MUNICIPIULUI CRAIOVA-DIRECŢIA DE ASISTENŢĂ ŞI PROTECŢIE SOCIALĂ",168,"Alegeri Prezidentiale",1,1386,800,669,131,0,782,18,1500,700,426,356
17,DOLJ,"MUNICIPIUL CRAIOVA",69900,CRAIOVA,"ŞCOALA GIMNAZIALĂ NR.38 - STRUCTURĂ A ŞCOLII GIMNAZIALE ”ION CREANGA” (FOSTĂ NR.16)",169,"Alegeri Prezidentiale",1,1522,700,672,28,0,695,5,1600,900,416,279
17,DOLJ,"MUNICIPIUL CRAIOVA",69900,CRAIOVA,"ŞCOALA GIMNAZIALĂ NR.38 - STRUCTURĂ A ŞCOLII GIMNAZIALE ”ION CREANGA” (FOSTĂ NR.16)",170,"Alegeri Prezidentiale",1,1656,566,520,46,0,560,6,1700,1134,339,221
17,DOLJ,"MUNICIPIUL CRAIOVA",69900,CRAIOVA,"ŞCOALA GIMNAZIALĂ NR.38 - STRUCTURĂ A ŞCOLII GIMNAZIALE ”ION CREANGA” (FOSTĂ NR.16)",171,"Alegeri Prezidentiale",1,1509,644,624,20,0,631,13,1600,956,361,270
17,DOLJ,"MUNICIPIUL CRAIOVA",69900,CRAIOVA,"GRĂDINIŢA CU PROGRAM NORMAL ROVINE 2 – STRUCTURĂ A ŞCOLII GIMNAZIALE ”ION CREANGA” (FOSTĂ NR.16)",172,"Alegeri Prezidentiale",1,570,263,246,17,0,254,9,700,437,156,98
17,DOLJ,"MUNICIPIUL CRAIOVA",69900,CRAIOVA,"ŞCOALA PRIMARĂ IZVORUL RECE – STRUCTURĂ A ŞCOLII GIMNAZIALE ”DECEBAL” (FOSTĂ NR.12)",173,"Alegeri Prezidentiale",1,667,346,323,23,0,344,2,800,454,226,118
17,DOLJ,"MUNICIPIUL BĂILEŞTI",70316,BĂILEŞTI,"ŞCOALA GIMNAZIALĂ NR. 1",174,"Alegeri Prezidentiale",1,1395,450,427,23,0,444,6,1500,1050,201,243
17,DOLJ,"MUNICIPIUL BĂILEŞTI",70316,BĂILEŞTI,"GRĂDINIŢA DE COPII NR. 3",175,"Alegeri Prezidentiale",1,1131,301,285,16,0,294,7,1200,899,152,142
17,DOLJ,"MUNICIPIUL BĂILEŞTI",70316,BĂILEŞTI,"ŞCOALA GIMNAZIALĂ NR. 3",176,"Alegeri Prezidentiale",1,538,151,126,25,0,149,2,600,449,88,61
17,DOLJ,"MUNICIPIUL BĂILEŞTI",70316,BĂILEŞTI,"ŞCOALA GIMNAZIALĂ NR. 3",177,"Alegeri Prezidentiale",1,898,305,292,13,0,300,5,1000,695,144,156
17,DOLJ,"MUNICIPIUL BĂILEŞTI",70316,BĂILEŞTI,"ŞCOALA GIMNAZIALĂ NR. 5",178,"Alegeri Prezidentiale",1,981,338,300,38,0,330,8,1100,762,164,166
17,DOLJ,"MUNICIPIUL BĂILEŞTI",70316,BĂILEŞTI,"GRĂDINIŢA DE COPII NR. 7",179,"Alegeri Prezidentiale",1,736,299,281,18,0,295,4,800,501,111,184
17,DOLJ,"MUNICIPIUL BĂILEŞTI",70316,BĂILEŞTI,"LICEUL MIHAI VITEAZUL",180,"Alegeri Prezidentiale",1,996,380,330,49,1,378,2,1100,720,207,171
17,DOLJ,"MUNICIPIUL BĂILEŞTI",70316,BĂILEŞTI,"GRĂDINIŢA DE COPII NR. 5",181,"Alegeri Prezidentiale",1,663,221,204,17,0,219,2,800,579,107,112
17,DOLJ,"MUNICIPIUL BĂILEŞTI",70316,BĂILEŞTI,"ŞCOALA GIMNAZIALĂ NR. 4",182,"Alegeri Prezidentiale",1,1485,492,469,23,0,485,7,1600,1108,225,260
17,DOLJ,"MUNICIPIUL BĂILEŞTI",70316,BĂILEŞTI,"ŞCOALA GIMNAZIALĂ NR. 4",183,"Alegeri Prezidentiale",1,992,367,346,21,0,363,4,1100,733,161,202
17,DOLJ,"MUNICIPIUL BĂILEŞTI",70316,BĂILEŞTI,"GRĂDINIŢA DE COPII NR. 8",184,"Alegeri Prezidentiale",1,1334,432,416,16,0,427,5,1400,968,201,226
17,DOLJ,"MUNICIPIUL BĂILEŞTI",70316,BĂILEŞTI,"LICEUL TEHNOLOGIC ŞTEFAN ANGHEL",185,"Alegeri Prezidentiale",1,623,232,211,21,0,230,2,700,468,125,105
17,DOLJ,"MUNICIPIUL BĂILEŞTI",70316,BĂILEŞTI,"GRĂDINIŢA DE COPII NR. 2",186,"Alegeri Prezidentiale",1,1008,302,286,16,0,298,4,1100,798,139,159
17,DOLJ,"MUNICIPIUL BĂILEŞTI",70316,BĂILEŞTI,"AGROZIND S.A.",187,"Alegeri Prezidentiale",1,790,297,277,20,0,294,3,900,603,119,175
17,DOLJ,"MUNICIPIUL BĂILEŞTI",70316,BĂILEŞTI,"ŞCOALA GIMNAZIALĂ NR. 6",188,"Alegeri Prezidentiale",1,1360,454,424,30,0,445,9,1400,946,239,206
17,DOLJ,"MUNICIPIUL BĂILEŞTI",70316,BALASAN,"ŞCOALA GIMNAZIALĂ BALASAN",189,"Alegeri Prezidentiale",1,487,135,121,14,0,134,1,600,465,56,78
17,DOLJ,"MUNICIPIUL CALAFAT",70352,GOLENŢI,"CAMINUL CULTURAL GOLENTI (DIN CADRUL CASEI DE CULTURA CALAFAT )",190,"Alegeri Prezidentiale",1,404,228,209,19,0,226,2,500,272,57,169
17,DOLJ,"MUNICIPIUL CALAFAT",70352,BASARABI,"CAMINUL CULTURAL BASARABI (DIN CADRUL CASEI DE CULTURA CALAFAT )",191,"Alegeri Prezidentiale",1,873,434,396,38,0,428,6,1000,566,186,242
17,DOLJ,"MUNICIPIUL CALAFAT",70352,"CIUPERCENII VECHI","CAMINUL CULTURAL CIUPERCENII VECHII ( DIN CADRUL CASEI DE CULTURA CALAFAT )",192,"Alegeri Prezidentiale",1,1788,729,701,26,2,720,9,1900,1171,363,357
17,DOLJ,"MUNICIPIUL CALAFAT",70352,CALAFAT,"SC. GENERALA NR. 1 CALAFAT",193,"Alegeri Prezidentiale",1,1558,836,661,79,96,827,9,1600,764,369,458
17,DOLJ,"MUNICIPIUL CALAFAT",70352,CALAFAT,"LICEUL TEORETIC INDEPENDENTA",194,"Alegeri Prezidentiale",1,1802,839,788,51,0,827,12,1900,1061,366,461
17,DOLJ,"MUNICIPIUL CALAFAT",70352,CALAFAT,"CLUBUL COPIILOR",195,"Alegeri Prezidentiale",1,1451,639,584,42,13,629,10,1500,861,272,357
17,DOLJ,"MUNICIPIUL CALAFAT",70352,CALAFAT,"SC. GENERALA NR. 2 CALAFAT",196,"Alegeri Prezidentiale",1,1803,741,676,65,0,730,11,1900,1159,352,378
17,DOLJ,"MUNICIPIUL CALAFAT",70352,CALAFAT,"SC.GENERALA NR. 2 CALAFAT",197,"Alegeri Prezidentiale",1,1685,651,592,59,0,641,10,1800,1149,306,335
17,DOLJ,"MUNICIPIUL CALAFAT",70352,CALAFAT,"GRADINITA NR. 4 ( DIN CADRUL SC.GENERALE NR.1 CALAFAT )",198,"Alegeri Prezidentiale",1,1717,626,588,38,0,618,8,1800,1174,336,282
17,DOLJ,"MUNICIPIUL CALAFAT",70352,CALAFAT,"CLUBUL PENSIONARILOR",199,"Alegeri Prezidentiale",1,1749,668,620,47,1,664,4,1800,1132,332,332
17,DOLJ,"ORAŞ BECHET",70879,BECHET,"LICEUL TEORETIC BECHET",200,"Alegeri Prezidentiale",1,1360,613,525,77,11,599,14,1400,787,235,364
17,DOLJ,"ORAŞ BECHET",70879,BECHET,"SCOALA PRIMARA BECHET VALE",201,"Alegeri Prezidentiale",1,643,379,307,58,14,376,3,700,321,139,237
17,DOLJ,"ORAŞ BECHET",70879,BECHET,"BIBLIOTECA ORASENEASCA BECHET",202,"Alegeri Prezidentiale",1,1273,530,404,66,60,520,10,1400,870,161,359
17,DOLJ,"ORAŞ DĂBULENI",72007,DĂBULENI,"STRUCTURA SCOLII GIMNAZIALE NR. 1 DABULENI",203,"Alegeri Prezidentiale",1,1673,816,760,50,6,805,11,1800,984,336,469
17,DOLJ,"ORAŞ DĂBULENI",72007,DĂBULENI,"CLUBUL COPIILOR DABULENI",204,"Alegeri Prezidentiale",1,1515,866,775,62,29,851,15,1600,734,353,498
17,DOLJ,"ORAŞ DĂBULENI",72007,DĂBULENI,"SCOALA GIMNAZIALA CU CLASELE I-VIII NR.1 DABULENI, NORD",205,"Alegeri Prezidentiale",1,1521,914,807,47,60,898,16,1600,686,314,584
17,DOLJ,"ORAŞ DĂBULENI",72007,DĂBULENI,"SCOALA GIMNAZIALA CU CLASELE I-VIII NR.1 DABULENI, SUD",206,"Alegeri Prezidentiale",1,1680,934,887,43,4,925,9,1800,866,377,548
17,DOLJ,"ORAŞ DĂBULENI",72007,DĂBULENI,"LICEUL TEORETIC CONSTANTIN BRANCOVEANU",207,"Alegeri Prezidentiale",1,1153,628,584,34,10,620,8,1200,572,243,377
17,DOLJ,"ORAŞ DĂBULENI",72007,DĂBULENI,"LICEUL TEORETIC CONSTANTIN BRANCOVEANU (FOSTA SCOALA NR. 3, INTRARE ELEVI)",208,"Alegeri Prezidentiale",1,1317,733,694,37,2,713,20,1400,667,290,423
17,DOLJ,"ORAŞ DĂBULENI",72007,DĂBULENI,"LICEUL TEORETIC CONSTANTIN BRANCOVEANU (FOSTA SCOALA NR. 3, INTRARE PROFESORI)",209,"Alegeri Prezidentiale",1,1255,743,671,47,25,730,13,1300,557,274,456
17,DOLJ,"ORAŞ FILIAŞI",70414,FILIAŞI,"CORP 2 PRIMĂRIE",210,"Alegeri Prezidentiale",1,1467,649,610,39,0,637,12,1600,951,279,358
17,DOLJ,"ORAŞ FILIAŞI",70414,FILIAŞI,"GRĂDINIŢA NR. 1 FILIAŞI",211,"Alegeri Prezidentiale",1,1819,941,884,54,3,924,17,1900,959,415,509
17,DOLJ,"ORAŞ FILIAŞI",70414,FILIAŞI,"GRĂDINIŢA NR. 2 FILIAŞI",212,"Alegeri Prezidentiale",1,1751,770,615,85,70,750,20,1800,1030,288,462
17,DOLJ,"ORAŞ FILIAŞI",70414,FILIAŞI,"GRĂDINIŢA NR. 3 FILIAŞI",213,"Alegeri Prezidentiale",1,1295,707,574,128,5,701,6,1400,693,285,416
17,DOLJ,"ORAŞ FILIAŞI",70414,FILIAŞI,"LICEUL TEHNOLOGIC DIMITRIE FILIŞANU",214,"Alegeri Prezidentiale",1,1550,707,597,110,0,688,19,1600,893,238,450
17,DOLJ,"ORAŞ FILIAŞI",70414,FILIAŞI,"PRIMĂRIA ORAŞULUI FILIAŞI",215,"Alegeri Prezidentiale",1,1724,826,739,87,0,816,10,1800,974,344,472
17,DOLJ,"ORAŞ FILIAŞI",70414,FILIAŞI,"ŞCOALA GIMNAZIALĂ FILIAŞI",216,"Alegeri Prezidentiale",1,1351,754,689,62,3,740,14,1400,646,264,476
17,DOLJ,"ORAŞ FILIAŞI",70414,BÂLTA,"ŞCOALA BÎLTA",217,"Alegeri Prezidentiale",1,920,559,507,42,10,549,10,1000,441,203,346
17,DOLJ,"ORAŞ FILIAŞI",70414,FRATOŞTIŢA,"SCOALA GIMNAZIALĂ FRATOŞTIŢA - CORP 1",218,"Alegeri Prezidentiale",1,1312,635,602,33,0,628,7,1400,765,238,390
17,DOLJ,"ORAŞ FILIAŞI",70414,FRATOŞTIŢA,"ŞCOALA GIMNAZIALĂ FRATOŞTITA - CORP 2",219,"Alegeri Prezidentiale",1,777,317,298,19,0,315,2,900,583,121,194
17,DOLJ,"ORAŞ FILIAŞI",70414,"RĂCARII DE SUS","ŞCOALA RĂCARII DE SUS",220,"Alegeri Prezidentiale",1,951,501,476,25,0,495,6,1000,499,159,336
17,DOLJ,"ORAŞ ŞEGARCEA",70502,ȘEGARCEA,"LICEUL TEHNOLOGIC HORIA VINTILĂ",221,"Alegeri Prezidentiale",1,1648,876,782,63,31,862,14,1700,824,312,550
17,DOLJ,"ORAŞ ŞEGARCEA",70502,ȘEGARCEA,"SCOALA CU CLASELE I-VIII",222,"Alegeri Prezidentiale",1,1465,541,500,41,0,538,3,1600,1059,219,319
17,DOLJ,"ORAŞ ŞEGARCEA",70502,ȘEGARCEA,"BIBLIOTECA ORĂŞENEASCĂ MIRCEA RĂDINA",223,"Alegeri Prezidentiale",1,1565,820,746,74,0,810,10,1700,880,355,455
17,DOLJ,"ORAŞ ŞEGARCEA",70502,ȘEGARCEA,"CLUBUL COPIILOR",224,"Alegeri Prezidentiale",1,1666,810,763,46,1,798,12,1700,890,303,495
17,DOLJ,AFUMAŢI,70520,AFUMAŢI,"CONSILIUL LOCAL AFUMATI",225,"Alegeri Prezidentiale",1,895,489,404,85,0,484,5,1000,511,325,159
17,DOLJ,AFUMAŢI,70520,BOURENI,"CAMINUL CULTURAL BOURENI",226,"Alegeri Prezidentiale",1,833,458,359,99,0,453,5,900,442,242,211
17,DOLJ,AFUMAŢI,70520,COVEI,"CAMINUL CULTURAL COVEI",227,"Alegeri Prezidentiale",1,390,204,150,54,0,202,2,500,296,126,76
17,DOLJ,ALMĂJ,70566,ALMĂJ,"ŞCOALA GIMNAZIALĂ ”ION GHE. PLEŞA”",228,"Alegeri Prezidentiale",1,1074,688,544,144,0,683,5,1200,512,399,284
17,DOLJ,ALMĂJ,70566,ŞITOAIA,"ŞCOALA PRIMARĂ ŞITOAIA",229,"Alegeri Prezidentiale",1,507,346,269,77,0,344,2,600,254,172,172
17,DOLJ,"AMĂRĂŞTII DE JOS",70637,"AMĂRĂŞTII DE JOS","CĂMINUL CULTURAL",230,"Alegeri Prezidentiale",1,1155,810,617,145,48,806,4,1200,390,400,406
17,DOLJ,"AMĂRĂŞTII DE JOS",70637,"AMĂRĂŞTII DE JOS","GRADINITA TOSCA",231,"Alegeri Prezidentiale",1,1009,578,512,63,3,572,6,1100,522,267,305
17,DOLJ,"AMĂRĂŞTII DE JOS",70637,PRAPOR,"GRĂDINIŢA PRAPOR",232,"Alegeri Prezidentiale",1,1097,650,587,55,8,645,5,1200,550,267,378
17,DOLJ,"AMĂRĂŞTII DE JOS",70637,OCOLNA,"GRADINITA OCOLNA",233,"Alegeri Prezidentiale",1,988,555,533,22,0,540,15,1100,545,292,248
17,DOLJ,"AMĂRĂŞTII DE SUS",70673,"AMĂRĂŞTII DE SUS","CĂMINUL CULTURAL",234,"Alegeri Prezidentiale",2,1316,1081,828,199,54,1073,8,1400,319,330,743
17,DOLJ,"APELE VII",70726,"APELE VII","CĂMINUL CULTURAL",235,"Alegeri Prezidentiale",1,1686,1095,880,179,36,1057,38,1800,705,661,396
17,DOLJ,ARGETOAIA,70744,ARGETOAIA,"ȘCOALA PROFESIONALĂ C-TIN ARGETOAIANU",236,"Alegeri Prezidentiale",1,1095,514,470,44,0,503,11,1200,686,271,232
17,DOLJ,ARGETOAIA,70744,ARGETOAIA,"ȘCOALA PROFESIONALĂ C-TIN ARGETOAIANU",237,"Alegeri Prezidentiale",1,688,367,328,39,0,361,6,800,433,158,203
17,DOLJ,ARGETOAIA,70744,SALCIA,"ȘCOALA. GIMNAZIALĂ SALCIA",238,"Alegeri Prezidentiale",1,943,604,519,81,4,592,12,1000,396,294,298
17,DOLJ,ARGETOAIA,70744,PIRIA,"ȘCOALA. PRIMARĂ PIRIA",239,"Alegeri Prezidentiale",1,294,139,120,18,1,138,1,400,261,32,106
17,DOLJ,ARGETOAIA,70744,LEORDOASA,"ȘCOALA. PRIMARĂ LEORDOASA",240,"Alegeri Prezidentiale",1,387,195,164,31,0,194,1,500,305,98,96
17,DOLJ,ARGETOAIA,70744,NOVAC,"GRĂDINIȚA CU PROGRAM NORMAL NOVACU",241,"Alegeri Prezidentiale",1,219,158,123,33,2,155,3,300,142,69,86
17,DOLJ,BÂRCA,70940,BÂRCA,"CAMINUL CULTURAL",242,"Alegeri Prezidentiale",1,1667,692,592,100,0,680,12,1800,1108,311,369
17,DOLJ,BÂRCA,70940,BÂRCA,"GRADINITA DE COPII",243,"Alegeri Prezidentiale",1,1468,657,584,73,0,654,3,1600,943,275,379
17,DOLJ,BISTREŢ,70897,BISTREŢ,"ȘCOALA GIMNAZIALĂ BISTREȚ",244,"Alegeri Prezidentiale",1,1035,546,487,59,0,538,8,1200,654,181,357
17,DOLJ,BISTREŢ,70897,BISTREŢ,"ȘCOALA GIMNAZIALĂ BISTREȚ",245,"Alegeri Prezidentiale",1,804,463,398,65,0,456,7,900,437,200,256
17,DOLJ,BISTREŢ,70897,"BISTREŢU NOU","ȘCOALA PRIMARĂ BISTRETU NOU",246,"Alegeri Prezidentiale",1,625,273,227,46,0,269,4,700,427,109,160
17,DOLJ,BISTREŢ,70897,PLOSCA,"ȘCOALA PRIMARĂ PLOSCA",247,"Alegeri Prezidentiale",1,716,396,339,57,0,387,9,800,404,123,264
17,DOLJ,BOTOŞEŞTI-PAIA,70968,BOTOŞEŞTI-PAIA,"CĂMINUL CULTURAL",248,"Alegeri Prezidentiale",1,568,511,338,134,39,509,2,700,189,136,373
17,DOLJ,BRABOVA,70986,BRABOVA,"CĂMINUL CULTURAL BRABOVA",249,"Alegeri Prezidentiale",1,444,310,218,73,19,306,4,514,204,55,251
17,DOLJ,BRABOVA,70986,URDINIŢA,"CĂMINUL CULTURAL URDINIȚA",250,"Alegeri Prezidentiale",1,226,155,95,60,0,154,1,300,145,73,81
17,DOLJ,BRABOVA,70986,"RĂCHITA DE JOS","CĂMINUL CULTURAL RĂCHITA DE JOS",251,"Alegeri Prezidentiale",1,222,140,114,26,0,140,0,300,160,44,96
17,DOLJ,BRABOVA,70986,MOSNA,"ȘCOALA CU CLASELE I-IV MOSNA",252,"Alegeri Prezidentiale",1,130,95,69,26,0,95,0,300,205,30,65
17,DOLJ,BRALOŞTIŢA,71126,BRALOŞTIŢA,"SALA DE SEDINȚE A CONSILIULUI LOCAL BRALOȘTIȚA",253,"Alegeri Prezidentiale",1,625,341,272,69,0,338,3,700,359,144,194
17,DOLJ,BRALOŞTIŢA,71126,SFIRCEA,"SCOALA DIN SATUL SFIRCEA",254,"Alegeri Prezidentiale",1,822,479,418,61,0,469,10,900,421,226,243
17,DOLJ,BRALOŞTIŢA,71126,"VALEA FÂNTÂNILOR","ŞCOALA DIN SATUL VALEA FÎNTÎNILOR",255,"Alegeri Prezidentiale",1,526,280,249,31,0,277,3,600,320,198,79
17,DOLJ,BRALOŞTIŢA,71126,CIOCANELE,"ŞCOALA DIN SATUL CIOCANE",256,"Alegeri Prezidentiale",1,653,352,301,51,0,348,4,800,448,183,165
17,DOLJ,BRALOŞTIŢA,71126,SCHITU,"ŞCOALA DIN SATUL SCHITU",257,"Alegeri Prezidentiale",1,389,203,193,10,0,201,2,500,297,117,84
17,DOLJ,BRATOVOEŞTI,71199,BĂDOŞI,"ȘCOALA PRIMARĂ BĂDOȘI",258,"Alegeri Prezidentiale",2,714,385,327,58,0,382,3,800,415,202,180
17,DOLJ,BRATOVOEŞTI,71199,PRUNET,"ȘCOALA PRIMARĂ PRUNET",259,"Alegeri Prezidentiale",1,466,249,203,46,0,247,2,600,351,114,133
17,DOLJ,BRATOVOEŞTI,71199,BRATOVOEŞTI,"ȘCOALA GIMNAZIALĂ BRATOVOEȘTI",260,"Alegeri Prezidentiale",1,1098,592,535,57,0,589,3,1200,608,249,340
17,DOLJ,BRATOVOEŞTI,71199,"GEOROCU MARE","ȘCOALA PRIMARĂ GEOROCU MARE",261,"Alegeri Prezidentiale",1,391,228,185,43,0,224,4,500,272,119,105
17,DOLJ,BRĂDEŞTI,71055,BRĂDEŞTI,"GRĂDINIȚA ”PROF. GHEORGHE LUȚĂ” BRĂDEȘTI",262,"Alegeri Prezidentiale",1,1573,738,617,121,0,731,7,1700,962,357,374
17,DOLJ,BRĂDEŞTI,71055,"BRĂDEŞTII BĂTRÂNI","SCOALA GENERALA BRADESTI BATRINI",263,"Alegeri Prezidentiale",1,326,209,164,43,2,206,3,400,191,88,118
17,DOLJ,BRĂDEŞTI,71055,TATOMIREŞTI,"GRĂDINIȚA CU PROGRAM NORMAL TATOMIREȘTI",264,"Alegeri Prezidentiale",1,833,462,442,20,0,456,6,1000,538,158,298
17,DOLJ,BRĂDEŞTI,71055,RĂCARI,"SCOALA GENERALA RACARII DE JOS",265,"Alegeri Prezidentiale",1,956,535,480,54,1,527,8,1100,565,177,350
17,DOLJ,BRĂDEŞTI,71055,PISCANI,"SCOALA GENERALA PISCANI",266,"Alegeri Prezidentiale",1,76,28,17,11,0,28,0,200,172,10,18
17,DOLJ,BREASTA,71260,BREASTA,"ŞCOALA BREASTA",267,"Alegeri Prezidentiale",1,1180,558,484,74,0,553,5,1300,742,296,257
17,DOLJ,BREASTA,71260,BREASTA,"ŞCOALA BREASTA",268,"Alegeri Prezidentiale",1,943,580,454,126,0,569,11,1100,520,326,243
17,DOLJ,BREASTA,71260,"VALEA LUNGULUI","ŞCOALA VALEA LUNGULUI",269,"Alegeri Prezidentiale",1,547,285,239,46,0,285,0,700,415,109,176
17,DOLJ,BREASTA,71260,OBEDIN,"ŞCOALA OBEDIN",270,"Alegeri Prezidentiale",1,565,252,218,34,0,249,3,700,448,152,97
17,DOLJ,BUCOVĂŢ,69964,BUCOVĂŢ,"SCOALA GENERALA CU CLASELE L-VLLL BUCOVAT",271,"Alegeri Prezidentiale",1,1632,948,759,189,0,938,10,1800,852,543,395
17,DOLJ,BUCOVĂŢ,69964,"LEAMNA DE JOS","SCOALA GENERALA CU CLASELE L-LV LEAMNA DE JOS",272,"Alegeri Prezidentiale",1,288,193,141,51,1,191,2,400,207,104,87
17,DOLJ,BUCOVĂŢ,69964,"LEAMNA DE SUS","SCOALA GENERALA CU CLASELE L-LV LEAMNA DE SUS",273,"Alegeri Prezidentiale",1,324,244,169,54,21,241,3,600,356,125,116
17,DOLJ,BUCOVĂŢ,69964,SĂRBĂTOAREA,"SCOALA GENERALA CU CLASELE L-VLLL SARBATOAREA",274,"Alegeri Prezidentiale",1,619,357,283,74,0,346,11,700,343,156,190
17,DOLJ,BUCOVĂŢ,69964,PALILULA,"SCOALA GENERALA CU CLASELE L-VLLL PALILULA",275,"Alegeri Prezidentiale",1,637,305,248,57,0,304,1,800,495,186,118
17,DOLJ,BULZEŞTI,71340,BULZEŞTI,"CĂMINUL CULTURAL",276,"Alegeri Prezidentiale",1,635,347,243,95,9,339,8,700,353,186,153
17,DOLJ,BULZEŞTI,71340,SĂLIŞTE,"PUNCT INFORMARE, PRIMĂRIA BULZEŞTI",277,"Alegeri Prezidentiale",1,511,363,244,94,25,357,6,600,237,126,231
17,DOLJ,CALOPĂR,71457,CALOPĂR,"ȘCOALA CU CLS.I-VIII CALOPĂR",278,"Alegeri Prezidentiale",1,1089,460,396,64,0,458,2,1200,740,240,218
17,DOLJ,CALOPĂR,71457,BELCINU,"ȘCOALA CU CLS I-VIII BELCINU",279,"Alegeri Prezidentiale",1,413,215,178,37,0,213,2,500,285,91,122
17,DOLJ,CALOPĂR,71457,PANAGHIA,"ȘCOALA CU CLS I-IV PANAGHIA",280,"Alegeri Prezidentiale",1,567,246,217,29,0,244,2,700,454,92,152
17,DOLJ,CALOPĂR,71457,SĂLCUŢA,"CĂMIN CULTURAL SĂLCUȚA",281,"Alegeri Prezidentiale",1,886,312,277,35,0,310,2,1000,688,80,230
17,DOLJ,CARAULA,71518,CARAULA,"CĂMINUL CULTURAL",282,"Alegeri Prezidentiale",1,949,595,496,74,25,591,4,1000,405,260,331
17,DOLJ,CARAULA,71518,CARAULA,"CENTRUL SOCIAL CARAULA",283,"Alegeri Prezidentiale",1,963,483,430,40,13,476,7,1100,617,110,366
17,DOLJ,CARPEN,71536,CARPEN,"CĂMINUL CULTURAL CARPEN",284,"Alegeri Prezidentiale",2,762,453,385,68,0,447,6,900,447,132,315
17,DOLJ,CARPEN,71536,CLEANOV,"CĂMINUL CULTURAL CLEANOV",285,"Alegeri Prezidentiale",1,1074,512,460,52,0,511,1,1200,688,128,383
17,DOLJ,CASTRANOVA,71572,CASTRANOVA,"CAMINUL CULTURAL",286,"Alegeri Prezidentiale",1,1460,996,845,151,0,996,0,1600,604,766,230
17,DOLJ,CASTRANOVA,71572,PUŢURI,"ŞCOALA PUŢURI",287,"Alegeri Prezidentiale",1,1078,591,452,139,0,589,2,1200,609,453,136
17,DOLJ,CATANE,74842,CATANE,"SCOALA GIMNAZIALA CATANE",288,"Alegeri Prezidentiale",1,1401,682,537,71,74,676,6,1600,918,222,454
17,DOLJ,CĂLĂRAŞI,71607,CĂLĂRAŞI,"CĂMINUL CULTURAL",289,"Alegeri Prezidentiale",1,1482,795,724,53,18,784,11,1600,805,419,365
17,DOLJ,CĂLĂRAŞI,71607,CĂLĂRAŞI,"ŞCOALA GIMNAZIALĂ NR. 1 CĂLĂRAŞI",290,"Alegeri Prezidentiale",1,1731,959,859,74,26,948,11,1900,941,463,485
17,DOLJ,CĂLĂRAŞI,71607,SĂRATA,"ŞCOALA GIMNAZIALĂ SĂRATA",291,"Alegeri Prezidentiale",1,1653,986,896,65,25,977,9,1800,814,434,543
17,DOLJ,CÂRCEA,74859,CÂRCEA,"CENTRUL CULTURAL",292,"Alegeri Prezidentiale",1,1553,1121,811,262,48,1100,21,1800,679,541,559
17,DOLJ,CÂRCEA,74859,CÂRCEA,"LICEUL TEHNOLOGIC ”CONSTANTIN IANCULESCU”",293,"Alegeri Prezidentiale",1,800,539,403,125,11,533,6,900,361,347,186
17,DOLJ,CÂRNA,74867,CÂRNA,"SCOALA CU CLS. I-VIII CÂRNA",294,"Alegeri Prezidentiale",1,1081,723,594,125,4,716,7,1200,477,399,317
17,DOLJ,CELARU,71634,CELARU,"SCOALA NOUA CELARU",295,"Alegeri Prezidentiale",1,1462,707,603,103,1,701,6,1600,893,323,378
17,DOLJ,CELARU,71634,"MAROTINU DE JOS","CAMIN CULTURAL MAROTINU DE JOS",296,"Alegeri Prezidentiale",1,449,217,178,39,0,215,2,500,283,92,123
17,DOLJ,CELARU,71634,GHIZDĂVEŞTI,"CAMIN CULTURAL GHIZDAVESTI",297,"Alegeri Prezidentiale",1,1196,678,572,106,0,675,3,1300,622,279,396
17,DOLJ,CELARU,71634,"MAROTINU DE SUS","CAMIN CULTURAL MAROTINU DE SUS",298,"Alegeri Prezidentiale",1,455,307,212,95,0,306,1,600,293,182,124
17,DOLJ,CERĂT,71698,CERĂT,"CAMINUL CULTURAL CERAT",299,"Alegeri Prezidentiale",1,1962,804,725,79,0,792,12,2100,1296,286,506
17,DOLJ,CERĂT,71698,CERĂT,"SCOALA GIMNAZIALA CERĂT - LOCALUL NR. 3",300,"Alegeri Prezidentiale",1,1209,317,290,27,0,308,9,1300,983,118,190
17,DOLJ,CERNĂTEŞTI,71723,CERNĂTEŞTI,"CĂMINUL CULTURAL",301,"Alegeri Prezidentiale",1,373,299,214,85,0,296,3,500,201,115,181
17,DOLJ,CERNĂTEŞTI,71723,ŢIU,GRĂDINIŢĂ,302,"Alegeri Prezidentiale",1,369,234,192,42,0,232,2,500,266,81,151
17,DOLJ,CERNĂTEŞTI,71723,CORNIŢA,"ŞCOALA GENERALĂ",303,"Alegeri Prezidentiale",1,241,147,112,35,0,147,0,300,153,47,100
17,DOLJ,CERNĂTEŞTI,71723,"RASNICU OGHIAN","ŞCOALA GENERALĂ",304,"Alegeri Prezidentiale",1,424,235,189,46,0,233,2,500,265,85,148
17,DOLJ,CETATE,71787,CETATE,"SCOALA CU CLS. I-IV CETATE",305,"Alegeri Prezidentiale",1,1640,838,763,50,25,820,18,1700,862,208,612
17,DOLJ,CETATE,71787,CETATE,"CĂMINUL CULTURAL CETATE",306,"Alegeri Prezidentiale",1,1437,714,585,71,58,697,17,1500,786,226,471
17,DOLJ,CETATE,71787,CETATE,"SCOALA CU CLS. I-VIII F-B",307,"Alegeri Prezidentiale",1,760,397,342,43,12,393,4,900,503,155,238
17,DOLJ,CETATE,71787,MORENI,"SCOALA CU CLS. I-IV MORENI",308,"Alegeri Prezidentiale",1,415,250,207,32,11,246,4,500,250,84,162
17,DOLJ,CIOROIAŞI,71812,CIOROIAŞI,"ȘCOALA CU CLASELE I-VIII CIOROIAȘI",309,"Alegeri Prezidentiale",1,818,375,297,69,9,370,5,1000,625,157,213
17,DOLJ,CIOROIAŞI,71812,"CIOROIU NOU","ȘCOALA CU CLASELE I-IV CIOROIU NOU",310,"Alegeri Prezidentiale",1,405,268,184,80,4,266,2,500,232,105,161
17,DOLJ,"CIUPERCENII NOI",71858,"CIUPERCENII NOI","ȘCOALA GIMNAZIALĂ ”NICOLAE CARAȘ ”",311,"Alegeri Prezidentiale",1,1517,679,647,32,0,674,5,1600,921,228,446
17,DOLJ,"CIUPERCENII NOI",71858,"CIUPERCENII NOI","SCOALA GENERALA CIUPERCENII NOI",312,"Alegeri Prezidentiale",1,1850,766,733,33,0,762,4,2000,1234,348,414
17,DOLJ,"CIUPERCENII NOI",71858,SMÂRDAN,"SCOALA GENERALA SMÎRDAN",313,"Alegeri Prezidentiale",1,1043,359,324,35,0,359,0,1200,841,157,202
17,DOLJ,COŞOVENI,71885,COŞOVENI,"CAMIN CULTURAL",314,"Alegeri Prezidentiale",1,887,533,450,83,0,529,4,1000,467,211,318
17,DOLJ,COŞOVENI,71885,COŞOVENI,"GRADINITA NR. 1",315,"Alegeri Prezidentiale",1,1081,631,538,90,3,621,10,1200,569,365,256
17,DOLJ,COŞOVENI,71885,COŞOVENI,"GRADINITA NR. 2",316,"Alegeri Prezidentiale",1,697,432,333,98,1,427,5,800,368,245,182
17,DOLJ,"COŢOFENII DIN DOS",71910,"COŢOFENII DIN DOS","SCOALA GIMNAZIALA COTOFENII DIN DOS",317,"Alegeri Prezidentiale",1,849,477,429,48,0,474,3,1000,523,247,227
17,DOLJ,"COŢOFENII DIN DOS",71910,POTMELŢU,"GRADINITA CU POGRAM NORMAL POTMELTU",318,"Alegeri Prezidentiale",1,423,264,202,62,0,261,3,500,236,154,107
17,DOLJ,"COŢOFENII DIN DOS",71910,MIHĂIŢA,"SCOALA GIMNAZIALA MIHAITA",319,"Alegeri Prezidentiale",1,628,337,276,61,0,331,6,700,363,167,164
17,DOLJ,"COŢOFENII DIN FAŢĂ",74875,"COŢOFENII DIN FAŢĂ","ŞCOALA CU CLASELE I-VIII COȚOFENII DIN FAŢĂ",320,"Alegeri Prezidentiale",1,1326,618,539,79,0,610,8,1400,782,238,372
17,DOLJ,"COŢOFENII DIN FAŢĂ",74875,BEHARCA,"ȘCOALA CU CLASELE I-IV",321,"Alegeri Prezidentiale",1,253,231,156,75,0,228,3,400,169,83,145
17,DOLJ,DANEŢI,71956,DANEŢI,"ȘCOALA PROFESIONALĂ DANEŢI",322,"Alegeri Prezidentiale",1,1632,828,715,113,0,819,9,1800,972,339,480
17,DOLJ,DANEŢI,71956,DANEŢI,"ŞCOALA PROFESIONALĂ DANEŢI",323,"Alegeri Prezidentiale",1,1378,589,529,60,0,579,10,1500,911,273,306
17,DOLJ,DANEŢI,71956,BRANIŞTE,"ŞCOALA GENERALĂ CU CLASELE I-VIII BRANIŞTE",324,"Alegeri Prezidentiale",1,512,273,216,57,0,273,0,600,327,114,159
17,DOLJ,DANEŢI,71956,LOCUSTENI,"ŞCOALA GENERALĂ CU CLASELE I-IV LOCUSTENI",325,"Alegeri Prezidentiale",1,479,296,243,53,0,292,4,600,304,122,170
17,DOLJ,DANEŢI,71956,BRABEŢI,"ŞCOALA GENERALĂ CU CLASELE I-VIII BRABEŢI",326,"Alegeri Prezidentiale",1,836,442,351,91,0,440,2,1000,558,196,244
17,DOLJ,DESA,72034,DESA,"GRADINITA DE COPII DESA",327,"Alegeri Prezidentiale",1,1194,527,490,37,0,523,4,1300,773,222,301
17,DOLJ,DESA,72034,DESA,"ŞCOALA GIMNAZIALĂ DESA -CORPUL 1",328,"Alegeri Prezidentiale",1,1347,669,634,35,0,667,2,1500,831,303,364
17,DOLJ,DESA,72034,DESA,"ŞCOALA GIMNAZIALĂ DESA",329,"Alegeri Prezidentiale",1,1339,540,521,19,0,535,5,1500,960,241,294
17,DOLJ,DIOŞTI,72052,DIOŞTI,"CLUB CAMIN CULTURAL DIOSTI",330,"Alegeri Prezidentiale",1,969,547,433,97,17,532,15,1100,553,245,287
17,DOLJ,DIOŞTI,72052,RADOMIR,"SCOALA GENERALA CU CLASELE I-IV RADOMIR",331,"Alegeri Prezidentiale",1,882,400,337,44,19,398,2,1000,600,124,274
17,DOLJ,DIOŞTI,72052,CIOCĂNEŞTI,"SCOALA GENERALA CU CLASELE I-VIII CIOCANESTI",332,"Alegeri Prezidentiale",1,572,293,232,44,17,290,3,700,407,133,157
17,DOLJ,DOBREŞTI,72098,DOBREŞTI,"ȘCOALA DOBREȘTI",333,"Alegeri Prezidentiale",1,320,136,113,17,6,133,3,400,264,62,71
17,DOLJ,DOBREŞTI,72098,MURTA,"ȘCOALA MURTA",334,"Alegeri Prezidentiale",2,681,314,254,57,3,312,2,800,486,134,178
17,DOLJ,DOBREŞTI,72098,TOCENI,"ȘCOALA TOCENI",335,"Alegeri Prezidentiale",1,511,307,249,37,21,304,3,600,293,102,202
17,DOLJ,DOBREŞTI,72098,CĂCIULĂTEŞTI,"ȘCOALA CĂCIULĂTEȘTI",336,"Alegeri Prezidentiale",1,402,201,148,49,4,198,3,500,299,100,98
17,DOLJ,DOBROTEŞTI,74883,DOBROTEŞTI,"CĂMINUL CULTURAL",337,"Alegeri Prezidentiale",1,1361,869,714,120,35,844,25,1500,631,402,442
17,DOLJ,DRĂGOTEŞTI,72150,VIIŞOARA,"SCOALA CU CLS. I - IV VIIŞOARA",338,"Alegeri Prezidentiale",1,416,261,214,39,8,256,5,500,239,98,158
17,DOLJ,DRĂGOTEŞTI,72150,DRĂGOTEŞTI,"SCOALA VECHE DRĂGOTEŞTI",339,"Alegeri Prezidentiale",1,362,274,215,42,17,272,2,500,226,73,199
17,DOLJ,DRĂGOTEŞTI,72150,BENEŞTI,"SCOALA CU CLS. I - IV BENEŞTI",340,"Alegeri Prezidentiale",1,344,212,179,27,6,208,4,400,188,72,136
17,DOLJ,DRĂGOTEŞTI,72150,POPÂNZĂLEŞTI,"TARG SAPTAMANAL-CLADIREA PRODUSE LACTATE",341,"Alegeri Prezidentiale",1,488,334,251,69,14,331,3,600,266,114,217
17,DOLJ,DRĂGOTEŞTI,72150,BUZDUC,"SCOALA CU CLS. I - IV BUZDUC",342,"Alegeri Prezidentiale",1,110,88,55,28,5,85,3,200,112,30,55
17,DOLJ,DRĂNIC,72221,DRĂNIC,"CAMINUL CULTURAL DRANIC",343,"Alegeri Prezidentiale",1,796,327,263,64,0,327,0,900,573,142,185
17,DOLJ,DRĂNIC,72221,PADEA,"SCOALA PRIMARA PADEA",344,"Alegeri Prezidentiale",1,621,295,226,69,0,291,4,700,405,186,105
17,DOLJ,DRĂNIC,72221,BOOVENI,"SCOALA CU CLASELE I-IV BOOVENI",345,"Alegeri Prezidentiale",1,290,191,167,24,0,191,0,400,209,101,90
17,DOLJ,DRĂNIC,72221,FOIŞOR,"SCOALA CU CLASELE I-IV FOISOR",346,"Alegeri Prezidentiale",1,205,104,67,37,0,104,0,300,196,43,61
17,DOLJ,FĂRCAŞ,72276,FĂRCAŞ,"CAMINUL CULTURAL FARCAS",347,"Alegeri Prezidentiale",1,1010,426,373,53,0,417,9,1200,774,195,222
17,DOLJ,FĂRCAŞ,72276,GOLUMBU,"SCOALA GENERALA GOLUMBU",348,"Alegeri Prezidentiale",1,657,350,305,45,0,349,1,800,450,143,206
17,DOLJ,"GALICEA MARE",72383,"GALICEA MARE","ȘCOALA GIMNAZIALĂ CORP 3",349,"Alegeri Prezidentiale",1,1445,518,496,22,0,512,6,1600,1082,271,241
17,DOLJ,"GALICEA MARE",72383,"GALICEA MARE","ȘCOALA GIMNAZIALĂ -CORP 3",350,"Alegeri Prezidentiale",1,687,381,292,89,0,381,0,800,419,236,145
17,DOLJ,"GALICEA MARE",72383,"GALICEA MARE","ȘCOALA GIMNAZIALĂ - CORP 3",351,"Alegeri Prezidentiale",1,1168,473,461,12,0,472,1,1300,827,292,180
17,DOLJ,GALICIUICA,74891,GALICIUICA,"CAMINUL CULTURAL",352,"Alegeri Prezidentiale",1,1160,699,611,82,6,693,6,1300,601,265,428
17,DOLJ,GÂNGIOVA,72579,GÂNGIOVA,"CĂMINUL CULTURAL GÎNGIOVA",353,"Alegeri Prezidentiale",1,1153,515,437,78,0,508,7,1300,785,203,305
17,DOLJ,GÂNGIOVA,72579,COMOŞTENI,"CĂMINUL CULTURAL COMOŞTENI",354,"Alegeri Prezidentiale",1,838,315,264,51,0,312,3,1000,685,126,186
17,DOLJ,GHERCEŞTI,72409,GHERCEŞTI,"CĂMINUL CULTURAL",355,"Alegeri Prezidentiale",1,857,673,477,190,6,665,8,1000,327,356,309
17,DOLJ,GHERCEŞTI,72409,GÂRLEŞTI,"ŞCOALA GENERALĂ GÂRLEŞTI",356,"Alegeri Prezidentiale",1,373,297,206,87,4,297,0,502,205,141,156
17,DOLJ,GHERCEŞTI,72409,UNGURENI,"ŞCOALA GENERALĂ UNGURENI",357,"Alegeri Prezidentiale",1,252,272,161,108,3,264,8,403,131,92,172
17,DOLJ,GHIDICI,74907,GHIDICI,"CĂMINUL CULTURAL",358,"Alegeri Prezidentiale",1,1835,993,823,86,84,987,6,2100,1107,214,773
17,DOLJ,GHINDENI,74915,GHINDENI,"CAMIN CULTURAL",359,"Alegeri Prezidentiale",1,1544,925,747,178,0,907,18,1700,775,464,443
17,DOLJ,GIGHERA,72463,GIGHERA,"CĂMINUL CULTURAL GIGHERA",360,"Alegeri Prezidentiale",1,964,486,409,77,0,481,5,1100,614,147,334
17,DOLJ,GIGHERA,72463,NEDEIA,"CĂMINUL CULTURAL NEDEIA",361,"Alegeri Prezidentiale",1,675,396,299,97,0,393,3,800,404,159,234
17,DOLJ,GIGHERA,72463,ZĂVAL,"CĂMINUL CULTURAL ZĂVAL",362,"Alegeri Prezidentiale",1,614,320,256,64,0,317,3,700,380,141,176
17,DOLJ,GIUBEGA,72506,GIUBEGA,"ȘCOALA GIMNAZIALĂ GIUBEGA",363,"Alegeri Prezidentiale",1,896,434,335,99,0,429,5,1000,566,214,215
17,DOLJ,GIUBEGA,72506,GIUBEGA,"PRIMARIA VECHE",364,"Alegeri Prezidentiale",1,841,442,384,58,0,439,3,1000,558,234,205
17,DOLJ,GIURGIŢA,72533,GIURGIŢA,"SCOALA GIMNAZIALA GIURGITA",365,"Alegeri Prezidentiale",1,971,496,413,83,0,489,7,1100,604,133,356
17,DOLJ,GIURGIŢA,72533,GIURGIŢA,"GRADINITA PORTARESTI",366,"Alegeri Prezidentiale",1,967,380,323,57,0,378,2,1100,720,117,261
17,DOLJ,GIURGIŢA,72533,CURMĂTURA,"GRADINITA CURMATURA",367,"Alegeri Prezidentiale",1,415,224,165,59,0,224,0,500,276,72,152
17,DOLJ,GOGOŞU,72604,GOGOŞU,"CĂMINUL CULTURAL GOGOŞU",368,"Alegeri Prezidentiale",1,175,173,97,76,0,167,6,300,127,109,58
17,DOLJ,GOGOŞU,72604,GOGOŞIŢA,"ŞCOALA CU CLASELE I-IV",369,"Alegeri Prezidentiale",1,146,137,89,48,0,133,4,317,180,77,56
17,DOLJ,GOGOŞU,72604,ŞTEFĂNEL,"ŞCOALA CU CLASELE I-IV",370,"Alegeri Prezidentiale",1,144,175,88,87,0,172,3,310,135,116,56
17,DOLJ,GOICEA,72640,GOICEA,"GRĂDINIȚA NR.1",371,"Alegeri Prezidentiale",1,1178,732,556,125,51,720,12,1300,568,226,494
17,DOLJ,GOICEA,72640,GOICEA,"GRĂDINIȚA NR.2",372,"Alegeri Prezidentiale",1,861,450,340,85,25,440,10,1000,550,187,253
17,DOLJ,GOIEŞTI,72677,GOIEŞTI,"CAMIN CULTURAL GOIESTI SALA",373,"Alegeri Prezidentiale",1,1170,620,485,134,1,611,9,1300,680,322,289
17,DOLJ,GOIEŞTI,72677,MOGOŞEŞTI,"SCOALA CLS I-IV MOGOSESTI SALA",374,"Alegeri Prezidentiale",1,491,245,207,38,0,239,6,600,355,143,96
17,DOLJ,GOIEŞTI,72677,MĂLĂEŞTI,"SCOALA CU CLS I-IV MALAESTI SALA",375,"Alegeri Prezidentiale",1,479,267,229,38,0,264,3,600,333,135,129
17,DOLJ,GOIEŞTI,72677,ŢANDĂRA,"SCOALA CU CLS I-VIII TANDARA SALA",376,"Alegeri Prezidentiale",1,425,217,183,33,1,215,2,500,283,101,114
17,DOLJ,GRECEŞTI,72819,BĂRBOI,"ȘCOALA BĂRBOI",377,"Alegeri Prezidentiale",1,308,194,132,42,20,193,1,394,200,78,115
17,DOLJ,GRECEŞTI,72819,GRECEŞTI,"ȘCOALA GRECEȘTI",378,"Alegeri Prezidentiale",1,227,208,143,59,6,206,2,300,92,79,127
17,DOLJ,GRECEŞTI,72819,BUSU,"ȘCOALA BUSU",379,"Alegeri Prezidentiale",1,538,373,292,55,26,371,2,600,227,91,280
17,DOLJ,GRECEŞTI,72819,GROPANELE,"ȘCOALA GROPANELE",380,"Alegeri Prezidentiale",1,241,167,142,23,2,166,1,300,133,49,117
17,DOLJ,IŞALNIŢA,70094,IŞALNIŢA,"ŞCOALA GIMNAZIALĂ ELIZA OPRAN",381,"Alegeri Prezidentiale",1,1668,1033,845,145,43,1021,12,1900,867,491,530
17,DOLJ,IŞALNIŢA,70094,IŞALNIŢA,"ŞCOALA GIMNAZIALĂ ELIZA OPRAN",382,"Alegeri Prezidentiale",1,1785,1132,926,166,40,1122,10,2000,868,382,740
17,DOLJ,IZVOARE,72882,IZVOARE,"GRADINITA IZVOARE",383,"Alegeri Prezidentiale",1,946,484,390,81,13,478,6,1100,616,202,276
17,DOLJ,IZVOARE,72882,CORLATE,"SCOALA CLASELE I-IV",384,"Alegeri Prezidentiale",1,265,180,128,42,10,179,1,400,220,89,90
17,DOLJ,ÎNTORSURA,74923,ÎNTORSURA,"SCOALA GIMNAZIALA N. GH. POPESCU",385,"Alegeri Prezidentiale",1,1205,679,565,114,0,673,6,1400,721,300,373
17,DOLJ,LEU,72926,LEU,"GRADINA DE VARA LEU",386,"Alegeri Prezidentiale",2,1402,784,650,134,0,774,10,1600,816,334,440
17,DOLJ,LEU,72926,LEU,"GRADINA DE VARA LEU",387,"Alegeri Prezidentiale",1,1525,868,735,133,0,860,8,1700,832,395,465
17,DOLJ,LEU,72926,ZĂNOAGA,"GRADINITA ZĂNOAGA",388,"Alegeri Prezidentiale",1,951,527,416,111,0,524,3,1100,573,242,282
17,DOLJ,LIPOVU,72953,LIPOVU,"SCOALA GIMNAZIALA CLASELE I-VIII PETRE MANARCESCU",389,"Alegeri Prezidentiale",1,1299,446,389,57,0,436,10,1500,1054,205,231
17,DOLJ,LIPOVU,72953,LIPOVU,"LOCAL PRIMĂRIE",390,"Alegeri Prezidentiale",2,862,288,253,35,0,285,3,1000,712,121,164
17,DOLJ,LIPOVU,72953,"LIPOVU DE SUS","SCOALA PRIMARA CLSELE I-VIII",391,"Alegeri Prezidentiale",1,158,88,68,20,0,87,1,200,112,22,65
17,DOLJ,MAGLAVIT,73031,MAGLAVIT,"SCOALA CU CLASELE I-VIII MAGLAVIT",392,"Alegeri Prezidentiale",1,1813,777,658,109,10,765,12,2000,1223,301,464
17,DOLJ,MAGLAVIT,73031,MAGLAVIT,"SCOALA CLASELE I-IV MAGLAVIT",393,"Alegeri Prezidentiale",1,1027,440,359,75,6,430,10,1200,760,174,256
17,DOLJ,MAGLAVIT,73031,HUNIA,"ȘCOALA GENERALĂ HUNIA",394,"Alegeri Prezidentiale",1,1068,487,376,79,32,480,7,1200,713,188,292
17,DOLJ,"MALU MARE",73068,"MALU MARE","LICEUL TEHNOLOGIC ”ING. IONETE AURELIAN”",395,"Alegeri Prezidentiale",1,937,544,394,135,15,538,6,1100,556,317,221
17,DOLJ,"MALU MARE",73068,PREAJBA,"ŞCOALA PRIMARĂ PREAJBA",396,"Alegeri Prezidentiale",1,999,566,438,128,0,562,4,1100,534,338,224
17,DOLJ,"MALU MARE",73068,"MALU MARE","ȘCOALA GIMNAZIALĂ MALU MARE",397,"Alegeri Prezidentiale",1,1243,609,492,117,0,596,13,1400,791,345,251
17,DOLJ,"MALU MARE",73068,PREAJBA,"ȘCOALA GIMNAZIALĂ PREAJBA",398,"Alegeri Prezidentiale",1,1271,443,381,62,0,437,6,1400,957,318,119
17,DOLJ,"MĂCEŞU DE JOS",72980,"MĂCEŞU DE JOS","PRIMĂRIA MĂCEŞU DE JOS",399,"Alegeri Prezidentiale",1,802,534,448,83,3,525,9,900,366,168,357
17,DOLJ,"MĂCEŞU DE JOS",72980,SĂPATA,"ŞCOALA SĂPATA",400,"Alegeri Prezidentiale",1,263,156,122,34,0,156,0,400,244,69,87
17,DOLJ,"MĂCEŞU DE SUS",73013,"MĂCEŞU DE SUS","CAMINUL CULTURAL",401,"Alegeri Prezidentiale",1,1017,620,546,74,0,605,15,1200,580,382,223
17,DOLJ,MÂRŞANI,73317,MÂRŞANI,"ȘCOALA GENERALĂ NR. 2 MÎRȘANI",402,"Alegeri Prezidentiale",1,1427,874,716,103,55,866,8,1600,726,293,573
17,DOLJ,MÂRŞANI,73317,MÂRŞANI,"ȘCOALA GIMNAZIALĂ NR. 1 MÂRȘANI",403,"Alegeri Prezidentiale",1,1093,734,619,95,20,723,11,1200,466,289,434
17,DOLJ,MÂRŞANI,73317,MÂRŞANI,"ȘCOALA GENERALĂ NR. 3 MÎRȘANI",404,"Alegeri Prezidentiale",1,1208,745,633,82,30,732,13,1400,655,303,429
17,DOLJ,MELINEŞTI,73102,MELINEŞTI,"CĂMINUL CULTURAL MELINEŞTI",405,"Alegeri Prezidentiale",1,947,567,417,135,15,560,7,1100,533,252,308
17,DOLJ,MELINEŞTI,73102,NEGOIEŞTI,"ŞCOALA GENERALĂ NEGOIEŞTI",406,"Alegeri Prezidentiale",1,1171,542,444,97,1,532,10,1300,758,239,293
17,DOLJ,MELINEŞTI,73102,BODĂIEŞTI,"SEDIUL FOSTEI ŞCOLI GENERALE BODAIESTI",407,"Alegeri Prezidentiale",1,593,212,177,35,0,211,1,700,488,92,119
17,DOLJ,MELINEŞTI,73102,"BODĂIEŞTII DE SUS","ŞCOALA GENERALĂ BODĂIEŞTII DE SUS",408,"Alegeri Prezidentiale",1,242,137,109,28,0,135,2,300,163,67,68
17,DOLJ,MELINEŞTI,73102,SPINENI,"ŞCOALA GENERALĂ SPINENI",409,"Alegeri Prezidentiale",1,260,156,123,33,0,155,1,404,248,61,94
17,DOLJ,MISCHII,73246,MISCHII,"ŞCOALA GENERALĂ MISCHII",410,"Alegeri Prezidentiale",1,495,339,235,102,2,337,2,600,261,200,137
17,DOLJ,MISCHII,73246,MLECĂNEŞTI,"ŞCOALA GENERALĂ MLECĂNEŞTI",411,"Alegeri Prezidentiale",1,434,269,208,61,0,260,9,500,231,130,130
17,DOLJ,MISCHII,73246,URECHEŞTI,"ŞCOALA GENERALĂ URECHEŞTI",412,"Alegeri Prezidentiale",1,410,291,208,83,0,286,5,499,208,176,110
17,DOLJ,MISCHII,73246,CĂLINEŞTI,"ŞCOALA GENERALĂ CĂLINEŞTI",413,"Alegeri Prezidentiale",1,104,61,39,22,0,60,1,300,239,33,27
17,DOLJ,MOŢĂŢEI,73335,MOŢĂŢEI-GARĂ,"ŞCOALA MOŢĂŢEI GARĂ",414,"Alegeri Prezidentiale",1,683,297,266,31,0,293,4,800,503,142,151
17,DOLJ,MOŢĂŢEI,73335,MOŢĂŢEI,"GRĂDINIŢA NR. 2 MOŢĂŢEI",415,"Alegeri Prezidentiale",1,1742,822,761,53,8,819,3,2000,1178,312,507
17,DOLJ,MOŢĂŢEI,73335,MOŢĂŢEI,"ŞCOALA NR. 1 MOŢĂŢEI",416,"Alegeri Prezidentiale",1,1111,498,434,64,0,495,3,1300,802,211,284
17,DOLJ,MOŢĂŢEI,73335,MOŢĂŢEI,"GRĂDINIŢA NR. 3 MOŢĂŢEI",417,"Alegeri Prezidentiale",1,1602,747,700,47,0,738,9,1800,1053,337,401
17,DOLJ,MOŢĂŢEI,73335,DOBRIDOR,"GRĂDINIŢA NR. 2 DOBRIDOR",418,"Alegeri Prezidentiale",1,641,296,256,40,0,295,1,800,504,138,157
17,DOLJ,MURGAŞI,73371,MURGAŞI,"ŞCOALA CU CLASELE I-VIII MURGAŞI",419,"Alegeri Prezidentiale",1,853,566,433,106,27,560,6,1000,434,210,350
17,DOLJ,MURGAŞI,73371,"BALOTA DE JOS","GRĂDINIŢA BALOTA DE JOS",420,"Alegeri Prezidentiale",1,707,453,371,58,24,447,6,800,347,122,325
17,DOLJ,MURGAŞI,73371,VELEŞTI,"ŞCOALA CU CLASELE I-IV VELEŞTI",421,"Alegeri Prezidentiale",1,367,243,168,58,17,239,4,500,257,67,172
17,DOLJ,NEGOI,73460,NEGOI,"SCOALA GIMNAZIALA NEGOI",422,"Alegeri Prezidentiale",1,917,479,363,70,46,471,8,1100,621,130,341
17,DOLJ,NEGOI,73460,NEGOI,"SCOALA GIMNAZIALA NEGOI",423,"Alegeri Prezidentiale",1,803,305,243,41,21,298,7,900,595,80,218
17,DOLJ,ORODEL,73503,ORODEL,"ŞCOALA GENERALĂ ORODEL",424,"Alegeri Prezidentiale",1,937,536,465,70,1,527,9,1100,564,161,366
17,DOLJ,ORODEL,73503,CORNU,"ŞCOALA GENERALĂ CORNU",425,"Alegeri Prezidentiale",1,412,242,193,49,0,236,6,500,258,92,144
17,DOLJ,ORODEL,73503,TEIU,"ŞCOALA GENERALĂ TEIU",426,"Alegeri Prezidentiale",1,184,109,88,21,0,107,2,300,191,43,64
17,DOLJ,ORODEL,73503,CĂLUGĂREI,"ŞCOALA GENERALĂ CĂLUGĂREI",427,"Alegeri Prezidentiale",1,500,278,234,44,0,278,0,600,322,81,197
17,DOLJ,OSTROVENI,73567,OSTROVENI,"CĂMINUL CULTURAL OSTROVENI",428,"Alegeri Prezidentiale",1,1083,582,480,102,0,580,2,1200,618,165,415
17,DOLJ,OSTROVENI,73567,OSTROVENI,"GRĂDINIŢA DE COPII ORĂŞANI",429,"Alegeri Prezidentiale",1,1093,560,474,86,0,553,7,1200,640,152,401
17,DOLJ,OSTROVENI,73567,OSTROVENI,"GRĂDINIŢA DE COPII GRINDENI",430,"Alegeri Prezidentiale",1,562,295,234,61,0,291,4,700,405,81,210
17,DOLJ,OSTROVENI,73567,LIŞTEAVA,"ŞCOALA GIMNAZIALĂ LIŞTEAVA",431,"Alegeri Prezidentiale",1,1215,497,432,65,0,488,9,1400,903,191,297
17,DOLJ,PERIŞOR,73594,PERIŞOR,"ŞCOALA PRIMARĂ(LOCAL VECHI)",432,"Alegeri Prezidentiale",1,1144,747,533,206,8,737,10,1300,553,424,313
17,DOLJ,PERIŞOR,73594,MĂRĂCINELE,"ŞCOALA PRIMARĂ CL. I-IV",433,"Alegeri Prezidentiale",1,213,150,87,59,4,149,1,300,150,72,77
17,DOLJ,PIELEŞTI,73629,PIELEŞTI,"ŞCOALA GIMNAZIALĂ PIELEŞTI",434,"Alegeri Prezidentiale",1,1252,713,500,213,0,704,9,1400,687,398,306
17,DOLJ,PIELEŞTI,73629,PIELEŞTI,"SEDIUL FOSTEI ŞCOLI GENERALE NR 2 PIELEŞTI",435,"Alegeri Prezidentiale",1,1441,602,510,92,0,593,9,1600,998,407,186
17,DOLJ,PIELEŞTI,73629,CÂMPENI,"ŞCOALA GIMNAZIALĂ PIELEŞTI",436,"Alegeri Prezidentiale",1,612,284,231,53,0,280,4,700,416,159,121
17,DOLJ,"PISCU VECHI",73665,"PISCU VECHI","CAMINUL CULTURAL PISCU VECHI",437,"Alegeri Prezidentiale",1,959,513,471,42,0,507,6,1100,587,109,398
17,DOLJ,"PISCU VECHI",73665,PISCULEŢ,"SCOALA PISCULET",438,"Alegeri Prezidentiale",1,234,155,115,40,0,153,2,300,145,26,127
17,DOLJ,"PISCU VECHI",73665,"PISCU VECHI","SCOALA GIMNAZIALA PISCU VECHI",439,"Alegeri Prezidentiale",1,976,508,461,47,0,505,3,1100,592,144,361
17,DOLJ,PLENIŢA,73709,PLENIŢA,"LICEUL TEHNOLOGIC C.N. PLOPSOR",440,"Alegeri Prezidentiale",1,1039,454,403,45,6,443,11,1200,746,228,215
17,DOLJ,PLENIŢA,73709,PLENIŢA,"SCOALA CU CALSELE I-VIII LOCAL B POIANA",441,"Alegeri Prezidentiale",1,946,401,367,24,10,397,4,1100,699,194,203
17,DOLJ,PLENIŢA,73709,PLENIŢA,"GRADINITA ”ALBA CA ZAPADA”",442,"Alegeri Prezidentiale",1,1051,477,392,40,45,471,6,1200,723,208,263
17,DOLJ,PLENIŢA,73709,"CASTRELE TRAIANE","SCOALA CU CLASELEI-IV DIN SATUL CASTRELE TRAIANE",443,"Alegeri Prezidentiale",1,644,312,256,35,21,308,4,800,488,122,186
17,DOLJ,PLEŞOI,74931,PLEŞOI,"SCOALA GIMNAZIALA PLEŞOI",444,"Alegeri Prezidentiale",1,1016,568,461,107,0,560,8,1199,631,204,356
17,DOLJ,PODARI,70110,BRANIŞTE,"ŞCOALA GENERALĂ BRANIŞTE",445,"Alegeri Prezidentiale",1,703,425,323,102,0,417,8,800,375,186,231
17,DOLJ,PODARI,70110,"BALTA VERDE","ŞCOALA GENERALĂ BALTA VERDE",446,"Alegeri Prezidentiale",1,430,250,203,47,0,245,5,500,250,135,110
17,DOLJ,PODARI,70110,PODARI,"PRIMĂRIA PODARI",447,"Alegeri Prezidentiale",1,1388,732,614,118,0,718,14,1500,768,333,385
17,DOLJ,PODARI,70110,PODARI,"ŞCOALA GENERALĂ PODARI",448,"Alegeri Prezidentiale",1,1946,859,713,146,0,845,14,2100,1241,411,434
17,DOLJ,PODARI,70110,LIVEZI,"ŞCOALA GENERALĂ LIVEZI",449,"Alegeri Prezidentiale",1,744,369,306,63,0,365,4,900,531,183,182
17,DOLJ,PODARI,70110,"GURA VĂII","ŞCOALA GENERALĂ GURA VĂII",450,"Alegeri Prezidentiale",1,372,217,176,41,0,217,0,500,283,92,125
17,DOLJ,"POIANA MARE",73736,"POIANA MARE","ŞCOALA PRIMARĂ I-IV SÎRBI",451,"Alegeri Prezidentiale",1,1459,699,652,47,0,692,7,1600,901,293,399
17,DOLJ,"POIANA MARE",73736,"POIANA MARE","ŞCOALA GENERALĂ DRAGU",452,"Alegeri Prezidentiale",1,1547,661,625,36,0,658,3,1700,1039,291,367
17,DOLJ,"POIANA MARE",73736,"POIANA MARE","ŞCOALA GENERALĂ 3 CENTRU",453,"Alegeri Prezidentiale",1,1383,616,508,49,59,610,6,1600,984,270,340
17,DOLJ,"POIANA MARE",73736,"POIANA MARE","LICEUL GEORGE ST. MARINCU",454,"Alegeri Prezidentiale",1,1254,561,519,42,0,555,6,1400,839,275,280
17,DOLJ,"POIANA MARE",73736,"POIANA MARE","ŞCOALA GENERALĂ TRAISTARU",455,"Alegeri Prezidentiale",1,1645,760,703,57,0,755,5,1800,1040,367,388
17,DOLJ,"POIANA MARE",73736,"TUNARII VECHI","ŞCOALA GENERALĂ TUNARII VECHI",456,"Alegeri Prezidentiale",1,1080,483,439,44,0,477,6,1200,717,252,225
17,DOLJ,"POIANA MARE",73736,"TUNARII NOI","ŞCOALA GENERALĂ TUNARII NOI",457,"Alegeri Prezidentiale",1,423,222,188,34,0,221,1,500,278,102,119
17,DOLJ,PREDEŞTI,73772,PREDEŞTI,"ŞC.GIMNAZIALĂ PREDEŞTI",458,"Alegeri Prezidentiale",1,1653,1494,797,697,0,1477,17,1900,406,823,654
17,DOLJ,RADOVAN,73852,RADOVAN,"ŞCOALA GIMNAZIALA RADOVAN",459,"Alegeri Prezidentiale",1,799,376,296,80,0,373,3,900,524,162,211
17,DOLJ,RADOVAN,73852,FÂNTÂNELE,"CAMIN CULTURAL FÂNTÂNELE",460,"Alegeri Prezidentiale",1,79,81,40,41,0,81,0,200,119,49,32
17,DOLJ,RADOVAN,73852,TÂRNAVA,"CAMIN CULTURAL TÂRNAVA",461,"Alegeri Prezidentiale",1,151,111,59,49,3,110,1,198,87,72,38
17,DOLJ,RAST,73905,RAST,"CAMINUL CULTURAL",462,"Alegeri Prezidentiale",1,1651,819,770,48,1,810,9,1800,981,382,428
17,DOLJ,RAST,73905,RAST,"SEDIUL NOU PRIMARIE",463,"Alegeri Prezidentiale",1,1192,539,496,43,0,535,4,1300,761,309,226
17,DOLJ,ROBĂNEŞTI,73923,"ROBĂNEŞTII DE JOS","CĂMIN CULTURAL",464,"Alegeri Prezidentiale",1,491,287,230,55,2,286,1,600,313,91,195
17,DOLJ,ROBĂNEŞTI,73923,GOLFIN,"ŞCOALA GOLFIN",465,"Alegeri Prezidentiale",1,500,301,237,63,1,294,7,600,299,96,198
17,DOLJ,ROBĂNEŞTI,73923,"LĂCRIŢA MARE","ŞCOALA LĂCRIŢA MARE",466,"Alegeri Prezidentiale",1,468,317,242,75,0,315,2,600,283,109,206
17,DOLJ,ROBĂNEŞTI,73923,"ROBĂNEŞTII DE SUS","ŞCOALA ROBĂNEŞTII DE SUS",467,"Alegeri Prezidentiale",1,509,277,233,42,2,275,2,600,323,112,163
17,DOLJ,ROJIŞTE,74949,ROJIŞTE,"ŞCOALA GIMNAZIALĂ ROJIŞTE",468,"Alegeri Prezidentiale",1,1451,936,775,131,30,933,3,1600,664,636,297
17,DOLJ,ROJIŞTE,74949,TÂMBUREŞTI,"ŞCOALA CU CLS.I-IV",469,"Alegeri Prezidentiale",2,519,363,271,72,20,361,2,600,237,205,156
17,DOLJ,SADOVA,73996,SADOVA,"SCOALA GIMNAZIALA STRUCTURA RAIETI",470,"Alegeri Prezidentiale",1,520,255,215,39,1,251,4,600,345,148,103
17,DOLJ,SADOVA,73996,SADOVA,"SCOALA GIMNAZIALA STRUCTURA RAIETI",471,"Alegeri Prezidentiale",1,1398,204,194,10,0,202,2,1500,1296,67,135
17,DOLJ,SADOVA,73996,SADOVA,"SCOALA GIMNAZIALA SADOVA LOCAL VALE",472,"Alegeri Prezidentiale",1,1241,491,450,40,1,488,3,1400,909,243,245
17,DOLJ,SADOVA,73996,SADOVA,"SCOALA GIMNAZIALA SADOVA, LOCAL DEAL",473,"Alegeri Prezidentiale",1,1210,539,458,48,33,534,5,1300,761,317,217
17,DOLJ,SADOVA,73996,SADOVA,"CĂMINUL CULTURAL DAMIAN",474,"Alegeri Prezidentiale",1,1370,693,619,74,0,689,4,1500,807,445,244
17,DOLJ,SADOVA,73996,"PISCU SADOVEI","ŞCOALA GIMNAZIALĂ SADOVA, STRUCTURA PISCU – SADOVEI LOCAL VECHI",475,"Alegeri Prezidentiale",1,926,529,440,87,2,521,8,1100,571,279,242
17,DOLJ,SĂLCUŢA,74028,SĂLCUŢA,"ŞCOALA VECHE SĂLCUŢA",476,"Alegeri Prezidentiale",1,871,376,291,85,0,370,6,1000,624,223,147
17,DOLJ,SĂLCUŢA,74028,TENCĂNĂU,"ŞCOALA VECHE TENCĂNĂU",477,"Alegeri Prezidentiale",1,674,236,186,50,0,232,4,800,564,98,134
17,DOLJ,SCĂEŞTI,74073,SCĂEŞTI,"ŞCOALA GENERALĂ SCAEŞTI",478,"Alegeri Prezidentiale",1,886,527,405,110,12,513,12,1000,475,237,276
17,DOLJ,SCĂEŞTI,74073,"VALEA LUI PĂTRU","ŞCOALA GENERALĂ VALEA LUI PĂTRU",479,"Alegeri Prezidentiale",1,757,373,286,85,2,364,9,900,527,153,211
17,DOLJ,"SEACA DE CÂMP",74108,"SEACA DE CÂMP","ŞCOALA GIMNAZIALĂ CU CLASELE I-VIII DIN SEACA DE CÎMP",480,"Alegeri Prezidentiale",1,769,619,485,89,45,611,8,900,281,340,271
17,DOLJ,"SEACA DE CÂMP",74108,"PISCU NOU","ȘCOALA GIMNAZIALĂ PISCU NOU",481,"Alegeri Prezidentiale",1,727,625,462,133,30,619,6,800,175,294,325
17,DOLJ,"SEACA DE PĂDURE",74135,"SEACA DE PĂDURE","ŞCOALA SEACA DE PĂDURE",482,"Alegeri Prezidentiale",1,321,246,179,55,12,244,2,400,154,36,208
17,DOLJ,"SEACA DE PĂDURE",74135,VELENI,"ŞCOALA VELENI",483,"Alegeri Prezidentiale",1,303,203,153,41,9,203,0,400,197,56,147
17,DOLJ,"SEACA DE PĂDURE",74135,"RĂCHITA DE SUS","ŞCOALA RĂCHITA DE SUS",484,"Alegeri Prezidentiale",1,138,122,76,37,9,119,3,200,78,16,103
17,DOLJ,SECU,74171,SECU,"ȘCOALA GEN.CLASELE I-IV SECU",485,"Alegeri Prezidentiale",1,637,502,370,101,31,499,3,700,198,138,361
17,DOLJ,SECU,74171,"SMADOVICIOARA DE SECU","ŞCOALA GENERALĂ CU CLS. I-IV SMADOVICIOARA",486,"Alegeri Prezidentiale",1,165,151,118,25,8,151,0,300,149,41,110
17,DOLJ,"SILIŞTEA CRUCII",74224,"SILIŞTEA CRUCII","CĂMINUL CULTURAL",487,"Alegeri Prezidentiale",1,1207,755,564,148,43,750,5,1400,645,345,405
17,DOLJ,SOPOT,74242,SOPOT,"SCOALA CU CLASELE I-IV SOPOT",488,"Alegeri Prezidentiale",1,390,206,160,46,0,204,2,500,294,69,135
17,DOLJ,SOPOT,74242,BELOŢ,"SCOALA CU CLASELE I-VIII BELOŢ",489,"Alegeri Prezidentiale",1,253,133,102,31,0,132,1,300,167,46,86
17,DOLJ,SOPOT,74242,SÂRSCA,"SCOALA SÎRSCA",490,"Alegeri Prezidentiale",1,134,84,59,25,0,83,1,200,116,44,39
17,DOLJ,SOPOT,74242,BAŞCOV,"SCOALA CU CLASELE I-IV BAŞCOV",491,"Alegeri Prezidentiale",1,288,170,141,29,0,168,2,400,230,51,117
17,DOLJ,SOPOT,74242,PIETROAIA,"SCOALA CU CLASELE I-IV PIETROAIA",492,"Alegeri Prezidentiale",1,354,171,141,30,0,168,3,499,328,115,53
17,DOLJ,"ŞIMNICU DE SUS",70174,ALBEŞTI,"GRADINITA ALBESTI",493,"Alegeri Prezidentiale",1,894,530,400,130,0,519,11,1000,470,355,164
17,DOLJ,"ŞIMNICU DE SUS",70174,DUDOVICEŞTI,"SCOALA DUDOVICESTI",494,"Alegeri Prezidentiale",1,777,429,284,145,0,423,6,900,471,246,177
17,DOLJ,"ŞIMNICU DE SUS",70174,FLOREŞTI,"CAMIN CULTURAL FLORESTI",495,"Alegeri Prezidentiale",1,658,303,245,58,0,297,6,800,497,149,148
17,DOLJ,"ŞIMNICU DE SUS",70174,IZVOR,"SCOALA IZVOR",496,"Alegeri Prezidentiale",1,576,332,265,67,0,328,4,700,368,171,157
17,DOLJ,"ŞIMNICU DE SUS",70174,LEŞILE,"GRADINITA LESILE",497,"Alegeri Prezidentiale",1,740,382,290,92,0,376,6,900,518,193,183
17,DOLJ,"ŞIMNICU DE SUS",70174,MILEŞTI,"SCOALA MILESTI",498,"Alegeri Prezidentiale",1,666,285,235,50,0,283,2,800,515,134,149
17,DOLJ,TĂLPAŞ,74956,TĂLPAŞ,"SCOALA GIMNAZIALA TĂLPAȘ",499,"Alegeri Prezidentiale",1,990,506,416,90,0,501,5,1100,594,232,269
17,DOLJ,TEASC,74322,TEASC,"ŞCOALA GIMNAZIALĂ TEASC",500,"Alegeri Prezidentiale",1,1346,699,597,102,0,691,8,1500,801,444,247
17,DOLJ,TEASC,74322,SECUI,"ŞCOALA GIMNAZIALĂ SECUI",501,"Alegeri Prezidentiale",1,1204,586,516,70,0,580,6,1400,814,354,226
17,DOLJ,TERPEZIŢA,74359,TERPEZIŢA,"ŞCOALA GENERALĂ TERPEZIŢA",502,"Alegeri Prezidentiale",1,701,569,415,129,25,560,9,800,231,211,349
17,DOLJ,TERPEZIŢA,74359,CĂCIULATU,"ŞCOALA CU CLASELE I-IV CĂCIULATU",503,"Alegeri Prezidentiale",1,276,215,165,40,10,211,4,400,185,138,73
17,DOLJ,TERPEZIŢA,74359,LAZU,"ŞCOALA CU CLASELE I-IV LAZU",504,"Alegeri Prezidentiale",1,261,227,134,85,8,218,9,300,73,114,104
17,DOLJ,TESLUI,74411,TESLUI,"SCOALA GIMNAZIALA TESLUI",505,"Alegeri Prezidentiale",1,451,213,179,34,0,208,5,500,287,72,136
17,DOLJ,TESLUI,74411,"PREAJBA DE PĂDURE","ȘCOALA GENERALĂ CLASELE V-VIII PREAJBA DE PĂDURE",506,"Alegeri Prezidentiale",1,644,419,351,68,0,412,7,800,381,120,292
17,DOLJ,TESLUI,74411,ŢĂRŢĂL,"ȘCOALA CLASELE I-IV ȚĂRȚĂL",507,"Alegeri Prezidentiale",1,278,210,162,48,0,208,2,400,190,85,123
17,DOLJ,TESLUI,74411,URIENI,"SCOALA VIISOARA MOSNENI",508,"Alegeri Prezidentiale",1,430,247,204,43,0,245,2,500,253,93,152
17,DOLJ,ŢUGLUI,74509,ŢUGLUI,"ȘCOALA GIMNAZIALĂ ȚUGLUI",509,"Alegeri Prezidentiale",1,1320,742,650,92,0,735,7,1400,658,344,391
17,DOLJ,ŢUGLUI,74509,ŢUGLUI,"GRĂDINIȚA NR 2 ȚUGLUI",510,"Alegeri Prezidentiale",1,893,544,495,49,0,536,8,1000,456,271,265
17,DOLJ,ŢUGLUI,74509,JIUL,"DISPENSAR UMAN",511,"Alegeri Prezidentiale",1,225,155,112,43,0,155,0,300,145,63,92
17,DOLJ,UNIREA,74536,UNIREA,"SCOALA DIN VALE NR.1",512,"Alegeri Prezidentiale",1,1648,895,794,81,20,882,13,1800,905,490,392
17,DOLJ,UNIREA,74536,UNIREA,"SCOALA NR.2",513,"Alegeri Prezidentiale",1,1407,739,653,77,9,729,10,1500,761,427,302
17,DOLJ,URZICUŢA,74554,URZICUŢA,"SCOALA CU CLS. I-VIII BARBU IONESCU URZICUTA",514,"Alegeri Prezidentiale",1,1883,778,660,111,7,776,2,2000,1222,239,537
17,DOLJ,URZICUŢA,74554,"URZICA MARE","CORP ADMINISTRATIV - PRIMARIE",515,"Alegeri Prezidentiale",1,379,239,184,54,1,237,2,500,261,142,95
17,DOLJ,"VALEA STANCIULUI",74581,"VALEA STANCIULUI","SCOALA CU CLASELE I-VIII",516,"Alegeri Prezidentiale",1,1168,625,520,105,0,622,3,1300,675,266,356
17,DOLJ,"VALEA STANCIULUI",74581,HOREZU-POENARI,"SCOALA CU CLASELE I-VIII",517,"Alegeri Prezidentiale",1,1337,611,549,62,0,601,10,1400,789,199,402
17,DOLJ,"VALEA STANCIULUI",74581,"VALEA STANCIULUI","GRADINITA TUGURESTI",518,"Alegeri Prezidentiale",1,526,283,225,58,0,280,3,600,317,107,173
17,DOLJ,"VALEA STANCIULUI",74581,"VALEA STANCIULUI","CAMINUL CULTURAL BIRZA",519,"Alegeri Prezidentiale",1,682,339,280,59,0,330,9,800,461,129,201
17,DOLJ,"VALEA STANCIULUI",74581,HOREZU-POENARI,"SCOALA CU CLASELE I-IV",520,"Alegeri Prezidentiale",1,561,342,265,77,0,340,2,700,358,124,216
17,DOLJ,VÂRTOP,74732,VÂRTOP,"ŞCOALA GIMNAZIALĂ VÎRTOP",521,"Alegeri Prezidentiale",1,1342,651,566,85,0,640,11,1500,849,192,448
17,DOLJ,"VÂRVORU DE JOS",74750,VÂRVOR,"ŞCOALA CU CLASELE I-IV VÎRVOR",522,"Alegeri Prezidentiale",1,524,294,200,83,11,292,2,600,306,127,165
17,DOLJ,"VÂRVORU DE JOS",74750,"VÂRVORU DE JOS","ŞCOALA CU CLASELE I-VIII VÎRVORU DE JOS",523,"Alegeri Prezidentiale",1,966,612,425,135,52,602,10,1100,488,206,396
17,DOLJ,"VÂRVORU DE JOS",74750,CIUTURA,"SCOALA CU CLASELE I-IV CIUTURA",524,"Alegeri Prezidentiale",1,576,400,243,133,24,395,5,700,300,136,259
17,DOLJ,VELA,74616,VELA,"ŞCOALA CU CLASELE I-VIII VELA",525,"Alegeri Prezidentiale",1,354,303,198,90,15,296,7,400,97,86,210
17,DOLJ,VELA,74616,BUCOVICIOR,"ŞCOALA CU CLASELE I-IV BUCOVICIOR",526,"Alegeri Prezidentiale",1,320,214,157,35,22,212,2,400,186,81,131
17,DOLJ,VELA,74616,ŞTIUBEI,"ŞCOALA CU CLASELE I-IV STIUBEI",527,"Alegeri Prezidentiale",1,76,61,33,23,5,61,0,200,139,15,46
17,DOLJ,VELA,74616,GUBAUCEA,"ŞCOALA CU CLASELE I-VIII GUBAUCEA",528,"Alegeri Prezidentiale",1,507,290,244,26,20,286,4,600,310,96,190
17,DOLJ,VELA,74616,SUHARU,"ŞCOALA CU CLASELE I-IV SUHARU",529,"Alegeri Prezidentiale",1,222,180,117,53,10,179,1,300,120,99,80
17,DOLJ,VERBIŢA,74705,VERBIŢA,"ŞCOALA GIMNAZIALĂ",530,"Alegeri Prezidentiale",1,653,212,184,28,0,210,2,800,588,93,117
17,DOLJ,VERBIŢA,74705,VERBICIOARA,"GRĂDINIŢA CU PROGRAM NORMAL",531,"Alegeri Prezidentiale",1,376,187,157,30,0,184,3,500,313,76,108
18,GALAŢI,"MUNICIPIUL GALAŢI",75098,GALAŢI,"ȘCOALA GIMNAZIALĂ NR. 26 (ŞCOALA GENERALĂ ”ION CREANGĂ” - ȘCOALA GENERALĂ NR. 26)",1,"Alegeri Prezidentiale",1,1231,623,573,49,1,609,14,1400,777,380,229
18,GALAŢI,"MUNICIPIUL GALAŢI",75098,GALAŢI,"ȘCOALA GIMNAZIALĂ NR. 26 (ŞCOALA GENERALĂ ”ION CREANGĂ” - ȘCOALA GENERALĂ NR. 26)",2,"Alegeri Prezidentiale",1,1149,671,603,66,2,656,15,1300,629,440,216
18,GALAŢI,"MUNICIPIUL GALAŢI",75098,GALAŢI,"ȘCOALA GIMNAZIALĂ NR. 28 (ŞCOALA GENERALĂ ”MIHAI EMINESCU” - ȘCOALA GENERALĂ NR. 28)",3,"Alegeri Prezidentiale",1,1199,714,650,64,0,698,16,1300,586,471,227
18,GALAŢI,"MUNICIPIUL GALAŢI",75098,GALAŢI,"ȘCOALA GIMNAZIALĂ NR. 28 (ŞCOALA GENERALĂ ”MIHAI EMINESCU” - ȘCOALA GENERALĂ NR. 28)",4,"Alegeri Prezidentiale",1,1057,629,563,66,0,616,13,1200,571,400,216
18,GALAŢI,"MUNICIPIUL GALAŢI",75098,GALAŢI,"ȘCOALA GIMNAZIALĂ NR. 28 (ŞCOALA GENERALĂ ”MIHAI EMINESCU” - ȘCOALA GENERALĂ NR. 28)",5,"Alegeri Prezidentiale",1,1307,735,664,71,0,713,22,1400,665,465,248
18,GALAŢI,"MUNICIPIUL GALAŢI",75098,GALAŢI,"ȘCOALA GIMNAZIALĂ NR. 28 (ŞCOALA GENERALĂ ”MIHAI EMINESCU” - ȘCOALA GENERALĂ NR. 28)",6,"Alegeri Prezidentiale",1,1307,738,693,45,0,708,30,1400,662,448,260
18,GALAŢI,"MUNICIPIUL GALAŢI",75098,GALAŢI,"ȘCOALA GIMNAZIALĂ NR. 28 (ŞCOALA GENERALĂ ”MIHAI EMINESCU” - ȘCOALA GENERALĂ NR. 28)",7,"Alegeri Prezidentiale",1,942,522,492,30,0,509,13,1000,478,334,175
18,GALAŢI,"MUNICIPIUL GALAŢI",75098,GALAŢI,"S.C. ”APA-CANAL” S.A.",8,"Alegeri Prezidentiale",1,1668,913,884,29,0,900,13,1800,887,556,344
18,GALAŢI,"MUNICIPIUL GALAŢI",75098,GALAŢI,"S.C. ”APA-CANAL” S.A.",9,"Alegeri Prezidentiale",1,1581,873,839,34,0,854,19,1700,827,554,300
18,GALAŢI,"MUNICIPIUL GALAŢI",75098,GALAŢI,"S.C. ”APA-CANAL” S.A.",10,"Alegeri Prezidentiale",1,1333,714,681,33,0,696,18,1500,786,461,235
18,GALAŢI,"MUNICIPIUL GALAŢI",75098,GALAŢI,"ȘCOALA GIMNAZIALĂ ”CONSTANTIN GHEORGHE MARINESCU” (SCOALA GENERALĂ NR.2)",11,"Alegeri Prezidentiale",1,1458,796,747,49,0,781,15,1608,812,527,254
18,GALAŢI,"MUNICIPIUL GALAŢI",75098,GALAŢI,"ȘCOALA GIMNAZIALĂ ”CONSTANTIN GHEORGHE MARINESCU” (SCOALA GENERALĂ NR.2)",12,"Alegeri Prezidentiale",1,1603,790,764,26,0,770,20,1800,1010,488,282
18,GALAŢI,"MUNICIPIUL GALAŢI",75098,GALAŢI,"LICEUL TEORETIC ”EMIL RACOVIȚĂ” (LICEUL ”EMIL RACOVIŢĂ” - ȘCOALA GENERALĂ NR. 6)",13,"Alegeri Prezidentiale",1,1703,849,810,39,0,831,18,1900,1051,571,260
18,GALAŢI,"MUNICIPIUL GALAŢI",75098,GALAŢI,"LICEUL TEORETIC ”EMIL RACOVIȚĂ” (LICEUL ”EMIL RACOVIŢĂ” - ȘCOALA GENERALĂ NR. 6)",14,"Alegeri Prezidentiale",1,1307,589,559,30,0,581,8,1400,811,364,217
18,GALAŢI,"MUNICIPIUL GALAŢI",75098,GALAŢI,"LICEUL TEORETIC ”EMIL RACOVIȚĂ” (LICEUL ”EMIL RACOVIŢĂ” - ȘCOALA GENERALĂ NR. 6)",15,"Alegeri Prezidentiale",1,1162,447,433,14,0,435,12,1300,853,279,156
18,GALAŢI,"MUNICIPIUL GALAŢI",75098,GALAŢI,"COLEGIUL NATIONAL ”MIHAIL KOGĂLNICEANU”",16,"Alegeri Prezidentiale",1,1155,476,409,66,1,464,12,1300,824,297,167
18,GALAŢI,"MUNICIPIUL GALAŢI",75098,GALAŢI,"COLEGIUL NATIONAL ”MIHAIL KOGĂLNICEANU”",17,"Alegeri Prezidentiale",1,1188,646,584,61,1,638,8,1300,654,444,194
18,GALAŢI,"MUNICIPIUL GALAŢI",75098,GALAŢI,"COLEGIUL NAȚIONAL ”COSTACHE NEGRI” (LICEUL PEDAGOGIC ”COSTACHE NEGRI”)",18,"Alegeri Prezidentiale",1,1120,559,514,45,0,549,10,1200,641,338,211
18,GALAŢI,"MUNICIPIUL GALAŢI",75098,GALAŢI,"COLEGIUL NAȚIONAL ”COSTACHE NEGRI” (LICEUL PEDAGOGIC ”COSTACHE NEGRI”)",19,"Alegeri Prezidentiale",1,1514,770,699,71,0,758,12,1700,930,511,247
18,GALAŢI,"MUNICIPIUL GALAŢI",75098,GALAŢI,"COLEGIUL NAȚIONAL ”COSTACHE NEGRI” (LICEUL PEDAGOGIC ”COSTACHE NEGRI”)",20,"Alegeri Prezidentiale",1,1522,770,734,20,16,756,14,1700,930,493,263
18,GALAŢI,"MUNICIPIUL GALAŢI",75098,GALAŢI,"COLEGIUL NAȚIONAL ”COSTACHE NEGRI” (LICEUL PEDAGOGIC ”COSTACHE NEGRI”)",21,"Alegeri Prezidentiale",1,1483,743,719,24,0,717,26,1600,857,458,259
18,GALAŢI,"MUNICIPIUL GALAŢI",75098,GALAŢI,"COLEGIUL NAȚIONAL ”COSTACHE NEGRI” (LICEUL PEDAGOGIC ”COSTACHE NEGRI”)",22,"Alegeri Prezidentiale",1,1454,745,719,26,0,730,15,1600,855,464,266
18,GALAŢI,"MUNICIPIUL GALAŢI",75098,GALAŢI,"ȘCOALA GIMNAZIALĂ ”ELENA CUZA” (ȘCOALA NR.15)",23,"Alegeri Prezidentiale",1,1365,668,638,30,0,651,17,1500,832,403,248
18,GALAŢI,"MUNICIPIUL GALAŢI",75098,GALAŢI,"ȘCOALA GIMNAZIALĂ ”ELENA CUZA” (ȘCOALA NR.15)",24,"Alegeri Prezidentiale",1,1691,702,687,15,0,688,14,1900,1198,432,256
18,GALAŢI,"MUNICIPIUL GALAŢI",75098,GALAŢI,"GRĂDINIȚA CU PROGRAM NORMAL ”IOAN NENIȚESCU” (GRĂDINIȚA NR. 15)",25,"Alegeri Prezidentiale",1,1400,592,566,26,0,582,10,1500,908,386,196
18,GALAŢI,"MUNICIPIUL GALAŢI",75098,GALAŢI,"GRĂDINIȚA CU PROGRAM NORMAL ”IOAN NENIȚESCU” (GRĂDINIȚA NR. 15)",26,"Alegeri Prezidentiale",1,1350,580,548,32,0,571,9,1500,920,388,183
18,GALAŢI,"MUNICIPIUL GALAŢI",75098,GALAŢI,"COLEGIUL NAȚIONAL ”VASILE ALECSANDRI”",27,"Alegeri Prezidentiale",1,960,508,433,74,1,489,19,1100,592,299,190
18,GALAŢI,"MUNICIPIUL GALAŢI",75098,GALAŢI,"COLEGIUL NAȚIONAL ”VASILE ALECSANDRI”",28,"Alegeri Prezidentiale",1,1364,648,615,33,0,633,15,1500,852,433,200
18,GALAŢI,"MUNICIPIUL GALAŢI",75098,GALAŢI,"COLEGIUL NAȚIONAL ”VASILE ALECSANDRI”",29,"Alegeri Prezidentiale",1,1314,667,639,28,0,643,24,1500,833,440,203
18,GALAŢI,"MUNICIPIUL GALAŢI",75098,GALAŢI,"ȘCOALA GIMNAZIALĂ NR. 16 (ȘCOALA GENERALĂ ”NICOLAE BĂLCESCU” - ȘCOALA GENERALĂ NR. 16)",30,"Alegeri Prezidentiale",1,1399,727,692,35,0,717,10,1500,773,456,261
18,GALAŢI,"MUNICIPIUL GALAŢI",75098,GALAŢI,"ȘCOALA GIMNAZIALĂ NR. 16 (ȘCOALA GENERALĂ ”NICOLAE BĂLCESCU” - ȘCOALA GENERALĂ NR. 16)",31,"Alegeri Prezidentiale",1,1188,542,511,31,0,533,9,1300,758,321,212
18,GALAŢI,"MUNICIPIUL GALAŢI",75098,GALAŢI,"ȘCOALA GIMNAZIALĂ NR. 16 (ȘCOALA GENERALĂ ”NICOLAE BĂLCESCU” - ȘCOALA GENERALĂ NR. 16)",32,"Alegeri Prezidentiale",1,1272,697,668,29,0,676,21,1400,703,484,192
18,GALAŢI,"MUNICIPIUL GALAŢI",75098,GALAŢI,"ȘCOALA GIMNAZIALĂ NR. 16 (ȘCOALA GENERALĂ ”NICOLAE BĂLCESCU” - ȘCOALA GENERALĂ NR. 16)",33,"Alegeri Prezidentiale",1,1285,627,605,22,0,613,14,1400,773,392,221
18,GALAŢI,"MUNICIPIUL GALAŢI",75098,GALAŢI,"ȘCOALA GIMNAZIALĂ NR. 25 (ȘCOALA GENERALĂ ”PETRU RAREȘ” - ȘCOALA GENERALĂ NR. 25)",34,"Alegeri Prezidentiale",1,1499,649,617,32,0,635,14,1700,1051,405,230
18,GALAŢI,"MUNICIPIUL GALAŢI",75098,GALAŢI,"ȘCOALA GIMNAZIALĂ NR. 25 (ȘCOALA GENERALĂ ”PETRU RAREȘ” - ȘCOALA GENERALĂ NR. 25)",35,"Alegeri Prezidentiale",1,1503,843,738,85,20,823,20,1700,857,549,274
18,GALAŢI,"MUNICIPIUL GALAŢI",75098,GALAŢI,"ȘCOALA GIMNAZIALĂ NR. 25 (ȘCOALA GENERALĂ ”PETRU RAREȘ” - ȘCOALA GENERALĂ NR. 25)",36,"Alegeri Prezidentiale",1,1284,641,581,58,2,626,15,1400,759,407,219
18,GALAŢI,"MUNICIPIUL GALAŢI",75098,GALAŢI,"UNIVERSITATEA ”DUNĂREA DE JOS” GALAȚI (UNIVERSITATEA GALAŢI)",37,"Alegeri Prezidentiale",1,1495,831,646,124,61,815,16,1700,869,553,262
18,GALAŢI,"MUNICIPIUL GALAŢI",75098,GALAŢI,"ȘCOALA GIMNAZIALĂ ”LUDOVIC COSMA” (ȘCOALA GENERALĂ NR. 19)",38,"Alegeri Prezidentiale",1,1333,782,613,25,144,769,13,1500,718,448,321
18,GALAŢI,"MUNICIPIUL GALAŢI",75098,GALAŢI,"ȘCOALA GIMNAZIALĂ ”LUDOVIC COSMA” (ȘCOALA GENERALĂ NR. 19)",39,"Alegeri Prezidentiale",1,1520,778,699,30,49,762,16,1701,923,507,255
18,GALAŢI,"MUNICIPIUL GALAŢI",75098,GALAŢI,"COLEGIUL TEHNIC ”RADU NEGRU”",40,"Alegeri Prezidentiale",1,1659,889,688,53,148,877,12,1800,911,462,415
18,GALAŢI,"MUNICIPIUL GALAŢI",75098,GALAŢI,"COLEGIUL DE INDUSTRIE ALIMENTARĂ ”ELENA DOAMNA” (GRUP ȘCOLAR ”ELENA DOAMNA”)",41,"Alegeri Prezidentiale",1,1886,948,719,159,70,930,18,2100,1152,639,291
18,GALAŢI,"MUNICIPIUL GALAŢI",75098,GALAŢI,"COLEGIUL DE INDUSTRIE ALIMENTARĂ ”ELENA DOAMNA” (GRUP ȘCOLAR ”ELENA DOAMNA”)",42,"Alegeri Prezidentiale",1,1666,800,687,106,7,771,29,1800,1000,523,248
18,GALAŢI,"MUNICIPIUL GALAŢI",75098,GALAŢI,"COLEGIUL TEHNIC ”RADU NEGRU” (GRUP ȘCOLAR ”RADU NEGRU”)",43,"Alegeri Prezidentiale",1,1898,1055,892,28,135,1037,18,2100,1045,610,427
18,GALAŢI,"MUNICIPIUL GALAŢI",75098,GALAŢI,"ȘCOALA GIMNAZIALĂ NR. 20 (ȘCOALA GENERALĂ NR. 20 ”TRAIAN”)",44,"Alegeri Prezidentiale",1,1947,941,916,24,1,927,14,2100,1159,614,313
18,GALAŢI,"MUNICIPIUL GALAŢI",75098,GALAŢI,"ȘCOALA GIMNAZIALĂ NR. 20 (ȘCOALA GENERALĂ NR. 20 ”TRAIAN”)",45,"Alegeri Prezidentiale",1,1960,123,19,37,67,119,4,2200,2077,76,43
18,GALAŢI,"MUNICIPIUL GALAŢI",75098,GALAŢI,"ȘCOALA GIMNAZIALĂ NR. 20 (ȘCOALA GENERALĂ NR. 20 ”TRAIAN”)",46,"Alegeri Prezidentiale",1,1908,765,670,25,70,756,9,2100,1335,501,255
18,GALAŢI,"MUNICIPIUL GALAŢI",75098,GALAŢI,"ȘCOALA GIMNAZIALĂ NR. 24 (ȘCOALA GENERALĂ NR. 24)",47,"Alegeri Prezidentiale",1,1568,898,841,57,0,880,18,1700,802,585,295
18,GALAŢI,"MUNICIPIUL GALAŢI",75098,GALAŢI,"LICEUL TEHNOLOGIC DE MARINĂ (GRUP ȘCOLAR INDUSTRIAL DE MARINĂ - LICEUL DE MARINĂ)",48,"Alegeri Prezidentiale",1,1404,590,500,90,0,579,11,1500,910,373,206
18,GALAŢI,"MUNICIPIUL GALAŢI",75098,GALAŢI,"LICEUL TEHNOLOGIC DE MARINĂ (GRUP ȘCOLAR INDUSTRIAL DE MARINĂ - LICEUL DE MARINĂ)",49,"Alegeri Prezidentiale",1,1432,621,564,57,0,610,11,1600,979,401,209
18,GALAŢI,"MUNICIPIUL GALAŢI",75098,GALAŢI,"LICEUL TEHNOLOGIC DE MARINĂ (GRUP ȘCOLAR INDUSTRIAL DE MARINĂ - LICEUL DE MARINĂ)",50,"Alegeri Prezidentiale",1,1336,679,623,56,0,665,14,1500,821,452,213
18,GALAŢI,"MUNICIPIUL GALAŢI",75098,GALAŢI,"COLEGIUL NAȚIONAL ”ALEXANDRU IOAN CUZA” (GRĂDINIȚA NR. 59 - FOSTA ȘCOALĂ GENERALĂ NR. 8)",51,"Alegeri Prezidentiale",1,1297,684,657,25,2,667,17,1400,716,432,235
18,GALAŢI,"MUNICIPIUL GALAŢI",75098,GALAŢI,"COLEGIUL NAȚIONAL ”ALEXANDRU IOAN CUZA” (GRĂDINIȚA NR. 59 - FOSTA ȘCOALĂ GENERALĂ NR. 8)",52,"Alegeri Prezidentiale",1,1432,806,758,47,1,790,16,1600,794,468,322
18,GALAŢI,"MUNICIPIUL GALAŢI",75098,GALAŢI,"COLEGIUL NAȚIONAL ”ALEXANDRU IOAN CUZA” (GRĂDINIȚA NR. 59 - FOSTA ȘCOALĂ GENERALĂ NR. 8)",53,"Alegeri Prezidentiale",1,1418,719,672,47,0,696,23,1600,881,456,240
18,GALAŢI,"MUNICIPIUL GALAŢI",75098,GALAŢI,"COLEGIUL NAȚIONAL ”ALEXANDRU IOAN CUZA” (GRĂDINIȚA NR. 59 - FOSTA ȘCOALĂ GENERALĂ NR. 8)",54,"Alegeri Prezidentiale",1,1820,589,567,22,0,577,12,2000,1411,386,191
18,GALAŢI,"MUNICIPIUL GALAŢI",75098,GALAŢI,"LICEUL CU PROGRAM SPORTIV (LICEUL CU PROGRAM DE EDUCAȚIE FIZICĂ - LICEUL INDUSTRIAL NR.12)",55,"Alegeri Prezidentiale",1,1733,499,399,62,38,492,7,1800,1301,318,174
18,GALAŢI,"MUNICIPIUL GALAŢI",75098,GALAŢI,"LICEUL CU PROGRAM SPORTIV (LICEUL CU PROGRAM DE EDUCAȚIE FIZICĂ - LICEUL INDUSTRIAL NR.12)",56,"Alegeri Prezidentiale",1,1713,192,138,27,27,187,5,1800,1608,131,56
18,GALAŢI,"MUNICIPIUL GALAŢI",75098,GALAŢI,"LICEUL CU PROGRAM SPORTIV (LICEUL CU PROGRAM DE EDUCAȚIE FIZICĂ - LICEUL INDUSTRIAL NR.12)",57,"Alegeri Prezidentiale",1,1698,625,591,18,16,605,20,1800,1175,404,201
18,GALAŢI,"MUNICIPIUL GALAŢI",75098,GALAŢI,"LICEUL CU PROGRAM SPORTIV (LICEUL CU PROGRAM DE EDUCAȚIE FIZICĂ - LICEUL INDUSTRIAL NR.12)",58,"Alegeri Prezidentiale",1,1699,786,709,25,52,772,14,1900,1114,496,276
18,GALAŢI,"MUNICIPIUL GALAŢI",75098,GALAŢI,"ȘCOALA GIMNAZIALĂ NR. 17 (ȘCOALA GENERALĂ ”NICHITA STĂNESCU” - ȘCOALA GENERALĂ NR. 17)",59,"Alegeri Prezidentiale",1,1812,808,750,58,0,793,15,2000,1192,493,300
18,GALAŢI,"MUNICIPIUL GALAŢI",75098,GALAŢI,"ȘCOALA GIMNAZIALĂ NR. 17 (ȘCOALA GENERALĂ ”NICHITA STĂNESCU” - ȘCOALA GENERALĂ NR. 17)",60,"Alegeri Prezidentiale",1,1804,777,744,33,0,762,15,2000,1223,463,299
18,GALAŢI,"MUNICIPIUL GALAŢI",75098,GALAŢI,"ȘCOALA GIMNAZIALĂ NR. 17 (ȘCOALA GENERALĂ ”NICHITA STĂNESCU” - ȘCOALA GENERALĂ NR. 17)",61,"Alegeri Prezidentiale",1,1795,629,606,22,1,618,11,1900,1271,358,260
18,GALAŢI,"MUNICIPIUL GALAŢI",75098,GALAŢI,"COLEGIUL ECONOMIC ”VIRGIL MADGEARU” (GRUP ȘCOLAR ECONOMIC ADMINISTRATIV ”VIRGIL MADGEARU”)",62,"Alegeri Prezidentiale",1,1297,643,582,61,0,632,11,1400,757,400,232
18,GALAŢI,"MUNICIPIUL GALAŢI",75098,GALAŢI,"ȘCOALA GIMNAZIALĂ NR. 29 (ȘCOALA GENERALĂ ”SFÂNTA ANA” - ȘCOALA GENERALĂ NR. 29)",63,"Alegeri Prezidentiale",1,1629,755,722,32,1,733,22,1800,1045,426,307
18,GALAŢI,"MUNICIPIUL GALAŢI",75098,GALAŢI,"ȘCOALA GIMNAZIALĂ NR. 29 (ȘCOALA GENERALĂ ”SFÂNTA ANA” - ȘCOALA GENERALĂ NR. 29)",64,"Alegeri Prezidentiale",1,1576,741,713,27,1,724,17,1700,959,439,285
18,GALAŢI,"MUNICIPIUL GALAŢI",75098,GALAŢI,"ȘCOALA GIMNAZIALĂ NR. 29 (ȘCOALA GENERALĂ ”SFÂNTA ANA” - ȘCOALA GENERALĂ NR. 29)",65,"Alegeri Prezidentiale",1,1330,666,637,28,1,650,16,1500,834,398,252
18,GALAŢI,"MUNICIPIUL GALAŢI",75098,GALAŢI,"ȘCOALA GIMNAZIALĂ NR. 29 (ȘCOALA GENERALĂ ”SFÂNTA ANA” - ȘCOALA GENERALĂ NR. 29)",66,"Alegeri Prezidentiale",1,1474,779,766,13,0,767,12,1600,821,487,280
18,GALAŢI,"MUNICIPIUL GALAŢI",75098,GALAŢI,"ȘCOALA GIMNAZIALĂ NR. 22 (ȘCOALA GENERALĂ ”DIMITRIE CANTEMIR” - ȘCOALA GENERALĂ NR. 22)",67,"Alegeri Prezidentiale",1,1504,759,693,66,0,750,9,1700,941,464,286
18,GALAŢI,"MUNICIPIUL GALAŢI",75098,GALAŢI,"ȘCOALA GIMNAZIALĂ NR. 22 (ȘCOALA GENERALĂ ”DIMITRIE CANTEMIR” - ȘCOALA GENERALĂ NR. 22)",68,"Alegeri Prezidentiale",1,1485,792,754,37,1,777,15,1600,808,470,307
18,GALAŢI,"MUNICIPIUL GALAŢI",75098,GALAŢI,"ȘCOALA GIMNAZIALĂ NR. 22 (ȘCOALA GENERALĂ ”DIMITRIE CANTEMIR” - ȘCOALA GENERALĂ NR. 22)",69,"Alegeri Prezidentiale",1,1554,704,676,28,0,692,11,1700,996,383,309
18,GALAŢI,"MUNICIPIUL GALAŢI",75098,GALAŢI,"GRĂDINIȚA CU PROGRAM PRELUNGIT ”PRICHINDEL” (GRĂDINIȚA ”PRICHINDEL” - GRĂDINIȚA NR. 62)",70,"Alegeri Prezidentiale",1,1518,825,789,36,0,812,13,1700,875,488,324
18,GALAŢI,"MUNICIPIUL GALAŢI",75098,GALAŢI,"GRĂDINIȚA CU PROGRAM PRELUNGIT ”PRICHINDEL” (GRĂDINIȚA ”PRICHINDEL” - GRĂDINIȚA NR. 62)",71,"Alegeri Prezidentiale",1,1484,757,695,62,0,744,13,1600,843,471,273
18,GALAŢI,"MUNICIPIUL GALAŢI",75098,GALAŢI,"GRĂDINIȚA CU PROGRAM PRELUNGIT ”PRICHINDEL” (GRĂDINIȚA ”PRICHINDEL” - GRĂDINIȚA NR. 62)",72,"Alegeri Prezidentiale",1,1381,697,655,42,0,685,12,1500,803,438,247
18,GALAŢI,"MUNICIPIUL GALAŢI",75098,GALAŢI,"GARA CFR BARBOȘI",73,"Alegeri Prezidentiale",1,481,267,217,50,0,259,8,500,233,146,113
18,GALAŢI,"MUNICIPIUL GALAŢI",75098,GALAŢI,"ȘCOALA GIMNAZIALĂ ”DAN BARBILIAN” (ȘCOALA GENERALĂ ”DAN BARBILIAN” - ȘCOALA GENERALĂ NR. 43)",74,"Alegeri Prezidentiale",1,1629,811,741,70,0,794,17,1800,989,486,308
18,GALAŢI,"MUNICIPIUL GALAŢI",75098,GALAŢI,"ȘCOALA GIMNAZIALĂ ”DAN BARBILIAN” (ȘCOALA GENERALĂ ”DAN BARBILIAN” - ȘCOALA GENERALĂ NR. 43)",75,"Alegeri Prezidentiale",1,1483,739,695,44,0,726,13,1600,861,426,300
18,GALAŢI,"MUNICIPIUL GALAŢI",75098,GALAŢI,"ȘCOALA GIMNAZIALĂ ”DAN BARBILIAN” (ȘCOALA GENERALĂ ”DAN BARBILIAN” - ȘCOALA GENERALĂ NR. 43)",76,"Alegeri Prezidentiale",1,1433,681,647,34,0,667,14,1600,919,422,245
18,GALAŢI,"MUNICIPIUL GALAŢI",75098,GALAŢI,"ȘCOALA GIMNAZIALĂ ”DAN BARBILIAN” (ȘCOALA GENERALĂ ”DAN BARBILIAN” - ȘCOALA GENERALĂ NR. 43)",77,"Alegeri Prezidentiale",1,1501,695,680,15,0,678,17,1700,1005,464,214
18,GALAŢI,"MUNICIPIUL GALAŢI",75098,GALAŢI,"ȘCOALA GIMNAZIALĂ ”DAN BARBILIAN” (ȘCOALA GENERALĂ ”DAN BARBILIAN” - ȘCOALA GENERALĂ NR. 43)",78,"Alegeri Prezidentiale",1,1508,694,673,21,0,685,9,1700,1006,402,283
18,GALAŢI,"MUNICIPIUL GALAŢI",75098,GALAŢI,"ȘCOALA GIMNAZIALĂ ”DAN BARBILIAN” (ȘCOALA GENERALĂ ”DAN BARBILIAN” - ȘCOALA GENERALĂ NR. 43)",79,"Alegeri Prezidentiale",1,1458,725,698,27,0,710,15,1600,875,463,247
18,GALAŢI,"MUNICIPIUL GALAŢI",75098,GALAŢI,"ȘCOALA GIMNAZIALĂ ”DAN BARBILIAN” (ȘCOALA GENERALĂ ”DAN BARBILIAN” - ȘCOALA GENERALĂ NR. 43)",80,"Alegeri Prezidentiale",1,1551,676,663,13,0,664,12,1700,1024,415,249
18,GALAŢI,"MUNICIPIUL GALAŢI",75098,GALAŢI,"ȘCOALA GIMNAZIALĂ NR. 3 (ȘCOALA GENERALĂ NR. 3)",81,"Alegeri Prezidentiale",1,1562,811,770,41,0,792,19,1700,889,543,249
18,GALAŢI,"MUNICIPIUL GALAŢI",75098,GALAŢI,"ȘCOALA GIMNAZIALĂ NR. 3 (ȘCOALA GENERALĂ NR. 3)",82,"Alegeri Prezidentiale",1,1595,733,677,56,0,711,22,1800,1067,436,275
18,GALAŢI,"MUNICIPIUL GALAŢI",75098,GALAŢI,"ȘCOALA GIMNAZIALĂ NR. 3 (ȘCOALA GENERALĂ NR. 3)",83,"Alegeri Prezidentiale",1,1505,721,707,14,0,697,24,1700,979,440,257
18,GALAŢI,"MUNICIPIUL GALAŢI",75098,GALAŢI,"ȘCOALA GIMNAZIALĂ NR. 3 (ȘCOALA GENERALĂ NR. 3)",84,"Alegeri Prezidentiale",1,1677,820,804,16,0,805,15,1800,980,508,297
18,GALAŢI,"MUNICIPIUL GALAŢI",75098,GALAŢI,"ȘCOALA GIMNAZIALĂ NR. 3 (ȘCOALA GENERALĂ NR. 3)",85,"Alegeri Prezidentiale",1,1394,736,695,41,0,718,18,1500,764,491,227
18,GALAŢI,"MUNICIPIUL GALAŢI",75098,GALAŢI,"ȘCOALA GIMNAZIALĂ ”IULIA HAȘDEU” (ȘCOALA GENERALĂ ”IULIA HAȘDEU” - ȘCOALA GENERALĂ NR. 40)",86,"Alegeri Prezidentiale",1,1452,712,659,53,0,700,12,1608,896,452,248
18,GALAŢI,"MUNICIPIUL GALAŢI",75098,GALAŢI,"ȘCOALA GIMNAZIALĂ ”IULIA HAȘDEU” (ȘCOALA GENERALĂ ”IULIA HAȘDEU” - ȘCOALA GENERALĂ NR. 40)",87,"Alegeri Prezidentiale",1,1379,639,609,30,0,629,10,1500,861,358,271
18,GALAŢI,"MUNICIPIUL GALAŢI",75098,GALAŢI,"ȘCOALA GIMNAZIALĂ ”IULIA HAȘDEU” (ȘCOALA GENERALĂ ”IULIA HAȘDEU” - ȘCOALA GENERALĂ NR. 40)",88,"Alegeri Prezidentiale",1,1406,654,634,20,0,640,14,1500,846,364,276
18,GALAŢI,"MUNICIPIUL GALAŢI",75098,GALAŢI,"ȘCOALA GIMNAZIALĂ ”IULIA HAȘDEU” (ȘCOALA GENERALĂ ”IULIA HAȘDEU” - ȘCOALA GENERALĂ NR. 40)",89,"Alegeri Prezidentiale",1,1437,722,703,19,0,712,10,1600,878,454,258
18,GALAŢI,"MUNICIPIUL GALAŢI",75098,GALAŢI,"ȘCOALA GIMNAZIALĂ ”IULIA HAȘDEU” (ȘCOALA GENERALĂ ”IULIA HAȘDEU” - ȘCOALA GENERALĂ NR. 40)",90,"Alegeri Prezidentiale",1,1591,751,731,19,1,742,9,1700,949,451,291
18,GALAŢI,"MUNICIPIUL GALAŢI",75098,GALAŢI,"ȘCOALA GIMNAZIALĂ ”IULIA HAȘDEU” (ȘCOALA GENERALĂ ”IULIA HAȘDEU” - ȘCOALA GENERALĂ NR. 40)",91,"Alegeri Prezidentiale",1,1277,609,597,12,0,595,14,1400,791,377,218
18,GALAŢI,"MUNICIPIUL GALAŢI",75098,GALAŢI,"ȘCOALA GIMNAZIALĂ NR. 9 (ȘCOALA GIMNAZIALĂ NR. 9 ”CALISTRAT HOGAȘ”)",92,"Alegeri Prezidentiale",1,1460,806,769,37,0,775,31,1601,795,496,279
18,GALAŢI,"MUNICIPIUL GALAŢI",75098,GALAŢI,"ȘCOALA GIMNAZIALĂ NR. 9 (ȘCOALA GIMNAZIALĂ NR. 9 ”CALISTRAT HOGAȘ”)",93,"Alegeri Prezidentiale",1,1274,578,558,20,0,567,11,1400,822,364,203
18,GALAŢI,"MUNICIPIUL GALAŢI",75098,GALAŢI,"ȘCOALA GIMNAZIALĂ NR. 9 (ȘCOALA GIMNAZIALĂ NR. 9 ”CALISTRAT HOGAȘ”)",94,"Alegeri Prezidentiale",1,1325,656,639,17,0,646,10,1508,852,409,237
18,GALAŢI,"MUNICIPIUL GALAŢI",75098,GALAŢI,"GRĂDINIȚA CU PROGRAM NORMAL NR. 59 (FOSTA ȘCOALĂ GIMNAZIALĂ ”NICOLAE MANTU”)",95,"Alegeri Prezidentiale",1,1598,826,743,25,58,812,14,1799,973,505,307
18,GALAŢI,"MUNICIPIUL GALAŢI",75098,GALAŢI,"GRĂDINIȚA CU PROGRAM NORMAL NR. 59 (FOSTA ȘCOALĂ GIMNAZIALĂ ”NICOLAE MANTU”)",96,"Alegeri Prezidentiale",1,1429,723,649,42,32,710,13,1600,877,446,264
18,GALAŢI,"MUNICIPIUL GALAŢI",75098,GALAŢI,"ȘCOALA GIMNAZIALĂ NR. 5 (ȘCOALA GENERALĂ ”CUZA VODĂ” - ȘCOALA GENERALĂ NR. 5)",97,"Alegeri Prezidentiale",1,1527,708,680,28,0,689,19,1700,992,472,217
18,GALAŢI,"MUNICIPIUL GALAŢI",75098,GALAŢI,"ȘCOALA GIMNAZIALĂ NR. 5 (ȘCOALA GENERALĂ ”CUZA VODĂ” - ȘCOALA GENERALĂ NR. 5)",98,"Alegeri Prezidentiale",1,1303,707,660,47,0,700,7,1398,691,478,222
18,GALAŢI,"MUNICIPIUL GALAŢI",75098,GALAŢI,"ȘCOALA GIMNAZIALĂ NR. 5 (ȘCOALA GENERALĂ ”CUZA VODĂ” - ȘCOALA GENERALĂ NR. 5)",99,"Alegeri Prezidentiale",1,1562,745,694,51,0,725,20,1700,955,484,241
18,GALAŢI,"MUNICIPIUL GALAŢI",75098,GALAŢI,"ȘCOALA GIMNAZIALĂ NR. 5 (ȘCOALA GENERALĂ ”CUZA VODĂ” - ȘCOALA GENERALĂ NR. 5)",100,"Alegeri Prezidentiale",1,1397,743,701,41,1,726,17,1500,757,470,256
18,GALAŢI,"MUNICIPIUL GALAŢI",75098,GALAŢI,"LICEUL TEORETIC ”DUNAREA”",101,"Alegeri Prezidentiale",1,1312,773,617,80,76,759,14,1500,727,488,271
18,GALAŢI,"MUNICIPIUL GALAŢI",75098,GALAŢI,"LICEUL TEORETIC ”DUNAREA”",102,"Alegeri Prezidentiale",1,1262,657,597,33,27,642,15,1400,743,393,249
18,GALAŢI,"MUNICIPIUL GALAŢI",75098,GALAŢI,"LICEUL TEORETIC ”DUNAREA”",103,"Alegeri Prezidentiale",1,1411,729,659,28,42,710,19,1600,871,451,259
18,GALAŢI,"MUNICIPIUL GALAŢI",75098,GALAŢI,"ȘCOALA GIMNAZIALĂ ”MIHAIL SADOVEANU” (ȘCOALA GENERALĂ ”MIHAIL SADOVEANU” - ȘCOALA GENERALĂ NR. 11)",104,"Alegeri Prezidentiale",1,1531,762,722,40,0,748,14,1700,938,450,298
18,GALAŢI,"MUNICIPIUL GALAŢI",75098,GALAŢI,"ȘCOALA GIMNAZIALĂ ”MIHAIL SADOVEANU” (ȘCOALA GENERALĂ ”MIHAIL SADOVEANU” - ȘCOALA GENERALĂ NR. 11)",105,"Alegeri Prezidentiale",1,1476,734,701,33,0,716,18,1592,858,448,268
18,GALAŢI,"MUNICIPIUL GALAŢI",75098,GALAŢI,"ȘCOALA GIMNAZIALĂ ”MIHAIL SADOVEANU” (ȘCOALA GENERALĂ ”MIHAIL SADOVEANU” - ȘCOALA GENERALĂ NR. 11)",106,"Alegeri Prezidentiale",1,1155,560,533,27,0,549,11,1300,740,352,197
18,GALAŢI,"MUNICIPIUL GALAŢI",75098,GALAŢI,"ȘCOALA GIMNAZIALĂ ”MIHAIL SADOVEANU” (ȘCOALA GENERALĂ ”MIHAIL SADOVEANU” - ȘCOALA GENERALĂ NR. 11)",107,"Alegeri Prezidentiale",1,1410,685,671,14,0,665,20,1592,907,455,210
18,GALAŢI,"MUNICIPIUL GALAŢI",75098,GALAŢI,"ȘCOALA GIMNAZIALĂ ”MIHAIL SADOVEANU” (ȘCOALA GENERALĂ ”MIHAIL SADOVEANU” - ȘCOALA GENERALĂ NR. 11)",108,"Alegeri Prezidentiale",1,1365,698,680,18,0,687,11,1500,802,440,247
18,GALAŢI,"MUNICIPIUL GALAŢI",75098,GALAŢI,"ȘCOALA GIMNAZIALĂ ”MIHAIL SADOVEANU” (ȘCOALA GENERALĂ ”MIHAIL SADOVEANU” - ȘCOALA GENERALĂ NR. 11)",109,"Alegeri Prezidentiale",1,1408,685,661,24,0,672,13,1500,815,407,265
18,GALAŢI,"MUNICIPIUL GALAŢI",75098,GALAŢI,"ȘCOALA GIMNAZIALĂ NR. 10 (ȘCOALA GENERALĂ ”PETRE ȚUȚEA” - ȘCOALA GENERALĂ NR. 10)",110,"Alegeri Prezidentiale",1,1624,822,793,29,0,804,18,1800,978,509,295
18,GALAŢI,"MUNICIPIUL GALAŢI",75098,GALAŢI,"ȘCOALA GIMNAZIALĂ NR. 10 (ȘCOALA GENERALĂ ”PETRE ȚUȚEA” - ȘCOALA GENERALĂ NR. 10)",111,"Alegeri Prezidentiale",1,1618,792,735,57,0,779,13,1800,1008,496,283
18,GALAŢI,"MUNICIPIUL GALAŢI",75098,GALAŢI,"ȘCOALA GIMNAZIALĂ NR. 10 (ȘCOALA GENERALĂ ”PETRE ȚUȚEA” - ȘCOALA GENERALĂ NR. 10)",112,"Alegeri Prezidentiale",1,1693,863,800,63,0,835,28,1900,1037,519,316
18,GALAŢI,"MUNICIPIUL GALAŢI",75098,GALAŢI,"ȘCOALA GIMNAZIALĂ NR. 10 (ȘCOALA GENERALĂ ”PETRE ȚUȚEA” - ȘCOALA GENERALĂ NR. 10)",113,"Alegeri Prezidentiale",1,1466,715,678,37,0,701,14,1600,885,439,262
18,GALAŢI,"MUNICIPIUL GALAŢI",75098,GALAŢI,"ȘCOALA GIMNAZIALĂ NR. 10 (ȘCOALA GENERALĂ ”PETRE ȚUȚEA” - ȘCOALA GENERALĂ NR. 10)",114,"Alegeri Prezidentiale",1,1766,874,853,21,0,859,15,1900,1026,544,315
18,GALAŢI,"MUNICIPIUL GALAŢI",75098,GALAŢI,"COLEGIUL TEHNIC ”TRAIAN VUIA” (GRUP ŞCOLAR TRANSPORTURI AUTO)",115,"Alegeri Prezidentiale",1,1298,666,629,35,2,655,11,1400,734,429,226
18,GALAŢI,"MUNICIPIUL GALAŢI",75098,GALAŢI,"COLEGIUL TEHNIC ”TRAIAN VUIA” (GRUP ŞCOLAR TRANSPORTURI AUTO)",116,"Alegeri Prezidentiale",1,1374,737,706,31,0,726,11,1500,763,524,202
18,GALAŢI,"MUNICIPIUL GALAŢI",75098,GALAŢI,"COLEGIUL TEHNIC ”TRAIAN VUIA” (GRUP ŞCOLAR TRANSPORTURI AUTO)",117,"Alegeri Prezidentiale",1,1318,676,653,23,0,658,18,1508,832,413,245
18,GALAŢI,"MUNICIPIUL GALAŢI",75098,GALAŢI,"ȘCOALA GIMNAZIALĂ ”SFINȚII ÎMPĂRAȚI” (ȘCOALA GENERALĂ ”SFINȚII ÎMPĂRAȚI” - ȘCOALA GENERALĂ NR. 42)",118,"Alegeri Prezidentiale",1,1339,694,642,52,0,677,17,1500,806,435,242
18,GALAŢI,"MUNICIPIUL GALAŢI",75098,GALAŢI,"ȘCOALA GIMNAZIALĂ ”SFINȚII ÎMPĂRAȚI” (ȘCOALA GENERALĂ ”SFINȚII ÎMPĂRAȚI” - ȘCOALA GENERALĂ NR. 42)",119,"Alegeri Prezidentiale",1,1570,810,786,23,1,789,21,1700,890,493,296
18,GALAŢI,"MUNICIPIUL GALAŢI",75098,GALAŢI,"ȘCOALA GIMNAZIALĂ ”SFINȚII ÎMPĂRAȚI” (ȘCOALA GENERALĂ ”SFINȚII ÎMPĂRAȚI” - ȘCOALA GENERALĂ NR. 42)",120,"Alegeri Prezidentiale",1,1371,686,664,22,0,672,14,1500,814,408,264
18,GALAŢI,"MUNICIPIUL GALAŢI",75098,GALAŢI,"ȘCOALA GIMNAZIALĂ ”SFÂNTUL GRIGORE TEOLOGUL” (ȘCOALA GENERALĂ ”SFÂNTUL GRIGORE TEOLOGUL” - ȘCOALA GENERALĂ NR. 41)",121,"Alegeri Prezidentiale",1,1742,901,871,30,0,887,14,1899,998,533,354
18,GALAŢI,"MUNICIPIUL GALAŢI",75098,GALAŢI,"ȘCOALA GIMNAZIALĂ ”SFÂNTUL GRIGORE TEOLOGUL” (ȘCOALA GENERALĂ ”SFÂNTUL GRIGORE TEOLOGUL” - ȘCOALA GENERALĂ NR. 41)",122,"Alegeri Prezidentiale",1,1747,842,785,57,0,822,20,1908,1066,548,274
18,GALAŢI,"MUNICIPIUL GALAŢI",75098,GALAŢI,"ȘCOALA GIMNAZIALĂ ”SFÂNTUL GRIGORE TEOLOGUL” (ȘCOALA GENERALĂ ”SFÂNTUL GRIGORE TEOLOGUL” - ȘCOALA GENERALĂ NR. 41)",123,"Alegeri Prezidentiale",1,1746,868,835,33,0,846,22,1900,1032,518,328
18,GALAŢI,"MUNICIPIUL GALAŢI",75098,GALAŢI,"ȘCOALA GIMNAZIALĂ ”SFÂNTUL GRIGORE TEOLOGUL” (ȘCOALA GENERALĂ ”SFÂNTUL GRIGORE TEOLOGUL” - ȘCOALA GENERALĂ NR. 41)",124,"Alegeri Prezidentiale",1,1755,831,811,20,0,815,16,1900,1069,487,328
18,GALAŢI,"MUNICIPIUL GALAŢI",75098,GALAŢI,"LICEUL TEHNOLOGIC ”ANGHEL SALIGNY” (GRUP ȘCOLAR INDUSTRIAL ”ANGHEL SALIGNY” - LICEUL INDUSTRIAL NR.9)",125,"Alegeri Prezidentiale",1,1878,829,824,5,0,810,19,2000,1171,515,295
18,GALAŢI,"MUNICIPIUL GALAŢI",75098,GALAŢI,"LICEUL TEHNOLOGIC ”ANGHEL SALIGNY” (GRUP ȘCOLAR INDUSTRIAL ”ANGHEL SALIGNY” - LICEUL INDUSTRIAL NR.9)",126,"Alegeri Prezidentiale",1,1992,134,64,70,0,131,3,2101,1967,98,33
18,GALAŢI,"MUNICIPIUL GALAŢI",75098,GALAŢI,"LICEUL TEHNOLOGIC ”ANGHEL SALIGNY” (GRUP ȘCOLAR INDUSTRIAL ”ANGHEL SALIGNY” - LICEUL INDUSTRIAL NR.9)",127,"Alegeri Prezidentiale",1,1913,236,214,22,0,225,11,2100,1864,141,84
18,GALAŢI,"MUNICIPIUL GALAŢI",75098,GALAŢI,"LICEUL TEHNOLOGIC ”ANGHEL SALIGNY” (GRUP ȘCOLAR INDUSTRIAL ”ANGHEL SALIGNY” - LICEUL INDUSTRIAL NR.9)",128,"Alegeri Prezidentiale",1,1868,766,751,15,0,758,8,2002,1236,545,213
18,GALAŢI,"MUNICIPIUL GALAŢI",75098,GALAŢI,"LICEUL TEORETIC ”SFÂNTA MARIA” (GRUP ȘCOLAR INDUSTRIAL ”SFÂNTA MARIA” - LICEUL INDUSTRIAL NR.10)",129,"Alegeri Prezidentiale",1,1209,686,599,87,0,669,17,1300,614,441,228
18,GALAŢI,"MUNICIPIUL GALAŢI",75098,GALAŢI,"LICEUL TEORETIC ”SFÂNTA MARIA” (GRUP ȘCOLAR INDUSTRIAL ”SFÂNTA MARIA” - LICEUL INDUSTRIAL NR.10)",130,"Alegeri Prezidentiale",1,1480,743,690,53,0,727,16,1608,865,465,262
18,GALAŢI,"MUNICIPIUL GALAŢI",75098,GALAŢI,"ȘCOALA GIMNAZIALĂ ”ȘTEFAN CEL MARE” (ȘCOALA GENERALĂ ”ȘTEFAN CEL MARE” - ȘCOALA GENERALĂ NR. 13)",131,"Alegeri Prezidentiale",1,1419,657,625,32,0,649,8,1600,943,382,267
18,GALAŢI,"MUNICIPIUL GALAŢI",75098,GALAŢI,"ȘCOALA GIMNAZIALĂ ”ȘTEFAN CEL MARE” (ȘCOALA GENERALĂ ”ȘTEFAN CEL MARE” - ȘCOALA GENERALĂ NR. 13)",132,"Alegeri Prezidentiale",1,1552,768,743,25,0,752,16,1700,932,458,294
18,GALAŢI,"MUNICIPIUL GALAŢI",75098,GALAŢI,"ȘCOALA GIMNAZIALĂ ”GRIGORE MOISIL” (ȘCOALA GENERALĂ ”GRIGORE MOISIL” - ȘCOALA GENERALĂ NR. 38)",133,"Alegeri Prezidentiale",1,1717,851,817,34,0,830,21,1900,1049,544,286
18,GALAŢI,"MUNICIPIUL GALAŢI",75098,GALAŢI,"ȘCOALA GIMNAZIALĂ ”GRIGORE MOISIL” (ȘCOALA GENERALĂ ”GRIGORE MOISIL” - ȘCOALA GENERALĂ NR. 38)",134,"Alegeri Prezidentiale",1,1373,700,677,23,0,679,21,1500,800,417,262
18,GALAŢI,"MUNICIPIUL GALAŢI",75098,GALAŢI,"ȘCOALA GIMNAZIALĂ ”GRIGORE MOISIL” (ȘCOALA GENERALĂ ”GRIGORE MOISIL” - ȘCOALA GENERALĂ NR. 38)",135,"Alegeri Prezidentiale",1,1428,655,634,21,0,647,8,1600,945,409,238
18,GALAŢI,"MUNICIPIUL GALAŢI",75098,GALAŢI,"ȘCOALA GIMNAZIALĂ ”GRIGORE MOISIL” (ȘCOALA GENERALĂ ”GRIGORE MOISIL” - ȘCOALA GENERALĂ NR. 38)",136,"Alegeri Prezidentiale",1,1701,848,826,21,1,832,16,1908,1060,496,336
18,GALAŢI,"MUNICIPIUL GALAŢI",75098,GALAŢI,"ȘCOALA GIMNAZIALĂ ”GHEORGHE MUNTEANU” (ȘCOALA GENERALĂ ”GHEORGHE MUNTEANU” - ȘCOALA GENERALĂ NR. 31)",137,"Alegeri Prezidentiale",1,1488,740,704,36,0,727,13,1600,860,447,280
18,GALAŢI,"MUNICIPIUL GALAŢI",75098,GALAŢI,"ȘCOALA GIMNAZIALĂ ”GHEORGHE MUNTEANU” (ȘCOALA GENERALĂ ”GHEORGHE MUNTEANU” - ȘCOALA GENERALĂ NR. 31)",138,"Alegeri Prezidentiale",1,1521,664,635,29,0,646,18,1700,1036,409,237
18,GALAŢI,"MUNICIPIUL GALAŢI",75098,GALAŢI,"ȘCOALA GIMNAZIALĂ ”GHEORGHE MUNTEANU” (ȘCOALA GENERALĂ ”GHEORGHE MUNTEANU” - ȘCOALA GENERALĂ NR. 31)",139,"Alegeri Prezidentiale",1,1445,639,620,19,0,622,17,1600,961,398,224
18,GALAŢI,"MUNICIPIUL GALAŢI",75098,GALAŢI,"GRĂDINIȚA CU PROGRAM NORMAL NR. 29, ARONDATĂ GRĂDINIȚEI CU PROGRAM PRELUNGIT ”CAMIL RESSU” (GRĂDINIȚA FILEȘTI - GRĂDINIȚA NR.29)",140,"Alegeri Prezidentiale",1,472,231,216,15,0,228,3,500,269,147,81
18,GALAŢI,"MUNICIPIUL GALAŢI",75098,GALAŢI,"COLEGIUL TEHNIC ”PAUL DIMO” (LICEUL ENERGETIC NR.4)",141,"Alegeri Prezidentiale",1,1432,663,605,58,0,652,11,1600,937,432,220
18,GALAŢI,"MUNICIPIUL GALAŢI",75098,GALAŢI,"COLEGIUL TEHNIC ”PAUL DIMO” (LICEUL ENERGETIC NR.4)",142,"Alegeri Prezidentiale",1,1430,653,627,26,0,643,10,1600,947,410,233
18,GALAŢI,"MUNICIPIUL GALAŢI",75098,GALAŢI,"COLEGIUL TEHNIC ”PAUL DIMO” (LICEUL ENERGETIC NR.4)",143,"Alegeri Prezidentiale",1,1503,678,663,15,0,664,14,1708,1030,385,279
18,GALAŢI,"MUNICIPIUL GALAŢI",75098,GALAŢI,"COLEGIUL TEHNIC ”PAUL DIMO” (LICEUL ENERGETIC NR.4)",144,"Alegeri Prezidentiale",1,1102,525,511,14,0,510,15,1200,675,298,212
18,GALAŢI,"MUNICIPIUL GALAŢI",75098,GALAŢI,"ȘCOALA GIMNAZIALĂ NR. 33 (ȘCOALA GENERALĂ ”SFÂNTUL DUMITRU” - ȘCOALA GENERALĂ NR.33)",145,"Alegeri Prezidentiale",1,1413,681,649,32,0,670,11,1600,919,417,253
18,GALAŢI,"MUNICIPIUL GALAŢI",75098,GALAŢI,"ȘCOALA GIMNAZIALĂ NR. 33 (ȘCOALA GENERALĂ ”SFÂNTUL DUMITRU” - ȘCOALA GENERALĂ NR.33)",146,"Alegeri Prezidentiale",1,1774,691,667,24,0,684,7,1892,1201,440,244
18,GALAŢI,"MUNICIPIUL GALAŢI",75098,GALAŢI,"ȘCOALA GIMNAZIALĂ NR. 33 (ȘCOALA GENERALĂ ”SFÂNTUL DUMITRU” - ȘCOALA GENERALĂ NR.33)",147,"Alegeri Prezidentiale",1,1385,613,590,23,0,595,18,1500,887,364,231
18,GALAŢI,"MUNICIPIUL GALAŢI",75098,GALAŢI,"ȘCOALA GIMNAZIALĂ NR. 33 (ȘCOALA GENERALĂ ”SFÂNTUL DUMITRU” - ȘCOALA GENERALĂ NR.33)",148,"Alegeri Prezidentiale",1,1390,596,565,31,0,587,9,1500,904,354,233
18,GALAŢI,"MUNICIPIUL GALAŢI",75098,GALAŢI,"ȘCOALA GIMNAZIALĂ ”MIHAI VITEAZUL” (ȘCOALA GENERALĂ ”MIHAI VITEAZUL” - ȘCOALA GENERALĂ NR. 34)",149,"Alegeri Prezidentiale",1,1579,710,675,35,0,696,14,1692,982,440,256
18,GALAŢI,"MUNICIPIUL GALAŢI",75098,GALAŢI,"ȘCOALA GIMNAZIALĂ ”MIHAI VITEAZUL” (ȘCOALA GENERALĂ ”MIHAI VITEAZUL” - ȘCOALA GENERALĂ NR. 34)",150,"Alegeri Prezidentiale",1,1414,623,591,32,0,606,17,1600,977,381,225
18,GALAŢI,"MUNICIPIUL GALAŢI",75098,GALAŢI,"GRĂDINIȚA CU PROGRAM PRELUNGIT NR. 47, ARONDATĂ GRĂDINIȚEI CU PROGRAM NORMAL ”ION CREANGĂ” (GRĂDINIȚA NR.47)",151,"Alegeri Prezidentiale",1,1769,800,779,21,0,785,15,1900,1100,487,298
18,GALAŢI,"MUNICIPIUL GALAŢI",75098,GALAŢI,"GRĂDINIȚA CU PROGRAM PRELUNGIT NR. 47, ARONDATĂ GRĂDINIȚEI CU PROGRAM NORMAL ”ION CREANGĂ” (GRĂDINIȚA NR.47)",152,"Alegeri Prezidentiale",1,1623,650,631,19,0,639,11,1800,1150,397,242
18,GALAŢI,"MUNICIPIUL GALAŢI",75098,GALAŢI,"GRĂDINIȚA CU PROGRAM PRELUNGIT NR. 47, ARONDATĂ GRĂDINIȚEI CU PROGRAM NORMAL ”ION CREANGĂ” (GRĂDINIȚA NR.47)",153,"Alegeri Prezidentiale",1,1514,551,502,49,0,540,11,1708,1157,355,185
18,GALAŢI,"MUNICIPIUL GALAŢI",75098,GALAŢI,"GRĂDINIȚA CU PROGRAM PRELUNGIT NR. 47, ARONDATĂ GRĂDINIȚEI CU PROGRAM NORMAL ”ION CREANGĂ” (GRĂDINIȚA NR.47)",154,"Alegeri Prezidentiale",1,1923,355,319,36,0,350,5,2100,1745,227,123
18,GALAŢI,"MUNICIPIUL GALAŢI",75098,GALAŢI,"COLEGIUL TEHNIC ”AUREL VLAICU” (GRUP ȘCOLAR METALURGIC - LICEUL INDUSTRIAL NR. 3 )",155,"Alegeri Prezidentiale",1,1268,511,471,40,0,502,9,1400,889,335,167
18,GALAŢI,"MUNICIPIUL GALAŢI",75098,GALAŢI,"COLEGIUL TEHNIC ”AUREL VLAICU” (GRUP ȘCOLAR METALURGIC - LICEUL INDUSTRIAL NR. 3 )",156,"Alegeri Prezidentiale",1,1978,424,385,39,0,422,2,2100,1676,293,129
18,GALAŢI,"MUNICIPIUL GALAŢI",75098,GALAŢI,"COLEGIUL TEHNIC ”AUREL VLAICU” (GRUP ȘCOLAR METALURGIC - LICEUL INDUSTRIAL NR. 3 )",157,"Alegeri Prezidentiale",2,1534,726,713,13,0,703,23,1700,974,433,270
18,GALAŢI,"MUNICIPIUL GALAŢI",75098,GALAŢI,"COLEGIUL TEHNIC ”AUREL VLAICU” (GRUP ȘCOLAR METALURGIC - LICEUL INDUSTRIAL NR. 3 )",158,"Alegeri Prezidentiale",1,1776,748,720,28,0,732,16,2000,1252,461,271
18,GALAŢI,"MUNICIPIUL GALAŢI",75098,GALAŢI,"LICEUL TEORETIC ”MIRCEA ELIADE” (GRUP ȘCOLAR INDUSTRIAL ”GHEORGHE ASACHI” - LICEUL INDUSTRIAL NR. 8)",159,"Alegeri Prezidentiale",1,1977,705,665,40,0,698,7,2100,1395,503,195
18,GALAŢI,"MUNICIPIUL GALAŢI",75098,GALAŢI,"LICEUL TEORETIC ”MIRCEA ELIADE” (GRUP ȘCOLAR INDUSTRIAL ”GHEORGHE ASACHI” - LICEUL INDUSTRIAL NR. 8)",160,"Alegeri Prezidentiale",1,1731,488,451,37,0,479,9,1900,1412,324,155
18,GALAŢI,"MUNICIPIUL GALAŢI",75098,GALAŢI,"LICEUL TEORETIC ”MIRCEA ELIADE” (GRUP ȘCOLAR INDUSTRIAL ”GHEORGHE ASACHI” - LICEUL INDUSTRIAL NR. 8)",161,"Alegeri Prezidentiale",1,1815,529,487,42,0,517,12,2000,1471,352,165
18,GALAŢI,"MUNICIPIUL GALAŢI",75098,GALAŢI,"LICEUL TEHNOLOGIC CĂI FERATE (GRUP ȘCOLAR INDUSTRIAL TRANSPORTURI CF - LICEUL CFR)",162,"Alegeri Prezidentiale",1,1513,718,665,53,0,699,19,1700,982,485,214
18,GALAŢI,"MUNICIPIUL GALAŢI",75098,GALAŢI,"LICEUL TEHNOLOGIC CĂI FERATE (GRUP ȘCOLAR INDUSTRIAL TRANSPORTURI CF - LICEUL CFR)",163,"Alegeri Prezidentiale",1,1495,699,674,25,0,681,18,1600,901,435,246
18,GALAŢI,"MUNICIPIUL GALAŢI",75098,GALAŢI,"LICEUL TEHNOLOGIC CĂI FERATE (GRUP ȘCOLAR INDUSTRIAL TRANSPORTURI CF - LICEUL CFR)",164,"Alegeri Prezidentiale",1,1546,676,646,30,0,667,9,1708,1032,403,264
18,GALAŢI,"MUNICIPIUL GALAŢI",75098,GALAŢI,"ȘCOALA GIMNAZIALĂ ”MIRON COSTIN” (ȘCOALA GENERALĂ ”MIRON COSTIN” - ȘCOALA GENERALĂ NR.12)",165,"Alegeri Prezidentiale",1,1478,699,685,14,0,687,12,1600,901,438,249
18,GALAŢI,"MUNICIPIUL GALAŢI",75098,GALAŢI,"ȘCOALA GIMNAZIALĂ ”MIRON COSTIN” (ȘCOALA GENERALĂ ”MIRON COSTIN” - ȘCOALA GENERALĂ NR.12)",166,"Alegeri Prezidentiale",1,1496,717,671,46,0,695,22,1700,983,450,245
18,GALAŢI,"MUNICIPIUL GALAŢI",75098,GALAŢI,"ȘCOALA GIMNAZIALĂ ”MIRON COSTIN” (ȘCOALA GENERALĂ ”MIRON COSTIN” - ȘCOALA GENERALĂ NR.12)",167,"Alegeri Prezidentiale",1,1565,728,675,53,0,712,16,1700,972,496,216
18,GALAŢI,"MUNICIPIUL GALAŢI",75098,GALAŢI,"ȘCOALA GIMNAZIALĂ ”MIRON COSTIN” (ȘCOALA GENERALĂ ”MIRON COSTIN” - ȘCOALA GENERALĂ NR.12)",168,"Alegeri Prezidentiale",1,1535,718,693,25,0,710,8,1700,982,481,229
18,GALAŢI,"MUNICIPIUL GALAŢI",75098,GALAŢI,"ȘCOALA GIMNAZIALĂ ”MIRON COSTIN” (ȘCOALA GENERALĂ ”MIRON COSTIN” - ȘCOALA GENERALĂ NR.12)",169,"Alegeri Prezidentiale",1,1494,701,674,27,0,682,19,1600,899,431,251
18,GALAŢI,"MUNICIPIUL GALAŢI",75098,GALAŢI,"ȘCOALA GIMNAZIALĂ ”MIRON COSTIN” (ȘCOALA GENERALĂ ”MIRON COSTIN” - ȘCOALA GENERALĂ NR.12)",170,"Alegeri Prezidentiale",1,1540,767,741,26,0,750,17,1708,941,490,260
18,GALAŢI,"MUNICIPIUL GALAŢI",75098,GALAŢI,"ȘCOALA GIMNAZIALĂ ”MIRON COSTIN” (ȘCOALA GENERALĂ ”MIRON COSTIN” - ȘCOALA GENERALĂ NR.12)",171,"Alegeri Prezidentiale",1,1408,676,625,51,0,661,15,1600,924,438,223
18,GALAŢI,"MUNICIPIUL GALAŢI",75098,GALAŢI,"ȘCOALA GIMNAZIALĂ ”MIRON COSTIN” (ȘCOALA GENERALĂ ”MIRON COSTIN” - ȘCOALA GENERALĂ NR.12)",172,"Alegeri Prezidentiale",1,1475,733,676,57,0,713,20,1600,867,478,235
18,GALAŢI,"MUNICIPIUL GALAŢI",75098,GALAŢI,"ȘCOALA GIMNAZIALĂ ”MIRON COSTIN” (ȘCOALA GENERALĂ ”MIRON COSTIN” - ȘCOALA GENERALĂ NR.12)",173,"Alegeri Prezidentiale",1,1461,723,703,20,0,707,16,1592,869,442,265
18,GALAŢI,"MUNICIPIUL GALAŢI",75098,GALAŢI,"ȘCOALA GIMNAZIALĂ ”MIRON COSTIN” (ȘCOALA GENERALĂ ”MIRON COSTIN” - ȘCOALA GENERALĂ NR.12)",174,"Alegeri Prezidentiale",1,1338,618,599,19,0,606,12,1492,874,380,226
18,GALAŢI,"MUNICIPIUL GALAŢI",75098,GALAŢI,"GRĂDINIȚA CU PROGRAM NORMAL NR. 20, ARONDATĂ ȘCOLII GIMNAZIALE ”MIRON COSTIN” (GRĂDINIȚA NR. 20 - ANEXA ȘCOLII NR. 12)",175,"Alegeri Prezidentiale",1,1520,735,705,30,0,724,11,1700,965,515,209
18,GALAŢI,"MUNICIPIUL GALAŢI",75098,GALAŢI,"GRĂDINIȚA CU PROGRAM NORMAL NR. 20, ARONDATĂ ȘCOLII GIMNAZIALE ”MIRON COSTIN” (GRĂDINIȚA NR. 20 - ANEXA ȘCOLII NR. 12)",176,"Alegeri Prezidentiale",1,1410,646,620,26,0,632,14,1600,954,384,248
18,GALAŢI,"MUNICIPIUL TECUCI",75203,TECUCI,"ŞCOALA NR.1",177,"Alegeri Prezidentiale",1,1324,560,530,30,0,554,6,1400,840,356,198
18,GALAŢI,"MUNICIPIUL TECUCI",75203,TECUCI,"ŞCOALA NR.1",178,"Alegeri Prezidentiale",1,1306,522,504,18,0,513,9,1392,870,310,203
18,GALAŢI,"MUNICIPIUL TECUCI",75203,TECUCI,"ŞCOALA NR.1",179,"Alegeri Prezidentiale",1,1492,636,610,26,0,626,10,1592,956,407,219
18,GALAŢI,"MUNICIPIUL TECUCI",75203,TECUCI,"ŞCOALA NR.10",180,"Alegeri Prezidentiale",1,931,454,433,21,0,445,9,1040,586,233,212
18,GALAŢI,"MUNICIPIUL TECUCI",75203,TECUCI,"ŞCOALA NR.10",181,"Alegeri Prezidentiale",1,745,353,317,36,0,343,10,792,439,190,153
18,GALAŢI,"MUNICIPIUL TECUCI",75203,TECUCI,"ŞCOALA NR.2",182,"Alegeri Prezidentiale",1,970,355,327,28,0,351,4,1100,745,207,144
18,GALAŢI,"MUNICIPIUL TECUCI",75203,TECUCI,"ŞCOALA NR.2",183,"Alegeri Prezidentiale",1,1414,499,476,23,0,486,13,1499,1000,281,205
18,GALAŢI,"MUNICIPIUL TECUCI",75203,TECUCI,"BIROU OBOR",184,"Alegeri Prezidentiale",1,1647,589,561,28,0,582,7,1700,1111,358,224
18,GALAŢI,"MUNICIPIUL TECUCI",75203,TECUCI,"ŞCOALA NR.4",185,"Alegeri Prezidentiale",1,994,453,398,55,0,442,11,1100,647,248,194
18,GALAŢI,"MUNICIPIUL TECUCI",75203,TECUCI,"ŞCOALA NR.4",186,"Alegeri Prezidentiale",1,733,402,330,25,47,399,3,800,398,211,188
18,GALAŢI,"MUNICIPIUL TECUCI",75203,TECUCI,"LICEUL SPIRU HARET",187,"Alegeri Prezidentiale",1,1201,600,562,38,0,586,14,1300,700,336,250
18,GALAŢI,"MUNICIPIUL TECUCI",75203,TECUCI,"LICEUL SPIRU HARET",188,"Alegeri Prezidentiale",1,694,310,273,37,0,308,2,800,490,176,132
18,GALAŢI,"MUNICIPIUL TECUCI",75203,TECUCI,"COLEGIUL AGRICOL",189,"Alegeri Prezidentiale",1,1014,416,365,51,0,409,7,1100,684,232,177
18,GALAŢI,"MUNICIPIUL TECUCI",75203,TECUCI,"COLEGIUL AGRICOL",190,"Alegeri Prezidentiale",1,1272,616,583,33,0,602,14,1400,784,330,272
18,GALAŢI,"MUNICIPIUL TECUCI",75203,TECUCI,"GRĂDINIŢA NR.17",191,"Alegeri Prezidentiale",1,1164,506,484,22,0,500,6,1200,694,299,201
18,GALAŢI,"MUNICIPIUL TECUCI",75203,TECUCI,"GRĂDINIŢA NR.17",192,"Alegeri Prezidentiale",1,909,375,356,19,0,367,8,1000,625,229,138
18,GALAŢI,"MUNICIPIUL TECUCI",75203,TECUCI,"ŞCOALA NR.11",193,"Alegeri Prezidentiale",1,838,375,355,20,0,363,12,900,525,204,159
18,GALAŢI,"MUNICIPIUL TECUCI",75203,TECUCI,"ŞCOALA NR.11",194,"Alegeri Prezidentiale",1,1155,534,469,65,0,515,19,1300,766,298,217
18,GALAŢI,"MUNICIPIUL TECUCI",75203,TECUCI,"ŞCOALA NR.11",195,"Alegeri Prezidentiale",1,1171,547,520,27,0,535,12,1300,753,358,177
18,GALAŢI,"MUNICIPIUL TECUCI",75203,TECUCI,"ŞCOALA NR.8",196,"Alegeri Prezidentiale",1,1298,627,588,38,1,611,16,1400,773,343,268
18,GALAŢI,"MUNICIPIUL TECUCI",75203,TECUCI,"ŞCOALA NR.6",197,"Alegeri Prezidentiale",1,1404,649,621,28,0,641,8,1600,951,365,276
18,GALAŢI,"MUNICIPIUL TECUCI",75203,TECUCI,"ŞCOALA NR.6",198,"Alegeri Prezidentiale",1,1122,491,465,26,0,477,14,1200,709,305,172
18,GALAŢI,"MUNICIPIUL TECUCI",75203,TECUCI,"ŞCOALA NR.7",199,"Alegeri Prezidentiale",1,1113,424,412,12,0,410,14,1200,776,213,197
18,GALAŢI,"MUNICIPIUL TECUCI",75203,TECUCI,"ŞCOALA NR.7",200,"Alegeri Prezidentiale",1,1013,449,438,11,0,442,7,1100,651,262,180
18,GALAŢI,"MUNICIPIUL TECUCI",75203,TECUCI,"GRĂDINIŢA DIN CARTIERUL N BALCESCU",201,"Alegeri Prezidentiale",1,991,427,411,15,1,420,7,1100,673,254,166
18,GALAŢI,"MUNICIPIUL TECUCI",75203,TECUCI,"GRĂDINIŢA 18",202,"Alegeri Prezidentiale",1,1260,560,525,35,0,543,17,1400,840,275,268
18,GALAŢI,"MUNICIPIUL TECUCI",75203,TECUCI,"GRĂDINIŢA NR.2",203,"Alegeri Prezidentiale",1,1056,508,476,31,1,499,9,1192,684,274,225
18,GALAŢI,"MUNICIPIUL TECUCI",75203,TECUCI,"GRĂDINIŢA NR.2",204,"Alegeri Prezidentiale",1,1246,553,514,39,0,544,9,1400,847,286,258
18,GALAŢI,"MUNICIPIUL TECUCI",75203,TECUCI,"LICEUL CALISTRAT HOGAŞ",205,"Alegeri Prezidentiale",1,1609,333,299,34,0,327,6,1700,1367,198,129
18,GALAŢI,"MUNICIPIUL TECUCI",75203,TECUCI,"LICEUL CALISTRAT HOGAŞ",206,"Alegeri Prezidentiale",2,878,374,355,18,1,367,7,993,619,185,182
18,GALAŢI,"MUNICIPIUL TECUCI",75203,TECUCI,"GRĂDINIŢA NR.1",207,"Alegeri Prezidentiale",1,834,321,297,24,0,316,5,900,579,161,155
18,GALAŢI,"MUNICIPIUL TECUCI",75203,TECUCI,"CAMINUL NR. 15",208,"Alegeri Prezidentiale",1,810,331,301,30,0,328,3,900,569,174,154
18,GALAŢI,"MUNICIPIUL TECUCI",75203,TECUCI,"ŞCOALA NR.9",209,"Alegeri Prezidentiale",2,980,470,440,30,0,463,7,1092,622,263,200
18,GALAŢI,"ORAŞ BEREŞTI",75338,BEREŞTI,"CASA DE CULTURA „ION CREANGĂ” BERESTI",210,"Alegeri Prezidentiale",1,1278,634,554,62,18,624,10,1400,758,270,354
18,GALAŢI,"ORAŞ BEREŞTI",75338,BEREŞTI,"LICEUL TEHNOLOGIC „PAUL BUJOR” BERESTI",211,"Alegeri Prezidentiale",1,1363,639,576,38,25,625,14,1500,861,227,398
18,GALAŢI,"ORAŞ TÂRGU BUJOR",75472,"TÂRGU BUJOR","GRADINIŢA NR.2 CĂSUŢA PITICILOR",212,"Alegeri Prezidentiale",1,727,338,307,19,12,332,6,792,454,154,178
18,GALAŢI,"ORAŞ TÂRGU BUJOR",75472,"TÂRGU BUJOR","GRADINIŢA NR.2 CĂSUŢA PITICILOR",213,"Alegeri Prezidentiale",1,803,335,294,36,5,330,5,908,573,143,187
18,GALAŢI,"ORAŞ TÂRGU BUJOR",75472,"TÂRGU BUJOR","ŞCOALA GIMNAZIALĂ ”GRIGORE HAGIU”",214,"Alegeri Prezidentiale",1,1325,613,546,50,17,606,7,1500,887,346,260
18,GALAŢI,"ORAŞ TÂRGU BUJOR",75472,"TÂRGU BUJOR","CASA DE CULTURA ”MIHAI EMINESCU”",215,"Alegeri Prezidentiale",1,1069,550,485,51,14,543,7,1200,650,306,237
18,GALAŢI,"ORAŞ TÂRGU BUJOR",75472,MOSCU,"GRĂDINIŢA MOSCU",216,"Alegeri Prezidentiale",1,1024,481,441,32,8,478,3,1100,619,222,256
18,GALAŢI,"ORAŞ TÂRGU BUJOR",75472,UMBRĂREŞTI,"SCOALA GENERALĂ UMBRĂREŞTI",217,"Alegeri Prezidentiale",1,896,370,329,37,4,364,6,1008,638,197,167
18,GALAŢI,BARCEA,75515,BARCEA,"ŞCOALA NR. 2 BARCEA",218,"Alegeri Prezidentiale",1,832,340,310,30,0,334,6,900,560,245,89
18,GALAŢI,BARCEA,75515,BARCEA,"ŞCOALA NR. 2 BARCEA",219,"Alegeri Prezidentiale",1,891,356,327,29,0,351,5,1000,644,245,106
18,GALAŢI,BARCEA,75515,BARCEA,"ŞCOALA NR. 3 BARCEA",220,"Alegeri Prezidentiale",1,1003,435,394,40,1,428,7,1092,657,296,132
18,GALAŢI,BARCEA,75515,BARCEA,"ŞCOALA NR. 1 BARCEA",221,"Alegeri Prezidentiale",1,1093,433,410,23,0,429,4,1200,767,243,186
18,GALAŢI,BARCEA,75515,PODOLENI,"ŞCOALA NR. 4 PODOLENI",222,"Alegeri Prezidentiale",1,1242,452,421,31,0,448,4,1400,948,267,181
18,GALAŢI,BĂLĂBĂNEŞTI,75542,BĂLĂBĂNEŞTI,"CĂMINUL CULTURAL BĂLĂBĂNEŞTI",223,"Alegeri Prezidentiale",1,613,348,293,55,0,344,4,700,352,168,176
18,GALAŢI,BĂLĂBĂNEŞTI,75542,BURSUCANI,"CAMIN CULTURAL BURSUCANI",224,"Alegeri Prezidentiale",1,487,248,206,42,0,245,3,500,252,130,115
18,GALAŢI,BĂLĂBĂNEŞTI,75542,LUNGEŞTI,"SCOALA GENERALĂ LUNGEŞTI",225,"Alegeri Prezidentiale",1,466,232,188,44,0,228,4,500,268,96,132
18,GALAŢI,BĂLĂŞEŞTI,75613,BĂLĂŞEŞTI,"CĂMINUL CULTURAL BĂLĂŞEŞTI",226,"Alegeri Prezidentiale",1,934,420,388,30,2,418,2,992,572,195,223
18,GALAŢI,BĂLĂŞEŞTI,75613,"CIUREŞTII NOI","GRADINITA CIUREŞTII NOI",227,"Alegeri Prezidentiale",1,415,243,186,57,0,241,2,500,257,116,125
18,GALAŢI,BĂLĂŞEŞTI,75613,CIUREŞTI,"SCOALA GENERALĂ CIUREŞTI",228,"Alegeri Prezidentiale",1,246,132,103,29,0,129,3,300,168,54,75
18,GALAŢI,BĂLĂŞEŞTI,75613,PUPEZENI,"SCOALA GENERALĂ PUPEZENI",229,"Alegeri Prezidentiale",1,149,92,67,25,0,91,1,200,108,34,57
18,GALAŢI,BĂLENI,75668,BĂLENI,"”ȘCOALA GIMNAZIALĂ NR. 1 BĂLENI”",230,"Alegeri Prezidentiale",1,944,402,335,45,22,399,3,1000,598,204,195
18,GALAŢI,BĂLENI,75668,BĂLENI,"”ȘCOALA GIMNAZIALĂ NR. 1 BĂLENI”",231,"Alegeri Prezidentiale",1,975,441,353,58,30,436,5,1100,659,227,209
18,GALAŢI,BĂNEASA,75686,ROŞCANI,"SCOALA PRIMARA ”ION VODA CEL VITEAZ ROSCANI",232,"Alegeri Prezidentiale",1,487,237,209,28,0,234,3,500,263,129,105
18,GALAŢI,BĂNEASA,75686,BĂNEASA,"CĂMIN CULTURAL",233,"Alegeri Prezidentiale",1,1210,585,530,46,9,580,5,1300,715,251,329
18,GALAŢI,BEREŞTI-MERIA,75356,BEREŞTI-MERIA,"ŞCOALA GIMNAZIALĂ NR. 1 SAT BEREŞTI - MERIA",234,"Alegeri Prezidentiale",1,433,210,190,20,0,207,3,500,290,110,97
18,GALAŢI,BEREŞTI-MERIA,75356,SLIVNA,"ŞCOALA GIMNAZIALĂ NR. 1 SAT SLIVNA",235,"Alegeri Prezidentiale",1,556,239,193,43,3,237,2,600,361,99,138
18,GALAŢI,BEREŞTI-MERIA,75356,PURICANI,"CĂMIN CULTURAL",236,"Alegeri Prezidentiale",1,219,148,102,46,0,147,1,300,152,60,87
18,GALAŢI,BEREŞTI-MERIA,75356,ALDEŞTI,"ŞCOALA PRIMARĂ ANDRONACHI GOGA NR. 1 SAT ALDEŞTI",237,"Alegeri Prezidentiale",1,353,175,145,28,2,174,1,400,225,59,115
18,GALAŢI,BEREŞTI-MERIA,75356,PLEŞA,"GRĂDINIŢA CU PROGRAM NORMAL NR. 1 SAT PLEŞA",238,"Alegeri Prezidentiale",1,509,238,196,34,8,233,5,600,362,121,112
18,GALAŢI,BEREŞTI-MERIA,75356,BALINTEŞTI,"ȘCOALA GIMNAZIALĂ NR.1 SAT BALINTEȘTI",239,"Alegeri Prezidentiale",1,775,382,330,43,9,380,2,900,518,160,220
18,GALAŢI,BRANIŞTEA,75711,BRANIŞTEA,"ȘCOALA GIMNAZIALĂ UNIREA BRANIȘTEA",240,"Alegeri Prezidentiale",1,1225,528,472,56,0,521,7,1400,872,339,182
18,GALAŢI,BRANIŞTEA,75711,BRANIŞTEA,"ȘCOALA GIMNAZIALĂ UNIREA BRANIȘTEA",241,"Alegeri Prezidentiale",1,1023,455,410,45,0,450,5,1100,645,289,161
18,GALAŢI,BRANIŞTEA,75711,"VASILE ALECSANDRI","SCOALA GENERALA VASILE ALECSANDRI",242,"Alegeri Prezidentiale",1,902,452,403,49,0,452,0,1000,548,291,161
18,GALAŢI,BRANIŞTEA,75711,TRAIAN,"SCOALA GENERALĂ TRAIAN",243,"Alegeri Prezidentiale",1,455,258,207,51,0,254,4,500,242,186,68
18,GALAŢI,BRĂHĂŞEŞTI,75766,BRĂHĂŞEŞTI,"SCOALA GIMNAZIALA NR.1 BRĂHĂŞEŞTI",244,"Alegeri Prezidentiale",1,1306,371,325,44,2,369,2,1400,1029,165,204
18,GALAŢI,BRĂHĂŞEŞTI,75766,BRĂHĂŞEŞTI,"SCOALA GIMNAZIALA NR.1 BRĂHĂŞEŞTI",245,"Alegeri Prezidentiale",1,1020,314,290,24,0,309,5,1100,786,153,156
18,GALAŢI,BRĂHĂŞEŞTI,75766,TOFLEA,"SCOALA GIMNAZIALA TOFLEA",246,"Alegeri Prezidentiale",1,1541,217,197,20,0,215,2,1700,1483,22,193
18,GALAŢI,BRĂHĂŞEŞTI,75766,TOFLEA,"SCOALA GIMNAZIALA TOFLEA",247,"Alegeri Prezidentiale",1,1142,179,162,17,0,176,3,1300,1121,15,161
18,GALAŢI,BRĂHĂŞEŞTI,75766,TOFLEA,"SCOALA GIMNAZIALA TOFLEA",248,"Alegeri Prezidentiale",1,1459,218,200,18,0,216,2,1600,1382,21,195
18,GALAŢI,BUCIUMENI,75819,BUCIUMENI,"SCOALA NATALIA NEGRU",249,"Alegeri Prezidentiale",1,925,374,338,36,0,367,7,1000,626,159,208
18,GALAŢI,BUCIUMENI,75819,HĂNŢEŞTI,"SCOALA SMARANDA BRAESCU",250,"Alegeri Prezidentiale",1,382,193,167,26,0,191,2,400,207,91,100
18,GALAŢI,BUCIUMENI,75819,VIZUREŞTI,"SCOALA CU CLASE I-IV",251,"Alegeri Prezidentiale",1,326,139,122,17,0,137,2,400,261,67,70
18,GALAŢI,BUCIUMENI,75819,"TECUCELU SEC","SCOALA CU CLASE I-IV",252,"Alegeri Prezidentiale",1,355,180,147,33,0,177,3,400,220,66,111
18,GALAŢI,CAVADINEŞTI,75864,CAVADINEŞTI,"SCOALA PRIMARA NR.3",253,"Alegeri Prezidentiale",1,178,105,78,27,0,104,1,200,95,45,59
18,GALAŢI,CAVADINEŞTI,75864,CAVADINEŞTI,"SCOALA GIMNAZIALĂ NR.2",254,"Alegeri Prezidentiale",1,879,516,425,82,9,509,7,1000,484,248,261
18,GALAŢI,CAVADINEŞTI,75864,GĂNEŞTI,"SCOALA GIMNAZIALA GĂNEŞTI",255,"Alegeri Prezidentiale",1,721,364,294,64,6,357,7,800,436,175,182
18,GALAŢI,CAVADINEŞTI,75864,VĂDENI,"SCOALA GENERALĂ VĂDENI",256,"Alegeri Prezidentiale",1,356,177,146,31,0,174,3,400,223,72,102
18,GALAŢI,CAVADINEŞTI,75864,COMĂNEŞTI,"SCOALA GENERALĂ COMĂNEŞTI",257,"Alegeri Prezidentiale",1,175,87,69,18,0,86,1,200,113,30,56
18,GALAŢI,CERŢEŞTI,75917,CERŢEŞTI,"SCOALA GIMNAZIALA GEORGE IVASCU",258,"Alegeri Prezidentiale",1,697,290,258,32,0,287,3,800,510,174,113
18,GALAŢI,CERŢEŞTI,75917,CÂRLOMĂNEŞTI,"SCOALA GIMNAZIALA",259,"Alegeri Prezidentiale",1,607,261,237,24,0,257,4,700,439,153,104
18,GALAŢI,CERŢEŞTI,75917,COTOROAIA,"SCOALA PRIMARA",260,"Alegeri Prezidentiale",1,573,297,255,42,0,293,4,600,303,174,119
18,GALAŢI,CORNI,76004,CORNI,"SCOALA NOUA - SAT CORNI",261,"Alegeri Prezidentiale",1,689,317,277,40,0,315,2,800,483,172,143
18,GALAŢI,CORNI,76004,MĂCIŞENI,"SCOALA GENERALA MĂCIŞENI",262,"Alegeri Prezidentiale",1,657,304,269,35,0,301,3,700,396,195,106
18,GALAŢI,CORNI,76004,URLEŞTI,"SCOALA GENERALA URLEŞTI",263,"Alegeri Prezidentiale",1,375,180,164,16,0,180,0,400,220,105,75
18,GALAŢI,COROD,75953,COROD,"ŞCOALA NR.2 COROD",264,"Alegeri Prezidentiale",1,1215,500,473,27,0,492,8,1300,800,363,129
18,GALAŢI,COROD,75953,COROD,"CĂMIN CULTURAL COROD",265,"Alegeri Prezidentiale",1,1228,535,497,36,2,527,8,1400,865,365,162
18,GALAŢI,COROD,75953,COROD,"ŞCOALA NR.3 COROD",266,"Alegeri Prezidentiale",1,1516,564,537,27,0,558,6,1700,1136,375,183
18,GALAŢI,COROD,75953,BLÂNZI,"ŞCOALA BLÎNZI",267,"Alegeri Prezidentiale",1,980,333,314,19,0,328,5,1100,767,200,128
18,GALAŢI,COROD,75953,BRĂTULEŞTI,"ŞCOALA BRĂTULEŞTI",268,"Alegeri Prezidentiale",1,483,167,153,14,0,162,5,500,333,108,54
18,GALAŢI,COROD,75953,CĂRĂPCEŞTI,"ŞCOALA CĂRĂPCEŞTI",269,"Alegeri Prezidentiale",1,630,238,200,38,0,231,7,700,462,128,103
18,GALAŢI,COSMEŞTI,76040,COSMEŞTI,"CĂMIN CULTURAL ”G-RAL EREMIA GRIGORESCU”",270,"Alegeri Prezidentiale",1,1257,555,456,99,0,547,8,1400,845,295,252
18,GALAŢI,COSMEŞTI,76040,COSMEŞTII-VALE,"ŞCOALA CU CLASELE I-VIII COSMEŞTII-VALE",271,"Alegeri Prezidentiale",1,952,449,411,38,0,445,4,1000,551,148,297
18,GALAŢI,COSMEŞTI,76040,BĂLTĂREŢI,"ŞCOALA CU CLASELE I-IV BĂLTĂREŢI",272,"Alegeri Prezidentiale",1,735,309,275,34,0,305,4,800,491,190,115
18,GALAŢI,COSMEŞTI,76040,"FURCENII VECHI","CAMIN CULTURAL DIN SAT FURCENII VECHI",273,"Alegeri Prezidentiale",1,1275,463,423,40,0,457,6,1400,937,262,195
18,GALAŢI,COSMEŞTI,76040,"FURCENII NOI","SCOALA CU CLASELE I-VIII FURCENII NOI",274,"Alegeri Prezidentiale",1,1292,427,406,21,0,420,7,1400,973,259,161
18,GALAŢI,"COSTACHE NEGRI",76111,"COSTACHE NEGRI","CAMINUL CULTURAL COSTACHE NEGRI",275,"Alegeri Prezidentiale",1,1180,523,478,40,5,518,5,1300,777,298,220
18,GALAŢI,"COSTACHE NEGRI",76111,"COSTACHE NEGRI","CAMINUL CULTURAL COSTACHE NEGRI",276,"Alegeri Prezidentiale",1,1026,555,470,71,14,548,7,1100,545,300,248
18,GALAŢI,CUCA,76139,CUCA,"CĂMINUL CULTURAL CUCA",277,"Alegeri Prezidentiale",1,926,706,495,200,11,699,7,1000,294,387,312
18,GALAŢI,CUCA,76139,CUCA,"ŞCOALA GENERALĂ CUCA",278,"Alegeri Prezidentiale",1,869,498,402,89,7,491,7,1000,502,243,248
18,GALAŢI,CUDALBI,76157,CUDALBI,"ȘCOALA GIMNAZIALĂ PROF. EMIL PANAITESCU",279,"Alegeri Prezidentiale",1,1760,749,714,35,0,736,13,1900,1151,406,330
18,GALAŢI,CUDALBI,76157,CUDALBI,"ŞCOALA GIMNAZIALA PROF. EMIL PANAITESCU",280,"Alegeri Prezidentiale",1,1504,642,604,38,0,625,17,1700,1058,358,267
18,GALAŢI,CUDALBI,76157,CUDALBI,"ŞCOALA GIMNAZIALA PROF. EMIL PANAITESCU",281,"Alegeri Prezidentiale",1,1306,559,519,40,0,548,11,1400,841,317,231
18,GALAŢI,CUDALBI,76157,CUDALBI,"LICEUL TEHNOLOGIC NR.1",282,"Alegeri Prezidentiale",1,1603,653,619,34,0,639,14,1800,1147,426,213
18,GALAŢI,"CUZA VODĂ",77595,"CUZA VODĂ","ŞCOALA GIMNAZIALA ELENA DOAMNA,",283,"Alegeri Prezidentiale",1,1207,538,499,39,0,536,2,1260,722,276,260
18,GALAŢI,"CUZA VODĂ",77595,"CUZA VODĂ","ŞCOALA GIMNAZIALA ELENA DOAMNA,",284,"Alegeri Prezidentiale",1,1079,474,439,35,0,469,5,1200,726,244,225
18,GALAŢI,DRĂGĂNEŞTI,75221,DRĂGĂNEŞTI,"SCOALA DIN SATUL DRĂGĂNEŞTI",285,"Alegeri Prezidentiale",1,1851,713,673,40,0,707,6,2000,1287,468,239
18,GALAŢI,DRĂGĂNEŞTI,75221,DRĂGĂNEŞTI,"CAMINUL CULTURAL DIN SATUL DRĂGĂNEŞTI",286,"Alegeri Prezidentiale",1,1884,709,674,34,1,701,8,2000,1291,461,240
18,GALAŢI,DRĂGĂNEŞTI,75221,"MALU ALB","SCOALA DIN MALUL ALB",287,"Alegeri Prezidentiale",1,1715,760,700,50,10,746,14,1900,1140,557,189
18,GALAŢI,DRĂGUŞENI,76175,DRĂGUŞENI,"ŞCOALA DRĂGUŞENI",288,"Alegeri Prezidentiale",1,1494,593,555,33,5,587,6,1600,1007,197,390
18,GALAŢI,DRĂGUŞENI,76175,FUNDEANU,"SCOALA FUNDEANU",289,"Alegeri Prezidentiale",1,762,303,276,23,4,297,6,800,497,156,141
18,GALAŢI,DRĂGUŞENI,76175,NICOPOLE,"SCOALA NICOPOLE",290,"Alegeri Prezidentiale",1,459,177,152,25,0,174,3,500,323,109,65
18,GALAŢI,DRĂGUŞENI,76175,CĂUIEŞTI,"GRADINITA CU PROGRAM NORMAL NR.1",291,"Alegeri Prezidentiale",1,466,190,168,16,6,186,4,500,310,104,82
18,GALAŢI,DRĂGUŞENI,76175,ŞTIEŢEŞTI,"SCOALA ŞTIETEŞTI",292,"Alegeri Prezidentiale",1,253,129,113,12,4,129,0,298,169,73,56
18,GALAŢI,DRĂGUŞENI,76175,ADAM,"SCOALA ADAM",293,"Alegeri Prezidentiale",1,589,263,225,34,4,258,5,700,437,123,135
18,GALAŢI,DRĂGUŞENI,76175,GHINGHEŞTI,"SCOALA GHINGHEŞTI",294,"Alegeri Prezidentiale",1,240,122,101,17,4,121,1,300,178,44,77
18,GALAŢI,FÂRŢĂNEŞTI,76255,FÂRŢĂNEŞTI,"CAMINUL CULTURAL FIRTANESTI",295,"Alegeri Prezidentiale",1,1372,510,447,63,0,503,7,1500,990,214,289
18,GALAŢI,FÂRŢĂNEŞTI,76255,FÂRŢĂNEŞTI,"CAMINUL CULTURAL FIRTANESTI",296,"Alegeri Prezidentiale",1,1469,587,531,56,0,582,5,1600,1013,279,303
18,GALAŢI,FÂRŢĂNEŞTI,76255,VIILE,"CĂMINUL CULTURAL VIILE",297,"Alegeri Prezidentiale",1,1267,560,517,43,0,555,5,1400,840,217,338
18,GALAŢI,FOLTEŞTI,76282,FOLTEŞTI,"GRADINITA CU PROGRAM NORMAL NR. 1 FOLTESTI - SALA NR.1",298,"Alegeri Prezidentiale",1,886,388,328,59,1,384,4,1000,612,228,156
18,GALAŢI,FOLTEŞTI,76282,FOLTEŞTI,"GRADINITA CU PROGRAM NORMAL NR.1 FOLTESTI - SALA NR.2",299,"Alegeri Prezidentiale",1,901,441,376,65,0,431,10,1000,559,239,192
18,GALAŢI,FOLTEŞTI,76282,STOICANI,"SCOALA GIMNAZIALA NR.1 STOICANI",300,"Alegeri Prezidentiale",1,844,381,312,69,0,373,8,900,519,200,173
18,GALAŢI,FRUMUŞIŢA,76317,FRUMUŞIŢA,"ŞCOALA GENERALA NR.1 FRUMUŞIŢA (ŞCOALA DIN CENTRU)",301,"Alegeri Prezidentiale",1,1820,690,636,46,8,673,17,1900,1210,371,302
18,GALAŢI,FRUMUŞIŢA,76317,FRUMUŞIŢA,"SCOALA GENERALĂ NR.2 PETRU RAREŞ",302,"Alegeri Prezidentiale",1,855,391,323,55,13,387,4,900,509,205,182
18,GALAŢI,FRUMUŞIŢA,76317,IJDILENI,"SCOALA GENERALA IJDILENI",303,"Alegeri Prezidentiale",1,742,258,227,26,5,256,2,800,542,168,88
18,GALAŢI,FRUMUŞIŢA,76317,TĂMĂOANI,"SCOALA GENERALA TĂMĂOANI",304,"Alegeri Prezidentiale",1,962,405,336,61,8,402,3,1091,686,247,155
18,GALAŢI,FUNDENI,76353,FUNDENI,"ŞCOALA GENERALA FUNDENI",305,"Alegeri Prezidentiale",1,675,337,289,48,0,328,9,700,363,202,126
18,GALAŢI,FUNDENI,76353,LUNGOCI,"SCOALA ELEMENTARA LUNGOCI",306,"Alegeri Prezidentiale",1,427,233,182,51,0,231,2,500,267,117,114
18,GALAŢI,FUNDENI,76353,"HANU CONACHI","ŞCOALA GENERALA HANU CONACHI",307,"Alegeri Prezidentiale",1,1218,488,456,32,0,479,9,1300,812,316,163
18,GALAŢI,FUNDENI,76353,"HANU CONACHI","ŞCOALA GENERALA HANU CONACHI",308,"Alegeri Prezidentiale",1,870,372,317,55,0,367,5,1000,628,236,131
18,GALAŢI,GHIDIGENI,76406,GHIDIGENI,"ŞCOALA GIMNAZIALĂ NR.1 GHIDIGENI",309,"Alegeri Prezidentiale",1,1684,679,654,25,0,669,10,1800,1121,432,237
18,GALAŢI,GHIDIGENI,76406,GEFU,"ȘCOALA GEFU",310,"Alegeri Prezidentiale",1,838,503,481,22,0,498,5,892,389,280,218
18,GALAŢI,GHIDIGENI,76406,GÂRBOVĂŢ,"ȘCOALA GÂRBOVĂȚ",311,"Alegeri Prezidentiale",1,211,91,68,23,0,90,1,300,209,67,23
18,GALAŢI,GHIDIGENI,76406,TĂLPIGI,"ȘCOALA TĂLPIGI",312,"Alegeri Prezidentiale",1,1645,807,764,43,0,797,10,1800,993,564,233
18,GALAŢI,GHIDIGENI,76406,"SLOBOZIA CORNI","ȘCOALA SLOBOZIA",313,"Alegeri Prezidentiale",1,642,333,298,35,0,328,5,700,367,228,100
18,GALAŢI,GOHOR,76497,GOHOR,"ŞCOALA GIMNAZIALA NR.1 GOHOR",314,"Alegeri Prezidentiale",1,1319,761,668,77,16,745,16,1492,731,299,446
18,GALAŢI,GOHOR,76497,IREASCA,"ŞCOALA CU CLASELE I-IV IREASCA",315,"Alegeri Prezidentiale",1,225,132,99,33,0,131,1,300,168,38,93
18,GALAŢI,GOHOR,76497,NĂRTEŞTI,"ŞCOALA CU CLASELE I-IV NĂRTEŞTI",316,"Alegeri Prezidentiale",1,666,451,323,118,10,446,5,700,249,237,209
18,GALAŢI,GOHOR,76497,"GARA BERHECI","ŞCOALA GIMNAZIALA - SAT GARA BERHECI",317,"Alegeri Prezidentiale",1,554,328,255,73,0,324,4,600,272,149,175
18,GALAŢI,GRIVIŢA,76558,GRIVIŢA,"SCOALA NOUA GRIVITA",318,"Alegeri Prezidentiale",1,1528,518,474,44,0,514,4,1700,1182,295,219
18,GALAŢI,GRIVIŢA,76558,GRIVIŢA,"ŞCOALA VECHE GRIVIŢA",319,"Alegeri Prezidentiale",1,995,376,345,29,2,371,5,1100,724,214,157
18,GALAŢI,GRIVIŢA,76558,CĂLMĂŢUI,"SCOALA PRIMARA, SAT CĂLMĂŢUI",320,"Alegeri Prezidentiale",1,570,200,175,25,0,200,0,600,400,122,78
18,GALAŢI,INDEPENDENŢA,76585,INDEPENDENŢA,"SCOALA GIMNAZIALA NR. 1",321,"Alegeri Prezidentiale",1,1356,641,573,68,0,632,9,1500,859,379,253
18,GALAŢI,INDEPENDENŢA,76585,INDEPENDENŢA,"SCOALA GIMNAZIALA NR. 2",322,"Alegeri Prezidentiale",1,1627,749,660,89,0,737,12,1800,1051,475,262
18,GALAŢI,INDEPENDENŢA,76585,INDEPENDENŢA,"CLADIREA GRADINITA NR.1",323,"Alegeri Prezidentiale",1,947,363,324,39,0,356,7,1000,637,202,154
18,GALAŢI,IVEŞTI,76601,IVEŞTI,"ŞCOALA NR.2 IVEŞTI",324,"Alegeri Prezidentiale",1,734,300,270,30,0,295,5,800,500,189,106
18,GALAŢI,IVEŞTI,76601,IVEŞTI,"ŞCOALA GIMNAZIALĂ ”VICTOR ION POPA ” IVEŞTI (ŞCOALA GIMNAZIALA NR.3 IVEŞTI)",325,"Alegeri Prezidentiale",1,1520,804,767,37,0,790,14,1700,896,292,498
18,GALAŢI,IVEŞTI,76601,IVEŞTI,"LICEUL TEHNOLOGIC ”HORTENSIA PAPADAT – BENGESCU”",326,"Alegeri Prezidentiale",1,1008,374,328,46,0,368,6,1100,726,237,131
18,GALAŢI,IVEŞTI,76601,IVEŞTI,"LICEUL TEHNOLOGIC ”HORTENSIA PAPADAT – BENGESCU”",327,"Alegeri Prezidentiale",1,1051,475,440,35,0,467,8,1200,725,239,228
18,GALAŢI,IVEŞTI,76601,BUCEŞTI,"ŞCOALA GIMNAZIALA ”NEGOIŢĂ DĂNĂILĂ”",328,"Alegeri Prezidentiale",1,1920,741,680,61,0,721,20,2100,1359,445,276
18,GALAŢI,IVEŞTI,76601,BUCEŞTI,"ŞCOALA GIMNAZIALA ”GEN.EREMIA GRIGORESCU”",329,"Alegeri Prezidentiale",1,1742,773,695,78,0,767,6,1908,1135,486,281
18,GALAŢI,JORĂŞTI,76638,JORĂŞTI,"CĂMINUL CULTURAL JORĂȘTI",330,"Alegeri Prezidentiale",1,903,487,430,57,0,478,9,1000,513,194,284
18,GALAŢI,JORĂŞTI,76638,LUNCA,"SALĂ ÎNTRUNIRI LUNCA",331,"Alegeri Prezidentiale",1,170,105,82,23,0,105,0,200,95,45,60
18,GALAŢI,JORĂŞTI,76638,ZĂRNEŞTI,"CĂMINUL CULTURAL ZĂRNEȘTI",332,"Alegeri Prezidentiale",1,286,148,133,15,0,148,0,300,152,63,85
18,GALAŢI,LIEŞTI,76674,LIEŞTI,"ŞCOALA GIMNAZIALĂ NR. 1",333,"Alegeri Prezidentiale",1,1694,711,663,48,0,703,8,1800,1089,447,256
18,GALAŢI,LIEŞTI,76674,LIEŞTI,"ŞCOALA GIMNAZIALĂ NR. 2",334,"Alegeri Prezidentiale",1,1470,613,571,42,0,603,10,1600,987,432,171
18,GALAŢI,LIEŞTI,76674,LIEŞTI,"ŞCOALA GIMNAZIALĂ NR. 2",335,"Alegeri Prezidentiale",1,1365,573,538,34,1,565,8,1500,927,352,213
18,GALAŢI,LIEŞTI,76674,LIEŞTI,"ŞCOALA GIMNAZIALĂ NR. 3",336,"Alegeri Prezidentiale",1,1417,631,563,68,0,625,6,1600,969,401,224
18,GALAŢI,LIEŞTI,76674,LIEŞTI,"GRADINITA NR. 3",337,"Alegeri Prezidentiale",1,1409,547,501,46,0,540,7,1500,953,384,156
18,GALAŢI,LIEŞTI,76674,LIEŞTI,"ŞCOALA GIMNAZIALĂ ”SFÂNTUL NICOLAE”",338,"Alegeri Prezidentiale",1,1512,699,630,69,0,694,5,1700,1001,482,212
18,GALAŢI,MATCA,76692,MATCA,"ŞCOALA NR.2 MATCA",339,"Alegeri Prezidentiale",1,1475,671,635,36,0,663,8,1600,929,439,224
18,GALAŢI,MATCA,76692,MATCA,"ŞCOALA NR.1 SUSENI",340,"Alegeri Prezidentiale",1,1825,799,780,19,0,786,13,2000,1201,521,265
18,GALAŢI,MATCA,76692,MATCA,"SCOALA NR.1 MATCA",341,"Alegeri Prezidentiale",1,1522,647,624,23,0,646,1,1700,1053,436,210
18,GALAŢI,MATCA,76692,MATCA,"SCOALA NR.1 MATCA",342,"Alegeri Prezidentiale",1,1595,704,684,20,0,691,13,1800,1096,478,213
18,GALAŢI,MATCA,76692,MATCA,"ŞCOALA NR.1 MATCA",343,"Alegeri Prezidentiale",1,1583,674,653,21,0,662,12,1700,1026,423,239
18,GALAŢI,MATCA,76692,MATCA,"SCOALA NR.3 MATCA",344,"Alegeri Prezidentiale",1,1894,914,848,66,0,904,10,2000,1086,594,310
18,GALAŢI,MĂSTĂCANI,76718,MĂSTĂCANI,"SCOALA GIMNAZIALA NR 1 GHE. POALELUNGI MASTACANI",345,"Alegeri Prezidentiale",1,1097,422,352,70,0,416,6,1200,778,201,215
18,GALAŢI,MĂSTĂCANI,76718,MĂSTĂCANI,"SCOALA GIMNAZIALA NR. 3 MĂSTĂCANI",346,"Alegeri Prezidentiale",1,787,342,281,61,0,334,8,900,558,186,148
18,GALAŢI,MĂSTĂCANI,76718,CHIRAFTEI,"SCOALA GIMNAZIALA NR. 1 CHIRAFTEI",347,"Alegeri Prezidentiale",1,1105,420,376,44,0,416,4,1200,780,184,232
18,GALAŢI,MĂSTĂCANI,76718,CHIRAFTEI,"SCOALA GIMNAZIALA NR. 2 CHIRAFTEI",348,"Alegeri Prezidentiale",1,1067,391,337,41,13,383,8,1200,809,195,188
18,GALAŢI,MOVILENI,76745,MOVILENI,"CAMIN CULTURAL",349,"Alegeri Prezidentiale",1,1572,485,436,49,0,474,11,1700,1215,263,211
18,GALAŢI,MOVILENI,76745,MOVILENI,"SCOALA NR.2 MOVILENI",350,"Alegeri Prezidentiale",1,1186,354,333,20,1,351,3,1300,946,229,122
18,GALAŢI,MUNTENI,75258,MUNTENI,"SCOALA GIMNAZIALA NR.2",351,"Alegeri Prezidentiale",1,1360,682,628,51,3,671,11,1500,818,267,404
18,GALAŢI,MUNTENI,75258,MUNTENI,"SCOALA GENERALĂ NR.1 SAT MUNTENI",352,"Alegeri Prezidentiale",1,1667,734,681,51,2,722,12,1800,1066,340,382
18,GALAŢI,MUNTENI,75258,FRUNZEASCA,"SCOALA GENERALĂ FRUNZEASCA",353,"Alegeri Prezidentiale",1,1001,531,501,26,4,516,15,1100,569,271,245
18,GALAŢI,MUNTENI,75258,ŢIGĂNEŞTI,"SCOALA GENERALĂ – SAT ŢIGĂNEŞTI",354,"Alegeri Prezidentiale",1,827,381,357,23,1,378,3,900,519,200,178
18,GALAŢI,MUNTENI,75258,UNGURENI,"SCOALA GENERALĂ UNGURENI",355,"Alegeri Prezidentiale",1,1125,462,438,24,0,454,8,1200,738,252,202
18,GALAŢI,NĂMOLOASA,76763,NĂMOLOASA,"SCOALA GENERALA NAMOLOASA",356,"Alegeri Prezidentiale",1,789,402,318,51,33,398,4,900,498,183,215
18,GALAŢI,NĂMOLOASA,76763,NĂMOLOASA-SAT,"SCOALA GENERALA NAMOLOASA SAT",357,"Alegeri Prezidentiale",1,916,527,415,80,32,522,5,1000,473,179,343
18,GALAŢI,NEGRILEŞTI,77579,NEGRILEŞTI,"CĂMINUL CULTURAL DIN SATUL NEGRILEŞTI",358,"Alegeri Prezidentiale",1,1379,695,626,69,0,686,9,1500,805,308,378
18,GALAŢI,NEGRILEŞTI,77579,"SLOBOZIA BLĂNEASA","SCOALA GENERALĂ SLOBOZIA BLĂNEASA",359,"Alegeri Prezidentiale",1,777,468,403,65,0,463,5,900,432,234,229
18,GALAŢI,NICOREŞTI,76807,NICOREŞTI,"ŞCOALA NICOREŞTI",360,"Alegeri Prezidentiale",1,1163,402,343,59,0,399,3,1300,898,185,214
18,GALAŢI,NICOREŞTI,76807,FÂNTÂNI,"ŞCOALA FÎNTÂNI",361,"Alegeri Prezidentiale",1,482,209,177,32,0,209,0,500,291,87,122
18,GALAŢI,NICOREŞTI,76807,"COASTA LUPEI","ŞCOALA COASTA LUPEI",362,"Alegeri Prezidentiale",1,253,148,119,29,0,147,1,300,152,60,87
18,GALAŢI,NICOREŞTI,76807,"PISCU CORBULUI","ŞCOALA PISCU CORBULUI",363,"Alegeri Prezidentiale",1,243,114,91,23,0,114,0,300,186,61,53
18,GALAŢI,NICOREŞTI,76807,MĂLURENI,"ŞCOALA MĂLURENI",364,"Alegeri Prezidentiale",1,159,88,69,19,0,86,2,200,112,34,52
18,GALAŢI,NICOREŞTI,76807,IONĂŞEŞTI,"ŞCOALA IONĂŞEŞTI",365,"Alegeri Prezidentiale",1,548,209,188,21,0,204,5,600,391,132,72
18,GALAŢI,NICOREŞTI,76807,DOBRINEŞTI,"ŞCOALA DOBRINEŞTI.",366,"Alegeri Prezidentiale",1,406,167,144,23,0,167,0,500,333,94,73
18,GALAŢI,OANCEA,76932,OANCEA,"SCOALA GIMNAZIALA OANCEA",367,"Alegeri Prezidentiale",1,1370,708,511,176,21,696,12,1500,792,502,194
18,GALAŢI,PECHEA,76969,PECHEA,"SCOALA NR.1 PECHEA",368,"Alegeri Prezidentiale",1,1272,593,525,68,0,584,9,1400,807,338,246
18,GALAŢI,PECHEA,76969,PECHEA,"SCOALA NR.2 PECHEA",369,"Alegeri Prezidentiale",1,1437,609,549,60,0,602,7,1600,991,347,255
18,GALAŢI,PECHEA,76969,PECHEA,"SCOALA NR.3 PECHEA",370,"Alegeri Prezidentiale",1,1458,581,553,28,0,576,5,1600,1019,301,275
18,GALAŢI,PECHEA,76969,PECHEA,"GRĂDINIŢA NR.2 PECHEA",371,"Alegeri Prezidentiale",1,1313,533,492,41,0,525,8,1400,867,293,232
18,GALAŢI,PECHEA,76969,PECHEA,"CĂMINUL CULTURAL PECHEA",372,"Alegeri Prezidentiale",1,1938,767,707,60,0,753,14,2000,1233,403,350
18,GALAŢI,PECHEA,76969,PECHEA,"SCOALA NR.4 PECHEA",373,"Alegeri Prezidentiale",1,1721,650,604,46,0,640,10,1900,1250,332,308
18,GALAŢI,PISCU,76996,PISCU,"ȘCOALA GIMNAZIALĂ ” DIMITRIE LUCHIAN” , CORP A",374,"Alegeri Prezidentiale",1,1136,490,441,49,0,487,3,1300,810,279,208
18,GALAŢI,PISCU,76996,PISCU,"SCOALA GIMNAZIALĂ ”DIMITRIE LUCHIAN ”CORP B , PISCU",375,"Alegeri Prezidentiale",1,926,446,389,57,0,443,3,1000,554,242,201
18,GALAŢI,PISCU,76996,PISCU,"SCOALA GIMNAZIALĂ ” STEFAN CEL MARE” PISCU",376,"Alegeri Prezidentiale",1,1511,674,608,66,0,662,12,1700,1026,425,237
18,GALAŢI,PISCU,76996,VAMEŞ,"ȘCOALA PRIMARĂ VAMEȘ",377,"Alegeri Prezidentiale",1,434,198,156,42,0,197,1,500,302,110,87
18,GALAŢI,POIANA,77587,POIANA,"SCOALA GIMNAZIALA NR.1 COMUNA POIANA,JUDETUL GALATI",378,"Alegeri Prezidentiale",1,998,584,483,75,26,577,7,1100,516,228,349
18,GALAŢI,POIANA,77587,VIŞINA,"SCOALA PRIMARA NR.1 SAT VISINA, COMUNA POIANA, JUDETUL GALATI",379,"Alegeri Prezidentiale",1,397,242,198,38,6,240,2,400,158,95,145
18,GALAŢI,PRIPONEŞTI,77028,PRIPONEŞTI,"SCOALA GIMNAZIALĂ",380,"Alegeri Prezidentiale",1,756,299,249,37,13,290,9,800,501,156,134
18,GALAŢI,PRIPONEŞTI,77028,CIORĂŞTI,"CĂMIN CULTURAL",381,"Alegeri Prezidentiale",1,818,342,291,51,0,338,4,900,558,142,196
18,GALAŢI,PRIPONEŞTI,77028,LIEŞTI,"ȘCOALA PRIMARĂ",382,"Alegeri Prezidentiale",1,173,95,67,21,7,95,0,200,105,34,61
18,GALAŢI,RĂDEŞTI,77561,RĂDEŞTI,"CĂMINUL CULTURAL RĂDEŞTI",383,"Alegeri Prezidentiale",1,905,499,424,75,0,494,5,992,493,190,304
18,GALAŢI,RĂDEŞTI,77561,CRUCEANU,"GRĂDINIŢA CRUCEANU",384,"Alegeri Prezidentiale",1,242,125,114,11,0,123,2,300,175,40,83
18,GALAŢI,REDIU,77082,REDIU,"FOSTA GRADINITA NR. 1 REDIU",385,"Alegeri Prezidentiale",1,1308,596,502,66,28,590,6,1400,804,313,277
18,GALAŢI,REDIU,77082,PLEVNA,"SCOALA NR1 PLEVNA",386,"Alegeri Prezidentiale",1,452,220,177,40,3,217,3,500,280,101,116
18,GALAŢI,SCÂNTEIEŞTI,77126,SCÂNTEIEŞTI,"CAMINUL CULTURAL",387,"Alegeri Prezidentiale",1,734,371,292,71,8,363,8,800,429,225,138
18,GALAŢI,SCÂNTEIEŞTI,77126,FÂNTÂNELE,"CAMINUL CULTURAL",388,"Alegeri Prezidentiale",1,1262,544,500,44,0,537,7,1400,856,310,227
18,GALAŢI,SCHELA,77153,SCHELA,"GRADINITA DE COPII SCHELA",389,"Alegeri Prezidentiale",1,1413,732,689,43,0,724,8,1592,860,474,250
18,GALAŢI,SCHELA,77153,SCHELA,"GRADINITA DE COPII SCHELA",390,"Alegeri Prezidentiale",1,1171,669,572,97,0,662,7,1300,631,399,263
18,GALAŢI,SCHELA,77153,NEGREA,"AȘEZĂMÂNTUL CULTURAL NEGREA",391,"Alegeri Prezidentiale",1,531,284,242,42,0,279,5,600,316,191,88
18,GALAŢI,"SLOBOZIA CONACHI",77180,"SLOBOZIA CONACHI","SCOALA GIMNAZIALA SLOBOZIA-CONACHI",392,"Alegeri Prezidentiale",1,1376,612,550,50,12,598,14,1500,888,319,279
18,GALAŢI,"SLOBOZIA CONACHI",77180,"SLOBOZIA CONACHI","CENTRUL DE FORMARE PROFESIONALA",393,"Alegeri Prezidentiale",1,1231,569,472,89,8,564,5,1400,823,295,269
18,GALAŢI,"SLOBOZIA CONACHI",77180,IZVOARELE,"SCOALA GIMNAZIALA IZVOARELE",394,"Alegeri Prezidentiale",1,817,387,334,41,12,380,7,900,513,184,196
18,GALAŢI,SMÂRDAN,77224,SMÂRDAN,"SCOALA GENERALĂ ”SFÂNTA CUVIOASĂ PARASCHEVA” SMÎRDAN",395,"Alegeri Prezidentiale",1,1414,699,616,79,4,694,5,1600,901,447,247
18,GALAŢI,SMÂRDAN,77224,SMÂRDAN,"ŞCOALA GENERALĂ ”SFÂNTA CUVIOASĂ PARASCHEVA” SMÂRDAN",396,"Alegeri Prezidentiale",1,1170,537,473,60,4,533,4,1300,763,346,187
18,GALAŢI,SMÂRDAN,77224,"MIHAIL KOGĂLNICEANU","SCOALA GIMNAZIALĂ ”MIHAIL ŞI GAVRIL” M.KOGĂLNICEANU",397,"Alegeri Prezidentiale",1,889,402,345,57,0,395,7,1000,598,253,142
18,GALAŢI,SMÂRDAN,77224,CIŞMELE,"SCOALA PRIMARĂ NR.1 CIŞMELE",398,"Alegeri Prezidentiale",1,1224,530,481,48,1,517,13,1300,770,305,212
18,GALAŢI,SMULŢI,77260,SMULŢI,"GRADINITA SMULTI",399,"Alegeri Prezidentiale",1,1123,576,469,72,35,573,3,1200,624,212,361
18,GALAŢI,SUCEVENI,77288,SUCEVENI,"CĂMINUL CULTURAL SUCEVENI",400,"Alegeri Prezidentiale",1,921,551,421,99,31,543,8,992,441,213,330
18,GALAŢI,SUCEVENI,77288,ROGOJENI,"SCOALA GIMNAZIALĂ ROGOJENI",401,"Alegeri Prezidentiale",1,449,299,220,61,18,294,5,500,201,110,184
18,GALAŢI,SUHURLUI,77601,SUHURLUI,"SCOALA GIMNAZIALĂ NR.1 SUHURLUI",402,"Alegeri Prezidentiale",1,1143,559,473,68,18,556,3,1300,741,356,200
18,GALAŢI,ŞENDRENI,75114,ŞENDRENI,"SCOALA GIMNAZIALA NR. 1",403,"Alegeri Prezidentiale",1,1730,915,831,72,12,899,16,1800,885,623,276
18,GALAŢI,ŞENDRENI,75114,ŞENDRENI,"SCOALA GIMNAZIALA NR. 1",404,"Alegeri Prezidentiale",1,1172,705,552,147,6,695,10,1300,595,451,244
18,GALAŢI,ŞENDRENI,75114,MOVILENI,"GRADINITA MOVILENI",405,"Alegeri Prezidentiale",1,561,262,238,24,0,259,3,600,338,183,76
18,GALAŢI,ŞENDRENI,75114,"ŞERBEŞTII VECHI","GRADINITA SERBESTII VECHI",406,"Alegeri Prezidentiale",1,689,345,296,49,0,341,4,792,447,216,125
18,GALAŢI,"TUDOR VLADIMIRESCU",77313,"TUDOR VLADIMIRESCU","ŞCOALA GIMNAZIALĂ NR. 1(ŞCOALA GENERALA DE 8 CLASETUDOR VLADIMIRESCU MOARĂ)",407,"Alegeri Prezidentiale",1,788,332,284,48,0,329,3,900,568,191,138
18,GALAŢI,"TUDOR VLADIMIRESCU",77313,"TUDOR VLADIMIRESCU","GRĂDINIŢA TUDOR VLADIMIRESCU,",408,"Alegeri Prezidentiale",2,1403,714,612,102,0,711,3,1508,794,430,281
18,GALAŢI,"TUDOR VLADIMIRESCU",77313,"TUDOR VLADIMIRESCU","SCOALA GENERALA DE 4 ANI - PRIVAL",409,"Alegeri Prezidentiale",1,937,473,414,59,0,464,9,1000,527,254,210
18,GALAŢI,"TUDOR VLADIMIRESCU",77313,"TUDOR VLADIMIRESCU","LICEUL TEHNOLOGIC ”TUDOR VLADIMIRESCU”",410,"Alegeri Prezidentiale",1,1182,569,497,72,0,561,8,1300,731,356,205
18,GALAŢI,TULUCEŞTI,77331,TULUCEŞTI,"GRADINITA TULUCESTI",411,"Alegeri Prezidentiale",1,1643,700,630,70,0,696,4,1800,1100,450,246
18,GALAŢI,TULUCEŞTI,77331,TULUCEŞTI,"SCOALA TULUCESTI",412,"Alegeri Prezidentiale",2,1961,820,743,77,0,811,9,2099,1279,581,230
18,GALAŢI,TULUCEŞTI,77331,TĂTARCA,"SCOALA TATARCA",413,"Alegeri Prezidentiale",1,663,252,215,37,0,250,2,700,448,172,78
18,GALAŢI,TULUCEŞTI,77331,ŞIVIŢA,"SCOALA SIVITA",414,"Alegeri Prezidentiale",1,1056,463,401,62,0,454,9,1200,737,260,194
18,GALAŢI,TULUCEŞTI,77331,ŞIVIŢA,"ŞCOALA VECHE ŞIVIŢA",415,"Alegeri Prezidentiale",1,1030,436,385,51,0,429,7,1100,664,267,162
18,GALAŢI,ŢEPU,77377,ŢEPU,"SCOALA TUDOR PAMFILE",416,"Alegeri Prezidentiale",1,1154,694,602,73,19,680,14,1300,606,290,390
18,GALAŢI,ŢEPU,77377,ŢEPU,"GRĂDINIŢA PROFESOR IOAN BASOC",417,"Alegeri Prezidentiale",1,848,489,435,42,12,479,10,900,411,213,266
18,GALAŢI,UMBRĂREŞTI,77402,UMBRĂREŞTI,"ȘCOALA GIMNAZIALĂ NR. 1 UMBRĂREȘTI",418,"Alegeri Prezidentiale",1,1687,545,499,46,0,539,6,1800,1255,259,280
18,GALAŢI,UMBRĂREŞTI,77402,UMBRĂREŞTI-DEAL,"ȘCOALA GIMNAZIALĂ „ SFÂNTUL STELIAN” UMBRĂREȘTI - DEAL",419,"Alegeri Prezidentiale",1,1193,498,473,25,0,495,3,1300,802,315,180
18,GALAŢI,UMBRĂREŞTI,77402,UMBRĂREŞTI-DEAL,"ȘCOALA GIMNAZIALĂ „ SFÂNTUL STELIAN„ UMBRĂREȘTI - DEAL",420,"Alegeri Prezidentiale",1,837,326,303,23,0,321,5,900,574,167,154
18,GALAŢI,UMBRĂREŞTI,77402,TORCEŞTI,"ȘCOALA GIMNAZIALĂ TORCEȘTI",421,"Alegeri Prezidentiale",1,600,291,267,24,0,288,3,700,409,163,125
18,GALAŢI,UMBRĂREŞTI,77402,CONDREA,"ȘCOALA GIMNAZIALĂ CONDREA",422,"Alegeri Prezidentiale",1,569,235,204,31,0,230,5,600,365,154,76
18,GALAŢI,UMBRĂREŞTI,77402,SALCIA,"ȘCOALA GIMNAZIALĂ SALCIA",423,"Alegeri Prezidentiale",1,713,212,195,17,0,208,4,800,588,122,86
18,GALAŢI,UMBRĂREŞTI,77402,SILIŞTEA,"ȘCOALA GIMNAZIALĂ SILIȘTEA",424,"Alegeri Prezidentiale",1,276,132,107,25,0,132,0,300,168,73,59
18,GALAŢI,"VALEA MĂRULUI",77475,"VALEA MĂRULUI","ȘCOALA GIMNAZIALĂ NR.1",425,"Alegeri Prezidentiale",1,980,421,380,35,6,414,7,1100,679,257,157
18,GALAŢI,"VALEA MĂRULUI",77475,"VALEA MĂRULUI","ȘCOALA GIMNAZIALĂ NR. 1",426,"Alegeri Prezidentiale",1,806,321,294,25,2,318,3,900,579,170,148
18,GALAŢI,"VALEA MĂRULUI",77475,"VALEA MĂRULUI","ȘCOALA COASTA VĂII",427,"Alegeri Prezidentiale",1,379,174,161,13,0,170,4,400,226,129,41
18,GALAŢI,"VALEA MĂRULUI",77475,MÂNDREŞTI,"ȘCOALA MÎNDRESTI",428,"Alegeri Prezidentiale",1,799,334,286,34,14,332,2,900,566,162,170
18,GALAŢI,VÂNĂTORI,75150,VÂNĂTORI,"SCOALA SFINTUL NICOLAE",429,"Alegeri Prezidentiale",1,1199,706,589,117,0,696,10,1300,594,455,241
18,GALAŢI,VÂNĂTORI,75150,VÂNĂTORI,"SCOALA SFINTUL NICOLAE",430,"Alegeri Prezidentiale",1,1176,675,571,104,0,667,8,1300,625,405,262
18,GALAŢI,VÂNĂTORI,75150,"ODAIA MANOLACHE","SCOALA MARIA GRECU",431,"Alegeri Prezidentiale",1,1638,800,726,74,0,793,7,1800,1000,500,293
18,GALAŢI,VÂNĂTORI,75150,COSTI,"GRADINITA COPII",432,"Alegeri Prezidentiale",1,1196,670,558,112,0,658,12,1300,630,454,204
18,GALAŢI,VÂRLEZI,77509,VÂRLEZI,"SCOALA GIMNAZIALĂ VÎRLEZI",433,"Alegeri Prezidentiale",1,888,487,394,70,23,486,1,1008,521,258,228
18,GALAŢI,VÂRLEZI,77509,CRĂIEŞTI,"GRĂDINIŢA CRĂIEŞTI",434,"Alegeri Prezidentiale",2,637,394,343,42,9,384,10,700,306,183,201
18,GALAŢI,VLĂDEŞTI,77536,VLĂDEŞTI,"ŞCOALA GIMNAZIALẶ ” SFÎNTUL IERARH NICOLAE ”",435,"Alegeri Prezidentiale",1,1172,525,437,81,7,518,7,1300,775,354,164
18,GALAŢI,VLĂDEŞTI,77536,BRĂNEŞTI,"ȘCOALA GIMNAZIALĂ BRĂNEȘTI",436,"Alegeri Prezidentiale",1,866,340,281,59,0,336,4,1000,660,230,106
19,GIURGIU,"MUNICIPIUL GIURGIU",100521,GIURGIU,"ŞCOALA GIMNAZIALĂ SFÂNTUL GHEORGHE",1,"Alegeri Prezidentiale",1,1165,547,516,31,0,537,10,1280,733,230,307
19,GIURGIU,"MUNICIPIUL GIURGIU",100521,GIURGIU,"GALERIILE DE ARTĂ",2,"Alegeri Prezidentiale",1,1008,558,507,51,0,550,8,1108,550,220,330
19,GIURGIU,"MUNICIPIUL GIURGIU",100521,GIURGIU,"PRIMĂRIA MUNICIPIULUI GIURGIU",3,"Alegeri Prezidentiale",1,1149,526,475,51,0,515,11,1263,737,228,287
19,GIURGIU,"MUNICIPIUL GIURGIU",100521,GIURGIU,"LICEUL ”TUDOR VIANU”",4,"Alegeri Prezidentiale",1,1178,533,510,23,0,520,13,1295,762,208,312
19,GIURGIU,"MUNICIPIUL GIURGIU",100521,GIURGIU,"ŞCOALA GIMNAZIALĂ MIRCEA CEL BĂTRÂN",5,"Alegeri Prezidentiale",1,1273,625,584,40,1,604,21,1399,774,229,375
19,GIURGIU,"MUNICIPIUL GIURGIU",100521,GIURGIU,"LICEUL TEHNOLOGIC MIRON NICOLESCU",6,"Alegeri Prezidentiale",1,1100,382,365,17,0,371,11,1209,827,155,216
19,GIURGIU,"MUNICIPIUL GIURGIU",100521,GIURGIU,"CANTINA SEMINARULUI TEOLOGIC TEOCTIST PATRIARHUL",7,"Alegeri Prezidentiale",1,839,385,348,37,0,379,6,912,527,146,233
19,GIURGIU,"MUNICIPIUL GIURGIU",100521,GIURGIU,"COLEGIUL TEHNIC VICEAMIRAL IOAN BĂLĂNESCU",8,"Alegeri Prezidentiale",1,989,457,430,26,1,447,10,987,530,191,256
19,GIURGIU,"MUNICIPIUL GIURGIU",100521,GIURGIU,"LICEUL ”NICOLAE CARTOJAN”",9,"Alegeri Prezidentiale",1,1236,522,483,39,0,517,5,1359,837,197,320
19,GIURGIU,"MUNICIPIUL GIURGIU",100521,GIURGIU,"LICEUL ”NICOLAE CARTOJAN”",10,"Alegeri Prezidentiale",1,1300,480,461,19,0,467,13,1429,949,156,311
19,GIURGIU,"MUNICIPIUL GIURGIU",100521,GIURGIU,"PALATUL COPIILOR (PARCUL ELEVILOR)",11,"Alegeri Prezidentiale",1,971,420,397,23,0,416,4,1067,647,127,289
19,GIURGIU,"MUNICIPIUL GIURGIU",100521,GIURGIU,"ŞCOALA GIMNAZIALĂ NR.3",12,"Alegeri Prezidentiale",1,1343,642,478,26,138,634,8,1476,834,186,448
19,GIURGIU,"MUNICIPIUL GIURGIU",100521,GIURGIU,"GRĂDINIŢA CU PROGRAM NORMAL NR.8 GORNENI",13,"Alegeri Prezidentiale",1,1298,657,514,23,120,648,9,1426,769,200,448
19,GIURGIU,"MUNICIPIUL GIURGIU",100521,GIURGIU,"DIRECŢIA PENTRU AGRICULTURĂ JUDEŢEANĂ",14,"Alegeri Prezidentiale",1,1360,484,350,20,114,474,10,1495,1011,113,361
19,GIURGIU,"MUNICIPIUL GIURGIU",100521,GIURGIU,"DIRECŢIA PENTRU AGRICULTURĂ JUDEŢEANĂ",15,"Alegeri Prezidentiale",1,1179,574,435,28,111,563,11,1299,725,187,376
19,GIURGIU,"MUNICIPIUL GIURGIU",100521,GIURGIU,"GRĂDINIŢA CU PN NR.8 CĂRĂMIDARI",16,"Alegeri Prezidentiale",1,1766,755,721,34,0,740,15,1941,1186,340,400
19,GIURGIU,"MUNICIPIUL GIURGIU",100521,GIURGIU,"A.J.O.F.M. GIURGIU",17,"Alegeri Prezidentiale",1,1568,730,699,31,0,707,23,1723,993,312,395
19,GIURGIU,"MUNICIPIUL GIURGIU",100521,GIURGIU,"A.J.O.F.M. GIURGIU",18,"Alegeri Prezidentiale",1,1095,555,531,24,0,537,18,1203,648,209,328
19,GIURGIU,"MUNICIPIUL GIURGIU",100521,GIURGIU,"SPITALUL JUDEŢEAN",19,"Alegeri Prezidentiale",1,1826,751,644,107,0,733,18,2007,1256,221,512
19,GIURGIU,"MUNICIPIUL GIURGIU",100521,GIURGIU,"CLUBUL CADRELOR MILITARE ÎN RETRAGERE",20,"Alegeri Prezidentiale",1,1583,692,650,35,7,678,14,1740,1048,289,389
19,GIURGIU,"MUNICIPIUL GIURGIU",100521,GIURGIU,"ŞCOALA GIMNAZIALĂ ACAD. MARIN VOICULESCU",21,"Alegeri Prezidentiale",1,1155,543,487,56,0,535,8,1269,726,210,325
19,GIURGIU,"MUNICIPIUL GIURGIU",100521,GIURGIU,"ŞCOALA GIMNAZIALĂ ACAD. MARIN VOICULESCU",22,"Alegeri Prezidentiale",1,1179,503,475,28,0,497,6,1296,793,210,287
19,GIURGIU,"MUNICIPIUL GIURGIU",100521,GIURGIU,"ŞCOALA GIMNAZIALĂ ACAD. MARIN VOICULESCU",23,"Alegeri Prezidentiale",1,1295,583,540,43,0,575,8,1423,840,246,329
19,GIURGIU,"MUNICIPIUL GIURGIU",100521,GIURGIU,"ŞCOALA GIMNAZIALĂ ACAD. MARIN VOICULESCU",24,"Alegeri Prezidentiale",1,1022,430,411,18,1,423,7,1123,693,166,257
19,GIURGIU,"MUNICIPIUL GIURGIU",100521,GIURGIU,"GRĂDINIŢA CU PROGRAM NORMAL NR.6",25,"Alegeri Prezidentiale",1,1269,549,529,20,0,538,11,1395,846,231,307
19,GIURGIU,"MUNICIPIUL GIURGIU",100521,GIURGIU,"ŞCOALA GIMNAZIALĂ NR.10",26,"Alegeri Prezidentiale",1,1077,461,424,37,0,454,7,1184,723,188,266
19,GIURGIU,"MUNICIPIUL GIURGIU",100521,GIURGIU,"ŞCOALA GIMNAZIALĂ NR.10",27,"Alegeri Prezidentiale",1,1082,421,403,18,0,415,6,1189,768,174,241
19,GIURGIU,"MUNICIPIUL GIURGIU",100521,GIURGIU,"ŞCOALA GIMNAZIALĂ NR.10",28,"Alegeri Prezidentiale",1,1117,450,426,24,0,436,14,1228,778,148,288
19,GIURGIU,"MUNICIPIUL GIURGIU",100521,GIURGIU,"ȘCOALA GIMNAZIALĂ NR.10",29,"Alegeri Prezidentiale",1,1175,490,457,33,0,475,15,1291,801,216,259
19,GIURGIU,"MUNICIPIUL GIURGIU",100521,GIURGIU,"ŞCOALA GIMNAZIALĂ NR,10",30,"Alegeri Prezidentiale",1,914,415,374,41,0,406,9,1004,589,156,250
19,GIURGIU,"MUNICIPIUL GIURGIU",100521,GIURGIU,"ŞCOALA GIMNAZIALĂ NR.5",31,"Alegeri Prezidentiale",1,908,390,371,19,0,380,10,998,608,160,220
19,GIURGIU,"MUNICIPIUL GIURGIU",100521,GIURGIU,"ŞCOALA GIMNAZIALĂ NR.5",32,"Alegeri Prezidentiale",1,1198,517,488,29,0,507,10,1316,799,185,322
19,GIURGIU,"MUNICIPIUL GIURGIU",100521,GIURGIU,"ŞCOALA GIMNAZIALĂ NR.5",33,"Alegeri Prezidentiale",1,1184,447,427,20,0,439,8,1301,854,169,270
19,GIURGIU,"MUNICIPIUL GIURGIU",100521,GIURGIU,"PUNCTUL TERMIC NR. 35",34,"Alegeri Prezidentiale",1,1251,532,508,24,0,522,10,1375,843,204,318
19,GIURGIU,"MUNICIPIUL GIURGIU",100521,GIURGIU,"PUNCTUL TERMIC NR.35",35,"Alegeri Prezidentiale",1,820,378,355,23,0,366,12,901,523,149,217
19,GIURGIU,"MUNICIPIUL GIURGIU",100521,GIURGIU,"GRĂDINIŢA CU PN NR.9",36,"Alegeri Prezidentiale",1,950,365,342,23,0,356,9,1044,679,143,213
19,GIURGIU,"MUNICIPIUL GIURGIU",100521,GIURGIU,"GRĂDINIŢA CU PP NR.9",37,"Alegeri Prezidentiale",1,1026,381,354,27,0,374,7,1128,747,143,231
19,GIURGIU,"MUNICIPIUL GIURGIU",100521,GIURGIU,"GRĂDINIŢA CĂSUŢA FERMECATĂ",38,"Alegeri Prezidentiale",1,1063,444,428,16,0,432,12,1168,724,151,281
19,GIURGIU,"MUNICIPIUL GIURGIU",100521,GIURGIU,"CANTINA DE AJUTOR SOCIAL",39,"Alegeri Prezidentiale",1,890,300,285,15,0,290,10,978,678,113,177
19,GIURGIU,"MUNICIPIUL GIURGIU",100521,GIURGIU,"ŞCOALA GIMNAZIALĂ SAVIN POPESCU",40,"Alegeri Prezidentiale",1,1443,657,612,45,0,647,10,1586,929,240,407
19,GIURGIU,"MUNICIPIUL GIURGIU",100521,GIURGIU,"ŞCOALA GIMNAZIALĂ SAVIN POPESCU",41,"Alegeri Prezidentiale",1,1126,428,408,20,0,418,10,1237,809,168,250
19,GIURGIU,"MUNICIPIUL GIURGIU",100521,GIURGIU,"LICEUL TEHNOLOGIC ION BARBU",42,"Alegeri Prezidentiale",1,1231,513,464,49,0,502,11,1353,840,208,294
19,GIURGIU,"MUNICIPIUL GIURGIU",100521,GIURGIU,"CASA ARMATEI",43,"Alegeri Prezidentiale",1,1125,487,466,20,1,474,13,1236,749,177,297
19,GIURGIU,"MUNICIPIUL GIURGIU",100521,GIURGIU,"COLEGIUL NAŢIONAL ”ION MAIORESCU”",44,"Alegeri Prezidentiale",1,939,547,490,57,0,536,11,1032,485,239,297
19,GIURGIU,"MUNICIPIUL GIURGIU",100521,GIURGIU,"COLEGIUL NAŢIONAL ”ION MAIORESCU”",45,"Alegeri Prezidentiale",1,1021,485,463,21,1,472,13,1122,637,180,292
19,GIURGIU,"MUNICIPIUL GIURGIU",100521,GIURGIU,"ŞCOALA GIMNAZIALĂ NR.7",46,"Alegeri Prezidentiale",1,1388,678,621,43,14,668,10,1526,848,287,381
19,GIURGIU,"MUNICIPIUL GIURGIU",100521,GIURGIU,"ŞCOALA GIMNAZIALĂ MIHAI EMINESCU",47,"Alegeri Prezidentiale",1,1366,691,625,66,0,674,17,1502,811,266,408
19,GIURGIU,"MUNICIPIUL GIURGIU",100521,GIURGIU,"GRĂDINIŢA CU PN NR.3",48,"Alegeri Prezidentiale",1,1294,610,581,28,1,605,5,1422,812,202,403
19,GIURGIU,"ORAŞ BOLINTIN-VALE",101190,BOLINTIN-VALE,"ŞCOALA GIMNAZIALĂ NR. 1 BOLINTIN-VALE",49,"Alegeri Prezidentiale",1,1178,765,632,127,6,750,15,1295,530,462,288
19,GIURGIU,"ORAŞ BOLINTIN-VALE",101190,BOLINTIN-VALE,"ŞCOALA GIMNAZIALĂ NR. 1 BOLINTIN-VALE",50,"Alegeri Prezidentiale",1,1383,517,454,55,8,511,6,1520,1003,168,343
19,GIURGIU,"ORAŞ BOLINTIN-VALE",101190,BOLINTIN-VALE,"ŞCOALA GIMNAZIALĂ NR. 1 BOLINTIN-VALE",51,"Alegeri Prezidentiale",1,1620,491,460,23,8,481,10,1781,1290,130,351
19,GIURGIU,"ORAŞ BOLINTIN-VALE",101190,BOLINTIN-VALE,"LICEU TEHNOLOGIC ”DIMITRIE BOLINTINEANU”",52,"Alegeri Prezidentiale",1,884,633,467,164,2,624,9,971,338,367,257
19,GIURGIU,"ORAŞ BOLINTIN-VALE",101190,BOLINTIN-VALE,PRIMĂRIE,53,"Alegeri Prezidentiale",1,1725,978,810,152,16,963,15,1896,918,554,409
19,GIURGIU,"ORAŞ BOLINTIN-VALE",101190,"MALU SPART","ŞCOALA GIMNAZIALĂ NR. 1 MALU SPART",54,"Alegeri Prezidentiale",2,1394,695,623,69,3,686,9,1532,837,396,290
19,GIURGIU,"ORAŞ BOLINTIN-VALE",101190,"MALU SPART","ŞCOALA GIMNAZIALĂ NR. 1 MALU SPART",55,"Alegeri Prezidentiale",1,1563,684,648,32,4,671,13,1718,1034,464,207
19,GIURGIU,"ORAŞ BOLINTIN-VALE",101190,CRIVINA,"GRĂDINIŢA CRIVINA",56,"Alegeri Prezidentiale",1,748,447,353,94,0,438,9,822,375,264,174
19,GIURGIU,"ORAŞ MIHĂILEŞTI",104136,MIHĂILEŞTI,"LICEUL TEHNOLOGIC TIU DUMITRESCU",57,"Alegeri Prezidentiale",1,1013,677,560,117,0,661,16,1113,436,409,252
19,GIURGIU,"ORAŞ MIHĂILEŞTI",104136,MIHĂILEŞTI,"LICEUL TEHNOLOGIC TIU DUMITRESCU",58,"Alegeri Prezidentiale",1,893,681,505,176,0,676,5,981,300,458,218
19,GIURGIU,"ORAŞ MIHĂILEŞTI",104136,MIHĂILEŞTI,"LICEUL TEHNOLOGIC TIU DUMITRESCU",59,"Alegeri Prezidentiale",1,936,642,524,118,0,630,12,1029,387,422,208
19,GIURGIU,"ORAŞ MIHĂILEŞTI",104136,MIHĂILEŞTI,"ŞCOALA PRIMARĂ NR. 1 MIHĂILEŞTI-TUFA",60,"Alegeri Prezidentiale",1,1106,938,627,311,0,919,19,1215,277,628,291
19,GIURGIU,"ORAŞ MIHĂILEŞTI",104136,MIHĂILEŞTI,"ŞCOALA PRIMARĂ NR. 2 MIHĂILEŞTI-DRĂGĂNESCU",61,"Alegeri Prezidentiale",1,362,292,235,57,0,290,2,397,105,183,107
19,GIURGIU,"ORAŞ MIHĂILEŞTI",104136,POPEŞTI,"ŞCOALA GIMNAZIALĂ NR. 1 POPEŞTI",62,"Alegeri Prezidentiale",1,859,575,455,120,0,565,10,943,368,360,205
19,GIURGIU,"ORAŞ MIHĂILEŞTI",104136,NOVACI,"ŞCOALA PRIMARĂ NR. 3 NOVACI",63,"Alegeri Prezidentiale",1,920,518,386,132,0,508,10,1011,493,320,188
19,GIURGIU,ADUNAŢII-COPĂCENI,100781,ADUNAŢII-COPĂCENI,"ŞCOALA GIMNAZIALĂ NR. 1 ADUNAŢII COPĂCENI",64,"Alegeri Prezidentiale",1,1565,850,695,155,0,835,15,1721,871,449,386
19,GIURGIU,ADUNAŢII-COPĂCENI,100781,ADUNAŢII-COPĂCENI,"ŞCOALA GIMNAZIALĂ NR. 1 ADUNAŢII COPĂCENI",65,"Alegeri Prezidentiale",1,1132,745,585,160,0,735,10,1244,499,366,369
19,GIURGIU,ADUNAŢII-COPĂCENI,100781,DĂRĂŞTI-VLAŞCA,"ŞCOALA GIMNAZIALĂ NR. 2 DĂRĂŞTI VLAŞCA",66,"Alegeri Prezidentiale",1,1629,771,578,193,0,760,11,1791,1020,331,429
19,GIURGIU,ADUNAŢII-COPĂCENI,100781,VARLAAM,"GRĂDINIȚA CU PROGRAM NORMAL NR. 3 VARLAAM",67,"Alegeri Prezidentiale",1,474,307,234,73,0,299,8,520,213,173,126
19,GIURGIU,ADUNAŢII-COPĂCENI,100781,MOGOŞEŞTI,"GRĂDINIȚA CU PROGRAM NORMAL NR. 4 MOGOŞEŞTI",68,"Alegeri Prezidentiale",1,377,274,194,80,0,270,4,414,140,159,111
19,GIURGIU,BĂNEASA,101001,BĂNEASA,"ŞCOALA GIMNAZIALA ”MARIN M. ȚICULESCU” BĂNEASA",69,"Alegeri Prezidentiale",1,1130,575,484,91,0,564,11,1242,667,240,324
19,GIURGIU,BĂNEASA,101001,BĂNEASA,"ŞCOALA PIMARĂ NR.5 BĂNEASA",70,"Alegeri Prezidentiale",1,557,274,215,59,0,266,8,612,338,110,156
19,GIURGIU,BĂNEASA,101001,BĂNEASA,"ŞCOALA PRIMARĂ NR.2 BĂNEASA",71,"Alegeri Prezidentiale",1,793,330,285,45,0,328,2,871,541,123,205
19,GIURGIU,BĂNEASA,101001,PIETRELE,"ŞCOALA GIMNAZIALĂ ”REMUS BEGNESCU” PIETRELE",72,"Alegeri Prezidentiale",1,862,402,332,70,0,400,2,947,545,172,228
19,GIURGIU,BĂNEASA,101001,FRASINU,"ŞCOALA PRIMARĂ NR. 3 FRASINU",73,"Alegeri Prezidentiale",1,338,198,132,66,0,196,2,371,173,80,116
19,GIURGIU,BĂNEASA,101001,"SFÂNTU GHEORGHE","ŞCOALA PRIMARĂ NR. 6 SF. GHEORGHE",74,"Alegeri Prezidentiale",1,210,142,95,47,0,140,2,230,88,50,90
19,GIURGIU,BOLINTIN-DEAL,101163,BOLINTIN-DEAL,"CĂMINUL CULTURAL BOLINTIN - DEAL",75,"Alegeri Prezidentiale",1,1393,855,573,249,33,842,13,1531,676,585,257
19,GIURGIU,BOLINTIN-DEAL,101163,BOLINTIN-DEAL,"ŞCOALA GIMNAZIALĂ BANU BALEANU",76,"Alegeri Prezidentiale",1,1191,605,471,134,0,598,7,1309,704,446,152
19,GIURGIU,BOLINTIN-DEAL,101163,BOLINTIN-DEAL,"GRĂDINIŢA DE COPII BOLINTIN - DEAL",77,"Alegeri Prezidentiale",1,990,469,362,107,0,457,12,1088,619,359,98
19,GIURGIU,BOLINTIN-DEAL,101163,"MIHAI VODĂ","ŞCOALA GIMNAZIALĂ NR. 2 MIHAI VODĂ",78,"Alegeri Prezidentiale",1,1586,914,731,182,1,903,11,1744,830,648,255
19,GIURGIU,BUCŞANI,101378,BUCŞANI,"ȘCOALA GIMNAZIALĂ NR. 1",79,"Alegeri Prezidentiale",1,780,325,265,60,0,319,6,1375,1050,178,141
19,GIURGIU,BUCŞANI,101378,"VADU LAT","ŞCOALA GIMNAZIALĂ NR. 2",80,"Alegeri Prezidentiale",1,542,302,211,72,19,297,5,595,293,141,156
19,GIURGIU,BUCŞANI,101378,PODIŞOR,"ŞCOALA PRIMARĂ NR. 3",81,"Alegeri Prezidentiale",1,443,228,195,33,0,225,3,486,258,112,113
19,GIURGIU,BUCŞANI,101378,OBEDENI,"GRĂDINIȚA CU PROGRAM NORMAL NR. 6",82,"Alegeri Prezidentiale",1,364,149,114,35,0,146,3,399,250,57,89
19,GIURGIU,BUCŞANI,101378,UIEŞTI,"ŞCOALA PRIMARĂ NR. 4",83,"Alegeri Prezidentiale",1,257,181,133,48,0,181,0,282,101,50,131
19,GIURGIU,BUCŞANI,101378,GOLEASCA,"ŞCOALA PRIMARĂ NR. 5",84,"Alegeri Prezidentiale",1,353,180,143,37,0,178,2,387,207,58,120
19,GIURGIU,BULBUCATA,101519,BULBUCATA,"CĂMINUL CULTURAL BULBUCATA",85,"Alegeri Prezidentiale",1,1073,1023,648,366,9,1013,10,1179,156,372,641
19,GIURGIU,BUTURUGENI,101617,BUTURUGENI,"ŞCOALA GIMNAZIALA NR1 BUTURUGENI",86,"Alegeri Prezidentiale",1,1025,722,574,132,16,713,9,1126,404,334,379
19,GIURGIU,BUTURUGENI,101617,BUTURUGENI,"CAMIN CULTURAL BUTURUGENI",87,"Alegeri Prezidentiale",1,599,444,378,57,9,441,3,658,214,187,254
19,GIURGIU,BUTURUGENI,101617,PĂDURENI,"ŞCOALA GIMNAZIALA NR 2 PĂDURENI",88,"Alegeri Prezidentiale",1,1186,779,641,132,6,767,12,1304,525,278,489
19,GIURGIU,BUTURUGENI,101617,POŞTA,"CLĂDIRE ADMINISTRATIVĂ",89,"Alegeri Prezidentiale",2,342,204,157,44,3,199,5,375,171,99,100
19,GIURGIU,CĂLUGĂRENI,101662,CĂLUGĂRENI,"ŞCOALA VECHE CĂLUGĂRENI( MUZEU ).",90,"Alegeri Prezidentiale",1,1454,1066,703,363,0,1038,28,1596,530,517,521
19,GIURGIU,CĂLUGĂRENI,101662,BRĂNIŞTARI,"GRADINITA BRĂNIŞTARI",91,"Alegeri Prezidentiale",1,585,486,272,214,0,478,8,642,156,202,276
19,GIURGIU,CĂLUGĂRENI,101662,UZUNU,"ŞCOALA GIMNAZIALA NR.3 UZUNU",92,"Alegeri Prezidentiale",1,1175,647,537,110,0,640,7,1291,644,339,301
19,GIURGIU,CĂLUGĂRENI,101662,HULUBEŞTI,"CĂMINUL CULTURAL HULUBEŞTI",93,"Alegeri Prezidentiale",1,1320,852,713,139,0,842,10,1448,596,413,429
19,GIURGIU,CLEJANI,101984,CLEJANI,"CĂMINUL CULTURAL CLEJANI",94,"Alegeri Prezidentiale",1,1332,1020,760,232,28,1007,13,1464,444,396,611
19,GIURGIU,CLEJANI,101984,NEAJLOVU,"GRĂDINIŢA CU PN NR.3 NEAJLOV",95,"Alegeri Prezidentiale",1,1119,982,747,218,17,974,8,1230,248,402,572
19,GIURGIU,COLIBAŞI,102071,COLIBAŞI,"ŞCOALA GIMNAZIALA NR. 1 COLIBAŞI",96,"Alegeri Prezidentiale",1,885,757,658,99,0,748,9,972,215,292,456
19,GIURGIU,COLIBAŞI,102071,COLIBAŞI,"ŞCOALA PRIMARA NR. 3 COLIBAŞI",97,"Alegeri Prezidentiale",1,724,637,553,84,0,630,7,795,158,294,336
19,GIURGIU,COLIBAŞI,102071,CÂMPURELU,"ŞCOALA GIMNAZIALA NR. 2 CÂMPURELU",98,"Alegeri Prezidentiale",1,1074,732,642,90,0,727,5,1180,448,329,398
19,GIURGIU,COMANA,102106,COMANA,"LICEUL TEHNOLOGIC NR. 1 COMANA",99,"Alegeri Prezidentiale",1,835,547,449,98,0,540,7,917,370,230,310
19,GIURGIU,COMANA,102106,COMANA,"LICEUL TEHNOLOGIC NR. 1 COMANA",100,"Alegeri Prezidentiale",1,875,622,462,160,0,614,8,961,339,237,377
19,GIURGIU,COMANA,102106,BUDENI,"GRADINITA CU PROGRAM NORMAL NR. 1 BUDENI",101,"Alegeri Prezidentiale",1,592,433,306,127,0,421,12,650,217,206,215
19,GIURGIU,COMANA,102106,FALAŞTOACA,"ŞCOALA GIMNAZIALA NR. 3 FALASTOACA",102,"Alegeri Prezidentiale",1,624,467,346,121,0,459,8,685,218,219,240
19,GIURGIU,COMANA,102106,GRĂDIŞTEA,"GRĂDINIŢA CU PROGRAM NORMAL GRĂDIŞTEA",103,"Alegeri Prezidentiale",1,1181,652,531,121,0,644,8,1298,646,275,369
19,GIURGIU,COMANA,102106,"VLAD ŢEPEŞ","ŞCOALA GIMNAZIALA NR. 1 VLAD-TEPES, CORP B",104,"Alegeri Prezidentiale",1,1283,799,683,116,0,787,12,1410,611,315,472
19,GIURGIU,COSOBA,179748,COSOBA,"GRĂDINIŢA DE COPII COSOBA",105,"Alegeri Prezidentiale",1,1079,462,398,64,0,457,5,1186,724,322,135
19,GIURGIU,COSOBA,179748,COSOBA,"GRĂDINIŢA DE COPII COSOBA",106,"Alegeri Prezidentiale",1,1078,473,418,55,0,466,7,1185,712,328,138
19,GIURGIU,"CREVEDIA MARE",102348,"CREVEDIA MARE","ŞCOALA GIMNAZIALĂ NICOLAE CREVEDIA",107,"Alegeri Prezidentiale",1,1190,691,552,139,0,680,11,1308,617,395,285
19,GIURGIU,"CREVEDIA MARE",102348,DEALU,"ŞCOALA PRIMARĂ NR 1 DEALU",108,"Alegeri Prezidentiale",1,1082,483,427,56,0,476,7,1189,706,263,213
19,GIURGIU,"CREVEDIA MARE",102348,"CREVEDIA MICĂ","ŞCOALA GIMNAZIALĂ DUMITRU PĂTRAȘCU",109,"Alegeri Prezidentiale",1,1525,796,696,100,0,787,9,1676,880,435,352
19,GIURGIU,DAIA,102446,DAIA,"CAMIN CULTURAL",110,"Alegeri Prezidentiale",1,518,381,289,89,3,379,2,569,188,66,313
19,GIURGIU,DAIA,102446,DAIA,"PRIMĂRIA COMUNEI DAIA",111,"Alegeri Prezidentiale",1,276,229,123,106,0,224,5,303,74,71,153
19,GIURGIU,DAIA,102446,PLOPŞORU,"GRADINIŢA CU PROGRAM NORMAL NR.2 PLOPŞORU",112,"Alegeri Prezidentiale",1,614,349,267,82,0,346,3,674,325,190,156
19,GIURGIU,DAIA,102446,PLOPŞORU,"GRĂDINIŢA CU PROGRAM NORMAL NR.3 PLOPŞORU",113,"Alegeri Prezidentiale",1,706,364,280,84,0,342,22,776,412,88,254
19,GIURGIU,FLOREŞTI-STOENEŞTI,102794,STOENEŞTI,"ŞCOALA GIMNAZIALĂ NR.2 STOENEŞTI",114,"Alegeri Prezidentiale",1,1567,746,620,125,1,734,12,1723,977,508,226
19,GIURGIU,FLOREŞTI-STOENEŞTI,102794,FLOREŞTI,"ŞCOALA GIMNAZIALĂ NR.1 FLOREŞTI",115,"Alegeri Prezidentiale",1,1150,586,511,75,0,579,7,1264,678,371,208
19,GIURGIU,FLOREŞTI-STOENEŞTI,102794,FLOREŞTI,"ŞCOALA GIMNAZIALĂ NR.1 FLOREŞTI",116,"Alegeri Prezidentiale",1,1017,524,457,67,0,519,5,1118,594,323,196
19,GIURGIU,FLOREŞTI-STOENEŞTI,102794,FLOREŞTI,"ŞCOALA GIMNAZIALĂ NR.1 FLOREŞTI",117,"Alegeri Prezidentiale",1,1197,587,549,38,0,579,8,1316,729,359,220
19,GIURGIU,FLOREŞTI-STOENEŞTI,102794,PALANCA,"ŞCOALA GIMNAZIALĂ NR.3 PALANCA",118,"Alegeri Prezidentiale",1,1205,659,598,61,0,657,2,1324,665,526,131
19,GIURGIU,FLOREŞTI-STOENEŞTI,102794,PALANCA,"ŞCOALA GIMNAZIALĂ NR.3 PALANCA",119,"Alegeri Prezidentiale",1,989,546,483,63,0,537,9,1087,541,454,83
19,GIURGIU,FRĂTEŞTI,102909,FRĂTEŞTI,"CĂMINUL CULTURAL FRĂTEŞTI",120,"Alegeri Prezidentiale",1,1400,552,480,72,0,544,8,1539,987,134,410
19,GIURGIU,FRĂTEŞTI,102909,FRĂTEŞTI,"ŞCOALA GIMNAZIALA NR.2 LUNCA FRĂTEŞTI",121,"Alegeri Prezidentiale",1,645,328,285,43,0,323,5,708,380,97,226
19,GIURGIU,FRĂTEŞTI,102909,REMUŞ,"CĂMINUL CULTURAL REMUŞ",122,"Alegeri Prezidentiale",1,1644,905,754,151,0,886,19,1807,902,421,465
19,GIURGIU,FRĂTEŞTI,102909,CETATEA,"GRADINITA CU PROGRAM NORMAL NR 3 CETATEA",123,"Alegeri Prezidentiale",1,397,203,147,56,0,197,6,436,233,45,152
19,GIURGIU,FRĂTEŞTI,102909,CETATEA,"GRADINITA CU PROGRAM NORMAL NR 4 CETATEA (BĂLĂNOAIA)",124,"Alegeri Prezidentiale",1,208,130,71,59,0,127,3,228,98,47,80
19,GIURGIU,GĂISENI,103087,GĂISENI,"ȘCOALA GIMNAZIALA NR. 1 SAT GĂISENI , COM GĂISENI .",125,"Alegeri Prezidentiale",1,988,486,430,51,5,483,3,1080,594,197,286
19,GIURGIU,GĂISENI,103087,GĂISENI,"ȘCOALA GIMNAZIALA NR. 1 SAT GĂISENI , COM GĂISENI ,",126,"Alegeri Prezidentiale",1,823,408,357,50,1,407,1,901,493,181,226
19,GIURGIU,GĂISENI,103087,CĂSCIOARELE,"ȘCOALA GIMNAZIALA NR. 2 , SAT CĂSCIOARELE COM GĂISENI",127,"Alegeri Prezidentiale",1,888,398,345,51,2,392,6,973,575,175,217
19,GIURGIU,GĂISENI,103087,CĂSCIOARELE,"ȘCOALA GIMNAZIALA NR. 2 SAT CĂSCIOARELE , COM GĂISENI",128,"Alegeri Prezidentiale",1,755,342,298,43,1,339,3,829,487,172,167
19,GIURGIU,GĂISENI,103087,CĂRPENIŞU,"ȘCOALA PRIMARĂ NR. 3 SAT CĂRPENIȘU , COM GĂISENI",129,"Alegeri Prezidentiale",1,680,372,323,49,0,362,10,737,365,134,228
19,GIURGIU,GĂISENI,103087,"PODU POPA NAE","FOSTA ŞCOALA CU CLASELE I-IV PODU POPA NAE",130,"Alegeri Prezidentiale",1,124,98,69,29,0,98,0,135,37,28,70
19,GIURGIU,GĂUJANI,103194,CETĂŢUIA,"ŞCOALA DIN CETĂTUIA",131,"Alegeri Prezidentiale",1,147,97,57,40,0,96,1,161,64,37,59
19,GIURGIU,GĂUJANI,103194,GĂUJANI,"ŞCOALA GIMNAZIALĂ ”DRĂGHICI DAVILA”",132,"Alegeri Prezidentiale",1,918,447,363,84,0,441,6,1004,557,165,276
19,GIURGIU,GĂUJANI,103194,PIETRIŞU,"GRĂDINIŢA CU PROGRAM NORMAL NR.1 PIETRIŞU",133,"Alegeri Prezidentiale",1,777,336,293,43,0,332,4,772,436,107,225
19,GIURGIU,GHIMPAŢI,103238,GHIMPAŢI,"SCOALA GIMNAZIALA NR.1GHIMPATI",134,"Alegeri Prezidentiale",1,1201,849,645,119,85,844,5,1320,471,282,562
19,GIURGIU,GHIMPAŢI,103238,GHIMPAŢI,"CLADIREA PRIMARIEI GHIMPATI",135,"Alegeri Prezidentiale",1,570,503,307,121,75,497,6,626,123,121,376
19,GIURGIU,GHIMPAŢI,103238,COPACIU,"GRĂDINIŢA CU PROGRAM NORMAL NR.5 COPACIU",136,"Alegeri Prezidentiale",2,721,512,371,69,72,505,7,792,280,151,354
19,GIURGIU,GHIMPAŢI,103238,NAIPU,"FOSTA ŞCOALA CU CLASELE I-VIII NAIPU",137,"Alegeri Prezidentiale",1,1260,865,590,186,89,861,4,1385,520,358,503
19,GIURGIU,GHIMPAŢI,103238,"VALEA PLOPILOR","ŞCOALA PRIMARA NR.4 VALEA PLOPILOR",138,"Alegeri Prezidentiale",1,523,285,199,44,42,281,4,574,289,112,169
19,GIURGIU,GOGOŞARI,103309,GOGOŞARI,"CĂMINUL CULTURAL GOGOŞARI",139,"Alegeri Prezidentiale",1,626,408,287,118,3,407,1,688,280,261,146
19,GIURGIU,GOGOŞARI,103309,RĂLEŞTI,"FOSTA ŞCOALA RĂLEŞTI",140,"Alegeri Prezidentiale",1,113,103,56,47,0,102,1,125,22,34,68
19,GIURGIU,GOGOŞARI,103309,DRĂGHICEANU,"FOSTA PRIMĂRIE",141,"Alegeri Prezidentiale",1,95,118,50,67,1,117,1,123,5,69,48
19,GIURGIU,GOGOŞARI,103309,IZVORU,"DISPENSAR UMAN IZVORU",142,"Alegeri Prezidentiale",1,530,322,258,61,3,317,5,562,240,174,143
19,GIURGIU,GOSTINARI,103372,GOSTINARI,"ŞCOALA GIMNAZIALĂ NR.1 GOSTINARI",143,"Alegeri Prezidentiale",1,1512,1011,800,149,62,1002,9,1662,651,416,586
19,GIURGIU,GOSTINARI,103372,MIRONEŞTI,"ŞCOALA PRIMARĂ NR.3 MIRONEŞTI",144,"Alegeri Prezidentiale",1,336,297,148,94,55,295,2,367,70,111,184
19,GIURGIU,GOSTINU,103354,GOSTINU,"SCOALA GIMNAZIALA ANGHEL MARES - LOCAL GRADINITA GOSTINU",145,"Alegeri Prezidentiale",1,725,477,387,63,27,472,5,793,316,145,327
19,GIURGIU,GOSTINU,103354,GOSTINU,"SCOALA GIMNAZIALA ANGHEL MARES- LOCAL GRADINITA GOSTINU",146,"Alegeri Prezidentiale",1,801,545,414,97,34,540,5,877,332,150,390
19,GIURGIU,GRĂDINARI,103407,GRĂDINARI,"ŞCOALA GIMNZIALA NR. 1 GRADINARI",147,"Alegeri Prezidentiale",1,837,495,358,123,14,482,13,917,422,246,236
19,GIURGIU,GRĂDINARI,103407,TÂNTAVA,"ŞCOALA GIMNAZIALA NR. 2 TÂNTAVA",148,"Alegeri Prezidentiale",1,999,503,358,105,40,500,3,1095,592,287,213
19,GIURGIU,GRĂDINARI,103407,ZORILE,"ŞCOALA PRIMARA NR. 3 ZORILE",149,"Alegeri Prezidentiale",1,860,502,416,86,0,492,10,942,440,236,256
19,GIURGIU,GREACA,103470,GREACA,"ŞCOALA GIMNAZIALĂ NR.1 GREACA",150,"Alegeri Prezidentiale",1,1364,845,692,151,2,837,8,1496,651,337,500
19,GIURGIU,GREACA,103470,"PUŢU GRECI","ŞCOALA PUŢU GRECI",151,"Alegeri Prezidentiale",1,263,160,140,20,0,160,0,285,125,62,98
19,GIURGIU,GREACA,103470,ZBOIU,"ŞCOALA ZBOIU",152,"Alegeri Prezidentiale",1,243,171,144,27,0,166,5,263,92,78,88
19,GIURGIU,HERĂŞTI,179757,HERĂŞTI,"ŞCOALA GIMNAZIALĂ ”ELINA BASARAB” HERĂŞTI",153,"Alegeri Prezidentiale",1,1723,958,721,237,0,944,14,1891,933,627,317
19,GIURGIU,HOTARELE,103639,HOTARELE,"LICEUL ”UDRISTE NASTUREL HOTARELE",154,"Alegeri Prezidentiale",1,1083,574,454,120,0,566,8,1138,564,297,269
19,GIURGIU,HOTARELE,103639,HOTARELE,"GRADINITA CU PROGRAM NORMAL NR. 2",155,"Alegeri Prezidentiale",1,572,369,275,94,0,363,6,625,256,169,194
19,GIURGIU,HOTARELE,103639,HOTARELE,"LICEUL ”UDRIŞTE NĂSTUREL”",156,"Alegeri Prezidentiale",1,618,329,242,87,0,323,6,676,347,152,171
19,GIURGIU,HOTARELE,103639,HOTARELE,"GRADINITA CU PROGRAM NORMAL NR. 3",157,"Alegeri Prezidentiale",1,586,352,263,89,0,351,1,641,289,180,171
19,GIURGIU,IEPUREŞTI,103693,IEPUREŞTI,"CĂMINUL CULTURAL IEPUREŞTI",158,"Alegeri Prezidentiale",1,820,648,423,225,0,637,11,898,250,265,372
19,GIURGIU,IEPUREŞTI,103693,GORNENI,"GRADINITA CU PROGRAM NORMAL NR. 2 GORNENI",159,"Alegeri Prezidentiale",1,515,376,252,124,0,373,3,562,186,152,221
19,GIURGIU,IEPUREŞTI,103693,STÂLPU,"ŞCOALA STÂLPU",160,"Alegeri Prezidentiale",1,203,162,104,58,0,161,1,219,57,69,92
19,GIURGIU,ISVOARELE,179766,ISVOARELE,"ŞCOALA GIMNAZIALĂ STOLNICUL CONSTANTIN CANTACUZINO - ISVOARELE",161,"Alegeri Prezidentiale",1,1090,618,486,132,0,609,9,1145,527,304,305
19,GIURGIU,ISVOARELE,179766,TEIUŞU,"ŞCOALA TEIUŞU",162,"Alegeri Prezidentiale",1,168,108,72,36,0,104,4,181,73,42,62
19,GIURGIU,IZVOARELE,103899,IZVOARELE,"ŞCOALA GIMNAZIALA NR.1 IZVOARELE",163,"Alegeri Prezidentiale",1,1013,598,458,91,49,590,8,1010,412,207,383
19,GIURGIU,IZVOARELE,103899,CHIRIACU,"ŞCOALA GIMNAZIALA NR.2 CHIRIACU",164,"Alegeri Prezidentiale",1,997,617,476,115,26,610,7,1093,476,241,369
19,GIURGIU,IZVOARELE,103899,"PETRU RAREŞ","ŞCOALA GENERALĂ PETRU RAREŞ",165,"Alegeri Prezidentiale",1,74,110,41,69,0,107,3,180,70,18,89
19,GIURGIU,IZVOARELE,103899,"VALEA BUJORULUI","GRADINITA CU PROGRAM NORMAL NR.3 VALEA BUJORULUI",166,"Alegeri Prezidentiale",1,385,282,200,74,8,280,2,419,137,166,114
19,GIURGIU,IZVOARELE,103899,"DIMITRIE CANTEMIR","SEDIUL FOSTEI SECŢII DE MECANIZARE A SATULUI DIMITRIE CANTEMIR",167,"Alegeri Prezidentiale",1,134,122,63,58,1,121,1,146,24,28,93
19,GIURGIU,IZVOARELE,103899,"RADU VODĂ","ŞCOALA GENERALĂ RADU VODĂ",168,"Alegeri Prezidentiale",1,168,172,103,61,8,172,0,184,12,45,127
19,GIURGIU,JOIŢA,103997,JOIŢA,PRIMĂRIE,169,"Alegeri Prezidentiale",1,1798,1089,725,364,0,1070,19,1974,885,814,256
19,GIURGIU,JOIŢA,103997,BÂCU,"ȘCOALA GIMNAZIALĂ NR. 2 BÎCU",170,"Alegeri Prezidentiale",1,1259,1091,597,494,0,1063,28,1381,290,753,310
19,GIURGIU,"LETCA NOUĂ",104047,"LETCA NOUĂ","CĂMINUL CULTURAL LETCA NOUĂ",171,"Alegeri Prezidentiale",1,718,459,330,128,1,452,7,786,327,130,322
19,GIURGIU,"LETCA NOUĂ",104047,"LETCA VECHE","CĂMINUL CULTURAL LETCA VECHE",172,"Alegeri Prezidentiale",1,744,407,304,95,8,403,4,817,410,122,281
19,GIURGIU,"LETCA NOUĂ",104047,MILCOVĂŢU,"ŞCOALA GIMNAZIALĂ NR 2 MILCOVĂŢU",173,"Alegeri Prezidentiale",1,1114,647,529,113,5,643,4,1221,574,175,468
19,GIURGIU,MALU,179739,MALU,"CĂMINUL CULTURAL MALU",174,"Alegeri Prezidentiale",1,919,421,342,79,0,419,2,1007,586,134,285
19,GIURGIU,MALU,179739,MALU,"GRĂDINIŢA MALU",175,"Alegeri Prezidentiale",1,864,433,359,74,0,428,5,949,516,168,260
19,GIURGIU,MÂRŞA,104225,MÂRŞA,"ŞCOALA GIMNAZIALĂ NR. 1 MÂRŞA",176,"Alegeri Prezidentiale",1,976,431,404,27,0,425,6,1070,639,173,252
19,GIURGIU,MÂRŞA,104225,MÂRŞA,"ŞCOALA GIMNAZIALĂ NR. 1 MÂRŞA",177,"Alegeri Prezidentiale",1,1218,592,520,72,0,584,8,1336,744,218,366
19,GIURGIU,"MIHAI BRAVU",104118,"MIHAI BRAVU","SCOALA GIMNAZIALA DUMITRU CONSTANTIN MIHAI BRAVU",178,"Alegeri Prezidentiale",1,1020,718,549,122,47,710,8,1118,400,222,488
19,GIURGIU,"MIHAI BRAVU",104118,"MIHAI BRAVU","SCOALA GIMNAZIALA DUMITRU CONSTANTIN MIHAI BRAVU",179,"Alegeri Prezidentiale",1,850,625,477,104,44,613,12,934,309,170,443
19,GIURGIU,OGREZENI,104485,OGREZENI,"ŞCOALA GIMNAZIALA ” SFANTUL NECTARIE” OGREZENI",180,"Alegeri Prezidentiale",1,963,585,460,125,0,581,4,1055,470,354,227
19,GIURGIU,OGREZENI,104485,OGREZENI,"ŞCOALA GIMNAZIALA ” AUREL SOLACOLU” OGREZENI",181,"Alegeri Prezidentiale",1,1260,669,554,115,0,660,9,1380,711,364,296
19,GIURGIU,OGREZENI,104485,OGREZENI,"GRĂDINIŢA ” IRIS” OGREZENI",182,"Alegeri Prezidentiale",1,805,501,406,95,0,498,3,884,383,314,184
19,GIURGIU,OGREZENI,104485,HOBAIA,"ŞCOALA PRIMARA NR.1 HOBAIA",183,"Alegeri Prezidentiale",1,741,362,306,56,0,362,0,814,452,197,165
19,GIURGIU,OINACU,104519,OINACU,"CĂMINUL CULTURAL OINACU",184,"Alegeri Prezidentiale",1,1436,804,670,134,0,781,23,1570,766,246,535
19,GIURGIU,OINACU,104519,BRANIŞTEA,"GRADINITA NR. 2 BRANISTEA",185,"Alegeri Prezidentiale",1,796,679,439,240,0,665,14,875,196,348,317
19,GIURGIU,OINACU,104519,COMASCA,"GRADINITA NR. 3 COMASCA",186,"Alegeri Prezidentiale",1,519,330,260,70,0,325,5,565,235,191,134
19,GIURGIU,PRUNDU,104680,PRUNDU,"CĂMINUL CULTURAL PRUNDU",187,"Alegeri Prezidentiale",1,1689,791,717,74,0,785,6,1854,1063,323,462
19,GIURGIU,PRUNDU,104680,PRUNDU,"ŞCOALA PRIMARĂ NR.1 PRUNDU",188,"Alegeri Prezidentiale",1,1075,503,455,48,0,495,8,1177,674,203,292
19,GIURGIU,PRUNDU,104680,PUIENI,"ŞCOALA PRIMARĂ NR.1 PUIENI",189,"Alegeri Prezidentiale",1,611,320,280,40,0,315,5,665,345,108,207
19,GIURGIU,PUTINEIU,104715,PUTINEIU,"CASA DE CULTURĂ PUTINEIU",190,"Alegeri Prezidentiale",1,979,760,598,162,0,753,7,1073,313,180,573
19,GIURGIU,PUTINEIU,104715,HODIVOAIA,"ŞCOALA HODIVOAIA",191,"Alegeri Prezidentiale",1,308,333,193,140,0,330,3,435,102,150,180
19,GIURGIU,PUTINEIU,104715,VIERU,"ŞCOALA VIERU",192,"Alegeri Prezidentiale",1,555,462,303,159,0,457,5,600,138,138,319
19,GIURGIU,RĂSUCENI,104788,RĂSUCENI,"ŞCOALA GIMNAZIALĂ ”CONSTANTIN STĂNCESCU”",193,"Alegeri Prezidentiale",1,776,516,344,105,67,510,6,853,337,132,378
19,GIURGIU,RĂSUCENI,104788,RĂSUCENI,"ŞCOALA GENERALĂ NR. 2 RĂSUCENI",194,"Alegeri Prezidentiale",1,294,223,136,65,22,223,0,319,96,90,133
19,GIURGIU,RĂSUCENI,104788,CUCURUZU,"ŞCOALA GIMNAZIALĂ NR.1 CUCURUZU",195,"Alegeri Prezidentiale",1,691,328,240,88,0,324,4,750,422,103,221
19,GIURGIU,"ROATA DE JOS",104831,"ROATA MICĂ","GRADINITA CU PROGRAM NORMAL NR. 1 ROATA MICA",196,"Alegeri Prezidentiale",1,408,210,179,31,0,206,4,444,234,75,131
19,GIURGIU,"ROATA DE JOS",104831,"ROATA DE JOS","GRĂDINIŢA CU PROGRAM NORMAL ROATA DE JOS",197,"Alegeri Prezidentiale",1,905,493,413,80,0,481,12,997,504,191,290
19,GIURGIU,"ROATA DE JOS",104831,CARTOJANI,"GRĂDINIŢA CU PROGRAM NORMAL CARTOJANI",198,"Alegeri Prezidentiale",2,783,315,282,33,0,314,1,860,545,145,169
19,GIURGIU,"ROATA DE JOS",104831,"ROATA DE JOS","ŞCOALA GIMNAZIALA NR. 1 ROATA DE JOS",199,"Alegeri Prezidentiale",1,986,489,438,51,0,485,4,1081,592,190,295
19,GIURGIU,"ROATA DE JOS",104831,SADINA,"ŞCOALA PRIMARA NR. 2 SADINA",200,"Alegeri Prezidentiale",1,1256,621,530,91,0,618,3,1375,754,208,410
19,GIURGIU,"ROATA DE JOS",104831,CARTOJANI,"ŞCOALA GIMNAZIALA NR. 2 CARTOJANI",201,"Alegeri Prezidentiale",1,1036,368,325,43,0,367,1,1136,768,137,230
19,GIURGIU,"ROATA DE JOS",104831,CARTOJANI,"ŞCOALA GIMNAZIALA NR. 2 CARTOJANI",202,"Alegeri Prezidentiale",1,1141,433,406,27,0,428,5,1250,817,198,230
19,GIURGIU,SĂBĂRENI,179775,SĂBĂRENI,"ŞCOALA GIMNAZIALA NR. 1 SABARENI",203,"Alegeri Prezidentiale",1,1071,775,492,282,1,761,14,1174,399,537,224
19,GIURGIU,SĂBĂRENI,179775,SĂBĂRENI,"ŞCOALA GIMNAZIALA NR. 1 SABARENI",204,"Alegeri Prezidentiale",1,1096,719,470,245,4,710,9,1200,481,496,214
19,GIURGIU,SCHITU,104975,SCHITU,"ŞCOALA SCHITU",205,"Alegeri Prezidentiale",1,180,150,103,43,4,147,3,197,47,36,111
19,GIURGIU,SCHITU,104975,BILA,"ŞCOALA PRIMARA FLORIN NICULESCU BILA",206,"Alegeri Prezidentiale",1,326,213,162,51,0,210,3,358,145,47,163
19,GIURGIU,SCHITU,104975,CĂMINEASCA,"ŞCOALA PRIMARA , NR.1 CAMINEASCA",207,"Alegeri Prezidentiale",2,415,296,204,77,15,292,4,455,159,64,228
19,GIURGIU,SCHITU,104975,VLAŞIN,"ŞCOALA GIMNAZIALA PROF. DINU NICOLAE VLASIN",208,"Alegeri Prezidentiale",1,372,291,221,50,20,287,4,408,117,84,203
19,GIURGIU,SINGURENI,105106,SINGURENI,"PRIMARIA SINGURENI",209,"Alegeri Prezidentiale",3,1176,742,510,198,34,730,12,1290,548,245,485
19,GIURGIU,SINGURENI,105106,CRÂNGURI,"ŞCOALA PRIMARĂ NR.2 CRÎNGURI",210,"Alegeri Prezidentiale",1,584,397,303,66,28,393,4,641,244,141,252
19,GIURGIU,SINGURENI,105106,STEJARU,"GRĂDINIŢA CU PROGRAM NORMAL NR. 3 STEJARU",211,"Alegeri Prezidentiale",1,594,473,363,85,25,469,4,652,179,94,375
19,GIURGIU,SLOBOZIA,100549,SLOBOZIA,"ŞCOALA GIMNAZIALĂ NR.1 SLOBOZIA",212,"Alegeri Prezidentiale",1,799,394,343,51,0,391,3,878,484,106,285
19,GIURGIU,SLOBOZIA,100549,SLOBOZIA,"GRĂDINIŢA DE COPII SLOBOZIA",213,"Alegeri Prezidentiale",1,1157,576,497,79,0,568,8,1268,692,171,397
19,GIURGIU,STĂNEŞTI,105295,STĂNEŞTI,"ȘCOALA GIMNAZIALĂ NR. 1 STĂNEȘTI",214,"Alegeri Prezidentiale",1,1040,648,460,167,21,634,14,890,242,394,240
19,GIURGIU,STĂNEŞTI,105295,GHIZDARU,"ŞCOALA PRIMARĂ NR. 2 GHIZDARU",215,"Alegeri Prezidentiale",1,417,283,186,91,6,280,3,458,175,124,156
19,GIURGIU,STĂNEŞTI,105295,BĂLANU,"GRĂDINIȚA CU PROGRAM NORMAL NR. 4 BĂLANU",216,"Alegeri Prezidentiale",1,413,374,166,194,14,372,2,452,78,155,217
19,GIURGIU,STĂNEŞTI,105295,ONCEŞTI,"GRĂDINIȚA CU PROGRAM NORMAL NR. 3 ONCEŞTI",217,"Alegeri Prezidentiale",1,274,474,136,331,7,461,13,550,76,138,323
19,GIURGIU,STOENEŞTI,105348,IANCULEŞTI,"ŞCOALA CU CLASELE I-IV IANCULEŞTI",218,"Alegeri Prezidentiale",1,218,179,141,33,5,176,3,239,60,53,123
19,GIURGIU,STOENEŞTI,105348,STOENEŞTI,"CĂMINUL CULTURAL STOENEŞTI",219,"Alegeri Prezidentiale",1,882,778,554,183,41,768,10,969,191,177,591
19,GIURGIU,STOENEŞTI,105348,STOENEŞTI,"GRĂDINIŢĂ CU PROGRAM NORMAL",220,"Alegeri Prezidentiale",1,358,322,205,102,15,321,1,393,71,82,239
19,GIURGIU,STOENEŞTI,105348,MIRĂU,"ŞCOALA CU CLASELE I-IV MIRĂU",221,"Alegeri Prezidentiale",1,122,121,69,46,6,121,0,133,12,19,102
19,GIURGIU,TOPORU,154709,TOPORU,"CĂMINUL CULTURAL TOPORU",222,"Alegeri Prezidentiale",1,954,675,468,131,76,670,5,1044,369,130,540
19,GIURGIU,TOPORU,154709,TOMULEŞTI,"ŞCOALA PRIMARA NR. 2 TOMULEŞTI",223,"Alegeri Prezidentiale",1,502,421,258,103,60,418,3,551,130,74,344
19,GIURGIU,ULMI,105623,ULMI,"SCOALA PRIMARA NR.3 ULMI",224,"Alegeri Prezidentiale",1,923,516,416,100,0,508,8,1010,494,358,150
19,GIURGIU,ULMI,105623,POENARI,"SCOALA GIMNAZIALA NR.1 POENARI",225,"Alegeri Prezidentiale",1,1125,693,550,143,0,684,9,1230,537,456,228
19,GIURGIU,ULMI,105623,TRESTIENI,"SCOALA GIMNAZIALA ”NICOLAE LAHOVARY",226,"Alegeri Prezidentiale",1,1015,575,472,103,0,567,8,1110,535,326,241
19,GIURGIU,ULMI,105623,TRESTIENI,"”SCOALA GIMNAZIALA ”NICOLAE LAHOVARY”",227,"Alegeri Prezidentiale",1,961,520,457,63,0,517,3,1053,533,297,220
19,GIURGIU,ULMI,105623,DRĂGĂNEASCA,"GRĂDINIŢA ”MARIN MOGESCU”",228,"Alegeri Prezidentiale",1,643,423,345,78,0,418,5,706,283,186,232
19,GIURGIU,ULMI,105623,ICOANA,"SCOALA PRIMARA NR.2 ICOANA",229,"Alegeri Prezidentiale",1,907,564,521,43,0,554,10,997,433,360,194
19,GIURGIU,ULMI,105623,GHIONEA,"GRADINITA NR.4 GHIONEA",230,"Alegeri Prezidentiale",1,474,339,240,99,0,337,2,520,181,221,116
19,GIURGIU,"VALEA DRAGULUI",105776,"VALEA DRAGULUI","SCOALA GIMNAZIALA NR.1 VALEA DRAGULUI",231,"Alegeri Prezidentiale",1,1251,719,609,110,0,711,8,1377,658,428,283
19,GIURGIU,"VALEA DRAGULUI",105776,"VALEA DRAGULUI","GRADINITA NR.2 VALEA DRAGULUI",232,"Alegeri Prezidentiale",1,1088,776,632,144,0,769,7,1193,417,415,354
19,GIURGIU,VĂRĂŞTI,105874,VĂRĂŞTI,"ȘCOALA GIMNAZIALĂ NR.1 VĂRĂȘTI",233,"Alegeri Prezidentiale",1,1006,710,587,118,5,702,8,1103,393,285,417
19,GIURGIU,VĂRĂŞTI,105874,VĂRĂŞTI,"ŞCOALA GIMNAZIALĂ NR.1 VĂRĂŞTI",234,"Alegeri Prezidentiale",1,868,649,539,108,2,641,8,951,302,222,419
19,GIURGIU,VĂRĂŞTI,105874,VĂRĂŞTI,"ŞCOALA PRIMARĂ NR.3 OBEDENI",235,"Alegeri Prezidentiale",1,914,630,530,97,3,623,7,1000,370,172,451
19,GIURGIU,VĂRĂŞTI,105874,DOBRENI,"ŞCOALA GIMNAZIALĂ NR.2 DOBRENI",236,"Alegeri Prezidentiale",1,1931,1031,875,156,0,1016,15,2118,1087,282,734
19,GIURGIU,"VÂNĂTORII MICI",105972,"VÂNĂTORII MICI","ŞCOALA GIMNAZIALĂ NR. 1 VÂNĂTORII MICI",237,"Alegeri Prezidentiale",1,796,402,321,81,0,399,3,875,473,177,222
19,GIURGIU,"VÂNĂTORII MICI",105972,IZVORU,"ŞCOALA GIMNAZIALĂ NR. 2 IZVORU",238,"Alegeri Prezidentiale",1,625,370,275,50,45,361,9,686,316,156,205
19,GIURGIU,"VÂNĂTORII MICI",105972,"VÂNĂTORII MARI","ŞCOALA GIMNAZIALĂ NR. 3 VÂNĂTORII MARI",239,"Alegeri Prezidentiale",1,919,513,424,89,0,512,1,1005,492,158,354
19,GIURGIU,"VÂNĂTORII MICI",105972,"POIANA LUI STÂNGĂ","ŞCOALA PRIMARĂ NR.5 POIANA LUI STÂNGĂ",240,"Alegeri Prezidentiale",1,562,309,258,51,0,306,3,617,308,170,136
19,GIURGIU,"VÂNĂTORII MICI",105972,CORBEANCA,"ŞCOALA PRIMARĂ NR.6 CORBEANCA",241,"Alegeri Prezidentiale",1,392,198,157,41,0,194,4,430,232,99,95
19,GIURGIU,"VÂNĂTORII MICI",105972,CUPELE,"ŞCOALA PRIMARĂ NR.7 CUPELE",242,"Alegeri Prezidentiale",1,359,238,204,34,0,234,4,394,156,68,166
19,GIURGIU,VEDEA,105909,VEDEA,"ŞCOALA JAPCA",243,"Alegeri Prezidentiale",1,646,295,229,65,1,294,1,710,415,105,189
19,GIURGIU,VEDEA,105909,VEDEA,"CĂMIN CULTURAL VEDEA",244,"Alegeri Prezidentiale",1,723,362,295,66,1,361,1,794,432,120,241
19,GIURGIU,VEDEA,105909,VEDEA,"ŞCOALA GIMNAZIALA ”APOSTOL ARSACHE” VEDEA",245,"Alegeri Prezidentiale",1,785,350,272,78,0,347,3,862,512,106,241
20,GORJ,"MUNICIPIUL TÂRGU JIU",77812,"TÂRGU JIU","UNIVERSITATEA „CONSTANTIN BRÂNCUȘI”",1,"Alegeri Prezidentiale",1,1376,864,657,88,119,844,20,1500,636,441,403
20,GORJ,"MUNICIPIUL TÂRGU JIU",77812,"TÂRGU JIU","COLEGIUL NAȚIONAL TUDOR VLADIMIRESCU",2,"Alegeri Prezidentiale",1,1119,670,568,102,0,656,14,1200,530,374,282
20,GORJ,"MUNICIPIUL TÂRGU JIU",77812,"TÂRGU JIU","COLEGIUL NAȚIONAL TUDOR VLADIMIRESCU",3,"Alegeri Prezidentiale",1,1143,654,585,69,0,648,6,1200,546,371,277
20,GORJ,"MUNICIPIUL TÂRGU JIU",77812,"TÂRGU JIU","ŞCOALA GIMNAZIALĂ CONSTANTIN SĂVOIU",4,"Alegeri Prezidentiale",1,1413,726,658,67,1,711,15,1500,774,428,283
20,GORJ,"MUNICIPIUL TÂRGU JIU",77812,"TÂRGU JIU","ŞCOALA GIMNAZIALĂ CONSTANTIN SĂVOIU",5,"Alegeri Prezidentiale",1,1199,592,525,67,0,577,15,1300,708,333,244
20,GORJ,"MUNICIPIUL TÂRGU JIU",77812,"TÂRGU JIU","COLEGIUL TEHNIC NR.2",6,"Alegeri Prezidentiale",2,1650,836,750,86,0,819,17,1800,964,482,337
20,GORJ,"MUNICIPIUL TÂRGU JIU",77812,ROMANEŞTI,"ȘCOALA PRIMARĂ DIN LOCALITATEA COMPONENTĂ ROMANEȘTI",7,"Alegeri Prezidentiale",1,737,369,341,28,0,359,10,800,431,188,171
20,GORJ,"MUNICIPIUL TÂRGU JIU",77812,"TÂRGU JIU","ŞCOALA GIMNAZIALĂ ALEXANDRU ŞTEFULESCU",8,"Alegeri Prezidentiale",1,1193,678,590,88,0,656,22,1300,622,351,305
20,GORJ,"MUNICIPIUL TÂRGU JIU",77812,"TÂRGU JIU","UNIVERSITATEA CONSTANTIN BRÂNCUŞI",9,"Alegeri Prezidentiale",1,1799,787,747,40,0,772,15,1900,1113,389,383
20,GORJ,"MUNICIPIUL TÂRGU JIU",77812,DRĂGOENI,"ŞCOALA PRIMARĂ DIN LOCALITATEA COMPONENTĂ DRĂGOENI",10,"Alegeri Prezidentiale",1,1492,728,687,41,0,710,18,1600,872,336,374
20,GORJ,"MUNICIPIUL TÂRGU JIU",77812,"TÂRGU JIU","COLEGIUL NAȚIONAL SPIRU HARET",11,"Alegeri Prezidentiale",1,1129,639,558,81,0,628,11,1200,561,352,276
20,GORJ,"MUNICIPIUL TÂRGU JIU",77812,"TÂRGU JIU","COLEGIUL NAŢIONAL SPIRU HARET",12,"Alegeri Prezidentiale",1,1074,538,478,59,1,525,13,1200,662,290,235
20,GORJ,"MUNICIPIUL TÂRGU JIU",77812,"TÂRGU JIU","COLEGIUL NAŢIONAL SPIRU HARET",13,"Alegeri Prezidentiale",1,1582,711,634,77,0,704,7,1700,989,417,287
20,GORJ,"MUNICIPIUL TÂRGU JIU",77812,"TÂRGU JIU","COLEGIUL NAŢIONAL SPIRU HARET",14,"Alegeri Prezidentiale",1,1481,623,566,57,0,603,20,1600,977,328,275
20,GORJ,"MUNICIPIUL TÂRGU JIU",77812,"TÂRGU JIU","COLEGIUL NAŢIONAL SPIRU HARET",15,"Alegeri Prezidentiale",1,1177,569,530,39,0,551,18,1300,731,307,244
20,GORJ,"MUNICIPIUL TÂRGU JIU",77812,"TÂRGU JIU","PALATUL COPIILOR",16,"Alegeri Prezidentiale",1,1063,536,483,53,0,526,10,1200,664,280,246
20,GORJ,"MUNICIPIUL TÂRGU JIU",77812,"TÂRGU JIU","LICEUL TEOLOGIC",17,"Alegeri Prezidentiale",1,1556,809,697,112,0,786,23,1700,891,454,332
20,GORJ,"MUNICIPIUL TÂRGU JIU",77812,"TÂRGU JIU","LICEUL TEOLOGIC",18,"Alegeri Prezidentiale",1,1465,627,521,53,53,610,17,1600,973,331,279
20,GORJ,"MUNICIPIUL TÂRGU JIU",77812,"TÂRGU JIU","LICEUL TEOLOGIC",19,"Alegeri Prezidentiale",1,1457,809,624,73,112,791,18,1600,791,414,377
20,GORJ,"MUNICIPIUL TÂRGU JIU",77812,"TÂRGU JIU","ŞCOALA GIMNAZIALĂ GHEORGHE TĂTĂRĂSCU",20,"Alegeri Prezidentiale",1,1570,645,605,40,0,628,17,1700,1055,344,284
20,GORJ,"MUNICIPIUL TÂRGU JIU",77812,"TÂRGU JIU","ŞCOALA GIMNAZIALĂ GHEORGHE TĂTĂRĂSCU",21,"Alegeri Prezidentiale",1,1607,781,734,47,0,759,22,1800,1019,374,385
20,GORJ,"MUNICIPIUL TÂRGU JIU",77812,"TÂRGU JIU","ŞCOALA GIMNAZIALĂ POMPILIU MARCEA",22,"Alegeri Prezidentiale",1,1710,738,630,108,0,721,17,1900,1162,412,309
20,GORJ,"MUNICIPIUL TÂRGU JIU",77812,"TÂRGU JIU","ŞCOALA GIMNAZIALĂ POMPILIU MARCEA",23,"Alegeri Prezidentiale",1,1728,731,693,38,0,707,24,1900,1169,383,324
20,GORJ,"MUNICIPIUL TÂRGU JIU",77812,"TÂRGU JIU","ŞCOALA GIMNAZIALĂ CONSTANTIN BRÂNCUŞI",24,"Alegeri Prezidentiale",1,1634,789,729,60,0,772,17,1800,1011,393,379
20,GORJ,"MUNICIPIUL TÂRGU JIU",77812,"TÂRGU JIU","ŞCOALA GIMNAZIALĂ CONSTANTIN BRÂNCUŞI",25,"Alegeri Prezidentiale",1,1633,729,682,47,0,711,18,1800,1071,370,341
20,GORJ,"MUNICIPIUL TÂRGU JIU",77812,"TÂRGU JIU","ŞCOALA GIMNAZIALĂ CONSTANTIN BRÂNCUŞI",26,"Alegeri Prezidentiale",1,1594,652,604,48,0,632,20,1700,1048,344,288
20,GORJ,"MUNICIPIUL TÂRGU JIU",77812,"TÂRGU JIU","ŞCOALA GIMNAZIALĂ CONSTANTIN BRÂNCUŞI",27,"Alegeri Prezidentiale",1,1512,604,571,33,0,588,16,1600,996,301,287
20,GORJ,"MUNICIPIUL TÂRGU JIU",77812,"TÂRGU JIU","COLEGIUL NAȚIONAL ECATERINA TEODOROIU",28,"Alegeri Prezidentiale",1,1407,674,583,91,0,657,17,1500,826,364,293
20,GORJ,"MUNICIPIUL TÂRGU JIU",77812,"TÂRGU JIU","COLEGIUL NAŢIONAL ECATERINA TEODOROIU",29,"Alegeri Prezidentiale",1,1537,669,608,61,0,646,23,1700,1031,343,303
20,GORJ,"MUNICIPIUL TÂRGU JIU",77812,"TÂRGU JIU","COLEGIUL NAŢIONAL ECATERINA TEODOROIU",30,"Alegeri Prezidentiale",1,1503,678,627,51,0,670,8,1700,1022,359,311
20,GORJ,"MUNICIPIUL TÂRGU JIU",77812,"TÂRGU JIU","LICEUL CU PROGRAM SPORTIV",31,"Alegeri Prezidentiale",1,1104,535,453,82,0,517,18,1200,665,275,242
20,GORJ,"MUNICIPIUL TÂRGU JIU",77812,"TÂRGU JIU","LICEUL CU PROGRAM SPORTIV",32,"Alegeri Prezidentiale",1,971,523,437,86,0,509,14,1100,577,266,243
20,GORJ,"MUNICIPIUL TÂRGU JIU",77812,"TÂRGU JIU","COLEGIUL ECONOMIC VIRGIL MADGEARU",33,"Alegeri Prezidentiale",1,1978,932,853,78,1,911,21,2200,1268,439,472
20,GORJ,"MUNICIPIUL TÂRGU JIU",77812,"TÂRGU JIU","COLEGIUL ECONOMIC VIRGIL MADGEARU",34,"Alegeri Prezidentiale",1,1794,987,901,85,1,960,27,1900,913,504,456
20,GORJ,"MUNICIPIUL TÂRGU JIU",77812,"TÂRGU JIU","LICEUL DE ARTE CONSTANTIN BRĂILOIU",35,"Alegeri Prezidentiale",1,1168,608,531,77,0,587,21,1300,692,317,270
20,GORJ,"MUNICIPIUL TÂRGU JIU",77812,"TÂRGU JIU","LICEUL DE ARTE CONSTANTIN BRĂILOIU",36,"Alegeri Prezidentiale",1,1682,877,827,50,0,857,20,1900,1023,471,386
20,GORJ,"MUNICIPIUL TÂRGU JIU",77812,"TÂRGU JIU","LICEUL DE ARTE CONSTANTIN BRĂILOIU",37,"Alegeri Prezidentiale",2,1374,587,550,37,0,569,18,1500,913,177,392
20,GORJ,"MUNICIPIUL TÂRGU JIU",77812,"TÂRGU JIU","LICEUL DE ARTE CONSTANTIN BRĂILOIU",38,"Alegeri Prezidentiale",1,958,449,418,31,0,438,11,1100,651,249,189
20,GORJ,"MUNICIPIUL TÂRGU JIU",77812,"TÂRGU JIU","CASA DE CULTURĂ A SINDICATELOR",39,"Alegeri Prezidentiale",1,1148,617,540,72,5,599,18,1303,686,328,271
20,GORJ,"MUNICIPIUL TÂRGU JIU",77812,"TÂRGU JIU","ŞCOALA GIMNAZIALĂ SFÂNTU NICOLAE",40,"Alegeri Prezidentiale",1,1741,1072,880,0,192,1055,17,1900,828,452,603
20,GORJ,"MUNICIPIUL TÂRGU JIU",77812,"TÂRGU JIU","ŞCOALA GIMNAZIALĂ SFÂNTU NICOLAE",41,"Alegeri Prezidentiale",1,767,437,318,118,1,432,5,800,363,228,204
20,GORJ,"MUNICIPIUL TÂRGU JIU",77812,"TÂRGU JIU","ŞCOALA GIMNAZIALĂ SFÂNTU NICOLAE",42,"Alegeri Prezidentiale",1,1285,645,593,50,2,634,11,1400,755,352,282
20,GORJ,"MUNICIPIUL TÂRGU JIU",77812,"TÂRGU JIU","ŞCOALA GENERALĂ ECATERINA TEODOROIU",43,"Alegeri Prezidentiale",1,1515,750,664,86,0,735,15,1700,950,404,331
20,GORJ,"MUNICIPIUL TÂRGU JIU",77812,"TÂRGU JIU","COLEGIUL TEHNIC ION MINCU",44,"Alegeri Prezidentiale",1,1741,776,734,42,0,760,16,1900,1124,457,303
20,GORJ,"MUNICIPIUL TÂRGU JIU",77812,"TÂRGU JIU","COLEGIUL TEHNIC ION MINCU",45,"Alegeri Prezidentiale",1,831,391,363,28,0,387,4,900,509,211,176
20,GORJ,"MUNICIPIUL TÂRGU JIU",77812,"TÂRGU JIU","COLEGIUL TEHNIC GENERAL GHEORGHE MAGHERU",46,"Alegeri Prezidentiale",1,1682,653,578,75,0,644,9,1900,1247,416,228
20,GORJ,"MUNICIPIUL TÂRGU JIU",77812,"TÂRGU JIU","COLEGIUL TEHNIC GENERAL GHEORGHE MAGHERU",47,"Alegeri Prezidentiale",1,1861,774,699,75,0,758,16,2000,1226,471,287
20,GORJ,"MUNICIPIUL TÂRGU JIU",77812,"TÂRGU JIU","ŞCOALA GIMNAZIALĂ NR.7",48,"Alegeri Prezidentiale",1,1706,811,738,73,0,786,25,1900,1089,402,384
20,GORJ,"MUNICIPIUL TÂRGU JIU",77812,"TÂRGU JIU","ŞCOALA GIMNAZIALĂ NR.7",49,"Alegeri Prezidentiale",1,1679,722,684,38,0,708,14,1800,1078,363,345
20,GORJ,"MUNICIPIUL TÂRGU JIU",77812,"TÂRGU JIU","ŞCOALA GIMNAZIALĂ VOIEVOD LITOVOI",50,"Alegeri Prezidentiale",1,1970,964,903,61,0,942,22,2100,1136,526,416
20,GORJ,"MUNICIPIUL TÂRGU JIU",77812,"TÂRGU JIU","ŞCOALA GIMNAZIALĂ VOIEVOD LITOVOI",51,"Alegeri Prezidentiale",1,1882,1064,1016,48,0,1047,17,2100,1036,413,634
20,GORJ,"MUNICIPIUL TÂRGU JIU",77812,"TÂRGU JIU","ŞCOALA GIMNAZIALĂ VOIEVOD LITOVOI",52,"Alegeri Prezidentiale",1,1851,831,793,38,0,810,21,2000,1169,387,423
20,GORJ,"MUNICIPIUL TÂRGU JIU",77812,BÂRSEŞTI,"ŞCOALA GIMNAZIALĂ NR.9",53,"Alegeri Prezidentiale",1,1504,798,731,67,0,778,20,1700,902,401,377
20,GORJ,"MUNICIPIUL TÂRGU JIU",77812,IEZURENI,"IMOBIL NR.42",54,"Alegeri Prezidentiale",1,737,371,348,23,0,368,3,800,429,174,194
20,GORJ,"MUNICIPIUL TÂRGU JIU",77812,URSAŢI,"ŞCOALA PRIMARĂ ŞI GRĂDINIŢA DE COPII URSAŢI",55,"Alegeri Prezidentiale",1,609,356,338,18,0,352,4,700,344,147,205
20,GORJ,"MUNICIPIUL TÂRGU JIU",77812,"TÂRGU JIU","COLEGIUL TEHNIC HENRI COANDĂ",56,"Alegeri Prezidentiale",1,817,417,380,37,0,400,17,900,483,233,167
20,GORJ,"MUNICIPIUL MOTRU",78141,MOTRU,"ŞCOALA GIMNAZIALĂ NR. 2 MOTRU",57,"Alegeri Prezidentiale",1,1471,594,553,41,0,585,9,1600,1006,303,282
20,GORJ,"MUNICIPIUL MOTRU",78141,MOTRU,"COLEGIUL TEHNIC MOTRU",58,"Alegeri Prezidentiale",1,1018,539,421,118,0,526,13,1018,479,247,279
20,GORJ,"MUNICIPIUL MOTRU",78141,MOTRU,"CASA DE CULTURĂ MOTRU",59,"Alegeri Prezidentiale",1,1725,835,705,130,0,802,33,1900,1065,473,329
20,GORJ,"MUNICIPIUL MOTRU",78141,MOTRU,"COLEGIUL NAŢIONAL GEORGE COŞBUC MOTRU",60,"Alegeri Prezidentiale",1,1506,629,569,58,2,613,16,1700,1071,330,283
20,GORJ,"MUNICIPIUL MOTRU",78141,MOTRU,"ŞCOALA GIMNAZIALĂ NR.1 MOTRU",61,"Alegeri Prezidentiale",1,1607,696,621,74,1,677,19,1800,1104,340,337
20,GORJ,"MUNICIPIUL MOTRU",78141,MOTRU,"GRĂDINIŢA ”VILE” MOTRU",62,"Alegeri Prezidentiale",1,1154,506,456,47,3,494,12,1300,794,277,217
20,GORJ,"MUNICIPIUL MOTRU",78141,MOTRU,"GRĂDINIŢA CATOLICĂ MOTRU",63,"Alegeri Prezidentiale",1,1689,703,667,36,0,694,9,1900,1197,355,339
20,GORJ,"MUNICIPIUL MOTRU",78141,MOTRU,"GRĂDINIŢA CREŞĂ NR.1 MOTRU",64,"Alegeri Prezidentiale",1,1778,818,685,51,82,796,22,2000,1182,374,422
20,GORJ,"MUNICIPIUL MOTRU",78141,MOTRU,"SEDIUL IMPOZITE ŞI TAXE LOCALE MOTRU",65,"Alegeri Prezidentiale",1,1683,772,683,89,0,752,20,1900,1128,387,365
20,GORJ,"MUNICIPIUL MOTRU",78141,MOTRU,"CASA MULTICULTURALĂ MOTRU",66,"Alegeri Prezidentiale",1,1695,728,656,71,1,710,18,1900,1172,376,334
20,GORJ,"MUNICIPIUL MOTRU",78141,LEURDA,"ŞCOALA LEURDA",67,"Alegeri Prezidentiale",1,656,323,307,16,0,316,7,700,377,117,199
20,GORJ,"MUNICIPIUL MOTRU",78141,HORĂŞTI,"ŞCOALA HORĂŞTI",68,"Alegeri Prezidentiale",1,414,213,204,9,0,213,0,500,287,110,103
20,GORJ,"MUNICIPIUL MOTRU",78141,PLOŞTINA,"ŞCOALA PRIMARĂ PLOŞTINA",69,"Alegeri Prezidentiale",1,1064,576,542,30,4,570,6,1200,624,260,310
20,GORJ,"MUNICIPIUL MOTRU",78141,ROŞIUŢA,"ŞCOALA PRIMARĂ ROŞIUŢA",70,"Alegeri Prezidentiale",1,474,258,239,18,1,255,3,500,242,115,140
20,GORJ,"MUNICIPIUL MOTRU",78141,RÂPA,"ŞCOALA RÂPA",71,"Alegeri Prezidentiale",1,272,152,141,11,0,147,5,300,148,59,88
20,GORJ,"ORAŞ BUMBEŞTI-JIU",79308,BUMBEŞTI-JIU,"SALA DE SPORT A ORAȘULUI",72,"Alegeri Prezidentiale",1,1047,529,428,54,47,519,10,1200,671,181,338
20,GORJ,"ORAŞ BUMBEŞTI-JIU",79308,BUMBEŞTI-JIU,"GRĂDINIȚA BUMBEȘTI-JIU",73,"Alegeri Prezidentiale",1,1112,487,444,43,0,473,14,1200,713,221,252
20,GORJ,"ORAŞ BUMBEŞTI-JIU",79308,BUMBEŞTI-JIU,"ȘCOALA GIMNAZIALĂ NR.1 BUMBEȘTI-JIU",74,"Alegeri Prezidentiale",1,1513,594,554,40,0,574,20,1700,1106,232,342
20,GORJ,"ORAŞ BUMBEŞTI-JIU",79308,BUMBEŞTI-JIU,"ȘCOALA GIMNAZIALĂ NR.1 BUMBEȘTI-JIU",75,"Alegeri Prezidentiale",1,946,409,355,54,0,395,14,1000,591,160,235
20,GORJ,"ORAŞ BUMBEŞTI-JIU",79308,BUMBEŞTI-JIU,"COLEGIUL MIHAI VITEAZUL BUMBEȘTI-JIU",76,"Alegeri Prezidentiale",1,970,449,411,38,0,446,3,1100,651,225,221
20,GORJ,"ORAŞ BUMBEŞTI-JIU",79308,BUMBEŞTI-JIU,"ȘCOALA PRIMARĂ BUMBEȘTI-JIU",77,"Alegeri Prezidentiale",1,898,471,432,39,0,460,11,1000,529,177,283
20,GORJ,"ORAŞ BUMBEŞTI-JIU",79308,TETILA,"ȘCOALA PRIMARĂ TETILA",78,"Alegeri Prezidentiale",1,1117,427,393,34,0,425,2,1200,773,161,264
20,GORJ,"ORAŞ BUMBEŞTI-JIU",79308,CURTIŞOARA,"ȘCOALA GIMNAZIALĂ CURTIȘOARA",79,"Alegeri Prezidentiale",1,575,327,261,66,0,325,2,600,273,128,197
20,GORJ,"ORAŞ NOVACI",78258,NOVACI,"ŞCOALA GIMNAZIALĂ NOVACI",80,"Alegeri Prezidentiale",1,1664,1063,839,190,34,1039,24,1800,737,639,400
20,GORJ,"ORAŞ NOVACI",78258,NOVACI,"CLUBUL ELEVILOR",81,"Alegeri Prezidentiale",1,1117,594,559,35,0,583,11,1200,606,407,176
20,GORJ,"ORAŞ NOVACI",78258,POCIOVALIŞTEA,"ŞCOALA GIMNAZIALĂ POCIOVALIŞTEA",82,"Alegeri Prezidentiale",1,1439,766,699,66,1,757,9,1600,834,438,319
20,GORJ,"ORAŞ NOVACI",78258,BERCEŞTI,"GRĂDINIŢA BERCEŞTI",83,"Alegeri Prezidentiale",1,544,329,287,42,0,325,4,600,271,185,140
20,GORJ,"ORAŞ ROVINARI",82895,ROVINARI,"ŞCOALA GIMNAZIALĂ NR. 1 ROVINARI",84,"Alegeri Prezidentiale",1,1369,552,468,84,0,540,12,1500,948,290,250
20,GORJ,"ORAŞ ROVINARI",82895,ROVINARI,"ŞCOALA GIMNAZIALĂ NR. 1 ROVINARI",85,"Alegeri Prezidentiale",1,1316,496,446,50,0,486,10,1500,1004,299,187
20,GORJ,"ORAŞ ROVINARI",82895,ROVINARI,"ŞCOALA GIMNAZIALĂ NR. 3 ROVINARI",86,"Alegeri Prezidentiale",1,1254,416,378,38,0,406,10,1400,984,236,170
20,GORJ,"ORAŞ ROVINARI",82895,ROVINARI,"ŞCOALA GIMNAZIALĂ NR. 3 ROVINARI",87,"Alegeri Prezidentiale",1,1263,458,424,34,0,449,9,1400,942,261,188
20,GORJ,"ORAŞ ROVINARI",82895,ROVINARI,"COLEGIUL ”GHEORGHE TĂTĂRESCU” ROVINARI",88,"Alegeri Prezidentiale",1,1238,499,390,56,53,488,11,1400,901,253,235
20,GORJ,"ORAŞ ROVINARI",82895,ROVINARI,"COLEGIUL ”GHEORGHE TĂTĂRESCU” ROVINARI",89,"Alegeri Prezidentiale",1,1143,447,395,52,0,439,8,1300,853,251,188
20,GORJ,"ORAŞ ROVINARI",82895,ROVINARI,"GRĂDINIŢA NR. 3 ROVINARI",90,"Alegeri Prezidentiale",1,1286,493,474,19,0,484,9,1400,907,275,209
20,GORJ,"ORAŞ ROVINARI",82895,ROVINARI,"GRĂDINIȚA NR. 3 ROVINARI",91,"Alegeri Prezidentiale",1,1268,419,385,34,0,407,12,1400,981,230,177
20,GORJ,"ORAŞ ROVINARI",82895,VÂRŢ,"GRĂDINIȚA CARTIER VÎRȚ",92,"Alegeri Prezidentiale",1,561,301,250,51,0,297,4,600,299,142,155
20,GORJ,"ORAŞ TÂRGU CĂRBUNEŞTI",78329,"TÂRGU CĂRBUNEŞTI","ŞCOALA GIMNAZIALĂ GEORGE USCĂTESCU",93,"Alegeri Prezidentiale",1,1348,679,529,150,0,670,9,1500,821,318,352
20,GORJ,"ORAŞ TÂRGU CĂRBUNEŞTI",78329,"TÂRGU CĂRBUNEŞTI","ȘCOALA GIMNAZIALĂ GEORGE USCĂTESCU",94,"Alegeri Prezidentiale",1,1338,526,475,51,0,519,7,1500,974,276,243
20,GORJ,"ORAŞ TÂRGU CĂRBUNEŞTI",78329,"TÂRGU CĂRBUNEŞTI","COLEGIU NAŢIONAL TUDOR ARGHEZI",95,"Alegeri Prezidentiale",1,1452,663,549,40,74,660,3,1600,937,285,375
20,GORJ,"ORAŞ TÂRGU CĂRBUNEŞTI",78329,CREŢEŞTI,"ŞCOALA GIMNAZIALĂ CREŢEŞTI",96,"Alegeri Prezidentiale",1,725,324,284,40,0,320,4,800,476,109,211
20,GORJ,"ORAŞ TÂRGU CĂRBUNEŞTI",78329,POJOGENI,"ŞCOALA GIMNAZIALĂ POJOGENI",97,"Alegeri Prezidentiale",1,601,313,254,57,2,307,6,700,387,123,184
20,GORJ,"ORAŞ TÂRGU CĂRBUNEŞTI",78329,ŞTEFĂNEŞTI,"ŞCOALA PRIMARĂ ŞTEFĂNEŞTI",98,"Alegeri Prezidentiale",1,442,239,205,34,0,236,3,500,261,77,159
20,GORJ,"ORAŞ TÂRGU CĂRBUNEŞTI",78329,CĂRBUNEŞTI-SAT,"CĂMIN CULTURAL",99,"Alegeri Prezidentiale",1,548,322,279,43,0,315,7,600,278,128,187
20,GORJ,"ORAŞ TÂRGU CĂRBUNEŞTI",78329,POJOGENI,"ŞCOALA PRIMARĂ POJOGENI CERĂT",100,"Alegeri Prezidentiale",1,247,152,115,37,0,152,0,300,148,32,120
20,GORJ,"ORAŞ TÂRGU CĂRBUNEŞTI",78329,COJANI,"ŞCOALA PRIMARĂ COJANI",101,"Alegeri Prezidentiale",1,337,183,150,33,0,183,0,400,217,86,97
20,GORJ,"ORAŞ TISMANA",82430,TISMANA,"GRADINITA CU PROGRAM NORMAL TISMANA",102,"Alegeri Prezidentiale",1,840,420,359,61,0,414,6,900,480,217,197
20,GORJ,"ORAŞ TISMANA",82430,TISMANA,"GRADINITA CU PROGRAM NORMAL TISMANA",103,"Alegeri Prezidentiale",1,960,452,382,70,0,436,16,1000,548,200,236
20,GORJ,"ORAŞ TISMANA",82430,CELEI,"SCOALA GENERALA CELEI",104,"Alegeri Prezidentiale",1,732,339,296,43,0,337,2,800,461,150,187
20,GORJ,"ORAŞ TISMANA",82430,TOPEŞTI,"SCOALA GENERALA TOPESTI",105,"Alegeri Prezidentiale",1,859,422,358,61,3,416,6,900,478,181,235
20,GORJ,"ORAŞ TISMANA",82430,POCRUIA,"SCOALA GENERALA POCRUIA",106,"Alegeri Prezidentiale",1,866,470,397,73,0,458,12,1000,530,248,210
20,GORJ,"ORAŞ TISMANA",82430,SOHODOL,"SCOALA GENERALA SOHODOL",107,"Alegeri Prezidentiale",1,721,319,296,23,0,315,4,800,481,158,157
20,GORJ,"ORAŞ TISMANA",82430,COSTENI,"SCOALA GENERALA COSTENI",108,"Alegeri Prezidentiale",1,901,377,333,44,0,371,6,1000,623,174,197
20,GORJ,"ORAŞ TURCENI",82617,TURCENI,"LICEUL TEHNOLOGIC TURCENI-CLĂDIREA INTERNAT",109,"Alegeri Prezidentiale",1,922,621,448,173,0,614,7,1000,379,244,370
20,GORJ,"ORAŞ TURCENI",82617,TURCENI,"LICEUL TEHNOLOGIC TURCENI-CLĂDIREA INTERNAT",110,"Alegeri Prezidentiale",1,1956,814,707,91,16,797,17,2100,1286,411,386
20,GORJ,"ORAŞ TURCENI",82617,TURCENI,"POLIȚIA LOCALĂ TURCENI",111,"Alegeri Prezidentiale",1,619,298,268,30,0,292,6,700,402,136,156
20,GORJ,"ORAŞ TURCENI",82617,TURCENI,"ȘCOALA GENERALĂ STOLOJANI",112,"Alegeri Prezidentiale",1,562,248,223,25,0,243,5,600,352,91,152
20,GORJ,"ORAŞ TURCENI",82617,MURGEŞTI,"ȘCOALA GENERALĂ MURGEȘTI",113,"Alegeri Prezidentiale",2,630,355,320,33,2,347,8,700,345,124,223
20,GORJ,"ORAŞ TURCENI",82617,GÂRBOVU,"ȘCOALA GENERALĂ GÂRBOVU",114,"Alegeri Prezidentiale",1,741,355,323,32,0,352,3,800,445,153,199
20,GORJ,"ORAŞ TURCENI",82617,STRÂMBA-JIU,"ȘCOALA GENERALĂ STRÂMBA JIU",115,"Alegeri Prezidentiale",1,1259,549,511,38,0,539,10,1400,851,269,270
20,GORJ,"ORAŞ ŢICLENI",78454,ŢICLENI,"GRĂDINIȚA NR. 2 TUNȘI",116,"Alegeri Prezidentiale",1,800,463,434,29,0,458,5,900,437,207,251
20,GORJ,"ORAŞ ŢICLENI",78454,ŢICLENI,"ȘCOALA GIMNAZIALĂ NR. 1 ȚICLENI",117,"Alegeri Prezidentiale",1,1052,583,517,66,0,578,5,1200,617,286,292
20,GORJ,"ORAŞ ŢICLENI",78454,ŢICLENI,"ȘCOALA GIMNAZIALĂ NR. 1 ȚICLENI",118,"Alegeri Prezidentiale",1,915,461,422,39,0,454,7,1000,539,239,215
20,GORJ,"ORAŞ ŢICLENI",78454,ŢICLENI,"GRĂDINIȚA NR. 3 RĂȘINA",119,"Alegeri Prezidentiale",1,1145,535,500,35,0,531,4,1300,765,241,290
20,GORJ,ALBENI,78472,ALBENI,"ȘCOALA GIMNAZIALĂ ALBENI",120,"Alegeri Prezidentiale",1,1066,585,509,76,0,580,5,1200,615,306,274
20,GORJ,ALBENI,78472,ALBENI,"ȘCOALA PRIMARÂ ALBENI",121,"Alegeri Prezidentiale",1,725,331,295,36,0,325,6,800,469,194,131
20,GORJ,ALBENI,78472,BOLBOCEŞTI,"ȘCOALA PRIMARÂ BOLBOCEȘTI",122,"Alegeri Prezidentiale",1,441,274,236,38,0,271,3,500,226,108,163
20,GORJ,ALBENI,78472,PRUNEŞTI,"ȘCOALA PRIMARÂ PRUNEȘTI",123,"Alegeri Prezidentiale",1,114,64,48,16,0,64,0,200,136,41,23
20,GORJ,ALIMPEŞTI,78542,ALIMPEŞTI,"ŞCOALA GENERALĂ ”ION LOTREANU ” ALIMPEŞTI, SAT. ALIMPEŞTI,",124,"Alegeri Prezidentiale",2,840,515,419,94,2,514,1,900,385,237,277
20,GORJ,ALIMPEŞTI,78542,ALIMPEŞTI,"ŞCOALA GENERALĂ SÎRBEŞTI , SAT.SÎRBEŞTI",125,"Alegeri Prezidentiale",1,642,419,345,74,0,413,6,700,281,217,196
20,GORJ,ANINOASA,78604,ANINOASA,"ŞCOALA GIMNAZIALĂ ANINOASA",126,"Alegeri Prezidentiale",1,1124,513,444,69,0,508,5,1200,687,210,298
20,GORJ,ANINOASA,78604,GROŞEREA,"ŞCOALA GIMNAZIALĂ GROȘEREA",127,"Alegeri Prezidentiale",1,477,257,207,50,0,254,3,500,243,101,153
20,GORJ,ANINOASA,78604,COSTEŞTI,"ŞCOALA PRIMARĂ COSTEȘTI",128,"Alegeri Prezidentiale",1,787,351,311,40,0,347,4,900,549,139,208
20,GORJ,ANINOASA,78604,STERPOAIA,"ŞCOALA PRIMARĂ NR.2 STERPOAIA",129,"Alegeri Prezidentiale",1,700,348,304,44,0,346,2,800,452,131,215
20,GORJ,ARCANI,78668,ARCANI,"ŞCOALA GIMNAZIALĂ ARCANI",130,"Alegeri Prezidentiale",1,1096,721,498,205,18,713,8,1200,479,357,356
20,GORJ,"BAIA DE FIER",78711,"BAIA DE FIER","ŞCOALA GENERALĂ BAIA DE FIER",131,"Alegeri Prezidentiale",1,1391,753,680,73,0,748,5,1500,747,364,384
20,GORJ,"BAIA DE FIER",78711,"BAIA DE FIER","ŞCOALA GENERALĂ BAIA DE FIER",132,"Alegeri Prezidentiale",1,1440,810,748,62,0,800,10,1600,790,328,472
20,GORJ,"BAIA DE FIER",78711,CERNĂDIA,"ŞCOALA GENERALĂ CERNĂDIA",133,"Alegeri Prezidentiale",1,672,366,312,54,0,361,5,700,334,211,150
20,GORJ,BĂLĂNEŞTI,78748,BĂLĂNEŞTI,"ȘCOALA PRIMARĂ BĂLANEȘTI",134,"Alegeri Prezidentiale",1,651,454,343,111,0,446,8,700,246,200,246
20,GORJ,BĂLĂNEŞTI,78748,"VOITEŞTII DIN VALE",PRIMĂRIE,135,"Alegeri Prezidentiale",1,515,463,298,161,4,451,12,600,137,125,326
20,GORJ,BĂLĂNEŞTI,78748,GLODENI,"ȘCOALA PRIMARĂ GLODENI",136,"Alegeri Prezidentiale",1,654,475,383,81,11,468,7,700,225,133,335
20,GORJ,BĂLEŞTI,77910,CORNEŞTI,"ŞCOALA PRIMARĂ CORNEŞTI",137,"Alegeri Prezidentiale",1,704,367,297,70,0,360,7,700,333,152,208
20,GORJ,BĂLEŞTI,77910,RASOVA,"ŞCOALA PRIMARĂ RASOVA",138,"Alegeri Prezidentiale",1,430,244,201,43,0,239,5,500,256,142,97
20,GORJ,BĂLEŞTI,77910,STOLOJANI,"ŞCOALA PRIMARĂ STOLOJANI",139,"Alegeri Prezidentiale",1,563,323,246,65,12,318,5,600,277,162,156
20,GORJ,BĂLEŞTI,77910,TĂLPĂŞEŞTI,"ŞCOALA PRIMARĂ TĂLPĂŞEŞTI",140,"Alegeri Prezidentiale",2,475,296,243,53,0,293,3,500,204,146,147
20,GORJ,BĂLEŞTI,77910,TĂMĂŞEŞTI,"ŞCOALA PRIMARĂ TĂMĂŞEŞTI",141,"Alegeri Prezidentiale",1,540,285,244,40,1,278,7,600,315,132,146
20,GORJ,BĂLEŞTI,77910,BĂLEŞTI,"CĂMIN CULTURAL BĂLEŞTI",142,"Alegeri Prezidentiale",1,1733,868,811,57,0,856,12,1900,1032,452,404
20,GORJ,BĂLEŞTI,77910,CEAURU,"ŞCOALA GIMNAZIALĂ ”ANTONIE MOGOŞ”",143,"Alegeri Prezidentiale",1,1919,921,863,58,0,897,24,2100,1179,409,488
20,GORJ,BĂRBĂTEŞTI,78828,BĂRBĂTEŞTI,"ŞCOALA GIMNAZIALĂ BĂRBĂTEŞTI",144,"Alegeri Prezidentiale",1,714,359,293,66,0,352,7,800,441,153,199
20,GORJ,BĂRBĂTEŞTI,78828,PETREŞTI,"ŞCOALA PRIMARĂ PETREŞTI",145,"Alegeri Prezidentiale",1,654,379,297,82,0,378,1,700,321,175,203
20,GORJ,BÂLTENI,79004,BÂLTENI,"ȘCOALA PRIMARĂ DINKĂ SKELERU",146,"Alegeri Prezidentiale",1,1654,760,698,62,0,749,11,1800,1040,413,336
20,GORJ,BÂLTENI,79004,PEŞTEANA-JIU,"ŞCOALA PRIMARĂ NR.2 PEŞTEANA-JIU",147,"Alegeri Prezidentiale",1,1768,774,716,58,0,766,8,1900,1126,364,402
20,GORJ,BÂLTENI,79004,MOI,"ŞCOALA GENERALĂ MOI",148,"Alegeri Prezidentiale",1,852,427,385,42,0,418,9,900,473,227,191
20,GORJ,BÂLTENI,79004,COCORENI,"ŞCOALA PRIMARĂ COCORENI",149,"Alegeri Prezidentiale",1,1067,472,442,30,0,468,4,1200,728,264,204
20,GORJ,BÂLTENI,79004,VLĂDULENI,"ȘCOALA PRIMARĂ VLĂDULENI",150,"Alegeri Prezidentiale",1,866,475,431,44,0,467,8,1000,525,262,205
20,GORJ,BENGEŞTI-CIOCADIA,78873,BENGEŞTI,"CĂMIN CULTURAL BENGEŞTI",151,"Alegeri Prezidentiale",1,965,435,354,81,0,426,9,1100,665,192,234
20,GORJ,BENGEŞTI-CIOCADIA,78873,BENGEŞTI,"CĂMIN CULTURAL BENGEŞTI",152,"Alegeri Prezidentiale",1,284,182,154,28,0,179,3,300,118,62,117
20,GORJ,BENGEŞTI-CIOCADIA,78873,BĂLCEŞTI,"CĂMIN CULTURAL BĂLCEŞTI",153,"Alegeri Prezidentiale",1,611,345,270,75,0,343,2,700,355,124,219
20,GORJ,BENGEŞTI-CIOCADIA,78873,CIOCADIA,"CĂMIN CULTURAL CIOCADIA",154,"Alegeri Prezidentiale",1,778,375,319,56,0,369,6,900,525,147,222
20,GORJ,BERLEŞTI,78926,BERLEŞTI,"ŞCOALA PRIMARĂ BERLEŞTI",155,"Alegeri Prezidentiale",1,692,380,317,63,0,379,1,800,420,199,180
20,GORJ,BERLEŞTI,78926,"PÂRÂU VIU","CĂMINUL CULTURAL PÎRÎU VIU",156,"Alegeri Prezidentiale",1,1004,579,473,106,0,573,6,1100,521,291,282
20,GORJ,BOLBOŞI,79077,BOLBOŞI,"ŞCOALA PRIMARĂ BOLBOŞI",157,"Alegeri Prezidentiale",1,909,450,384,66,0,443,7,1000,550,195,248
20,GORJ,BOLBOŞI,79077,BĂLĂCEŞTI,"ŞCOALA PRIMARĂ BĂLĂCEŞTI",158,"Alegeri Prezidentiale",1,540,246,232,14,0,241,5,600,354,121,120
20,GORJ,BOLBOŞI,79077,VALEA,"ŞCOALA GENERALĂ VALEA",159,"Alegeri Prezidentiale",2,1123,363,342,21,0,360,3,1200,837,172,188
20,GORJ,BORĂSCU,79157,BORĂSCU,"ŞCOALA GENERALĂ CU CLASELE I-IV BORĂSCU",160,"Alegeri Prezidentiale",1,943,450,396,54,0,444,6,1000,550,207,237
20,GORJ,BORĂSCU,79157,"MENŢII DIN DOS","ŞCOALA GENERALĂ CU CLASELE I-IV MENŢII DIN DOS",161,"Alegeri Prezidentiale",1,575,268,242,26,0,268,0,600,332,114,154
20,GORJ,BORĂSCU,79157,MILUTA,"ŞCOALA GIMNAZIALÂ MILUTA",162,"Alegeri Prezidentiale",1,495,176,149,26,1,176,0,500,324,78,98
20,GORJ,BORĂSCU,79157,CALAPĂRU,"ŞCOALA GENERALĂ CALAPĂRU",163,"Alegeri Prezidentiale",1,651,329,305,24,0,325,4,700,371,152,173
20,GORJ,BRĂNEŞTI,79237,"CAPU DEALULUI","ȘCOALA GIMNAZIALĂ CAPU-DEALULUI",164,"Alegeri Prezidentiale",1,645,393,331,62,0,389,4,700,307,162,227
20,GORJ,BRĂNEŞTI,79237,BRĂNEŞTI,"ȘCOALA PRIMARĂ BRĂNEȘTI",165,"Alegeri Prezidentiale",2,565,314,243,71,0,313,1,600,286,159,154
20,GORJ,BRĂNEŞTI,79237,PÂRÂU,"ȘCOALA PRIMARĂ GILORTU",166,"Alegeri Prezidentiale",1,474,202,166,35,1,201,1,500,298,84,117
20,GORJ,BRĂNEŞTI,79237,BĂDEŞTI,"ȘCOALA PRIMARĂ BĂDEȘTI",167,"Alegeri Prezidentiale",1,177,96,71,25,0,93,3,200,104,38,55
20,GORJ,BUMBEŞTI-PIŢIC,79362,BUMBEŞTI-PIŢIC,"CĂMINUL CULTURAL BUMBEŞTI-PIŢIC",168,"Alegeri Prezidentiale",1,1030,567,475,92,0,558,9,1100,533,260,298
20,GORJ,BUMBEŞTI-PIŢIC,79362,CÂRLIGEI,"GRĂDINIŢA CÂRLIGEI",169,"Alegeri Prezidentiale",1,175,137,80,57,0,136,1,200,63,75,61
20,GORJ,BUMBEŞTI-PIŢIC,79362,POIENARI,"ŞCOALA GENERALĂ POIENARI",170,"Alegeri Prezidentiale",1,566,362,294,68,0,358,4,600,238,183,175
20,GORJ,BUSTUCHIN,79406,BUSTUCHIN,"LICEUL TEHNOLOGIC BUSTUCHIN",171,"Alegeri Prezidentiale",1,906,375,345,30,0,372,3,1000,625,158,214
20,GORJ,BUSTUCHIN,79406,POIANA-SECIURI,"ŞCOALA GENERALĂ POIANA-SECIURI",172,"Alegeri Prezidentiale",1,740,296,261,35,0,293,3,800,504,109,184
20,GORJ,BUSTUCHIN,79406,"VALEA POJARULUI","ŞCOALA PRIMARĂ VALEA POJARULUI",173,"Alegeri Prezidentiale",1,337,190,163,27,0,189,1,400,210,92,97
20,GORJ,BUSTUCHIN,79406,POIENIŢA,"ŞCOALA PRIMARĂ POIENIŢA",174,"Alegeri Prezidentiale",1,311,179,150,29,0,177,2,300,121,32,145
20,GORJ,BUSTUCHIN,79406,POJARU,"ŞCOALA PRIMARĂ POJARU",175,"Alegeri Prezidentiale",1,403,163,138,25,0,161,2,400,237,65,96
20,GORJ,CĂPRENI,79497,CĂPRENI,"ŞCOALA GENERALĂ CĂPRENI",176,"Alegeri Prezidentiale",1,799,442,327,90,25,442,0,900,458,213,229
20,GORJ,CĂPRENI,79497,"SATU NOU","ŞCOALA PRIMARĂ CĂPRENI DE SUS",177,"Alegeri Prezidentiale",1,522,253,205,48,0,245,8,600,347,83,162
20,GORJ,CĂPRENI,79497,BULBUCENI,"ŞCOALA PRIMARĂ BULBUCENI",178,"Alegeri Prezidentiale",1,376,165,145,14,6,163,2,400,235,73,90
20,GORJ,CĂTUNELE,79585,"VALEA PERILOR","GRĂDINIȚA VALEA PERILOR",179,"Alegeri Prezidentiale",1,572,269,238,31,0,264,5,600,331,125,139
20,GORJ,CĂTUNELE,79585,"VALEA MÂNĂSTIRII","ȘCOALA GIMNAZIALA ”MAZILU VIPIE GHEORGHE”",180,"Alegeri Prezidentiale",1,358,216,193,23,0,212,4,400,184,83,129
20,GORJ,CĂTUNELE,79585,LUPOAIA,"CĂMINUL CULTURAL LUPOAIA",181,"Alegeri Prezidentiale",1,760,397,367,30,0,392,5,800,403,177,215
20,GORJ,CĂTUNELE,79585,"DEALU VIILOR","ȘCOALA PRIMARĂ DEALU VIILOR",182,"Alegeri Prezidentiale",1,484,241,200,41,0,238,3,500,259,94,144
20,GORJ,CÂLNIC,79736,CÂLNIC,"CĂMINUL CULTURAL CÎLNIC",183,"Alegeri Prezidentiale",2,665,530,393,117,20,522,8,700,170,344,178
20,GORJ,CÂLNIC,79736,"CÂLNICU DE SUS","ŞCOALA PRIMARĂ CÎLNICU DE SUS",184,"Alegeri Prezidentiale",1,657,392,318,61,13,389,3,700,308,234,155
20,GORJ,CÂLNIC,79736,HODOREASCA,"ŞCOALA PRIMARĂ HODOREASCA",185,"Alegeri Prezidentiale",1,329,246,182,49,15,244,2,400,154,145,99
20,GORJ,CÂLNIC,79736,PINOASA,"ŞCOALA PRIMARĂ PINOASA",186,"Alegeri Prezidentiale",1,189,133,94,34,5,132,1,200,67,75,57
20,GORJ,CIUPERCENI,79656,CIUPERCENI,"CĂMINUL CULTURAL CIUPERCENI",187,"Alegeri Prezidentiale",1,416,284,191,93,0,276,8,500,216,121,155
20,GORJ,CIUPERCENI,79656,STRÂMBA-VULCAN,"ŞCOALA PRIMARĂ STRÎMBA VULCAN",188,"Alegeri Prezidentiale",1,295,171,127,44,0,170,1,300,129,64,106
20,GORJ,CIUPERCENI,79656,VÂRTOPU,"ŞCOALA PRIMARĂ VÎRTOPU",189,"Alegeri Prezidentiale",1,322,215,152,63,0,215,0,400,185,113,102
20,GORJ,CIUPERCENI,79656,PEŞTEANA-VULCAN,"ŞCOALA PRIMARĂ PEŞTEANA VULCAN",190,"Alegeri Prezidentiale",1,258,169,121,48,0,168,1,300,131,56,112
20,GORJ,CRASNA,79834,CĂRPINIŞ,"CĂMINUL CULTURAL CĂRPINIŞ",191,"Alegeri Prezidentiale",1,1567,822,716,106,0,811,11,1700,878,418,393
20,GORJ,CRASNA,79834,DRĂGOIEŞTI,"ŞCOALA PRIMARĂ DRĂGOIEŞTI",192,"Alegeri Prezidentiale",1,1039,507,424,83,0,503,4,1100,593,282,221
20,GORJ,CRASNA,79834,DUMBRĂVENI,"CĂMINUL CULTURAL DUMBRĂVENI",193,"Alegeri Prezidentiale",1,711,430,341,89,0,426,4,800,370,200,226
20,GORJ,CRASNA,79834,"ANINIŞU DIN VALE","CĂMINUL CULTURAL ANINIŞ",194,"Alegeri Prezidentiale",1,771,396,355,41,0,389,7,800,404,184,205
20,GORJ,CRUŞEŢ,79932,CRUŞEȚ,"ȘCOALA PRIMARĂ CRUȘEȚ",195,"Alegeri Prezidentiale",1,1323,621,504,117,0,610,11,1500,879,289,321
20,GORJ,CRUŞEŢ,79932,MĂIAG,"CĂMINUL CULTURAL MĂIAG",196,"Alegeri Prezidentiale",1,631,294,237,57,0,287,7,700,406,99,188
20,GORJ,CRUŞEŢ,79932,SLĂVUŢA,"CĂMINUL CULTURAL SLĂVUȚA",197,"Alegeri Prezidentiale",1,498,249,194,55,0,249,0,600,351,131,118
20,GORJ,DĂNCIULEŞTI,80043,DĂNCIULEŞTI,"ŞCOALA GIMNAZIALĂ DĂNCIULEŞTI",198,"Alegeri Prezidentiale",1,646,390,277,107,6,390,0,700,310,188,202
20,GORJ,DĂNCIULEŞTI,80043,RĂDINEŞTI,"ŞCOALA GIMNAZIALĂ ”CORNELIUS RADU” RĂDINEŞTI",199,"Alegeri Prezidentiale",1,489,270,219,51,0,267,3,500,230,152,115
20,GORJ,DĂNCIULEŞTI,80043,OBÂRŞIA,"ȘCOALA GIMNAZIALĂ OBÂRȘIA",200,"Alegeri Prezidentiale",1,453,232,193,39,0,230,2,500,268,136,94
20,GORJ,DĂNEŞTI,80123,BRĂTUIA,"ŞCOALA PRIMARĂ BRĂTUIA",201,"Alegeri Prezidentiale",1,751,416,328,88,0,411,5,800,384,208,203
20,GORJ,DĂNEŞTI,80123,DĂNEŞTI,"ŞCOALA PRIMARĂ DĂNEȘTI",202,"Alegeri Prezidentiale",1,1135,704,542,162,0,699,5,1200,496,334,365
20,GORJ,DĂNEŞTI,80123,VĂCAREA,"ŞCOALA PRIMARĂ VĂCAREA",203,"Alegeri Prezidentiale",1,725,509,411,98,0,502,7,800,291,252,250
20,GORJ,DĂNEŞTI,80123,ŞASA,"ŞCOALA PRIMARĂ ȘASA",204,"Alegeri Prezidentiale",1,571,394,283,111,0,389,5,600,206,172,217
20,GORJ,DRĂGOTEŞTI,80249,DRĂGOTEŞTI,"CĂMINUL CULTURAL DRĂGOTEȘTI",205,"Alegeri Prezidentiale",1,985,505,446,57,2,499,6,1100,595,180,319
20,GORJ,DRĂGOTEŞTI,80249,COROBĂI,"ȘCOALA GENERALĂ COROBĂI",206,"Alegeri Prezidentiale",1,1106,524,494,30,0,519,5,1200,676,182,337
20,GORJ,DRĂGUŢEŞTI,78016,DRĂGUŢEŞTI,"ȘCOALA GENERALĂ DRĂGUȚEȘTI",207,"Alegeri Prezidentiale",1,897,630,481,149,0,624,6,1000,370,292,332
20,GORJ,DRĂGUŢEŞTI,78016,IAŞI-GORJ,"CĂMIN CULTURAL",208,"Alegeri Prezidentiale",1,839,656,442,214,0,644,12,900,244,283,361
20,GORJ,DRĂGUŢEŞTI,78016,URECHEŞTI,"ȘCOALA GENERALĂ URECHEȘTI",209,"Alegeri Prezidentiale",1,749,437,377,60,0,431,6,800,363,190,241
20,GORJ,DRĂGUŢEŞTI,78016,TÂLVEŞTI,"ȘCOALA PRIMARĂ TÎLVEȘTI",210,"Alegeri Prezidentiale",1,539,312,276,36,0,304,8,600,288,131,173
20,GORJ,DRĂGUŢEŞTI,78016,CÂRBEŞTI,"ȘCOALA GENERALĂ CÎRBEȘTI",211,"Alegeri Prezidentiale",1,1238,698,626,72,0,691,7,1400,702,306,385
20,GORJ,FĂRCĂŞEŞTI,80285,FĂRCĂŞEŞTI,"ŞCOALA PRIMARĂ FĂRCĂŞEŞTI",212,"Alegeri Prezidentiale",1,576,354,282,71,1,347,7,600,246,157,190
20,GORJ,FĂRCĂŞEŞTI,80285,ROŞIA-JIU,"LICEU ROŞIA JIU",213,"Alegeri Prezidentiale",1,649,481,352,125,4,477,4,700,219,256,221
20,GORJ,FĂRCĂŞEŞTI,80285,"PEŞTEANA DE JOS","GRĂDINIȚA PEȘTEANA DE JOS",214,"Alegeri Prezidentiale",1,660,430,369,54,7,423,7,700,270,206,217
20,GORJ,FĂRCĂŞEŞTI,80285,TIMIŞENI,"ŞCOALA PRIMARĂ TIMIŞENI",215,"Alegeri Prezidentiale",1,122,74,51,23,0,73,1,200,126,30,43
20,GORJ,FĂRCĂŞEŞTI,80285,"VALEA CU APĂ","ȘCOALA GENERALĂ VICTOR POPESCU",216,"Alegeri Prezidentiale",1,631,379,335,38,6,378,1,700,321,203,175
20,GORJ,GLOGOVA,80365,IORMĂNEŞTI,"PRIMARIA GLOGOVA",217,"Alegeri Prezidentiale",1,520,345,295,45,5,337,8,600,255,112,225
20,GORJ,GLOGOVA,80365,GLOGOVA,"ŞCOALA PRIMARĂ ÎNVĂŢĂTOR NICOLAE CARANDA",218,"Alegeri Prezidentiale",2,588,364,288,74,2,356,8,700,336,152,204
20,GORJ,GLOGOVA,80365,OLTEANU,"ŞCOALA PRIMARĂ OLTEANU",219,"Alegeri Prezidentiale",1,458,281,245,33,3,277,4,500,219,89,188
20,GORJ,GODINEŞTI,80427,GODINEŞTI,"PRIMĂRIA GODINEŞTI",220,"Alegeri Prezidentiale",1,880,474,384,90,0,464,10,1000,526,222,242
20,GORJ,GODINEŞTI,80427,CÂLCEŞTI,"ŞCOALA CÎLCEŞTI",221,"Alegeri Prezidentiale",1,248,160,92,68,0,156,4,300,140,64,92
20,GORJ,GODINEŞTI,80427,"PÂRÂU DE PRIPOR","ŞCOALA PRIMARĂ PÎRÎU DE PRIPOR",222,"Alegeri Prezidentiale",1,326,201,169,32,0,199,2,400,199,44,155
20,GORJ,GODINEŞTI,80427,"PÂRÂU DE VALE","ȘCOALA PÎRÎU DE VALE",223,"Alegeri Prezidentiale",1,166,137,92,45,0,136,1,200,63,38,98
20,GORJ,HUREZANI,80506,HUREZANI,"ŞCOALA GENERALĂ HUREZANI",224,"Alegeri Prezidentiale",1,1147,771,526,238,7,751,20,1300,529,415,336
20,GORJ,HUREZANI,80506,PLOPU,"ŞCOALA PRIMARĂ PLOPU",225,"Alegeri Prezidentiale",1,147,106,72,34,0,105,1,200,94,47,58
20,GORJ,IONEŞTI,80560,IONEŞTI,"ȘCOALA GIMNAZIALĂ IONEȘTI",226,"Alegeri Prezidentiale",1,955,479,430,49,0,472,7,1100,621,152,320
20,GORJ,IONEŞTI,80560,ILIEŞTI,"ȘCOALA PRIMARĂ ILIEȘTI",227,"Alegeri Prezidentiale",1,432,213,187,26,0,211,2,500,287,71,140
20,GORJ,IONEŞTI,80560,PICU,"ȘCOALA PRIMARĂ PICU",228,"Alegeri Prezidentiale",1,527,240,212,28,0,239,1,600,360,89,150
20,GORJ,JUPÂNEŞTI,80613,VIDIN,"ŞCOALA PRIMARĂ VIDIN",229,"Alegeri Prezidentiale",1,223,102,88,14,0,101,1,300,198,47,54
20,GORJ,JUPÂNEŞTI,80613,"PÂRÂU BOIA","ŞCOALA PRIMARĂ PÎRÎU-BOIA",230,"Alegeri Prezidentiale",1,281,127,109,18,0,124,3,300,173,48,76
20,GORJ,JUPÂNEŞTI,80613,JUPÂNEŞTI,"CĂMIN CULTURAL JUPÎNEŞTI",231,"Alegeri Prezidentiale",1,561,250,217,33,0,247,3,600,350,83,164
20,GORJ,JUPÂNEŞTI,80613,VIERŞANI,"SCOALA PRIMARĂ VIERŞANI",232,"Alegeri Prezidentiale",1,656,246,188,58,0,241,5,700,454,97,144
20,GORJ,LELEŞTI,80677,LELEŞTI,"ȘCOALA GENERALA ”ION GRIGOROIU” LELEȘTI",233,"Alegeri Prezidentiale",1,1035,632,519,113,0,619,13,1100,468,275,344
20,GORJ,LELEŞTI,80677,FRĂTEŞTI,"CĂMINUL CULTURAL FRĂTEȘTI",234,"Alegeri Prezidentiale",1,283,232,161,71,0,230,2,300,68,83,147
20,GORJ,LELEŞTI,80677,RASOVIŢA,"ȘCOALA PRIMARĂ RASOVIȚA",235,"Alegeri Prezidentiale",1,182,135,100,35,0,129,6,200,65,69,60
20,GORJ,LICURICI,80711,LICURICI,"ŞCOALA PRIMARĂ LICURICI",236,"Alegeri Prezidentiale",1,625,307,247,60,0,304,3,700,393,172,132
20,GORJ,LICURICI,80711,NEGRENI,"ŞCOALA GIMNAZIALĂ NEGRENI",237,"Alegeri Prezidentiale",1,549,315,246,69,0,312,3,600,285,182,130
20,GORJ,LICURICI,80711,TOTEA,"ŞCOALA GIMNAZIALĂ NR. 1 TOTEA",238,"Alegeri Prezidentiale",1,616,284,244,40,0,279,5,700,416,136,143
20,GORJ,LOGREŞTI,80766,FRUNZA,"CĂMIN CULTURAL FRUNZA",239,"Alegeri Prezidentiale",1,572,246,201,45,0,244,2,600,354,131,113
20,GORJ,LOGREŞTI,80766,"TÂRGU LOGREŞTI","CĂMIN CULTURAL TÎRGU LOGREȘTI",240,"Alegeri Prezidentiale",1,555,317,245,72,0,311,6,600,283,123,188
20,GORJ,LOGREŞTI,80766,LOGREŞTI-MOŞTENI,"ȘCOALA PRIMARĂ MOȘTENI",241,"Alegeri Prezidentiale",1,464,259,215,44,0,255,4,500,241,124,131
20,GORJ,LOGREŞTI,80766,MĂRU,"ȘCOALA PRIMARĂ MĂRU",242,"Alegeri Prezidentiale",1,292,177,136,41,0,174,3,300,123,72,102
20,GORJ,LOGREŞTI,80766,SEACA,"ȘCOALA PRIMARĂ SEACA",243,"Alegeri Prezidentiale",1,245,149,108,41,0,147,2,300,151,53,94
20,GORJ,MĂTĂSARI,80846,MĂTĂSARI,"GRĂDINIŢA MĂTĂSARI",244,"Alegeri Prezidentiale",1,972,362,326,36,0,360,2,1100,738,207,153
20,GORJ,MĂTĂSARI,80846,MĂTĂSARI,"GRĂDINIŢA MĂTĂSARI",245,"Alegeri Prezidentiale",1,1474,570,467,103,0,562,8,1600,1030,339,223
20,GORJ,MĂTĂSARI,80846,MĂTĂSARI,"ŞCOALA NR.2 MĂTĂSARI",246,"Alegeri Prezidentiale",2,562,319,271,48,0,314,5,600,281,163,151
20,GORJ,MĂTĂSARI,80846,BRĂDET,"ŞCOALA PRIMARĂ BRĂDET",247,"Alegeri Prezidentiale",1,750,354,326,28,0,345,9,800,446,196,149
20,GORJ,MĂTĂSARI,80846,CROICI,"ŞCOALA PRIMARĂ CROICI",248,"Alegeri Prezidentiale",1,280,139,130,9,0,135,4,300,161,53,82
20,GORJ,MUŞETEŞTI,80908,MUŞETEŞTI,"ȘCOALA GIMNAZIALĂ MUȘETEȘTI",249,"Alegeri Prezidentiale",1,716,447,374,68,5,440,7,800,353,161,279
20,GORJ,MUŞETEŞTI,80908,STĂNCEŞTI-LARGA,"ŞCOALA PRIMARĂ LARGA",250,"Alegeri Prezidentiale",1,463,275,225,50,0,274,1,500,225,136,138
20,GORJ,MUŞETEŞTI,80908,GRUI,"ŞCOLA PRIMARĂ GRUI",251,"Alegeri Prezidentiale",1,457,266,228,38,0,263,3,500,234,98,165
20,GORJ,NEGOMIR,80980,NEGOMIR,"ȘCOALA GIMNAZIALĂ NR.1 NEGOMIR",252,"Alegeri Prezidentiale",1,1097,646,567,79,0,635,11,1200,554,300,335
20,GORJ,NEGOMIR,80980,ARTANU,"ȘCOALA PRIMARĂ ARTANU",253,"Alegeri Prezidentiale",1,950,576,528,48,0,560,16,1000,424,246,314
20,GORJ,NEGOMIR,80980,CONDEIEŞTI,"ȘCOALA GIMNAZIALĂ RACI",254,"Alegeri Prezidentiale",1,814,508,455,53,0,501,7,900,392,183,318
20,GORJ,PADEŞ,81095,CĂLUGĂRENI,"CĂMIN CULTURAL CĂLUGĂRENI",255,"Alegeri Prezidentiale",1,914,437,401,36,0,431,6,1000,563,222,209
20,GORJ,PADEŞ,81095,PADEŞ,"ȘCOALA GIMNAZIALĂ PADEȘ",256,"Alegeri Prezidentiale",1,1285,567,504,63,0,559,8,1400,833,254,305
20,GORJ,PADEŞ,81095,"MOTRU SEC","ȘCOALA GIMNAZIALĂ MOTRU-SEC",257,"Alegeri Prezidentiale",1,1696,734,687,47,0,725,9,1900,1166,311,414
20,GORJ,PADEŞ,81095,CERNA-SAT,"ȘCOALA GENERALĂ CERNA SAT",258,"Alegeri Prezidentiale",1,50,60,21,39,0,60,0,100,40,36,24
20,GORJ,PEŞTIŞANI,81184,PEŞTIŞANI,"GRUP ȘCOLAR INDUSTRIAL MINIER CONSTANTIN BRÂNCUȘI",259,"Alegeri Prezidentiale",1,1356,846,687,155,4,830,16,1500,654,412,418
20,GORJ,PEŞTIŞANI,81184,PEŞTIŞANI,"ȘCOALA GIMNAZIALĂ PEȘTIȘANI",260,"Alegeri Prezidentiale",1,1294,794,649,143,2,783,11,1400,606,319,464
20,GORJ,PEŞTIŞANI,81184,BRĂDICENI,"ȘCOALA PRIMARĂ BRĂDICENI",261,"Alegeri Prezidentiale",1,507,404,296,106,2,401,3,600,196,139,262
20,GORJ,PLOPŞORU,81264,PLOPŞORU,"ȘCOALA GIMNAZIALĂ” NICOLAE TOMOVICI PLOPȘOR” PLOPȘORU",262,"Alegeri Prezidentiale",1,1928,972,862,94,16,959,13,2100,1128,465,494
20,GORJ,PLOPŞORU,81264,PISCURI,"ȘCOALA GIMNAZIALĂ PISCURI",263,"Alegeri Prezidentiale",1,1023,549,484,51,14,545,4,1100,551,168,377
20,GORJ,PLOPŞORU,81264,VĂLENI,"ȘCOALA PRIMARĂ VĂLENI",264,"Alegeri Prezidentiale",1,1519,670,614,43,13,659,11,1700,1030,305,354
20,GORJ,PLOPŞORU,81264,BROŞTENI,"ȘCOALA PRIMARĂ BROȘTENI",265,"Alegeri Prezidentiale",1,828,464,399,54,11,453,11,900,436,213,240
20,GORJ,POLOVRAGI,81380,POLOVRAGI,"ŞCOALA GIMNAZIALĂ NR.1 POLOVRAGI",266,"Alegeri Prezidentiale",1,944,521,463,58,0,508,13,1000,479,227,281
20,GORJ,POLOVRAGI,81380,POLOVRAGI,"ȘCOALA GIMNAZIALĂ NR.1 POLOVRAGI",267,"Alegeri Prezidentiale",1,920,530,467,62,1,517,13,1000,470,177,340
20,GORJ,POLOVRAGI,81380,RACOVIŢA,"ŞCOALA PRIMARĂ RACOVIȚA",268,"Alegeri Prezidentiale",1,370,247,200,47,0,243,4,400,153,82,161
20,GORJ,PRIGORIA,81415,PRIGORIA,"ŞCOALA GIMNAZIALĂ PRIGORIA",269,"Alegeri Prezidentiale",1,347,218,171,47,0,215,3,400,182,72,143
20,GORJ,PRIGORIA,81415,CĂLUGĂREASA,"ȘCOALA CU CLASELE I-IV CĂLUGAREASA",270,"Alegeri Prezidentiale",1,475,301,256,45,0,296,5,500,199,119,177
20,GORJ,PRIGORIA,81415,NEGOIEŞTI,"ȘCOALA CU CLASELE I-IV NEGOEȘTI",271,"Alegeri Prezidentiale",1,248,139,123,16,0,139,0,300,161,58,81
20,GORJ,PRIGORIA,81415,DOBRANA,"ȘCOALA CU CLASELE I-IV DOBRANA",272,"Alegeri Prezidentiale",1,313,200,164,36,0,200,0,400,200,119,81
20,GORJ,PRIGORIA,81415,BUCŞANA,"ȘCOALA CU CLASELE I-IV BUCȘANA",273,"Alegeri Prezidentiale",1,657,358,326,32,0,357,1,700,342,161,196
20,GORJ,PRIGORIA,81415,ZORLEŞTI,"ȘCOALA CU CLASELE I-IV ZORLEȘTI",274,"Alegeri Prezidentiale",1,346,204,167,37,0,204,0,400,196,76,128
20,GORJ,"ROŞIA DE AMARADIA",81497,"ROŞIA DE AMARADIA","CĂMINUL CULTURAL „IZVORUL”",275,"Alegeri Prezidentiale",1,1122,640,576,64,0,632,8,1200,560,317,315
20,GORJ,"ROŞIA DE AMARADIA",81497,SECIURILE,"ŞCOALA PRIMARĂ SECIURILE",276,"Alegeri Prezidentiale",1,579,245,226,19,0,244,1,600,355,134,110
20,GORJ,"ROŞIA DE AMARADIA",81497,RUGET,"ŞCOALA PRIMARĂ RUGET",277,"Alegeri Prezidentiale",1,475,241,215,26,0,238,3,500,259,133,105
20,GORJ,"ROŞIA DE AMARADIA",81497,ŞITOAIA,"GRĂDINIȚA ȘITOAIA",278,"Alegeri Prezidentiale",1,268,149,133,16,0,146,3,300,151,88,58
20,GORJ,RUNCU,81576,"VALEA MARE","CĂMINUL CULTURAL VALEA MARE",279,"Alegeri Prezidentiale",1,679,446,384,62,0,441,5,700,254,174,267
20,GORJ,RUNCU,81576,BÂLTA,"CĂMINUL CULTURAL BÎLTA",280,"Alegeri Prezidentiale",1,1392,890,786,104,0,876,14,1500,610,338,538
20,GORJ,RUNCU,81576,RUNCU,"ŞCOALA GENERALĂ RUNCU",281,"Alegeri Prezidentiale",2,1194,849,655,194,0,835,14,1300,451,366,469
20,GORJ,RUNCU,81576,DOBRIŢA,"CĂMINUL CULTURAL DOBRIŢA",282,"Alegeri Prezidentiale",1,785,529,419,97,13,521,8,900,371,169,352
20,GORJ,RUNCU,81576,SUSENI,"CENTRUL DE ÎNGRIJIRE ŞI ASISTENŢĂ SUSENI",283,"Alegeri Prezidentiale",2,239,294,106,60,128,292,2,300,6,105,187
20,GORJ,SAMARINEŞTI,81656,SAMARINEŞTI,"ŞCOALA GENERALĂ CU CLASELE V-VIII SAMARINEŞTI",284,"Alegeri Prezidentiale",1,1103,567,509,58,0,555,12,1200,633,224,331
20,GORJ,SAMARINEŞTI,81656,LARGA,"ŞCOALA PRIMARĂ LARGA",285,"Alegeri Prezidentiale",1,347,206,161,45,0,202,4,400,194,91,111
20,GORJ,SĂCELU,81754,SĂCELU,"ȘCOALA GENERALĂ SĂCELU",286,"Alegeri Prezidentiale",1,757,408,320,88,0,402,6,800,392,195,207
20,GORJ,SĂCELU,81754,SĂCELU,"ȘCOALA GENERALĂ SĂCELU",287,"Alegeri Prezidentiale",1,455,313,218,95,0,307,6,500,187,156,151
20,GORJ,SĂULEŞTI,81816,SĂULEŞTI,"ȘCOALA GIMNAZIALĂ SĂULEȘTI",288,"Alegeri Prezidentiale",1,1218,476,393,83,0,472,4,1300,824,218,254
20,GORJ,SĂULEŞTI,81816,BIBEŞTI,"ȘCOALA PRIMARĂ BIBEȘTI",289,"Alegeri Prezidentiale",1,624,295,232,63,0,289,6,700,405,123,166
20,GORJ,SCHELA,81987,SÂMBOTIN,"FOSTA ŞCOALA PRIMARĂ SÎMBOTIN",290,"Alegeri Prezidentiale",1,465,342,268,74,0,341,1,500,158,146,195
20,GORJ,SCHELA,81987,GORNĂCEL,"ȘCOALA PRIMARĂ CU CLASELE I - IV GORNĂCEL",291,"Alegeri Prezidentiale",1,474,236,218,18,0,233,3,500,264,113,120
20,GORJ,SCHELA,81987,SCHELA,"FOSTA ŞCOALĂ GENERALĂ CU CLASELE I - VIII SCHELA",292,"Alegeri Prezidentiale",1,501,278,229,49,0,276,2,600,322,127,149
20,GORJ,SCOARŢA,81861,BUDIENI,"ŞCOALA GENERALĂ BUDIENI",293,"Alegeri Prezidentiale",1,603,360,275,83,2,352,8,700,340,127,225
20,GORJ,SCOARŢA,81861,"PIŞTEŞTII DIN DEAL","ŞCOALA PRIMARĂ PIŞTEŞTII DIN DEAL",294,"Alegeri Prezidentiale",1,893,282,241,41,0,276,6,1000,718,86,190
20,GORJ,SCOARŢA,81861,COPĂCIOASA,"ŞCOALA PRIMARĂ COPĂCIOASA",295,"Alegeri Prezidentiale",1,718,423,343,79,1,417,6,800,377,159,258
20,GORJ,SCOARŢA,81861,SCOARŢA,"ȘCOALA GENERALĂ SCOARȚA",296,"Alegeri Prezidentiale",1,731,438,311,125,2,431,7,800,362,200,231
20,GORJ,SCOARŢA,81861,BOBU,"CĂMINUL CULTURAL BOBU",297,"Alegeri Prezidentiale",1,958,548,425,121,2,544,4,1000,452,247,297
20,GORJ,SLIVILEŞTI,82047,SLIVILEŞTI,"SALA MULTIFUNCȚIONALĂ",298,"Alegeri Prezidentiale",1,841,447,390,57,0,443,4,900,453,175,268
20,GORJ,SLIVILEŞTI,82047,STRÂMTU,"ȘCOALA PRIMARĂ STRÎMTU CU CLASELE I-IV",299,"Alegeri Prezidentiale",2,415,219,192,27,0,217,2,500,281,65,152
20,GORJ,SLIVILEŞTI,82047,MICULEŞTI,"SALA DE SPORT",300,"Alegeri Prezidentiale",1,757,446,386,60,0,439,7,800,354,179,260
20,GORJ,SLIVILEŞTI,82047,SURA,"ȘCOALA PRIMARĂ SURA CU CLASELE I-IV",301,"Alegeri Prezidentiale",1,593,289,239,50,0,287,2,700,411,88,199
20,GORJ,STĂNEŞTI,82136,STĂNEŞTI,"PRIMĂRIA STĂNEŞTI",302,"Alegeri Prezidentiale",1,1137,615,494,121,0,610,5,1200,585,308,302
20,GORJ,STĂNEŞTI,82136,CURPEN,"ŞCOALA GENERALĂ CURPEN",303,"Alegeri Prezidentiale",1,752,414,320,94,0,405,9,800,386,185,220
20,GORJ,STEJARI,82243,STEJARI,"CENTRUL CULTURAL ”GH.ZAMFIR”",304,"Alegeri Prezidentiale",1,838,392,304,88,0,388,4,900,508,221,167
20,GORJ,STEJARI,82243,PISCOIU,"CĂMINUL CULTURAL PISCOIU",305,"Alegeri Prezidentiale",1,690,299,256,43,0,296,3,800,501,146,150
20,GORJ,STEJARI,82243,BALOŞANI,"ŞCOALA PRIMARĂ BALOŞANI",306,"Alegeri Prezidentiale",1,419,199,151,48,0,197,2,500,301,78,119
20,GORJ,STOINA,82314,STOINA,"CĂMINUL CULTURAL STOINA",307,"Alegeri Prezidentiale",1,1196,659,523,136,0,653,6,1300,641,358,295
20,GORJ,STOINA,82314,PĂIŞANI,"ŞCOALA CU CLASELE I-IV PĂIŞANI",308,"Alegeri Prezidentiale",1,656,329,285,44,0,324,5,700,371,194,130
20,GORJ,TELEŞTI,82396,TELEŞTI,"CLĂDIREA DE LÂNGĂ SEDIUL PRIMĂRIEI COMUNEI TELEŞTI - SALA DE ŞEDINŢE A CONSILIULUI LOCAL TELEŞTI",309,"Alegeri Prezidentiale",1,507,306,237,69,0,299,7,600,294,130,169
20,GORJ,TELEŞTI,82396,TELEŞTI,"ŞCOALA PRIMARĂ TELEŞTI",310,"Alegeri Prezidentiale",1,542,333,260,73,0,327,6,600,267,135,192
20,GORJ,TELEŞTI,82396,BUDUHALA,"ŞCOALA PRIMARĂ NR.1 BUDUHALA",311,"Alegeri Prezidentiale",1,671,374,295,79,0,368,6,700,326,100,268
20,GORJ,TELEŞTI,82396,ŞOMĂNEŞTI,"ŞCOALA PRIMARĂ ŞOMĂNEŞTI",312,"Alegeri Prezidentiale",1,564,371,312,53,6,368,3,600,229,141,227
20,GORJ,TURBUREA,82555,TURBUREA,"ŞCOALA PRIMARĂ TURBUREA",313,"Alegeri Prezidentiale",1,440,294,236,51,7,288,6,500,206,99,189
20,GORJ,TURBUREA,82555,TURBUREA,"ŞCOALA GENERALĂ TURBUREA",314,"Alegeri Prezidentiale",1,742,408,349,55,4,399,9,800,392,168,231
20,GORJ,TURBUREA,82555,ŞIPOTU,"SPAȚIUL PUBLIC ȘIPOTU",315,"Alegeri Prezidentiale",1,709,488,389,91,8,482,6,800,312,156,326
20,GORJ,TURBUREA,82555,POIANA,"ŞCOALA GENERALĂ POIANA",316,"Alegeri Prezidentiale",1,1193,646,542,82,22,636,10,1300,654,191,445
20,GORJ,TURBUREA,82555,COCOROVA,"ŞCOALA PRIMARĂ COCOROVA",317,"Alegeri Prezidentiale",1,396,212,186,24,2,211,1,400,188,74,137
20,GORJ,TURCINEŞTI,78089,TURCINEŞTI,"ȘCOALA GIMNAZIALĂ GRIGORE GEAMĂNU",318,"Alegeri Prezidentiale",1,1311,850,687,163,0,835,15,1500,650,485,350
20,GORJ,TURCINEŞTI,78089,RUGI,"ȘCOALA PRIMARĂ RUGI",319,"Alegeri Prezidentiale",1,493,294,235,59,0,292,2,500,206,179,113
20,GORJ,ŢÂNŢĂRENI,82680,ŢÂNŢĂRENI,"ŞCOALA COORDONATOARE ŢÎNŢĂRENI",320,"Alegeri Prezidentiale",1,1891,840,765,75,0,816,24,2100,1260,341,475
20,GORJ,ŢÂNŢĂRENI,82680,FLOREŞTI,"ȘCOALA PRIMARĂ FLOREȘTI NR. 2",321,"Alegeri Prezidentiale",1,993,547,483,64,0,542,5,1100,553,258,284
20,GORJ,ŢÂNŢĂRENI,82680,FLOREŞTI,"ȘCOALA GENERALĂ FLOREȘTI NR. 1",322,"Alegeri Prezidentiale",1,1321,617,572,45,0,613,4,1400,783,254,359
20,GORJ,ŢÂNŢĂRENI,82680,CHICIORA,"ŞCOALA PRIMARĂ CHICIORA",323,"Alegeri Prezidentiale",1,252,124,93,31,0,124,0,300,176,61,63
20,GORJ,URDARI,82733,FÂNTÂNELE,"ŞCOALA GIMNAZIALĂ FÎNTÎNELE",324,"Alegeri Prezidentiale",1,784,493,417,76,0,482,11,900,407,246,236
20,GORJ,URDARI,82733,URDARI,"ŞCOALA GIMNAZIALĂ NR. 1 URDARI",325,"Alegeri Prezidentiale",1,1326,741,693,48,0,733,8,1500,759,323,410
20,GORJ,URDARI,82733,HOTĂROASA,"GRĂDINIŢA HOTĂROASA",326,"Alegeri Prezidentiale",1,457,240,210,30,0,236,4,500,260,133,103
20,GORJ,VĂGIULEŞTI,82779,VĂGIULEŞTI,"ŞCOALA GENERALĂ NR.1 VÂGIULEŞTI",327,"Alegeri Prezidentiale",1,1076,486,448,38,0,476,10,1200,714,195,281
20,GORJ,VĂGIULEŞTI,82779,COVRIGI,"CĂMINUL CULTURAL COVRIGI",328,"Alegeri Prezidentiale",1,987,462,381,81,0,457,5,1100,638,153,304
20,GORJ,VLADIMIR,82831,ANDREEŞTI,"ȘCOALA GIMNAZIALĂ NR 1 CORP B",329,"Alegeri Prezidentiale",1,846,386,311,75,0,384,2,900,514,214,170
20,GORJ,VLADIMIR,82831,VLADIMIR,"ŞCOALA PRIMARĂ NR 1 VLADIMIR",330,"Alegeri Prezidentiale",1,881,459,350,109,0,453,6,1000,541,213,240
20,GORJ,VLADIMIR,82831,FRASIN,"ŞCOALA PRIMARĂ NR. 2 FRASIN",331,"Alegeri Prezidentiale",1,555,256,202,54,0,255,1,613,357,131,124
21,HARGHITA,"MUNICIPIUL MIERCUREA-CIUC",83320,MIERCUREA-CIUC,"TEATRUL MUNICIPAL ”CSIKI JÁTÉKSZÍN” MIERCUREA-CIUC",1,"Alegeri Prezidentiale",2,1556,494,438,56,0,405,89,1700,1206,263,142
21,HARGHITA,"MUNICIPIUL MIERCUREA-CIUC",83320,MIERCUREA-CIUC,"LICEUL DE ARTE ”NAGY ISTVÁN” MIERCUREA-CIUC",2,"Alegeri Prezidentiale",1,1552,533,476,57,0,438,95,1700,1167,271,167
21,HARGHITA,"MUNICIPIUL MIERCUREA-CIUC",83320,MIERCUREA-CIUC,"CASA DE CULTURĂ A SINDICATELOR MIERCUREA-CIUC",3,"Alegeri Prezidentiale",1,1586,481,398,83,0,411,70,1700,1219,314,97
21,HARGHITA,"MUNICIPIUL MIERCUREA-CIUC",83320,MIERCUREA-CIUC,"ȘCOALA GIMNAZIALĂ ”NAGY IMRE” MIERCUREA-CIUC",4,"Alegeri Prezidentiale",1,1583,462,403,59,0,414,48,1700,1238,289,125
21,HARGHITA,"MUNICIPIUL MIERCUREA-CIUC",83320,MIERCUREA-CIUC,"ŞCOALA GIMNAZIALĂ „NAGY IMRE” MIERCUREA-CIUC",5,"Alegeri Prezidentiale",1,1638,418,394,24,0,363,55,1700,1282,241,122
21,HARGHITA,"MUNICIPIUL MIERCUREA-CIUC",83320,MIERCUREA-CIUC,"ȘCOALA GIMNAZIALĂ ”NAGY IMRE”",6,"Alegeri Prezidentiale",1,1682,456,437,19,0,403,53,1800,1344,301,102
21,HARGHITA,"MUNICIPIUL MIERCUREA-CIUC",83320,MIERCUREA-CIUC,"ȘCOALA GIMNAZIALĂ ”PETŐFI SÁNDOR” MIERCUREA-CIUC",7,"Alegeri Prezidentiale",1,1433,351,316,35,0,289,62,1600,1249,196,93
21,HARGHITA,"MUNICIPIUL MIERCUREA-CIUC",83320,MIERCUREA-CIUC,"ȘCOALA GIMNAZIALĂ ”PETŐFI SÁNDOR” MIERCUREA-CIUC",8,"Alegeri Prezidentiale",1,1454,389,347,42,0,342,47,1600,1211,236,106
21,HARGHITA,"MUNICIPIUL MIERCUREA-CIUC",83320,MIERCUREA-CIUC,"ȘCOALA GIMNAZIALĂ ”LIVIU REBREANU” MIERCUREA-CIUC",9,"Alegeri Prezidentiale",1,1591,522,413,55,54,463,59,1700,1178,340,123
21,HARGHITA,"MUNICIPIUL MIERCUREA-CIUC",83320,MIERCUREA-CIUC,"GRĂDINIŢA „NAPRAFORGÓ” MIERCUREA-CIUC",10,"Alegeri Prezidentiale",1,1485,467,410,57,0,410,57,1600,1133,290,120
21,HARGHITA,"MUNICIPIUL MIERCUREA-CIUC",83320,MIERCUREA-CIUC,"S.C. GOSCOM S.A MIERCUREA-CIUC",11,"Alegeri Prezidentiale",1,1550,282,258,24,0,259,23,1700,1418,202,57
21,HARGHITA,"MUNICIPIUL MIERCUREA-CIUC",83320,MIERCUREA-CIUC,"ȘCOALA GIMNAZIALĂ ”JÓZSEF ATTILA” MIERCUREA-CIUC",12,"Alegeri Prezidentiale",1,1442,584,394,63,127,520,64,1700,1116,260,260
21,HARGHITA,"MUNICIPIUL MIERCUREA-CIUC",83320,MIERCUREA-CIUC,"ȘCOALA GIMNAZIALĂ ”JÓZSEF ATTILA” MIERCUREA-CIUC",13,"Alegeri Prezidentiale",1,1517,413,386,25,2,357,56,1700,1287,247,110
21,HARGHITA,"MUNICIPIUL MIERCUREA-CIUC",83320,MIERCUREA-CIUC,"ȘCOALA GIMNAZIALĂ ”JÓZSEF ATTILA” MIERCUREA-CIUC",14,"Alegeri Prezidentiale",1,1667,462,429,33,0,428,34,1800,1338,298,130
21,HARGHITA,"MUNICIPIUL MIERCUREA-CIUC",83320,MIERCUREA-CIUC,"SALA DE SPORT A ȘCOLII GIMNAZIALE ”JÓZSEF ATTILA” MIERCUREA-CIUC",15,"Alegeri Prezidentiale",1,1645,572,436,58,78,519,53,1700,1128,348,171
21,HARGHITA,"MUNICIPIUL MIERCUREA-CIUC",83320,MIERCUREA-CIUC,"SALA DE SPORT A ȘCOLII GIMNAZILAE ”JÓZSEF ATTILA” MIERCUREA-CIUC",16,"Alegeri Prezidentiale",1,1544,488,444,44,0,440,48,1700,1212,295,145
21,HARGHITA,"MUNICIPIUL MIERCUREA-CIUC",83320,MIERCUREA-CIUC,"GRĂDINIŢA ”ARANYALMA” MIERCUREA-CIUC",17,"Alegeri Prezidentiale",1,1677,409,358,51,0,379,30,1800,1391,286,93
21,HARGHITA,"MUNICIPIUL MIERCUREA-CIUC",83320,MIERCUREA-CIUC,"LICEUL TEHNOLIGIC ”SZÉKELY KÁROLY” MIERCUREA-CIUC",18,"Alegeri Prezidentiale",1,1466,355,320,35,0,310,45,1600,1245,233,77
21,HARGHITA,"MUNICIPIUL MIERCUREA-CIUC",83320,MIERCUREA-CIUC,"LICEUL TEHNOLIGIC ”SZÉKELY KÁROLY” MIERCUREA-CIUC",19,"Alegeri Prezidentiale",1,1464,373,345,27,1,295,78,1600,1227,231,64
21,HARGHITA,"MUNICIPIUL MIERCUREA-CIUC",83320,MIERCUREA-CIUC,"ŞCOALA GIMNAZIALĂ ”XANTUS JANOS” MIERCUREA-CIUC",20,"Alegeri Prezidentiale",1,1248,300,282,18,0,227,73,1300,1000,160,67
21,HARGHITA,"MUNICIPIUL MIERCUREA-CIUC",83320,MIERCUREA-CIUC,"SEDIUL ASOCIAȚIEI ”CSÍKSOMLYÓ” MIERCUREA-CIUC",21,"Alegeri Prezidentiale",1,1810,405,339,45,21,329,76,1900,1495,256,73
21,HARGHITA,"MUNICIPIUL MIERCUREA-CIUC",83320,MIERCUREA-CIUC,"CASA DE CULTURĂ TOPLIȚA MIERCUREA-CIUC",22,"Alegeri Prezidentiale",1,1593,345,328,17,0,268,77,1700,1355,184,84
21,HARGHITA,"MUNICIPIUL MIERCUREA-CIUC",83320,HARGHITA-BĂI,"ȘCOALA GIMNAZIALĂ ”XÁNTUS JÁNOS” HARGHITA-BĂI MIERCUREA-CIUC",23,"Alegeri Prezidentiale",1,184,69,38,31,0,64,5,400,331,49,15
21,HARGHITA,"MUNICIPIUL GHEORGHENI",83561,GHEORGHENI,"ŞCOALA GIMNAZIALĂ ”KÓS KÁROLY”",24,"Alegeri Prezidentiale",1,1863,410,375,34,1,390,20,2000,1590,287,103
21,HARGHITA,"MUNICIPIUL GHEORGHENI",83561,GHEORGHENI,"ŞCOALA GIMNAZIALĂ ”KÓS KÁROLY”",25,"Alegeri Prezidentiale",1,1760,365,355,9,1,338,27,1900,1535,241,97
21,HARGHITA,"MUNICIPIUL GHEORGHENI",83561,GHEORGHENI,"ŞCOALA GIMNAZIALĂ ”KÓS KÁROLY”",26,"Alegeri Prezidentiale",1,1835,345,335,10,0,312,33,1900,1555,243,69
21,HARGHITA,"MUNICIPIUL GHEORGHENI",83561,GHEORGHENI,"ŞCOALA GIMNAZIALĂ ”VASKERTES”",27,"Alegeri Prezidentiale",1,1753,361,341,20,0,334,27,1900,1539,246,88
21,HARGHITA,"MUNICIPIUL GHEORGHENI",83561,GHEORGHENI,"ŞCOALA GIMNAZIALĂ ”VASKERTES”",28,"Alegeri Prezidentiale",1,1697,324,301,23,0,302,22,1800,1476,227,75
21,HARGHITA,"MUNICIPIUL GHEORGHENI",83561,GHEORGHENI,"ŞCOALA GIMNAZIALĂ ”VASKERTES”",29,"Alegeri Prezidentiale",1,1866,361,342,19,0,320,41,2000,1639,252,68
21,HARGHITA,"MUNICIPIUL GHEORGHENI",83561,GHEORGHENI,"LICEUL TEORETIC ”SALAMON ERNŐ”",30,"Alegeri Prezidentiale",1,1782,352,297,55,0,307,45,1900,1548,209,98
21,HARGHITA,"MUNICIPIUL GHEORGHENI",83561,GHEORGHENI,"LICEUL TEHNOLOGIC ”FOGARASY MIHÁLY”",31,"Alegeri Prezidentiale",1,1809,336,301,35,0,288,48,1900,1564,220,68
21,HARGHITA,"MUNICIPIUL GHEORGHENI",83561,GHEORGHENI,"COLEGIUL TEHNIC ”BATTHYÁNY IGNÁC”",32,"Alegeri Prezidentiale",1,1938,314,294,20,0,283,31,2000,1686,220,63
21,HARGHITA,"MUNICIPIUL GHEORGHENI",83561,"LACU ROŞU","CORP DE CLĂDIRE CU 20 DE APARTAMENTE",33,"Alegeri Prezidentiale",1,76,74,22,52,0,73,1,400,326,51,22
21,HARGHITA,"MUNICIPIUL ODORHEIU SECUIESC",83133,"ODORHEIU SECUIESC","COLEGIUL TEHNIC ”BÁNYAI JÁNOS”",34,"Alegeri Prezidentiale",1,1517,248,227,21,0,223,25,1600,1352,155,68
21,HARGHITA,"MUNICIPIUL ODORHEIU SECUIESC",83133,"ODORHEIU SECUIESC","COLEGIUL TEHNIC ”BÁNYAI JÁNOS”",35,"Alegeri Prezidentiale",1,1510,286,260,26,0,255,31,1600,1314,197,58
21,HARGHITA,"MUNICIPIUL ODORHEIU SECUIESC",83133,"ODORHEIU SECUIESC","GRĂDINIŢA ”ZSIBONGÓ”",36,"Alegeri Prezidentiale",1,1284,335,313,22,0,289,46,1400,1065,214,75
21,HARGHITA,"MUNICIPIUL ODORHEIU SECUIESC",83133,"ODORHEIU SECUIESC","COLEGIUL REFORMAT ”BACZKAMADARASI KIS GERGELY”",37,"Alegeri Prezidentiale",1,1521,344,302,42,0,304,40,1600,1256,246,58
21,HARGHITA,"MUNICIPIUL ODORHEIU SECUIESC",83133,"ODORHEIU SECUIESC","COLEGIUL REFORMAT ”BACZKAMADARASI KIS GERGELY”",38,"Alegeri Prezidentiale",1,1111,209,169,40,0,182,27,1200,991,162,20
21,HARGHITA,"MUNICIPIUL ODORHEIU SECUIESC",83133,"ODORHEIU SECUIESC","CASĂ DE CULTURĂ",39,"Alegeri Prezidentiale",1,1392,288,231,57,0,233,55,1500,1212,176,57
21,HARGHITA,"MUNICIPIUL ODORHEIU SECUIESC",83133,"ODORHEIU SECUIESC","LICEUL TEHNOLOGIC ”KÓS KÁROLY”",40,"Alegeri Prezidentiale",1,1598,276,251,25,0,234,42,1700,1424,185,49
21,HARGHITA,"MUNICIPIUL ODORHEIU SECUIESC",83133,"ODORHEIU SECUIESC","LICEUL TEHNOLOGIC ”KÓS KÁROLY”",41,"Alegeri Prezidentiale",1,1584,292,273,19,0,264,28,1700,1408,220,44
21,HARGHITA,"MUNICIPIUL ODORHEIU SECUIESC",83133,"ODORHEIU SECUIESC","IMOBILUL DIN STRADA BETHLEN GÁBOR NR. 50",42,"Alegeri Prezidentiale",1,1324,375,226,43,106,326,49,1500,1125,238,88
21,HARGHITA,"MUNICIPIUL ODORHEIU SECUIESC",83133,"ODORHEIU SECUIESC","ŞCOALA GIMNAZIALĂ ”ORBÁN BALÁZS”",43,"Alegeri Prezidentiale",1,1416,286,260,26,0,251,35,1500,1214,184,67
21,HARGHITA,"MUNICIPIUL ODORHEIU SECUIESC",83133,"ODORHEIU SECUIESC","ŞCOALA GIMNAZIALĂ ”ORBÁN BALÁZS”",44,"Alegeri Prezidentiale",1,1227,245,232,13,0,216,29,1300,1055,167,49
21,HARGHITA,"MUNICIPIUL ODORHEIU SECUIESC",83133,"ODORHEIU SECUIESC","ŞCOALA GIMNAZIALĂ ”ORBÁN BALÁZS”",45,"Alegeri Prezidentiale",1,1091,206,197,9,0,177,29,1200,994,144,33
21,HARGHITA,"MUNICIPIUL ODORHEIU SECUIESC",83133,"ODORHEIU SECUIESC","ŞCOALA GIMNAZIALĂ ”BETHLEN GÁBOR”",46,"Alegeri Prezidentiale",1,1383,296,265,31,0,264,32,1500,1204,199,65
21,HARGHITA,"MUNICIPIUL ODORHEIU SECUIESC",83133,"ODORHEIU SECUIESC","ŞCOALA GIMNAZIALĂ ”BETHLEN GÁBOR”",47,"Alegeri Prezidentiale",1,1385,276,253,23,0,243,33,1500,1224,181,62
21,HARGHITA,"MUNICIPIUL ODORHEIU SECUIESC",83133,"ODORHEIU SECUIESC","ŞCOALA GIMNAZIALĂ ”BETHLEN GÁBOR”",48,"Alegeri Prezidentiale",1,1332,317,305,12,0,280,37,1400,1083,226,54
21,HARGHITA,"MUNICIPIUL ODORHEIU SECUIESC",83133,"ODORHEIU SECUIESC","ŞCOALA GIMNAZIALĂ ”BETHLEN GÁBOR”",49,"Alegeri Prezidentiale",1,1458,305,292,13,0,269,36,1600,1295,206,63
21,HARGHITA,"MUNICIPIUL ODORHEIU SECUIESC",83133,"ODORHEIU SECUIESC","ŞCOALA GIMNAZIALĂ ”BETHLEN GÁBOR”",50,"Alegeri Prezidentiale",1,1468,209,194,15,0,186,23,1600,1391,142,44
21,HARGHITA,"MUNICIPIUL ODORHEIU SECUIESC",83133,"ODORHEIU SECUIESC","ŞCOALA GIMNAZIALĂ ”MÓRA FERENC”",51,"Alegeri Prezidentiale",1,1562,288,270,18,0,256,32,1700,1412,183,73
21,HARGHITA,"MUNICIPIUL ODORHEIU SECUIESC",83133,"ODORHEIU SECUIESC","ŞCOALA GIMNAZIALĂ ”MÓRA FERENC”",52,"Alegeri Prezidentiale",1,1532,292,279,13,0,267,25,1600,1308,207,60
21,HARGHITA,"MUNICIPIUL ODORHEIU SECUIESC",83133,"ODORHEIU SECUIESC","ŞCOALA GIMNAZIALĂ ”MÓRA FERENC”",53,"Alegeri Prezidentiale",1,1528,274,264,10,0,240,34,1600,1326,195,45
21,HARGHITA,"MUNICIPIUL ODORHEIU SECUIESC",83133,"ODORHEIU SECUIESC","ŞCOALA GIMNAZIALĂ ”MÓRA FERENC”",54,"Alegeri Prezidentiale",1,1599,294,281,13,0,269,25,1700,1406,194,75
21,HARGHITA,"MUNICIPIUL ODORHEIU SECUIESC",83133,"ODORHEIU SECUIESC","CLUBUL CASEI DE CULTURĂ BECLEAN",55,"Alegeri Prezidentiale",1,1610,369,341,28,0,320,49,1700,1331,245,75
21,HARGHITA,"MUNICIPIUL TOPLIŢA",83632,TOPLIŢA,"ŞCOALA GIMNAZIALĂ ”MIRON CRISTEA” TOPLIŢA",56,"Alegeri Prezidentiale",1,1504,671,552,66,53,654,17,1600,929,484,170
21,HARGHITA,"MUNICIPIUL TOPLIŢA",83632,TOPLIŢA,"ŞCOALA GIMNAZIALĂ ”MIRON CRISTEA” TOPLIŢA",57,"Alegeri Prezidentiale",1,1583,706,648,52,6,701,5,1700,994,532,169
21,HARGHITA,"MUNICIPIUL TOPLIŢA",83632,TOPLIŢA,"LICEUL TEORETIC ”KEMENY JANOS” TOPLIŢA",58,"Alegeri Prezidentiale",1,1395,664,631,33,0,653,11,1500,836,485,168
21,HARGHITA,"MUNICIPIUL TOPLIŢA",83632,TOPLIŢA,"GRĂDINIŢA VOINICEL NR.1 TOPLIŢA",59,"Alegeri Prezidentiale",1,1052,399,372,27,0,396,3,1200,801,316,80
21,HARGHITA,"MUNICIPIUL TOPLIŢA",83632,ZENCANI,"ŞCOALA GIMNAZIALĂ ”SF. ILIE” ZENCANI",60,"Alegeri Prezidentiale",1,1495,631,601,30,0,619,12,1600,969,450,169
21,HARGHITA,"MUNICIPIUL TOPLIŢA",83632,TOPLIŢA,"ŞCOALA GIMNAZIALĂ ”ANDREI ŞAGUNA” VALE",61,"Alegeri Prezidentiale",1,1547,752,707,45,0,747,5,1700,948,534,213
21,HARGHITA,"MUNICIPIUL TOPLIŢA",83632,TOPLIŢA,"COLEGIUL NAŢIONAL ”MIHAI EMINESCU” TOPLIŢA",62,"Alegeri Prezidentiale",1,998,465,417,48,0,460,5,1100,635,356,104
21,HARGHITA,"MUNICIPIUL TOPLIŢA",83632,TOPLIŢA,"ŞCOALA GIMNAZIALĂ ”SF. ILIE” TOPLIŢA",63,"Alegeri Prezidentiale",1,1110,454,417,37,0,448,6,1200,746,345,103
21,HARGHITA,"MUNICIPIUL TOPLIŢA",83632,TOPLIŢA,"LICEUL ”O.C.TĂSLĂUANU” TOPLIŢA",64,"Alegeri Prezidentiale",1,1289,494,473,21,0,492,2,1400,906,388,104
21,HARGHITA,"MUNICIPIUL TOPLIŢA",83632,TOPLIŢA,"ŞCOALA GIMNAZIALĂ ”ANDREI ŞAGUNA” CĂLIMĂNEL",65,"Alegeri Prezidentiale",1,985,398,378,20,0,393,5,1100,702,296,97
21,HARGHITA,"MUNICIPIUL TOPLIŢA",83632,SECU,"CABANA OCOLULUI SILVIC",66,"Alegeri Prezidentiale",1,60,32,19,13,0,31,1,300,268,22,9
21,HARGHITA,"ORAŞ BĂILE TUŞNAD",83428,"BĂILE TUŞNAD","SEDIUL NOU AL PRIMĂRIEI",67,"Alegeri Prezidentiale",1,1350,568,280,288,0,505,63,1500,932,379,126
21,HARGHITA,"ORAŞ BĂLAN",83464,BĂLAN,"CASA DE CULTURĂ BĂLAN",68,"Alegeri Prezidentiale",2,1266,323,288,35,0,307,16,1400,1077,188,119
21,HARGHITA,"ORAŞ BĂLAN",83464,BĂLAN,"SCOALA GIMNAZIALĂ ”GEO BOGZA” BĂLAN - CLĂDIRE ȘCOALA NR. 1",69,"Alegeri Prezidentiale",1,1294,321,307,13,1,306,15,1400,1079,192,114
21,HARGHITA,"ORAŞ BĂLAN",83464,BĂLAN,"ȘCOALA GIMNAZIALĂ ”GEO BOGZA” BĂLAN - CORP A,B",70,"Alegeri Prezidentiale",1,1179,269,253,16,0,264,5,1300,1031,121,143
21,HARGHITA,"ORAŞ BĂLAN",83464,BĂLAN,"LICEUL TEHNOLOGIC ”LIVIU REBREANU” BĂLAN - CLĂDIRE GRĂDINIȚA NR. 2",71,"Alegeri Prezidentiale",1,1241,310,296,14,0,304,6,1400,1090,162,142
21,HARGHITA,"ORAŞ BĂLAN",83464,BĂLAN,"CLUBUL ELEVILOR BĂLAN",72,"Alegeri Prezidentiale",1,1345,357,337,20,0,353,4,1400,1043,179,174
21,HARGHITA,"ORAŞ BORSEC",83491,BORSEC,"LICEUL TEHNOLOGIC „ZIMMETHAUSEN„",73,"Alegeri Prezidentiale",2,905,327,297,30,0,313,14,1000,673,241,72
21,HARGHITA,"ORAŞ BORSEC",83491,BORSEC,"SEDIUL CONSILIULUI LOCAL",74,"Alegeri Prezidentiale",1,1397,574,533,41,0,563,11,1500,926,477,86
21,HARGHITA,"ORAŞ CRISTURU SECUIESC",83525,BETEŞTI,"CĂMINUL CULTURAL BETEŞTI",75,"Alegeri Prezidentiale",1,656,96,79,17,0,89,7,700,604,54,35
21,HARGHITA,"ORAŞ CRISTURU SECUIESC",83525,"CRISTURU SECUIESC","ŞCOALA GIMNAZIALĂ ”PETŐFI SÁNDOR” CRISTURU SECUIESC",76,"Alegeri Prezidentiale",1,1240,191,177,14,0,172,19,1300,1109,132,40
21,HARGHITA,"ORAŞ CRISTURU SECUIESC",83525,"CRISTURU SECUIESC","ŞCOALA GIMNAZIALĂ ”PETŐFI SÁNDOR” CRISTURU SECUIESC",77,"Alegeri Prezidentiale",1,1539,291,257,34,0,245,46,1700,1409,197,48
21,HARGHITA,"ORAŞ CRISTURU SECUIESC",83525,"CRISTURU SECUIESC","PAROHIA ROMANO-CATOLICĂ CRISTURU SECUIESC",78,"Alegeri Prezidentiale",1,1417,265,251,14,0,244,21,1500,1235,187,57
21,HARGHITA,"ORAŞ CRISTURU SECUIESC",83525,"CRISTURU SECUIESC","ASOCIATIA INTREPRINZATORILOR PARTICULARI",79,"Alegeri Prezidentiale",1,1435,253,226,27,0,205,48,1500,1247,167,38
21,HARGHITA,"ORAŞ CRISTURU SECUIESC",83525,"CRISTURU SECUIESC","LICEUL TEOLOGIC UNITARIAN „BERDE MÓZES” CRISTURU SECUIESC",80,"Alegeri Prezidentiale",1,1653,301,286,15,0,266,35,1800,1499,205,61
21,HARGHITA,"ORAŞ CRISTURU SECUIESC",83525,FILIAŞ,"CENTRUL DE PLANIFICARE A FAMILIEI FILIAŞ",81,"Alegeri Prezidentiale",1,913,157,149,8,0,144,13,1000,843,78,66
21,HARGHITA,"ORAŞ VLĂHIŢA",83749,VLĂHIŢA,"ŞCOALA GIMNAZIALĂ ”MÁRTONFFI JÁNOS”, VLĂHIŢA",82,"Alegeri Prezidentiale",2,1341,210,194,16,0,196,14,1400,1190,125,71
21,HARGHITA,"ORAŞ VLĂHIŢA",83749,VLĂHIŢA,"ŞCOALA GIMNAZIALĂ ”MÁRTONFFI JÁNOS”, VLĂHIŢA",83,"Alegeri Prezidentiale",1,1520,247,229,18,0,195,52,1600,1353,149,46
21,HARGHITA,"ORAŞ VLĂHIŢA",83749,VLĂHIŢA,"LICEUL TEHNOLOGIC ”GÁBOR ÁRON”, VLĂHIŢA",84,"Alegeri Prezidentiale",1,1069,163,138,24,1,125,38,1200,1037,99,26
21,HARGHITA,"ORAŞ VLĂHIŢA",83749,VLĂHIŢA,"LICEUL TEHNOLOGIC ”GÁBOR ÁRON”, VLĂHIŢA",85,"Alegeri Prezidentiale",1,1021,174,162,12,0,150,24,1100,926,120,30
21,HARGHITA,"ORAŞ VLĂHIŢA",83749,VLĂHIŢA,"CASA DE CULTURĂ ”BARTÓK BÉLA”, VLĂHIŢA",86,"Alegeri Prezidentiale",1,1183,193,178,15,0,174,19,1300,1107,127,47
21,HARGHITA,ATID,83785,ATID,"CÃMINUL CULTURAL ATID",87,"Alegeri Prezidentiale",1,1058,200,192,8,0,185,15,1100,900,89,96
21,HARGHITA,ATID,83785,CRIŞENI,"CÃMINUL CULTURAL CRISENI",88,"Alegeri Prezidentiale",1,555,108,94,14,0,97,11,600,492,41,56
21,HARGHITA,ATID,83785,CUŞMED,"CÃMINUL CULTURAL CUSMED",89,"Alegeri Prezidentiale",1,342,54,40,14,0,42,12,400,346,17,25
21,HARGHITA,ATID,83785,ŞICLOD,"CÃMINUL CULTURAL SICLOD",90,"Alegeri Prezidentiale",1,158,43,27,16,0,43,0,200,157,30,13
21,HARGHITA,ATID,83785,INLĂCENI,"SEDIU COMPOSESORAT INLÃCENI",91,"Alegeri Prezidentiale",1,121,38,20,18,0,27,11,200,162,19,8
21,HARGHITA,AVRĂMEŞTI,83847,AVRĂMEŞTI,"SEDIUL PRIMĂRIEI AVRĂMEŞTI",92,"Alegeri Prezidentiale",1,843,85,75,10,0,76,9,900,815,56,20
21,HARGHITA,AVRĂMEŞTI,83847,CECHEŞTI,"ŞCOALA PRIMARĂ CECHEŞTI",93,"Alegeri Prezidentiale",1,488,66,45,21,0,59,7,500,434,37,22
21,HARGHITA,AVRĂMEŞTI,83847,GOAGIU,"ŞCOALA GIMNAZIALĂ ”MÓRA FERENC” GOAGIU",94,"Alegeri Prezidentiale",1,551,79,69,10,0,73,6,600,521,50,23
21,HARGHITA,AVRĂMEŞTI,83847,FIRTĂNUŞ,"ŞCOALA PRIMARĂ FIRTĂNUŞ",95,"Alegeri Prezidentiale",2,271,49,38,11,0,44,5,300,251,16,28
21,HARGHITA,BILBOR,83936,BILBOR,"CĂMINUL CULTURAL",96,"Alegeri Prezidentiale",1,856,425,395,29,1,420,5,900,475,254,166
21,HARGHITA,BILBOR,83936,BILBOR,"CĂMINUL CULTURAL",97,"Alegeri Prezidentiale",1,1369,633,601,31,1,632,1,1500,867,426,206
21,HARGHITA,BRĂDEŞTI,83151,BRĂDEŞTI,"ŞCOALA GIMNAZIALĂ MARTON ARON BRĂDEŞTI",98,"Alegeri Prezidentiale",1,1030,276,247,29,0,251,25,1100,824,192,59
21,HARGHITA,BRĂDEŞTI,83151,TÂRNOVIŢA,"SCOALA PRIMARA TIRNOVITA",99,"Alegeri Prezidentiale",1,609,205,185,20,0,195,10,700,495,108,87
21,HARGHITA,CĂPÂLNIŢA,83963,CĂPÂLNIŢA,"CĂMINUL CULTURAL ”SÜTŐ ANDRÁS”",100,"Alegeri Prezidentiale",1,823,147,131,16,0,120,27,900,753,71,49
21,HARGHITA,CĂPÂLNIŢA,83963,CĂPÂLNIŢA,"CĂMINUL CULTURAL ”SÜTŐ ANDRÁS”",101,"Alegeri Prezidentiale",1,835,119,114,5,0,111,8,900,781,61,50
21,HARGHITA,CÂRŢA,84102,CÂRŢA,"PRIMĂRIA CÎRŢA",102,"Alegeri Prezidentiale",1,831,166,129,37,0,128,38,900,734,99,29
21,HARGHITA,CÂRŢA,84102,INEU,COMPOSESORAT,103,"Alegeri Prezidentiale",1,1428,189,180,9,0,161,28,1500,1311,114,47
21,HARGHITA,CICEU,86461,CICEU,"PAROHIA ROM.CAT.",104,"Alegeri Prezidentiale",2,1506,326,316,10,0,264,62,1600,1274,168,96
21,HARGHITA,CICEU,86461,CICEU,"PAROHIA ROM.CAT.",105,"Alegeri Prezidentiale",1,769,150,131,19,0,127,23,900,750,84,43
21,HARGHITA,CIUCSÂNGEORGIU,83981,CIUCSÂNGEORGIU,"ŞCOALA GIMNAZIALĂ ”GAL SANDOR” CIUCSÂNGEORGIU",106,"Alegeri Prezidentiale",1,875,146,133,13,0,128,18,1000,854,64,64
21,HARGHITA,CIUCSÂNGEORGIU,83981,CIUCSÂNGEORGIU,"ŞCOALA GIMNAZIALĂ ”GAL SANDOR” CIUCSÂNGEORGIU",107,"Alegeri Prezidentiale",2,734,69,63,6,0,59,10,800,731,47,12
21,HARGHITA,CIUCSÂNGEORGIU,83981,"ARMĂŞENII NOI","CĂMINUL CULTURAL ARMĂŞENI-NOI",108,"Alegeri Prezidentiale",1,239,63,52,11,0,50,13,300,237,34,16
21,HARGHITA,CIUCSÂNGEORGIU,83981,ARMĂŞENI,"CĂMINUL CULTURAL ARMĂŞENI",109,"Alegeri Prezidentiale",1,705,98,92,6,0,82,16,800,702,63,19
21,HARGHITA,CIUCSÂNGEORGIU,83981,BANCU,"ŞCOALA GIMNAZIALĂ ”MARTON FERENC” BANCU",110,"Alegeri Prezidentiale",1,1080,131,120,11,0,109,22,1200,1069,76,33
21,HARGHITA,CIUCSÂNGEORGIU,83981,EGHERSEC,"CĂMINUL CULTURAL EGHERSEC-CINOD",111,"Alegeri Prezidentiale",1,137,56,42,14,0,51,5,200,144,27,24
21,HARGHITA,CIUCSÂNGEORGIU,83981,EGHERSEC,"CĂMINUL CULTURAL EGHERSEC",112,"Alegeri Prezidentiale",1,93,23,17,6,0,20,3,200,177,7,13
21,HARGHITA,CIUMANI,84086,CIUMANI,"ȘCOALA PRIMARĂ KÖLLŐ MIKLÓS",113,"Alegeri Prezidentiale",1,1361,193,179,14,0,164,29,1500,1307,99,65
21,HARGHITA,CIUMANI,84086,CIUMANI,"ȘCOALA PRIMARĂ KÖLLŐ MIKLÓS",114,"Alegeri Prezidentiale",1,1147,149,139,10,0,134,15,1200,1051,94,40
21,HARGHITA,CIUMANI,84086,CIUMANI,"ȘCOALA PRIMARA SZILÁGYI",115,"Alegeri Prezidentiale",1,1138,190,180,10,0,175,15,1198,1008,122,53
21,HARGHITA,CORBU,84148,CORBU,"LICEUL TEHNOLOGIC CORBU CORP A",116,"Alegeri Prezidentiale",1,741,312,265,47,0,309,3,800,488,206,103
21,HARGHITA,CORBU,84148,"CAPU CORBULUI","LICEUL TEHNOLOGIC CORP D",117,"Alegeri Prezidentiale",1,406,202,167,35,0,197,5,500,298,128,69
21,HARGHITA,CORUND,84175,CORUND,"LICEUL TEHNOLOGIC CORUND",118,"Alegeri Prezidentiale",1,1358,168,148,20,0,144,24,1500,1332,91,53
21,HARGHITA,CORUND,84175,CORUND,"ŞCOALA GIMNAZIALĂ CORUND",119,"Alegeri Prezidentiale",1,1307,211,195,16,0,188,23,1400,1189,111,77
21,HARGHITA,CORUND,84175,CORUND,"ȘCOALA GIMNAZIALĂ CORUND",120,"Alegeri Prezidentiale",1,1569,237,219,18,0,225,12,1700,1463,120,105
21,HARGHITA,CORUND,84175,ATIA,"CĂMINUL CULTURAL ATIA",121,"Alegeri Prezidentiale",2,172,42,32,10,0,34,8,200,158,22,12
21,HARGHITA,CORUND,84175,"FÂNTÂNA BRAZILOR","ŞCOALA GIMNAZIALĂ FÂNTÂNA BRAZILOR",122,"Alegeri Prezidentiale",1,256,75,66,9,0,73,2,300,225,36,37
21,HARGHITA,CORUND,84175,"VALEA LUI PAVEL","ŞCOALA GIMNAZIALĂ VALEA LUI PAVEL",123,"Alegeri Prezidentiale",1,298,82,76,6,0,79,3,400,318,52,27
21,HARGHITA,COZMENI,86446,COZMENI,"COMUNA COZMENI",124,"Alegeri Prezidentiale",1,1167,209,188,21,0,167,42,1300,1091,101,66
21,HARGHITA,COZMENI,86446,LĂZĂREŞTI,"COMUNA COZMENI",125,"Alegeri Prezidentiale",1,471,75,63,12,0,71,4,500,425,45,26
21,HARGHITA,DĂNEŞTI,84237,DĂNEŞTI,"CĂMINUL CULTURAL DĂNEȘTI",126,"Alegeri Prezidentiale",1,894,150,126,16,8,116,34,1000,850,83,33
21,HARGHITA,DĂNEŞTI,84237,DĂNEŞTI,"CĂMINUL CULTURAL DĂNEȘTI",127,"Alegeri Prezidentiale",1,958,147,131,9,7,117,30,1000,853,81,36
21,HARGHITA,DÂRJIU,84380,DÂRJIU,"ȘCOALA GENERALÂ DÂRJIU JÁNOS ZSIGMOND",128,"Alegeri Prezidentiale",2,528,71,56,15,0,64,7,600,529,53,11
21,HARGHITA,DÂRJIU,84380,MUJNA,"ȘCOALA GENERALĂ DIN MUJNA",129,"Alegeri Prezidentiale",1,284,61,42,19,0,58,3,296,235,41,17
21,HARGHITA,DEALU,84264,DEALU,"CASA SOCIALĂ",130,"Alegeri Prezidentiale",1,1551,309,297,12,0,278,31,1700,1391,209,69
21,HARGHITA,DEALU,84264,SÂNCRAI,"CAMIN CULTURAL",131,"Alegeri Prezidentiale",2,1076,191,178,13,0,174,17,1200,1009,120,54
21,HARGHITA,DEALU,84264,ULCANI,"CASĂ COMUNALĂ",132,"Alegeri Prezidentiale",1,558,96,79,17,0,89,7,600,504,50,39
21,HARGHITA,DITRĂU,84344,DITRĂU,"ȘCOALA GIMNAZIALĂ „SIKLODY LORINC” DITRĂU",133,"Alegeri Prezidentiale",1,1590,280,258,22,0,244,36,1700,1420,171,73
21,HARGHITA,DITRĂU,84344,DITRĂU,"GRADINITA CU PROGRAM NORMAL ”CSIGABIGA” DITRĂU",134,"Alegeri Prezidentiale",1,873,130,115,13,2,122,8,1000,870,90,32
21,HARGHITA,DITRĂU,84344,DITRĂU,"ȘCOALA GIMNAZIALĂ „CSIBY ANDOR” DITRĂU „KOHID”",135,"Alegeri Prezidentiale",1,945,133,124,9,0,119,14,1000,867,79,40
21,HARGHITA,DITRĂU,84344,DITRĂU,"ȘCOALA GIMNAZIALĂ „DR. CSIBY ANDOR” DITRĂU",136,"Alegeri Prezidentiale",1,893,136,129,7,0,127,9,1000,864,85,42
21,HARGHITA,DITRĂU,84344,JOLOTCA,"ȘCOALA GIMNAZIALĂ JOLOTCA",137,"Alegeri Prezidentiale",1,522,90,78,12,0,89,1,600,510,62,27
21,HARGHITA,FELICENI,83197,FELICENI,"ŞCOALA GIMNAZIALĂ ”FULOP ARON” FELICENI",138,"Alegeri Prezidentiale",1,1035,210,192,18,0,191,19,1100,890,145,46
21,HARGHITA,FELICENI,83197,TĂURENI,"ŞCOALA GENERALĂ TĂURENI",139,"Alegeri Prezidentiale",1,589,98,83,15,0,91,7,700,602,70,21
21,HARGHITA,FELICENI,83197,HOGHIA,"ŞCOALA GENERALĂ HOGHIA",140,"Alegeri Prezidentiale",1,232,58,43,15,0,56,2,300,242,45,11
21,HARGHITA,FELICENI,83197,FORŢENI,"ŞCOALA GENERALĂ FORŢENI",141,"Alegeri Prezidentiale",2,439,64,52,12,0,56,8,500,436,47,9
21,HARGHITA,FELICENI,83197,POLONIŢA,"ŞCOALA GENERALĂ POLONIŢA",142,"Alegeri Prezidentiale",1,290,84,67,17,0,76,8,400,316,57,19
21,HARGHITA,FELICENI,83197,TELEAC,"ŞCOALA GENERALĂ TELEAC",143,"Alegeri Prezidentiale",1,176,47,31,16,0,43,4,200,153,29,14
21,HARGHITA,FRUMOASA,84415,BÂRZAVA,"ȘCOALA GIMNAZIALĂ BÎRZAVA",144,"Alegeri Prezidentiale",1,525,84,75,9,0,66,18,600,516,47,19
21,HARGHITA,FRUMOASA,84415,FRUMOASA,"PRIMĂRIA COMUNEI FRUMOASA",145,"Alegeri Prezidentiale",1,1552,170,141,29,0,156,14,1600,1430,116,40
21,HARGHITA,FRUMOASA,84415,NICOLEŞTI,"ȘCOALA PRIMARĂ",146,"Alegeri Prezidentiale",2,920,158,141,17,0,134,24,1000,842,79,55
21,HARGHITA,GĂLĂUŢAŞ,84460,GĂLĂUŢAŞ,"ŞCOALA GIMNAZIALĂ ”DUMITRU GAFTON” GĂLĂUȚAȘ",147,"Alegeri Prezidentiale",1,977,390,366,24,0,386,4,1100,710,260,126
21,HARGHITA,GĂLĂUŢAŞ,84460,GĂLĂUŢAŞ,"ŞCOALA GIMNAZIALĂ ”DUMITRU GAFTON” GĂLĂUȚAȘ",148,"Alegeri Prezidentiale",1,720,237,222,15,0,235,2,800,563,180,55
21,HARGHITA,GĂLĂUŢAŞ,84460,GĂLĂUŢAŞ,"ȘCOALA GIMNAZIALĂ ”DUMITRU GAFTON” GĂLĂUȚAȘ",149,"Alegeri Prezidentiale",1,314,158,135,21,2,157,1,400,242,122,35
21,HARGHITA,JOSENI,84558,JOSENI,"LICEUL TEHNOLOGIC SOVER ELEK",150,"Alegeri Prezidentiale",1,1228,198,185,13,0,167,31,1300,1102,126,41
21,HARGHITA,JOSENI,84558,JOSENI,"LICEUL TEHNOLOGIC SOVER ELEK",151,"Alegeri Prezidentiale",1,1427,225,216,9,0,195,30,1500,1275,144,51
21,HARGHITA,JOSENI,84558,JOSENI,"LICEUL TEHNOLOGIC SOVER ELEK",152,"Alegeri Prezidentiale",1,1393,213,202,11,0,196,17,1500,1287,156,40
21,HARGHITA,JOSENI,84558,BORZONT,"SCOALA PRIMARA GAÁL TAMÁS, BORZONT",153,"Alegeri Prezidentiale",1,700,131,116,15,0,112,19,800,669,86,26
21,HARGHITA,LĂZAREA,84594,LĂZAREA,"ŞCOALA GIMNAZIALĂ ”BETHLEN GÁBOR” LĂZAREA",154,"Alegeri Prezidentiale",1,1668,256,237,19,0,225,31,1800,1544,170,55
21,HARGHITA,LĂZAREA,84594,LĂZAREA,"ŞCOALA GIMNAZIALĂ ”BETHLEN GÁBOR” LĂZAREA",155,"Alegeri Prezidentiale",1,1105,156,144,12,0,144,12,1200,1044,111,33
21,HARGHITA,LĂZAREA,84594,GHIDUŢ,"ŞCOALA GIMNAZIALĂ ”BETHLEN GÁBOR” GHIDUŢ",156,"Alegeri Prezidentiale",1,152,46,32,14,0,43,3,200,154,28,15
21,HARGHITA,LELICENI,86479,LELICENI,"CAMINUL CULTURAL",157,"Alegeri Prezidentiale",1,457,126,113,13,0,98,28,500,374,79,19
21,HARGHITA,LELICENI,86479,FITOD,"CAMINUL CULTURAL",158,"Alegeri Prezidentiale",1,401,98,83,15,0,73,25,500,402,48,25
21,HARGHITA,LELICENI,86479,MISENTEA,"SEDIU ADMINISTRATIV",159,"Alegeri Prezidentiale",1,891,127,107,20,0,106,21,1000,873,73,33
21,HARGHITA,LUETA,84629,LUETA,"SEDIUL PRIMĂRIEI",160,"Alegeri Prezidentiale",1,1470,139,128,11,0,112,27,1600,1461,80,32
21,HARGHITA,LUETA,84629,LUETA,"FOSTA AGENTIE CEC LUETA",161,"Alegeri Prezidentiale",1,1553,204,195,9,0,173,31,1700,1496,121,52
21,HARGHITA,"LUNCA DE JOS",84656,"VALEA RECE","ȘCOALA PRIMARĂ POIANA FAGULUI",162,"Alegeri Prezidentiale",1,1241,319,303,16,0,204,115,1300,981,145,59
21,HARGHITA,"LUNCA DE JOS",84656,"LUNCA DE JOS","CLĂDIREA PRIMĂRIEI",163,"Alegeri Prezidentiale",1,623,122,117,5,0,114,8,700,578,77,37
21,HARGHITA,"LUNCA DE JOS",84656,"LUNCA DE JOS","ŞCOALA GIMNAZIALA ” MAJLATH GUSZTAV KAROLY”",164,"Alegeri Prezidentiale",1,1426,247,236,10,1,233,14,1500,1253,142,91
21,HARGHITA,"LUNCA DE JOS",84656,"VALEA RECE","ŞCOALA PRIMARA GURA VAII RECE",165,"Alegeri Prezidentiale",1,889,297,275,22,0,206,91,1000,703,150,56
21,HARGHITA,"LUNCA DE JOS",84656,"PUNTEA LUPULUI","ŞCOALA PRIMARA PUNTEA LUPULUI II",166,"Alegeri Prezidentiale",1,112,91,72,19,0,89,2,200,109,70,19
21,HARGHITA,"LUNCA DE SUS",84754,COMIAT,"ŞCOALA PRIMARĂ COMIAT",167,"Alegeri Prezidentiale",1,309,58,40,18,0,57,1,400,342,34,23
21,HARGHITA,"LUNCA DE SUS",84754,"IZVORUL TROTUŞULUI","ŞCOALA GIMNAZIALĂ IZVORUL TROTUŞULUI",168,"Alegeri Prezidentiale",1,579,109,101,8,0,101,8,700,591,63,38
21,HARGHITA,"LUNCA DE SUS",84754,"LUNCA DE SUS","PRIMĂRIA LUNCA DE SUS",169,"Alegeri Prezidentiale",1,1352,271,261,10,0,248,23,1500,1229,155,93
21,HARGHITA,"LUNCA DE SUS",84754,PĂLTINIŞ-CIUC,"ŞCOALA PRIMARĂ PĂLTINIŞ-CIUC",170,"Alegeri Prezidentiale",1,442,114,99,15,0,106,8,500,386,63,43
21,HARGHITA,LUPENI,84825,MORĂRENI,"CASA DE CULTURĂ MORĂRENI",171,"Alegeri Prezidentiale",1,654,126,109,17,0,108,18,700,574,82,26
21,HARGHITA,LUPENI,84825,PĂLTINIŞ,"CASA DE CULTURĂ PĂLTINIŞ",172,"Alegeri Prezidentiale",1,436,73,62,11,0,71,2,500,427,53,18
21,HARGHITA,LUPENI,84825,LUPENI,"ŞCOALA GIMNAZIALĂ ”TAMASI ARON” LUPENI",173,"Alegeri Prezidentiale",1,1592,304,291,13,0,267,37,1700,1396,214,53
21,HARGHITA,LUPENI,84825,BISERICANI,"SCOALA GIMNAZIALĂ ”BENEDEK FIDEL” BISERICANI",174,"Alegeri Prezidentiale",1,597,133,119,14,0,122,11,700,567,102,20
21,HARGHITA,LUPENI,84825,BULGĂRENI,"SCOALA PRIMARĂ BULGĂRENI",175,"Alegeri Prezidentiale",1,235,54,42,12,0,46,8,300,246,26,20
21,HARGHITA,LUPENI,84825,PĂULENI,"SCOALA PRIMARĂ PĂULENI",176,"Alegeri Prezidentiale",1,287,72,61,11,0,67,5,500,428,41,26
21,HARGHITA,MĂDĂRAŞ,86438,MĂDĂRAŞ,"ŞCOALA GIMNAZIALĂ ”KISS FERENC”",177,"Alegeri Prezidentiale",1,1028,147,133,14,0,121,26,1100,953,73,48
21,HARGHITA,MĂDĂRAŞ,86438,MĂDĂRAŞ,"ŞCOALA GIMNAZIALĂ ”KISS FERENC”",178,"Alegeri Prezidentiale",1,803,119,107,12,0,102,17,900,781,78,24
21,HARGHITA,MĂRTINIŞ,84923,MĂRTINIŞ,"CĂMINUL CULTURAL MĂRTINIȘ",179,"Alegeri Prezidentiale",2,534,130,106,24,0,117,13,600,470,80,37
21,HARGHITA,MĂRTINIŞ,84923,CHINUŞU,"CĂMINUL CULTURAL CHINUȘU",180,"Alegeri Prezidentiale",1,116,40,24,16,0,35,5,200,160,21,14
21,HARGHITA,MĂRTINIŞ,84923,ALDEA,"ȘCOALA PRIMARĂ ALDEA",181,"Alegeri Prezidentiale",1,323,96,76,20,0,94,2,400,304,55,39
21,HARGHITA,MĂRTINIŞ,84923,BĂDENI,"ȘCOALA PRIMARĂ BĂDENI",182,"Alegeri Prezidentiale",2,161,40,28,12,0,38,2,200,160,29,9
21,HARGHITA,MĂRTINIŞ,84923,SÂNPAUL,"ȘCOALA GIMNAZIALĂ ”LÁSZLÓ GYULA” SÎNPAUL",183,"Alegeri Prezidentiale",1,411,114,101,13,0,100,14,500,386,73,27
21,HARGHITA,MĂRTINIŞ,84923,GHIPEŞ,"ȘCOALA PRIMARĂ GHIPEȘ",184,"Alegeri Prezidentiale",1,168,43,31,12,0,39,4,200,157,24,15
21,HARGHITA,MĂRTINIŞ,84923,COMĂNEŞTI,"ȘCOALA PRIMARĂ COMĂNEȘTI",185,"Alegeri Prezidentiale",1,177,68,55,13,0,66,2,200,132,51,15
21,HARGHITA,MĂRTINIŞ,84923,RAREŞ,"ȘCOALA PRIMARĂ RAREȘ",186,"Alegeri Prezidentiale",2,103,39,20,19,0,35,4,200,161,24,11
21,HARGHITA,MĂRTINIŞ,84923,ORĂŞENI,"GRĂDINIȚA CU PROGRAM NORMAL ORĂȘENI",187,"Alegeri Prezidentiale",1,202,59,41,18,0,53,6,300,241,37,16
21,HARGHITA,MĂRTINIŞ,84923,PETRENI,"ȘCOALA PRIMARĂ PETRENI",188,"Alegeri Prezidentiale",1,143,58,42,16,0,51,7,200,142,36,15
21,HARGHITA,MEREŞTI,85056,MEREŞTI,"PRIMĂRIA MEREŞTI",189,"Alegeri Prezidentiale",1,1099,209,179,30,0,182,27,1200,991,105,77
21,HARGHITA,MIHĂILENI,85074,MIHĂILENI,"SC.GIM. ARANY JANOS",190,"Alegeri Prezidentiale",1,795,126,116,10,0,108,18,900,774,56,52
21,HARGHITA,MIHĂILENI,85074,VĂCĂREŞTI,"SCOALA PRIMARA",191,"Alegeri Prezidentiale",1,491,98,84,14,0,91,7,600,502,54,37
21,HARGHITA,MIHĂILENI,85074,NĂDEJDEA,"SCOALA PRIMARA",192,"Alegeri Prezidentiale",1,505,94,79,15,0,79,15,600,506,51,28
21,HARGHITA,MIHĂILENI,85074,LIVEZI,"SCOALA GIMNAZIALA",193,"Alegeri Prezidentiale",1,414,124,102,22,0,123,1,500,376,56,67
21,HARGHITA,MUGENI,85127,MUGENI,"PRIMĂRIA COMUNEI MUGENI",194,"Alegeri Prezidentiale",1,943,170,155,15,0,159,11,1000,830,98,61
21,HARGHITA,MUGENI,85127,LUTIŢA,"CĂMINUL CULTURAL LUTIŢA",195,"Alegeri Prezidentiale",1,594,117,107,10,0,83,34,700,583,61,22
21,HARGHITA,MUGENI,85127,MĂTIŞENI,"CĂMINUL CULTURAL MĂTIŞENI",196,"Alegeri Prezidentiale",2,110,32,23,9,0,30,2,200,168,26,4
21,HARGHITA,MUGENI,85127,DEJUŢIU,"CĂMINUL CULTURAL DEJUŢIU",197,"Alegeri Prezidentiale",1,156,37,28,9,0,34,3,200,163,26,8
21,HARGHITA,MUGENI,85127,ALUNIŞ,"CĂMINUL CULTURAL ALUNIŞ",198,"Alegeri Prezidentiale",1,127,30,22,8,0,21,9,200,170,15,6
21,HARGHITA,MUGENI,85127,BETA,"CĂMINUL CULTURAL BETA",199,"Alegeri Prezidentiale",1,263,60,51,9,0,55,5,300,240,33,22
21,HARGHITA,MUGENI,85127,DOBENI,"CĂMINUL CULTURAL DOBENI",200,"Alegeri Prezidentiale",1,474,114,101,13,0,105,9,500,386,65,40
21,HARGHITA,MUGENI,85127,TĂIETURA,"CĂMINUL CULTURAL TĂIETURA",201,"Alegeri Prezidentiale",1,216,44,27,17,0,43,1,300,256,31,12
21,HARGHITA,OCLAND,85243,CRĂCIUNEL,"CĂMINUL CULTURAL",202,"Alegeri Prezidentiale",1,398,96,82,14,0,86,10,500,404,57,29
21,HARGHITA,OCLAND,85243,OCLAND,"CAMINUL CULTURAL OCLAND",203,"Alegeri Prezidentiale",1,590,82,73,9,0,80,2,700,618,54,26
21,HARGHITA,PĂULENI-CIUC,83375,PĂULENI-CIUC,"ȘCOALA GIMNAZIALĂ ”MARTON FERENC”",204,"Alegeri Prezidentiale",1,537,94,82,12,0,79,15,600,506,59,20
21,HARGHITA,PĂULENI-CIUC,83375,DELNIŢA,"SCOALA PRIMARĂ DELNIŢA",205,"Alegeri Prezidentiale",1,552,114,103,11,0,92,22,600,486,72,20
21,HARGHITA,PĂULENI-CIUC,83375,ŞOIMENI,"SCOALA PRIMARĂ ŞOIMENI",206,"Alegeri Prezidentiale",1,484,80,64,16,0,54,26,600,520,38,16
21,HARGHITA,"PLĂIEŞII DE JOS",85289,"PLĂIEŞII DE JOS","CASA DE CULTURĂ PLĂIEȘII DE JOS",207,"Alegeri Prezidentiale",1,639,139,117,22,0,129,10,700,561,84,45
21,HARGHITA,"PLĂIEŞII DE JOS",85289,"PLĂIEŞII DE SUS","ȘCOALA GIMNAZIALĂ NR.4 PLĂIEȘII DE SUS",208,"Alegeri Prezidentiale",1,609,204,186,18,0,187,17,700,496,92,95
21,HARGHITA,"PLĂIEŞII DE JOS",85289,IACOBENI,"ȘCOALA PRIMARĂ DR.PATAKI JÓZSEF NR.3 IACOBENI",209,"Alegeri Prezidentiale",2,294,62,53,9,0,61,1,400,338,34,27
21,HARGHITA,"PLĂIEŞII DE JOS",85289,"CASINU NOU","ȘCOALA GIMNAZIALĂ TUZSON JÁNOS NR.2 CASINU NOU",210,"Alegeri Prezidentiale",1,556,101,83,18,0,80,21,600,499,51,29
21,HARGHITA,PORUMBENI,86487,"PORUMBENII MARI","PRIMĂRIA COMUNEI PORUMBENI",211,"Alegeri Prezidentiale",2,1021,289,266,23,0,264,25,1100,811,170,94
21,HARGHITA,PORUMBENI,86487,"PORUMBENII MICI","SALA DE MANIFESTATII",212,"Alegeri Prezidentiale",1,391,97,78,19,0,85,12,500,403,59,26
21,HARGHITA,PRAID,85341,PRAID,"PRIMARIA COMUNEI PRAID- SALA DE SEDINTE AL CONS.LOCAL",213,"Alegeri Prezidentiale",1,1474,331,250,81,0,297,34,1600,1269,198,99
21,HARGHITA,PRAID,85341,PRAID,"CAMINUL CULTURAL PRAID",214,"Alegeri Prezidentiale",1,1537,362,315,47,0,331,31,1700,1338,179,152
21,HARGHITA,PRAID,85341,"OCNA DE JOS","ŞCOALA GIMNAZIALĂ ”SUKOSD FERENC” OCNA DE JOS",215,"Alegeri Prezidentiale",1,1277,200,182,18,0,184,16,1400,1200,118,66
21,HARGHITA,PRAID,85341,"OCNA DE SUS","ŞCOALA GIMNAZIALĂ ”SZEKELY MOZES” OCNA DE SUS",216,"Alegeri Prezidentiale",1,1186,128,117,11,0,120,8,1300,1172,87,33
21,HARGHITA,PRAID,85341,BECAŞ,"CĂMINUL CULTURAL BECAŞ",217,"Alegeri Prezidentiale",1,104,36,25,11,0,34,2,200,164,20,14
21,HARGHITA,RACU,86495,RACU,"CASA DE CULTURĂ RACU",218,"Alegeri Prezidentiale",1,910,127,114,13,0,112,15,1000,873,60,52
21,HARGHITA,RACU,86495,GÂRCIU,"GRĂDINIŢA DE COPII",219,"Alegeri Prezidentiale",1,396,67,59,8,0,53,14,500,433,39,14
21,HARGHITA,REMETEA,85412,REMETEA,"ȘCOALA GENERALA ”BALÁS JENŐ”",220,"Alegeri Prezidentiale",1,1142,330,317,13,0,317,13,1200,870,228,89
21,HARGHITA,REMETEA,85412,REMETEA,"GRĂDINITA DE COPII ALSZEG",221,"Alegeri Prezidentiale",1,1375,278,266,12,0,259,19,1591,1313,204,55
21,HARGHITA,REMETEA,85412,REMETEA,"SCOLA GIMNAZIALA FRÁTER GYÖRGY",222,"Alegeri Prezidentiale",1,1401,322,303,19,0,293,29,1500,1178,203,90
21,HARGHITA,REMETEA,85412,REMETEA,"GRADINIȚA DE COPII TULAMAROS",223,"Alegeri Prezidentiale",1,1250,237,221,16,0,220,17,1500,1263,158,62
21,HARGHITA,"SATU MARE",86501,"SATU MARE","CENTRUL DE INFORMARE TURISTICĂ",224,"Alegeri Prezidentiale",1,779,149,144,5,0,134,15,900,751,64,70
21,HARGHITA,"SATU MARE",86501,"SATU MARE","CAMINUL CULTURAL SATU MARE",225,"Alegeri Prezidentiale",1,861,115,101,14,0,100,15,900,785,55,45
21,HARGHITA,SĂCEL,85467,SĂCEL,"PRIMĂRIA COMUNEI SĂCEL",226,"Alegeri Prezidentiale",1,96,38,22,16,0,37,1,200,162,25,12
21,HARGHITA,SĂCEL,85467,VIDACUT,"CĂMIN CULTURAL VIDACUT",227,"Alegeri Prezidentiale",1,242,85,65,20,0,84,1,300,215,60,24
21,HARGHITA,SĂCEL,85467,"ŞOIMUŞU MIC","CĂMIN CULTURAL ȘOIMUȘU MIC",228,"Alegeri Prezidentiale",1,341,65,56,9,0,62,3,400,335,43,19
21,HARGHITA,SĂCEL,85467,"ŞOIMUŞU MARE","CĂMIN CULTURAL ȘOIMUȘU MARE",229,"Alegeri Prezidentiale",1,254,63,52,11,0,59,4,300,237,34,25
21,HARGHITA,SĂRMAŞ,85528,HODOŞA,"ȘCOALA GIMNAZIALĂ HODOȘA GARĂ",230,"Alegeri Prezidentiale",1,1205,485,457,28,0,480,5,1300,815,363,117
21,HARGHITA,SĂRMAŞ,85528,PLATONEŞTI,"ȘCOALA PRIMARĂ PLATONEȘTI",231,"Alegeri Prezidentiale",1,384,201,183,18,0,197,4,500,299,136,61
21,HARGHITA,SĂRMAŞ,85528,FUNDOAIA,"ȘCOALA PRIMARĂ FUNDOAIA",232,"Alegeri Prezidentiale",1,479,235,221,14,0,233,2,500,265,160,73
21,HARGHITA,SĂRMAŞ,85528,SĂRMAŞ,"ȘCOALA GIMNAZIALĂ ”SFÂNTU ANDREI ”SĂRMAȘ",233,"Alegeri Prezidentiale",1,1168,484,444,40,0,477,7,1300,816,327,150
21,HARGHITA,SÂNCRĂIENI,85680,SÂNCRĂIENI,"ŞCOALA GIMNAZIALĂ SÂNCRĂIENI",234,"Alegeri Prezidentiale",1,1136,185,169,16,0,159,26,1200,1015,115,44
21,HARGHITA,SÂNCRĂIENI,85680,SÂNCRĂIENI,"ŞCOALA GIMNAZIALĂ SÂNCRĂIENI",235,"Alegeri Prezidentiale",1,981,195,170,25,0,143,52,1100,905,106,37
21,HARGHITA,SÂNDOMINIC,85760,SÂNDOMINIC,"PRIMĂRIA SÎNDOMINIC",236,"Alegeri Prezidentiale",1,1514,200,186,14,0,187,13,1600,1400,121,66
21,HARGHITA,SÂNDOMINIC,85760,SÂNDOMINIC,"PRIMĂRIA SÎNDOMINIC",237,"Alegeri Prezidentiale",1,1514,221,208,13,0,194,27,1600,1379,139,55
21,HARGHITA,SÂNDOMINIC,85760,SÂNDOMINIC,"ŞCOALA GIMNAZIALĂ MARTON ARON SÎNDOMINIC",238,"Alegeri Prezidentiale",1,1084,158,149,9,0,142,16,1200,1042,110,32
21,HARGHITA,SÂNDOMINIC,85760,SÂNDOMINIC,"ȘCOALA GIMNAZIALĂ MARTON ARON SÎNDOMINIC",239,"Alegeri Prezidentiale",1,1085,154,144,10,0,135,19,1200,1046,89,46
21,HARGHITA,SÂNMARTIN,85788,SÂNMARTIN,"PRIMARIA SÎNMARTIN",240,"Alegeri Prezidentiale",1,942,161,138,23,0,125,36,1000,839,90,35
21,HARGHITA,SÂNMARTIN,85788,SÂNMARTIN,"PRIMARIA SÎNMARTIN",241,"Alegeri Prezidentiale",1,867,123,114,9,0,92,31,1000,877,60,32
21,HARGHITA,SÂNSIMION,85840,SÂNSIMION,"CĂMINUL CULTURAL",242,"Alegeri Prezidentiale",1,748,150,139,11,0,142,8,800,650,93,49
21,HARGHITA,SÂNSIMION,85840,SÂNSIMION,"CĂMINUL CULTURAL",243,"Alegeri Prezidentiale",1,1178,261,255,6,0,228,33,1300,1039,146,82
21,HARGHITA,SÂNSIMION,85840,CETĂŢUIA,"CĂMIN CULTURAL",244,"Alegeri Prezidentiale",2,842,164,140,24,0,141,23,900,736,101,40
21,HARGHITA,SÂNTIMBRU,86519,SÂNTIMBRU,"ŞCOALA GIMNAZIALĂ ”ARANY JÁNOS” SÂNTIMBRU",245,"Alegeri Prezidentiale",1,967,204,187,17,0,144,60,1000,796,88,56
21,HARGHITA,SÂNTIMBRU,86519,SÂNTIMBRU,"ŞCOALA PRIMARĂ PÁLSZEG SÂNTIMBRU",246,"Alegeri Prezidentiale",1,750,122,113,9,0,98,24,800,678,72,26
21,HARGHITA,SECUIENI,85582,SECUIENI,"CAMIN CULTURAL",247,"Alegeri Prezidentiale",1,633,153,138,15,0,144,9,700,547,124,20
21,HARGHITA,SECUIENI,85582,ELISENI,"CAMIN CULTURAL",248,"Alegeri Prezidentiale",1,948,160,141,19,0,154,6,1000,840,114,40
21,HARGHITA,SECUIENI,85582,BODOGAIA,"BIROU ADMINISTRATIV",249,"Alegeri Prezidentiale",1,722,136,124,12,0,131,5,800,664,99,32
21,HARGHITA,SICULENI,85626,SICULENI,"PRIMĂRIA COMUNEI SICULENI",250,"Alegeri Prezidentiale",1,863,230,203,27,0,190,40,1000,770,123,67
21,HARGHITA,SICULENI,85626,SICULENI,"ȘCOALA GIMNAZIALĂ ZOLD PETER SICULENI",251,"Alegeri Prezidentiale",1,1395,312,297,15,0,220,92,1500,1188,130,90
21,HARGHITA,SUBCETATE,85877,SUBCETATE,"LICEUL MIRON CRISTEA SUBCETATE",252,"Alegeri Prezidentiale",1,1483,591,540,51,0,586,5,1600,1009,441,145
21,HARGHITA,SUSENI,85920,SUSENI,"PRIMĂRIA COMUNEI SUSENI",253,"Alegeri Prezidentiale",1,871,130,121,9,0,123,7,1000,870,85,38
21,HARGHITA,SUSENI,85920,SUSENI,"PRIMĂRIA COMUNEI SUSENI",254,"Alegeri Prezidentiale",1,824,121,114,7,0,103,18,900,779,84,19
21,HARGHITA,SUSENI,85920,SUSENI,"ŞCOALA PRIMARĂ - MUREŞ SAT",255,"Alegeri Prezidentiale",1,741,125,111,14,0,118,7,800,675,84,34
21,HARGHITA,SUSENI,85920,CHILENI,"ŞCOALA PRIMARĂ CHILENI",256,"Alegeri Prezidentiale",1,652,82,71,11,0,75,7,700,618,53,22
21,HARGHITA,SUSENI,85920,"VALEA STRÂMBĂ","ŞCOALA GIMNAZIALĂ ”TARISZNYÁS MÁRTON” VALEA STRÎMBĂ",257,"Alegeri Prezidentiale",1,1117,144,131,13,0,129,15,1200,1056,103,26
21,HARGHITA,SUSENI,85920,LIBAN,"ŞCOALA PRIMARĂ LIBAN",258,"Alegeri Prezidentiale",1,59,17,6,11,0,16,1,100,83,10,6
21,HARGHITA,ŞIMONEŞTI,85984,RUGĂNEŞTI,"CÃMINUL CULTURAL RUGĂNEŞTI",259,"Alegeri Prezidentiale",1,713,130,112,18,0,120,10,800,670,83,37
21,HARGHITA,ŞIMONEŞTI,85984,COBĂTEŞTI,"CÃMINUL CULTURAL COBĂTEŞTI",260,"Alegeri Prezidentiale",1,445,90,79,11,0,82,8,500,410,53,29
21,HARGHITA,ŞIMONEŞTI,85984,CEHEŢEL,"CÃMINUL CULTURAL CEHEŢEL",261,"Alegeri Prezidentiale",2,102,30,21,9,0,29,1,200,170,18,11
21,HARGHITA,ŞIMONEŞTI,85984,TURDENI,"CÃMINUL CULTURAL TURDENI",262,"Alegeri Prezidentiale",1,69,36,18,18,0,34,2,100,64,23,11
21,HARGHITA,ŞIMONEŞTI,85984,TĂRCEŞTI,"CÃMINUL CULTURAL TĂRCEŞTI",263,"Alegeri Prezidentiale",1,183,43,32,11,0,42,1,200,157,31,11
21,HARGHITA,ŞIMONEŞTI,85984,MIHĂILENI,"CÃMINUL CULTURAL MIHĂILENI",264,"Alegeri Prezidentiale",1,426,119,101,18,0,111,8,500,381,83,28
21,HARGHITA,ŞIMONEŞTI,85984,ŞIMONEŞTI,"CLÃDIREA PRIMÃRIEI ŞIMONEŞTI",265,"Alegeri Prezidentiale",1,1119,223,206,17,0,199,24,1200,977,142,57
21,HARGHITA,ŞIMONEŞTI,85984,"MEDIŞORU MARE","ŞCOALĂ PRIMARĂ MEDIŞORU MARE",266,"Alegeri Prezidentiale",1,76,39,19,20,0,35,4,100,61,27,8
21,HARGHITA,TOMEŞTI,86453,TOMEŞTI,"CLĂDIREA CĂMINULUI CULTURAL TOMEȘTI",267,"Alegeri Prezidentiale",1,1154,165,151,14,0,147,18,1300,1135,102,45
21,HARGHITA,TOMEŞTI,86453,TOMEŞTI,"CLĂDIREA CĂMINULUI CULTURAL TOMEȘTI",268,"Alegeri Prezidentiale",1,1002,148,140,8,0,132,16,1100,952,93,39
21,HARGHITA,TULGHEŞ,86133,TULGHEŞ,"ŞCOALA GIMNAZIALĂ TULGHEŞ",269,"Alegeri Prezidentiale",1,1402,617,500,50,67,606,11,1500,883,443,163
21,HARGHITA,TULGHEŞ,86133,TULGHEŞ,"ŞCOALA PRIMARĂ PUTNA",270,"Alegeri Prezidentiale",1,452,195,180,15,0,193,2,500,305,128,65
21,HARGHITA,TULGHEŞ,86133,RECEA,"ŞCOALA PRIMARĂ RECEA",271,"Alegeri Prezidentiale",1,197,62,44,18,0,59,3,300,238,45,14
21,HARGHITA,TULGHEŞ,86133,TULGHEŞ,"ŞCOALA PRIMARĂ VALEA FRUMOASĂ",272,"Alegeri Prezidentiale",2,578,203,182,21,0,201,2,600,397,150,51
21,HARGHITA,TUŞNAD,86188,TUŞNAD,"CLĂDIREA PRIMRIEI",273,"Alegeri Prezidentiale",1,717,157,142,15,0,143,14,800,643,85,58
21,HARGHITA,TUŞNAD,86188,"TUŞNADU NOU","CĂMINUL CULTURAL",274,"Alegeri Prezidentiale",1,837,153,138,15,0,138,15,900,747,104,34
21,HARGHITA,TUŞNAD,86188,VRABIA,"CĂMINUL CULTURAL",275,"Alegeri Prezidentiale",1,162,47,39,8,0,39,8,200,153,19,20
21,HARGHITA,ULIEŞ,86222,ULIEŞ,"CĂMINUL CULTURAL ULIEȘ",276,"Alegeri Prezidentiale",1,282,69,54,15,0,59,10,300,231,44,15
21,HARGHITA,ULIEŞ,86222,NICOLEŞTI,"CĂMINUL CULTURAL NICOLEȘTI",277,"Alegeri Prezidentiale",1,177,41,32,9,0,37,4,199,158,32,5
21,HARGHITA,ULIEŞ,86222,DAIA,"ȘCOALA PRIMARĂ DAIA",278,"Alegeri Prezidentiale",1,223,77,61,16,0,75,2,300,223,51,24
21,HARGHITA,ULIEŞ,86222,IGHIU,"CĂMINUL CULTURAL IGHIU",279,"Alegeri Prezidentiale",1,48,25,12,13,0,19,6,100,75,14,5
21,HARGHITA,ULIEŞ,86222,PETECU,"CĂMINUL CULTURAL PETECU",280,"Alegeri Prezidentiale",1,186,71,50,21,0,67,4,200,129,50,17
21,HARGHITA,VĂRŞAG,86311,VĂRŞAG,"PRIMĂRIA COMUNEI VĂRȘAG",281,"Alegeri Prezidentiale",1,1066,155,133,22,0,135,20,1200,1045,98,37
21,HARGHITA,VĂRŞAG,86311,VĂRŞAG,"ȘCOALĂ PRIMARĂ SOLYOMKO",282,"Alegeri Prezidentiale",1,256,78,61,17,0,58,20,300,222,34,24
21,HARGHITA,VOŞLĂBENI,86339,VOŞLĂBENI,"ȘCOALA GIMNAZIALĂ ”TEODOR CHINDEA” VOȘLĂBENI",283,"Alegeri Prezidentiale",1,984,404,357,47,0,398,6,1100,696,237,161
21,HARGHITA,VOŞLĂBENI,86339,"IZVORU MUREŞULUI","CĂMINUL CULTURAL IZVORU MUREȘULUI",284,"Alegeri Prezidentiale",1,659,267,220,44,3,262,5,700,433,158,104
21,HARGHITA,ZETEA,86366,ZETEA,"GRĂDINIŢA CU PROGRAM NORMAL ALSZEG ZETEA",285,"Alegeri Prezidentiale",2,1221,221,207,14,0,184,37,1200,979,121,63
21,HARGHITA,ZETEA,86366,ZETEA,"PRIMĂRIA ZETEA",286,"Alegeri Prezidentiale",1,1277,206,192,14,0,159,47,1300,1094,121,38
21,HARGHITA,ZETEA,86366,ZETEA,"ŞCOALA PRIMARĂ TOFĂLĂU ZETEA",287,"Alegeri Prezidentiale",1,1196,224,208,16,0,190,34,1200,976,140,50
21,HARGHITA,ZETEA,86366,"SUB CETATE","ŞCOALA GIMNAZIALĂ ”JÓKAI MÓR” SUB CETATE",288,"Alegeri Prezidentiale",1,661,114,85,29,0,106,8,700,586,81,25
21,HARGHITA,ZETEA,86366,ŞICASĂU,"CĂMIN CULTURAL ŞICASĂU",289,"Alegeri Prezidentiale",1,136,54,32,22,0,50,4,200,146,37,13
21,HARGHITA,ZETEA,86366,IZVOARE,"ŞCOALA PRIMARĂ ”SZÉKELY JÁNOS” IZVOARE",290,"Alegeri Prezidentiale",1,308,50,32,18,0,48,2,400,350,24,24
22,HUNEDOARA,"MUNICIPIUL DEVA",86687,DEVA,"CENTRUL CULTURAL DRĂGAN MUNTEAN",1,"Alegeri Prezidentiale",1,1754,967,849,117,1,949,18,1800,833,619,330
22,HUNEDOARA,"MUNICIPIUL DEVA",86687,DEVA,"CENTRUL CULTURAL DRĂGAN MUNTEAN",2,"Alegeri Prezidentiale",1,1221,655,606,48,1,638,17,1300,645,407,231
22,HUNEDOARA,"MUNICIPIUL DEVA",86687,DEVA,"CENTRUL CULTURAL DRĂGAN MUNTEAN",3,"Alegeri Prezidentiale",1,1522,742,721,21,0,723,19,1600,858,460,263
22,HUNEDOARA,"MUNICIPIUL DEVA",86687,DEVA,"ŞCOALA GIMNAZIALĂ ”ANDREI ŞAGUNA”",4,"Alegeri Prezidentiale",1,1378,663,638,25,0,651,12,1500,837,420,231
22,HUNEDOARA,"MUNICIPIUL DEVA",86687,DEVA,"ŞCOALA GIMNAZIALĂ ”ANDREI ŞAGUNA”",5,"Alegeri Prezidentiale",1,1372,689,650,39,0,679,10,1500,811,400,279
22,HUNEDOARA,"MUNICIPIUL DEVA",86687,DEVA,"ŞCOALA GIMNAZIALĂ ”ANDREI ŞAGUNA”",6,"Alegeri Prezidentiale",1,1297,669,621,48,0,647,22,1350,681,412,235
22,HUNEDOARA,"MUNICIPIUL DEVA",86687,DEVA,"ŞCOALA GIMNAZIALĂ ”ANDREI ŞAGUNA”",7,"Alegeri Prezidentiale",1,1467,755,715,39,1,732,23,1550,795,483,249
22,HUNEDOARA,"MUNICIPIUL DEVA",86687,DEVA,"ŞCOALA GIMNAZIALĂ ”ANDREI ŞAGUNA”CORPUL DE CLĂDIRE A",8,"Alegeri Prezidentiale",1,1398,683,643,40,0,658,25,1500,817,427,231
22,HUNEDOARA,"MUNICIPIUL DEVA",86687,DEVA,"GRĂDINIȚA CU PROGRAM PRELUNGIT NR 7",9,"Alegeri Prezidentiale",1,1211,690,634,56,0,665,25,1300,610,427,238
22,HUNEDOARA,"MUNICIPIUL DEVA",86687,DEVA,"COLEGIUL NAŢIONAL PEDAGOGIC”REGINA MARIA”",10,"Alegeri Prezidentiale",1,1203,682,623,59,0,670,12,1300,618,430,240
22,HUNEDOARA,"MUNICIPIUL DEVA",86687,DEVA,"LICEUL DE ARTE SIGISMUND TODUTA (FOSTA ŞCOALA GENERALĂ ” LUCIAN BLAGA” NR.2)",11,"Alegeri Prezidentiale",1,1244,675,572,103,0,665,10,1350,675,426,239
22,HUNEDOARA,"MUNICIPIUL DEVA",86687,DEVA,"GALERIA FORMA",12,"Alegeri Prezidentiale",1,1320,757,668,88,1,734,23,1450,693,465,269
22,HUNEDOARA,"MUNICIPIUL DEVA",86687,DEVA,"COLEGIUL NAŢIONAL ”DECEBAL”",13,"Alegeri Prezidentiale",1,1152,674,596,78,0,656,18,1300,626,418,238
22,HUNEDOARA,"MUNICIPIUL DEVA",86687,DEVA,"COLEGIUL NAȚIONAL SPORTIV CETATE DEVA",14,"Alegeri Prezidentiale",1,1393,817,738,78,1,795,22,1550,733,518,277
22,HUNEDOARA,"MUNICIPIUL DEVA",86687,DEVA,"ŞCOALĂ PRIMARA VIILE NOI",15,"Alegeri Prezidentiale",1,885,447,409,38,0,442,5,1000,553,267,175
22,HUNEDOARA,"MUNICIPIUL DEVA",86687,DEVA,"LICEUL DE ARTE SIGISMUND TODUȚA (FOSTA ŞCOALA GENERALĂ ”LUCIAN BLAGA” NR.2)",16,"Alegeri Prezidentiale",1,1273,692,650,42,0,665,27,1400,708,434,231
22,HUNEDOARA,"MUNICIPIUL DEVA",86687,DEVA,"DIRECȚIA GENERALĂ DE ASISTENȚĂ SOCIALĂ ȘI PROTECȚIA COPILULUI",17,"Alegeri Prezidentiale",2,1105,650,530,120,0,640,10,1200,550,390,250
22,HUNEDOARA,"MUNICIPIUL DEVA",86687,DEVA,"DIRECŢIA SILVICĂ DEVA",18,"Alegeri Prezidentiale",1,1314,684,620,64,0,665,19,1450,766,417,248
22,HUNEDOARA,"MUNICIPIUL DEVA",86687,DEVA,"SPAŢIUL ADMINISTRATIV AL PRIMĂRIEI MUNICIPIULUI DEVA",19,"Alegeri Prezidentiale",1,1375,836,682,111,43,813,23,1550,714,497,316
22,HUNEDOARA,"MUNICIPIUL DEVA",86687,DEVA,"SALA SPORTURILOR",20,"Alegeri Prezidentiale",1,1287,663,584,79,0,649,14,1400,737,421,228
22,HUNEDOARA,"MUNICIPIUL DEVA",86687,DEVA,"COLEGIUL TEHNIC ”TRANSILVANIA”",21,"Alegeri Prezidentiale",1,941,537,414,86,37,525,12,1100,563,358,167
22,HUNEDOARA,"MUNICIPIUL DEVA",86687,DEVA,"COLEGIUL TEHNIC ”TRANSILVANIA”",22,"Alegeri Prezidentiale",1,1578,868,726,80,62,848,20,1750,882,546,302
22,HUNEDOARA,"MUNICIPIUL DEVA",86687,DEVA,"COLEGIUL TEHNIC ”TRANSILVANIA”",23,"Alegeri Prezidentiale",1,776,430,343,48,39,416,14,900,470,272,144
22,HUNEDOARA,"MUNICIPIUL DEVA",86687,DEVA,"LICEUL DE ARTE ”SIGISMUND TODUŢĂ”",24,"Alegeri Prezidentiale",1,1206,673,612,61,0,653,20,1350,677,394,259
22,HUNEDOARA,"MUNICIPIUL DEVA",86687,DEVA,"COLEGIUL TEHNIC ”TRANSILVANIA” (FOSTA ŞCOALĂ GENERALĂ)",25,"Alegeri Prezidentiale",1,1507,795,724,70,1,770,25,1600,805,510,260
22,HUNEDOARA,"MUNICIPIUL DEVA",86687,DEVA,"COLEGIUL TEHNIC ”TRANSILVANIA” (FOSTA ŞCOALĂ GENERALĂ)",26,"Alegeri Prezidentiale",1,1334,643,600,43,0,621,22,1450,807,417,204
22,HUNEDOARA,"MUNICIPIUL DEVA",86687,DEVA,"COLEGIUL TEHNIC ”TRANSILVANIA” (FOSTA ŞCOALĂ GENERALĂ)",27,"Alegeri Prezidentiale",1,1660,730,677,53,0,712,18,1750,1020,466,246
22,HUNEDOARA,"MUNICIPIUL DEVA",86687,DEVA,"COLEGIUL TEHNIC” TRANSILVANIA”",28,"Alegeri Prezidentiale",1,1489,741,707,25,9,727,14,1650,909,439,288
22,HUNEDOARA,"MUNICIPIUL DEVA",86687,DEVA,"CLUB ŞCOLAR SPORTIV",29,"Alegeri Prezidentiale",1,1367,758,708,48,2,741,17,1550,792,501,240
22,HUNEDOARA,"MUNICIPIUL DEVA",86687,DEVA,"CASA MAGHIARĂ DEVA ( FOSTA CASA ARMATEI)",30,"Alegeri Prezidentiale",1,1108,633,506,53,74,619,14,1200,567,409,210
22,HUNEDOARA,"MUNICIPIUL DEVA",86687,DEVA,"CASA MAGHIARĂ DEVA (FOSTA CASA ARMATEI)",31,"Alegeri Prezidentiale",1,1144,679,585,32,62,652,27,1250,571,390,262
22,HUNEDOARA,"MUNICIPIUL DEVA",86687,DEVA,"COLEGIUL TEHNIC ENERGETIC DRAGOMIR HURMUZESCU (FOSTA ŞCOALĂ GENERALĂ ”OCTAVIAN GOGA”)",32,"Alegeri Prezidentiale",1,1436,590,544,46,0,576,14,1550,960,376,200
22,HUNEDOARA,"MUNICIPIUL DEVA",86687,DEVA,"COLEGIUL TEHNIC ENERGETIC DRAGOMIR HURMUZESCU (FOSTA ŞCOALĂ GENERALĂ ”OCTAVIAN GOGA”)",33,"Alegeri Prezidentiale",1,1795,730,701,29,0,713,17,1900,1170,529,184
22,HUNEDOARA,"MUNICIPIUL DEVA",86687,DEVA,"COLEGIUL TEHNIC ENERGETIC DRAGOMIR HURMUZESCU (FOSTA ŞCOALĂ GENERALĂ ”OCTAVIAN GOGA”)",34,"Alegeri Prezidentiale",2,1453,590,572,18,0,579,11,1600,1010,412,167
22,HUNEDOARA,"MUNICIPIUL DEVA",86687,DEVA,"GRADINIŢA P.N. NR.3",35,"Alegeri Prezidentiale",1,1558,658,629,29,0,644,14,1700,1042,446,198
22,HUNEDOARA,"MUNICIPIUL DEVA",86687,DEVA,"GRADINIŢA P.N. NR.3",36,"Alegeri Prezidentiale",1,1570,753,721,32,0,737,16,1750,997,507,230
22,HUNEDOARA,"MUNICIPIUL DEVA",86687,DEVA,"LICEUL DE ARTE SIGISMUND TODUŢĂ",37,"Alegeri Prezidentiale",2,1468,727,683,44,0,714,13,1600,873,451,263
22,HUNEDOARA,"MUNICIPIUL DEVA",86687,DEVA,"LICEUL TEHNOLOGIC ”GRIGORE MOISIL”(FOSTUL LICEU MINIER)",38,"Alegeri Prezidentiale",2,854,454,394,59,1,439,15,950,496,284,155
22,HUNEDOARA,"MUNICIPIUL DEVA",86687,DEVA,"COLEGIUL TEHNIC ENERGETIC DRAGOMIR HURMUZESCU (FOSTA ȘCOALĂ GENERALĂ. NR.5)",39,"Alegeri Prezidentiale",1,1229,635,540,95,0,622,13,1350,715,420,202
22,HUNEDOARA,"MUNICIPIUL DEVA",86687,DEVA,"COLEGIUL TEHNIC ENERGETIC DRAGOMIR HURMUZESCU (FOSTA ȘCOALĂ GENERALĂ. NR.5)",40,"Alegeri Prezidentiale",1,949,456,427,29,0,442,14,1050,594,282,160
22,HUNEDOARA,"MUNICIPIUL DEVA",86687,DEVA,"COLEGIUL TEHNIC ENERGETIC DRAGOMIR HURMUZESCU (FOSTA ȘCOALĂ GENERALĂ. NR.5)",41,"Alegeri Prezidentiale",1,933,472,446,26,0,460,12,1050,578,290,170
22,HUNEDOARA,"MUNICIPIUL DEVA",86687,CRISTUR,"ȘCOALA PRIMARĂ CRISTUR",42,"Alegeri Prezidentiale",1,1384,807,657,53,97,791,16,1500,693,466,325
22,HUNEDOARA,"MUNICIPIUL DEVA",86687,SÂNTUHALM,"CĂMINUL CULTURAL SÎNTUHALM",43,"Alegeri Prezidentiale",1,611,362,274,19,69,354,8,700,338,211,143
22,HUNEDOARA,"MUNICIPIUL DEVA",86687,DEVA,"ŞCOALĂ PRIMARĂ VIILE NOI",44,"Alegeri Prezidentiale",1,829,422,396,25,1,416,6,900,478,263,153
22,HUNEDOARA,"MUNICIPIUL DEVA",86687,DEVA,"ADĂPOSTUL DE URGENŢĂ PE TIMP DE NOAPTE",45,"Alegeri Prezidentiale",1,769,387,364,23,0,373,14,850,463,229,144
22,HUNEDOARA,"MUNICIPIUL DEVA",86687,DEVA,"CANTINA DE AJUTOR SOCIAL (FOSTA CANTINA LICEU MINER)",46,"Alegeri Prezidentiale",1,1044,567,516,51,0,557,10,1150,583,375,182
22,HUNEDOARA,"MUNICIPIUL BRAD",87291,BRAD,"CASA DE CULTURA",47,"Alegeri Prezidentiale",1,885,462,405,57,0,454,8,1000,538,245,209
22,HUNEDOARA,"MUNICIPIUL BRAD",87291,BRAD,"CASA DE CULTURA",48,"Alegeri Prezidentiale",1,948,529,461,31,37,514,15,1050,521,235,279
22,HUNEDOARA,"MUNICIPIUL BRAD",87291,BRAD,"ŞCOALA GIMNAZIALA „MIRCEA SÂNTIMBREANU”",49,"Alegeri Prezidentiale",1,1566,769,726,43,0,757,12,1600,831,399,358
22,HUNEDOARA,"MUNICIPIUL BRAD",87291,BRAD,"ŞCOALA GIMNAZIALĂ „MIRCEA SÂNTIMBREANU”",50,"Alegeri Prezidentiale",1,1264,598,565,33,0,582,16,1350,752,304,278
22,HUNEDOARA,"MUNICIPIUL BRAD",87291,BRAD,"ŞCOALA GIMNAZIALĂ „MIRCEA SÂNTIMBREANU”",51,"Alegeri Prezidentiale",1,1257,598,555,43,0,590,8,1350,752,305,285
22,HUNEDOARA,"MUNICIPIUL BRAD",87291,BRAD,"ŞCOALA GIMNAZIALĂ „MIRCEA SÂNTIMBREANU”",52,"Alegeri Prezidentiale",2,1311,609,572,30,7,594,15,1450,841,294,300
22,HUNEDOARA,"MUNICIPIUL BRAD",87291,BRAD,"LICEUL TEORETIC „AVRAM IANCU” BRAD",53,"Alegeri Prezidentiale",1,1013,468,441,27,0,458,10,1100,632,214,244
22,HUNEDOARA,"MUNICIPIUL BRAD",87291,BRAD,"LICEUL TEORETIC „AVRAM IANCU” BRAD",54,"Alegeri Prezidentiale",1,1042,487,465,22,0,478,9,1150,663,241,237
22,HUNEDOARA,"MUNICIPIUL BRAD",87291,BRAD,"GRĂDINIŢA P.P. ”FLOARE DE COLŢ”",55,"Alegeri Prezidentiale",2,1105,641,536,33,72,632,9,1200,559,299,333
22,HUNEDOARA,"MUNICIPIUL BRAD",87291,BRAD,"ŞCOALA GIMNAZIALĂ „HOREA CLOŞCA ŞI CRIŞAN”",56,"Alegeri Prezidentiale",1,1075,497,441,56,0,488,9,1200,703,248,240
22,HUNEDOARA,"MUNICIPIUL BRAD",87291,"VALEA BRADULUI","ŞCOALA GENERALĂ VALEA BRADULUI",57,"Alegeri Prezidentiale",1,630,310,297,13,0,304,6,700,390,135,169
22,HUNEDOARA,"MUNICIPIUL BRAD",87291,ŢĂRĂŢEL,"CĂMINUL CULTURAL ŢĂRĂŢEL",58,"Alegeri Prezidentiale",1,598,305,275,30,0,301,4,650,345,174,127
22,HUNEDOARA,"MUNICIPIUL BRAD",87291,MESTEACĂN,"CĂMINUL CULTURAL MESTEACĂN",59,"Alegeri Prezidentiale",1,440,227,211,16,0,223,4,500,273,85,138
22,HUNEDOARA,"MUNICIPIUL BRAD",87291,RUDA-BRAD,"CĂMINUL CULTURAL RUDA-BRAD",60,"Alegeri Prezidentiale",1,154,73,61,12,0,72,1,199,126,42,30
22,HUNEDOARA,"MUNICIPIUL HUNEDOARA",86810,HUNEDOARA,"ȘCOALA GIMNAZIALĂ NR. 1 ( FOSTA ȘCOALĂ GENERALĂ NR. 12)",61,"Alegeri Prezidentiale",1,1491,560,544,16,0,550,10,1600,1040,312,238
22,HUNEDOARA,"MUNICIPIUL HUNEDOARA",86810,HUNEDOARA,"ȘCOALA GIMNAZIALĂ NR. 1 ( FOSTA ȘCOALĂ GENERALĂ NR. 12)",62,"Alegeri Prezidentiale",1,1482,437,415,22,0,430,7,1600,1163,242,188
22,HUNEDOARA,"MUNICIPIUL HUNEDOARA",86810,HUNEDOARA,"ȘCOALA GIMNAZIALĂ NR. 1 ( FOSTA ȘCOALĂ GENERALĂ NR. 12)",63,"Alegeri Prezidentiale",1,1454,466,445,21,0,455,11,1600,1134,272,183
22,HUNEDOARA,"MUNICIPIUL HUNEDOARA",86810,HUNEDOARA,"ŞCOALA GIMNAZIALĂ NR. 1 (FOSTA ȘCOALĂ GENERALĂ NR. 9)",64,"Alegeri Prezidentiale",1,1450,554,520,34,0,545,9,1600,1046,331,214
22,HUNEDOARA,"MUNICIPIUL HUNEDOARA",86810,HUNEDOARA,"ŞCOALA GIMNAZIALĂ NR. 1 (FOSTA ŞCOALĂ GENERALĂ NR. 9)",65,"Alegeri Prezidentiale",1,1514,564,548,16,0,553,11,1600,1036,279,274
22,HUNEDOARA,"MUNICIPIUL HUNEDOARA",86810,HUNEDOARA,"ŞCOALA GIMNAZIALĂ NR. 1 (FOSTA ŞCOALĂ GENERALĂ NR. 9)",66,"Alegeri Prezidentiale",1,1518,501,491,10,0,487,14,1600,1099,263,224
22,HUNEDOARA,"MUNICIPIUL HUNEDOARA",86810,HUNEDOARA,"ŞCOALA GIMNAZIALĂ NR. 1 (FOSTA ŞCOALĂ GENERALĂ NR. 9)",67,"Alegeri Prezidentiale",1,1436,606,584,22,0,591,15,1600,994,339,252
22,HUNEDOARA,"MUNICIPIUL HUNEDOARA",86810,HUNEDOARA,"ŞCOALA GIMNAZIALĂ NR. 1 (FOSTA ŞCOALĂ GENERALĂ NR. 9)",68,"Alegeri Prezidentiale",1,1308,545,524,21,0,531,14,1400,855,305,226
22,HUNEDOARA,"MUNICIPIUL HUNEDOARA",86810,HUNEDOARA,"GRĂDINIŢA CU PROGRAM NORMAL MICRO VII PN6",69,"Alegeri Prezidentiale",1,1255,468,447,21,0,459,9,1400,932,259,200
22,HUNEDOARA,"MUNICIPIUL HUNEDOARA",86810,HUNEDOARA,"COLEGIUL ECONOMIC ”EMANUIL GOJDU” (FOSTUL LICEU NR. 2)",70,"Alegeri Prezidentiale",1,1247,598,560,38,0,584,14,1300,702,333,251
22,HUNEDOARA,"MUNICIPIUL HUNEDOARA",86810,HUNEDOARA,"LICEUL TEHNOLOGIC ”CONSTANTIN BURSAN” (FOSTUL LICEU NR. 3)",71,"Alegeri Prezidentiale",1,1294,553,541,12,0,533,20,1400,847,324,209
22,HUNEDOARA,"MUNICIPIUL HUNEDOARA",86810,HUNEDOARA,"COLEGIUL NAŢIONAL DE INFORMATICĂ ”TRAIAN LALESCU” (CLĂDIREA NOUĂ)",72,"Alegeri Prezidentiale",1,1379,775,675,50,50,754,21,1500,725,455,299
22,HUNEDOARA,"MUNICIPIUL HUNEDOARA",86810,HUNEDOARA,"COLEGIUL NAŢIONAL DE INFORMATICĂ ”TRAIAN LALESCU” ( FOSTA ŞCOALĂ GENERALĂ NR. 4)",73,"Alegeri Prezidentiale",3,1132,712,617,38,57,693,19,1300,588,411,282
22,HUNEDOARA,"MUNICIPIUL HUNEDOARA",86810,HUNEDOARA,"COLEGIUL NAŢIONAL DE INFORMATICĂ ”TRAIAN LALESCU” ( FOSTA ŞCOALĂ GENERALĂ NR. 4)",74,"Alegeri Prezidentiale",1,1261,628,508,21,99,615,13,1400,772,351,264
22,HUNEDOARA,"MUNICIPIUL HUNEDOARA",86810,HUNEDOARA,"COLEGIUL NAȚIONAL ”IANCU DE HUNEDOARA” (FOSTA ȘCOALĂ GENERALĂ NR. 5)",75,"Alegeri Prezidentiale",1,1469,688,589,60,39,673,15,1600,912,393,280
22,HUNEDOARA,"MUNICIPIUL HUNEDOARA",86810,HUNEDOARA,"COLEGIUL NAȚIONAL ”IANCU DE HUNEDOARA” (FOSTA ȘCOALĂ GENERALĂ NR. 5)",76,"Alegeri Prezidentiale",1,1137,478,437,41,0,457,21,1200,722,302,155
22,HUNEDOARA,"MUNICIPIUL HUNEDOARA",86810,HUNEDOARA,"COLEGIUL NAȚIONAL ”IANCU DE HUNEDOARA” (FOSTA ȘCOALĂ GENERALĂ NR. 5)",77,"Alegeri Prezidentiale",1,1209,637,607,30,0,618,19,1300,663,375,243
22,HUNEDOARA,"MUNICIPIUL HUNEDOARA",86810,HĂŞDAT,"ŞCOALA PRIMARĂ HĂŞDAT",78,"Alegeri Prezidentiale",1,376,172,146,26,0,167,5,400,228,123,44
22,HUNEDOARA,"MUNICIPIUL HUNEDOARA",86810,HUNEDOARA,"ŞCOALA GIMNAZIALĂ NR.6 (FOSTA ȘCOALĂ GENERALĂ NR. 6)",79,"Alegeri Prezidentiale",1,1514,772,721,51,0,746,26,1600,828,432,314
22,HUNEDOARA,"MUNICIPIUL HUNEDOARA",86810,HUNEDOARA,"ŞCOALA GIMNAZIALĂ NR.6 (FOSTA ȘCOALĂ GENERALĂ NR. 6)",80,"Alegeri Prezidentiale",1,1585,682,649,33,0,660,22,1700,1018,387,273
22,HUNEDOARA,"MUNICIPIUL HUNEDOARA",86810,HUNEDOARA,"COLEGIUL TEHNIC ”MATEI CORVIN” (FOSTUL LICEU NR. 1)",81,"Alegeri Prezidentiale",1,1075,519,485,34,0,507,12,1200,681,264,243
22,HUNEDOARA,"MUNICIPIUL HUNEDOARA",86810,HUNEDOARA,"GRĂDINIŢA CU PROGRAM NORMAL NR.4 MICRO I (LÂNGĂ FOSTA ŞCOALĂ GENERALĂ NR. 3)",82,"Alegeri Prezidentiale",2,1541,686,646,38,2,665,21,1700,1014,391,274
22,HUNEDOARA,"MUNICIPIUL HUNEDOARA",86810,HUNEDOARA,"GRĂDINIŢA CU PROGRAM PRELUNGIT ”PITICOT”",83,"Alegeri Prezidentiale",1,877,439,409,30,0,426,13,950,511,231,195
22,HUNEDOARA,"MUNICIPIUL HUNEDOARA",86810,HUNEDOARA,"GRĂDINIŢA CU PROGRAM PRELUNGIT ”PITICOT”",84,"Alegeri Prezidentiale",1,1167,502,480,22,0,493,9,1300,798,277,216
22,HUNEDOARA,"MUNICIPIUL HUNEDOARA",86810,HUNEDOARA,"COLEGIUL ECONOMIC ”EMANUIL GOJDU” (FOSTA ŞCOALĂ GENERALĂ NR. 3)",85,"Alegeri Prezidentiale",1,1361,694,653,39,2,674,20,1500,806,411,263
22,HUNEDOARA,"MUNICIPIUL HUNEDOARA",86810,HUNEDOARA,"COLEGIUL ECONOMIC ”EMANUIL GOJDU” (FOSTA ŞCOALĂ GENERALĂ NR. 3)",86,"Alegeri Prezidentiale",1,1350,721,690,29,2,692,29,1500,779,409,283
22,HUNEDOARA,"MUNICIPIUL HUNEDOARA",86810,HUNEDOARA,"ŞCOALA GIMNAZIALĂ NR. 7 (FOSTA ȘCOALĂ GENERALĂ NR. 7)",87,"Alegeri Prezidentiale",2,1179,585,562,23,0,575,10,1300,715,360,215
22,HUNEDOARA,"MUNICIPIUL HUNEDOARA",86810,HUNEDOARA,"ŞCOALA GIMNAZIALĂ NR. 7 (FOSTA ȘCOALĂ GENERALĂ NR. 7)",88,"Alegeri Prezidentiale",2,1206,550,522,28,0,536,14,1300,750,325,211
22,HUNEDOARA,"MUNICIPIUL HUNEDOARA",86810,HUNEDOARA,"ŞCOALA GIMNAZIALĂ NR. 7 (FOSTA ȘCOALĂ GENERALĂ NR. 7)",89,"Alegeri Prezidentiale",1,1214,549,520,29,0,532,17,1350,801,294,238
22,HUNEDOARA,"MUNICIPIUL HUNEDOARA",86810,HUNEDOARA,"GRĂDINIȚA CU PROGRAM PRELUNGIT „FLOAREA SOARELUI” HUNEDOARA",90,"Alegeri Prezidentiale",1,1165,537,510,27,0,526,11,1300,763,291,235
22,HUNEDOARA,"MUNICIPIUL HUNEDOARA",86810,HUNEDOARA,"GRĂDINIȚA CU PROGRAM PRELUNGIT „FLOAREA SOARELUI” HUNEDOARA",91,"Alegeri Prezidentiale",1,1014,473,448,25,0,456,17,1100,627,268,188
22,HUNEDOARA,"MUNICIPIUL HUNEDOARA",86810,HUNEDOARA,"GRĂDINIȚA CU PROGRAM PRELUNGIT „FLOAREA SOARELUI” HUNEDOARA",92,"Alegeri Prezidentiale",1,1129,482,466,16,0,462,20,1250,768,267,195
22,HUNEDOARA,"MUNICIPIUL HUNEDOARA",86810,HUNEDOARA,"GRĂDINIŢA CU ORAR NORMAL MICRO III PN 2 ”ZORI DE ZI”",93,"Alegeri Prezidentiale",1,1340,591,559,32,0,575,16,1400,809,333,242
22,HUNEDOARA,"MUNICIPIUL HUNEDOARA",86810,HUNEDOARA,"ŞCOALA GIMNAZIALĂ NR. 2 (FOSTA ŞCOALĂ GENERALĂ NR. 2)",94,"Alegeri Prezidentiale",1,1535,707,685,22,0,684,23,1700,993,375,309
22,HUNEDOARA,"MUNICIPIUL HUNEDOARA",86810,HUNEDOARA,"ŞCOALA GIMNAZIALĂ NR. 2 (FOSTA ŞCOALĂ GENERALĂ NR. 2)",95,"Alegeri Prezidentiale",1,1518,787,731,56,0,767,20,1600,813,462,305
22,HUNEDOARA,"MUNICIPIUL HUNEDOARA",86810,HUNEDOARA,"ŞCOALA GIMNAZIALĂ NR. 2 (FOSTA ŞCOALĂ GENERALĂ NR. 2)",96,"Alegeri Prezidentiale",1,1330,657,637,20,0,635,22,1450,793,358,277
22,HUNEDOARA,"MUNICIPIUL HUNEDOARA",86810,HUNEDOARA,"ŞCOALA GIMNAZIALĂ NR. 2 (FOSTA ŞCOALĂ GENERALĂ NR. 2)",97,"Alegeri Prezidentiale",1,1544,646,634,12,0,624,22,1700,1054,355,269
22,HUNEDOARA,"MUNICIPIUL HUNEDOARA",86810,HUNEDOARA,"CENTRUL ŞCOLAR PENTRU EDUCAŢIE INCLUZIVĂ ”RUDOLF STEINER” (FOSTUL CENTRU DE ZI)",98,"Alegeri Prezidentiale",1,1164,459,445,14,0,448,11,1300,841,238,210
22,HUNEDOARA,"MUNICIPIUL HUNEDOARA",86810,HUNEDOARA,"CENTRUL ŞCOLAR PENTRU EDUCAŢIE INCLUZIVĂ ”RUDOLF STEINER” (FOSTUL CENTRU DE ZI)",99,"Alegeri Prezidentiale",1,1156,430,408,22,0,418,12,1250,820,261,157
22,HUNEDOARA,"MUNICIPIUL HUNEDOARA",86810,HUNEDOARA,"ȘCOALA GIMNAZIALĂ NR. 2 (FOSTA ȘCOALĂ GENERALĂ NR. 11)",100,"Alegeri Prezidentiale",1,1315,590,555,35,0,571,19,1400,810,327,244
22,HUNEDOARA,"MUNICIPIUL HUNEDOARA",86810,HUNEDOARA,"ȘCOALA GIMNAZIALĂ NR. 2 (FOSTA ȘCOALĂ GENERALĂ NR. 11)",101,"Alegeri Prezidentiale",1,1449,683,651,32,0,669,14,1600,917,382,287
22,HUNEDOARA,"MUNICIPIUL HUNEDOARA",86810,HUNEDOARA,"ȘCOALA GIMNAZIALĂ NR. 2 (FOSTA ȘCOALĂ GENERALĂ NR. 11)",102,"Alegeri Prezidentiale",1,1225,494,482,12,0,478,16,1350,856,271,207
22,HUNEDOARA,"MUNICIPIUL HUNEDOARA",86810,HUNEDOARA,"ȘCOALA GIMNAZIALĂ NR. 2 (FOSTA ȘCOALĂ GENERALĂ NR. 11)",103,"Alegeri Prezidentiale",1,1309,591,578,13,0,582,9,1400,809,365,217
22,HUNEDOARA,"MUNICIPIUL HUNEDOARA",86810,HUNEDOARA,"CĂMIN CULTURAL BUITURI",104,"Alegeri Prezidentiale",1,667,357,342,15,0,343,14,750,393,210,133
22,HUNEDOARA,"MUNICIPIUL HUNEDOARA",86810,HUNEDOARA,"SEDIUL PRIMĂRIEI MUNICIPIULUI HUNEDOARA (FOSTA B.R.D.)",105,"Alegeri Prezidentiale",1,1622,802,739,63,0,776,26,1700,898,449,327
22,HUNEDOARA,"MUNICIPIUL HUNEDOARA",86810,RĂCĂŞTIA,"ŞCOALA PRIMARĂ RĂCĂŞTIA",106,"Alegeri Prezidentiale",2,541,265,252,13,0,261,4,600,335,198,63
22,HUNEDOARA,"MUNICIPIUL HUNEDOARA",86810,HUNEDOARA,"COLEGIUL NAȚIONAL ”IANCU DE HUNEDOARA” (FOSTA ȘCOALĂ GENERALĂ ZLAȘTI)",107,"Alegeri Prezidentiale",1,442,238,224,14,0,236,2,500,262,146,90
22,HUNEDOARA,"MUNICIPIUL HUNEDOARA",86810,BOŞ,"CĂMIN CULTURAL BOŞ (GRĂDINIŢA)",108,"Alegeri Prezidentiale",1,482,255,242,13,0,248,7,550,295,166,82
22,HUNEDOARA,"MUNICIPIUL HUNEDOARA",86810,"PEŞTIŞU MARE","ŞCOALA PRIMARĂ PEŞTIŞUL MARE",109,"Alegeri Prezidentiale",1,1037,520,493,27,0,515,5,1150,630,322,193
22,HUNEDOARA,"MUNICIPIUL LUPENI",87059,LUPENI,"ŞCOALA GIMNAZIALĂ NR. 1, LUPENI",110,"Alegeri Prezidentiale",1,1565,736,716,20,0,722,14,1700,964,258,464
22,HUNEDOARA,"MUNICIPIUL LUPENI",87059,LUPENI,"ŞCOALA GIMNAZIALĂ NR. 1",111,"Alegeri Prezidentiale",1,1356,593,531,34,28,580,13,1500,907,258,322
22,HUNEDOARA,"MUNICIPIUL LUPENI",87059,LUPENI,"ŞCOALA GIMNAZIALĂ NR. 1",112,"Alegeri Prezidentiale",1,1108,502,484,18,0,491,11,1250,748,168,323
22,HUNEDOARA,"MUNICIPIUL LUPENI",87059,LUPENI,"GRĂDINIȚA CU PROGRAM NORMAL ŞCOALA GIMNAZIALĂ NR. 1",113,"Alegeri Prezidentiale",1,835,345,334,11,0,343,2,900,555,120,223
22,HUNEDOARA,"MUNICIPIUL LUPENI",87059,LUPENI,"SPCLEP LUPENI",114,"Alegeri Prezidentiale",1,1691,752,723,29,0,728,24,1800,1048,295,433
22,HUNEDOARA,"MUNICIPIUL LUPENI",87059,LUPENI,"ŞCOALA GIMNAZIALĂ NR. 3",115,"Alegeri Prezidentiale",2,1016,511,479,31,1,491,20,1100,589,214,277
22,HUNEDOARA,"MUNICIPIUL LUPENI",87059,LUPENI,"ŞCOALA GIMNAZIALĂ NR. 3",116,"Alegeri Prezidentiale",2,986,485,450,33,2,477,8,1100,615,216,261
22,HUNEDOARA,"MUNICIPIUL LUPENI",87059,LUPENI,"GRĂDINIŢA CU PROGRAM NORMAL NR. 1 LUPENI",117,"Alegeri Prezidentiale",1,1276,527,503,21,3,508,19,1392,865,213,295
22,HUNEDOARA,"MUNICIPIUL LUPENI",87059,LUPENI,"GRĂDINIŢA CU PROGRAM NORMAL NR. 1 LUPENI",118,"Alegeri Prezidentiale",1,1600,632,607,25,0,617,15,1700,1068,209,408
22,HUNEDOARA,"MUNICIPIUL LUPENI",87059,LUPENI,"GRĂDINIȚA CU PROGRAM SĂPTĂMÂNAL LUMEA COPIILOR",119,"Alegeri Prezidentiale",1,1585,739,716,22,1,706,33,1700,961,262,444
22,HUNEDOARA,"MUNICIPIUL LUPENI",87059,LUPENI,"LICEUL TEORETIC ”MIRCEA ELIADE” LUPENI",120,"Alegeri Prezidentiale",1,1405,551,522,29,0,538,13,1500,949,195,343
22,HUNEDOARA,"MUNICIPIUL LUPENI",87059,LUPENI,"LICEUL TEORETIC ”MIRCEA ELIADE” LUPENI",121,"Alegeri Prezidentiale",1,933,316,296,20,0,314,2,1001,685,136,178
22,HUNEDOARA,"MUNICIPIUL LUPENI",87059,LUPENI,"ŞCOALA GIMNAZIALĂ NR. 2 LUPENI",122,"Alegeri Prezidentiale",1,1302,572,544,28,0,559,13,1450,878,194,365
22,HUNEDOARA,"MUNICIPIUL LUPENI",87059,LUPENI,"ŞCOALA GIMNAZIALĂ NR. 2 LUPENI",123,"Alegeri Prezidentiale",1,1051,498,483,15,0,486,12,1150,652,180,306
22,HUNEDOARA,"MUNICIPIUL LUPENI",87059,LUPENI,"GRĂDINIŢA CU PROGRAM NORMAL NR. 2 LUPENI",124,"Alegeri Prezidentiale",1,951,405,385,20,0,396,9,1050,645,169,227
22,HUNEDOARA,"MUNICIPIUL LUPENI",87059,LUPENI,"GRĂDINIŢA CU PROGRAM NORMAL NR. 2 LUPENI",125,"Alegeri Prezidentiale",1,945,376,356,20,0,368,8,1050,674,149,219
22,HUNEDOARA,"MUNICIPIUL LUPENI",87059,LUPENI,"GRĂDINIŢA CU PROGRAM NORMAL NR. 2 LUPENI",126,"Alegeri Prezidentiale",1,1266,505,488,17,0,492,13,1350,845,184,308
22,HUNEDOARA,"MUNICIPIUL LUPENI",87059,LUPENI,"SC UNIVERSAL EDIL SA",127,"Alegeri Prezidentiale",1,801,310,293,17,0,305,5,850,540,136,169
22,HUNEDOARA,"MUNICIPIUL ORĂŞTIE",87638,ORĂŞTIE,"CASA DE CULTURĂ",128,"Alegeri Prezidentiale",1,1641,911,776,135,0,892,19,1900,989,585,307
22,HUNEDOARA,"MUNICIPIUL ORĂŞTIE",87638,ORĂŞTIE,"SALA DE SPORT A ŞCOLII GIMNAZIALE ” DOMINIC STANCA ”",129,"Alegeri Prezidentiale",1,1557,649,600,49,0,631,18,1700,1051,435,196
22,HUNEDOARA,"MUNICIPIUL ORĂŞTIE",87638,ORĂŞTIE,"GRĂDINIŢA CU PROGRAM NORMAL ”SCUFIŢA ROŞIE”",130,"Alegeri Prezidentiale",2,1429,657,556,42,59,641,15,1550,894,404,237
22,HUNEDOARA,"MUNICIPIUL ORĂŞTIE",87638,ORĂŞTIE,"ŞC. GIM. ”D.STANCA”",131,"Alegeri Prezidentiale",2,1469,669,588,81,0,659,10,1600,931,470,189
22,HUNEDOARA,"MUNICIPIUL ORĂŞTIE",87638,ORĂŞTIE,"COMPLEX SERVICII PENTRU VÂRSTNICI",132,"Alegeri Prezidentiale",1,1624,813,705,108,0,804,9,1800,987,543,261
22,HUNEDOARA,"MUNICIPIUL ORĂŞTIE",87638,ORĂŞTIE,"ŞC.GIM. ”DR. AUREL VLAD”",133,"Alegeri Prezidentiale",1,1513,704,664,38,2,685,19,1600,896,430,255
22,HUNEDOARA,"MUNICIPIUL ORĂŞTIE",87638,ORĂŞTIE,"ŞC.GIM. I-IV GARĂ",134,"Alegeri Prezidentiale",1,1482,640,603,37,0,632,8,1600,960,431,201
22,HUNEDOARA,"MUNICIPIUL ORĂŞTIE",87638,ORĂŞTIE,"OFICIUL DE GOSPODĂRIRE A APELOR",135,"Alegeri Prezidentiale",1,1716,908,848,60,0,887,21,1800,892,547,340
22,HUNEDOARA,"MUNICIPIUL ORĂŞTIE",87638,ORĂŞTIE,"LIC.TEHNOLOGIC ”N.OLAHUS”",136,"Alegeri Prezidentiale",1,1378,651,609,41,1,639,12,1500,849,398,241
22,HUNEDOARA,"MUNICIPIUL ORĂŞTIE",87638,ORĂŞTIE,"COLEGIUL NAŢIONAL ”AUREL VLAICU”",137,"Alegeri Prezidentiale",1,1363,607,532,74,1,599,8,1450,843,372,227
22,HUNEDOARA,"MUNICIPIUL ORĂŞTIE",87638,ORĂŞTIE,"PRIMĂRIA MUNICIPIULUI ORĂŞTIE",138,"Alegeri Prezidentiale",1,1409,661,607,54,0,649,12,1500,839,412,237
22,HUNEDOARA,"MUNICIPIUL ORĂŞTIE",87638,ORĂŞTIE,"SERVICIUL PUBLIC DE ASISTENŢĂ SOCIALĂ",139,"Alegeri Prezidentiale",1,1716,791,743,48,0,774,17,1800,1009,534,240
22,HUNEDOARA,"MUNICIPIUL PETROŞANI",86990,PETROŞANI,"ȘCOALA GIMNAZIALĂ ”I. G. DUCA” (ȘCOALA GENERALĂ NR.1) SEDIUL VECHI",140,"Alegeri Prezidentiale",2,1673,839,791,48,0,799,40,1800,961,433,366
22,HUNEDOARA,"MUNICIPIUL PETROŞANI",86990,PETROŞANI,"ȘCOALA GIMNAZIALĂ I.G.DUCA (ȘCOALA GENERALĂ NR. 1 - SEDIUL VECHI)",141,"Alegeri Prezidentiale",1,1508,772,717,55,0,750,22,1650,878,378,372
22,HUNEDOARA,"MUNICIPIUL PETROŞANI",86990,PETROŞANI,"ȘCOALA GIMNAZIALĂ I.G. DUCA (ȘCOALA GENERALĂ NR. 1 - SEDIUL NOU)",142,"Alegeri Prezidentiale",1,1365,716,682,34,0,695,21,1500,784,321,374
22,HUNEDOARA,"MUNICIPIUL PETROŞANI",86990,PETROŞANI,"AMFITEATRUL UNIVERSITĂȚII",143,"Alegeri Prezidentiale",1,1393,684,614,70,0,667,17,1550,866,356,311
22,HUNEDOARA,"MUNICIPIUL PETROŞANI",86990,PETROŞANI,"CLUB SPORTIV ȘCOLAR",144,"Alegeri Prezidentiale",1,1002,498,462,36,0,482,16,1100,602,239,243
22,HUNEDOARA,"MUNICIPIUL PETROŞANI",86990,PETROŞANI,"ȘCOALA GIMNAZIALĂ AVRAM STANCA (ȘCOALA GENERALĂ NR.4)",145,"Alegeri Prezidentiale",1,1061,553,514,39,0,532,21,1150,597,278,254
22,HUNEDOARA,"MUNICIPIUL PETROŞANI",86990,PETROŞANI,"ȘCOALA GIMNAZIALĂ AVRAM STANCA (ȘCOALA GENERALĂ NR.4)",146,"Alegeri Prezidentiale",1,1670,841,770,71,0,821,20,1800,959,421,400
22,HUNEDOARA,"MUNICIPIUL PETROŞANI",86990,PETROŞANI,"COLEGIUL NAȚIONAL ”MIHAI EMINESCU” (LICEUL TEORETIC)",147,"Alegeri Prezidentiale",1,1801,800,752,37,11,777,23,1900,1100,358,419
22,HUNEDOARA,"MUNICIPIUL PETROŞANI",86990,PETROŞANI,"GRĂDINIȚA NR.3 CU PROGRAM PRELUNGIT",148,"Alegeri Prezidentiale",1,915,522,444,24,54,511,11,1050,528,257,254
22,HUNEDOARA,"MUNICIPIUL PETROŞANI",86990,PETROŞANI,"COLEGIUL NAȚIONAL DE INFORMATICĂ CARMEN SYLVA (LICEUL DE INFORMATICĂ)",149,"Alegeri Prezidentiale",1,1403,727,667,22,38,701,26,1550,823,349,352
22,HUNEDOARA,"MUNICIPIUL PETROŞANI",86990,PETROŞANI,"COLEGIUL ECONOMIC ”HERMES ”",150,"Alegeri Prezidentiale",1,1511,759,687,31,41,747,12,1650,891,345,402
22,HUNEDOARA,"MUNICIPIUL PETROŞANI",86990,PETROŞANI,"COLEGIUL NAȚIONAL DE INFORMATICĂ ”CARMEN SYLVA” (GRĂDINIȚA CU PROGRAM NORMAL NR.5)",151,"Alegeri Prezidentiale",1,1517,674,653,21,0,658,16,1650,976,289,369
22,HUNEDOARA,"MUNICIPIUL PETROŞANI",86990,PETROŞANI,"COLEGIUL NAȚIONAL DE INFORMATICĂ ”CARMEN SYLVA” (GRĂDINIȚA CU PROGRAM NORMAL NR.5)",152,"Alegeri Prezidentiale",1,1443,604,582,21,1,585,19,1600,996,270,315
22,HUNEDOARA,"MUNICIPIUL PETROŞANI",86990,PETROŞANI,"ȘCOALA GIMNAZIALĂ CARMEN SYLVA (ȘCOALA GENERALĂ NR.6)",153,"Alegeri Prezidentiale",1,1671,793,768,24,1,770,23,1800,1007,361,409
22,HUNEDOARA,"MUNICIPIUL PETROŞANI",86990,PETROŞANI,"ȘCOALA GIMNAZIALĂ CARMEN SYLVA (ȘCOALA GENERALĂ NR.6)",154,"Alegeri Prezidentiale",2,1642,592,576,16,0,578,14,1800,1208,228,350
22,HUNEDOARA,"MUNICIPIUL PETROŞANI",86990,PETROŞANI,"GRĂDINIȚA CU PROGRAM PRELUNGIT AEROPORT",155,"Alegeri Prezidentiale",1,883,389,334,21,34,372,17,950,561,141,231
22,HUNEDOARA,"MUNICIPIUL PETROŞANI",86990,PETROŞANI,"BIBLIOTECA MUNICIPALĂ PETROȘANI",156,"Alegeri Prezidentiale",1,1488,614,595,19,0,597,17,1650,1036,259,338
22,HUNEDOARA,"MUNICIPIUL PETROŞANI",86990,PETROŞANI,"BIBLIOTECA MUNICIPALĂ PETROȘANI",157,"Alegeri Prezidentiale",1,1726,614,584,30,0,585,29,1850,1236,224,361
22,HUNEDOARA,"MUNICIPIUL PETROŞANI",86990,PETROŞANI,"ȘCOALA GIMNAZIALĂ NR.7",158,"Alegeri Prezidentiale",1,1695,647,618,29,0,626,21,1800,1153,222,404
22,HUNEDOARA,"MUNICIPIUL PETROŞANI",86990,PETROŞANI,"ȘCOALA GIMNAZIALĂ NR.7",159,"Alegeri Prezidentiale",1,1825,646,628,18,0,627,19,2000,1354,255,372
22,HUNEDOARA,"MUNICIPIUL PETROŞANI",86990,PETROŞANI,"S.C. GENERAL TRANS S.A.",160,"Alegeri Prezidentiale",1,642,304,286,18,0,293,11,700,396,140,153
22,HUNEDOARA,"MUNICIPIUL PETROŞANI",86990,PETROŞANI,"CASA PENSIONARILOR",161,"Alegeri Prezidentiale",1,1464,573,556,15,2,558,15,1600,1027,289,269
22,HUNEDOARA,"MUNICIPIUL PETROŞANI",86990,PETROŞANI,"CASA PENSIONARILOR",162,"Alegeri Prezidentiale",1,1029,429,407,22,0,424,5,1100,671,172,252
22,HUNEDOARA,"MUNICIPIUL PETROŞANI",86990,PETROŞANI,"ȘCOALA GIMNAZIALĂ NR. 2",163,"Alegeri Prezidentiale",1,1207,478,461,17,0,458,20,1300,822,174,284
22,HUNEDOARA,"MUNICIPIUL PETROŞANI",86990,PETROŞANI,"SEDIUL S.C. TERMOFICARE",164,"Alegeri Prezidentiale",1,1131,482,456,26,0,472,10,1250,768,200,272
22,HUNEDOARA,"MUNICIPIUL PETROŞANI",86990,PETROŞANI,"COLEGIUL NAŢIONAL ”MIHAI EMINESCU” (ŞCOALA GIMNAZIALĂ DÂLJA MARE)",165,"Alegeri Prezidentiale",1,170,117,107,10,0,113,4,200,83,19,94
22,HUNEDOARA,"MUNICIPIUL VULCAN",87175,VULCAN,"GRĂDINIȚA PN+PP NR. 1",166,"Alegeri Prezidentiale",1,1176,489,465,24,0,478,11,1300,811,187,291
22,HUNEDOARA,"MUNICIPIUL VULCAN",87175,VULCAN,"ȘCOALĂ GIMNAZIALĂ NR. 4",167,"Alegeri Prezidentiale",1,1033,469,450,19,0,451,18,1100,631,184,267
22,HUNEDOARA,"MUNICIPIUL VULCAN",87175,VULCAN,"ȘCOALA GIMNAZIALĂ NR. 4",168,"Alegeri Prezidentiale",2,1090,472,452,20,0,446,26,1200,728,161,285
22,HUNEDOARA,"MUNICIPIUL VULCAN",87175,VULCAN,"CANTINA DE AJUTOR SOCIAL",169,"Alegeri Prezidentiale",1,1349,559,542,17,0,550,9,1500,941,217,333
22,HUNEDOARA,"MUNICIPIUL VULCAN",87175,VULCAN,"LICEUL TEHNOLOGIC ”MIHAI VITEAZU” VULCAN",170,"Alegeri Prezidentiale",1,1072,477,430,25,22,469,8,1200,723,202,267
22,HUNEDOARA,"MUNICIPIUL VULCAN",87175,VULCAN,"LICEUL TEHNOLOGIC ”MIHAI VITEAZU” VULCAN",171,"Alegeri Prezidentiale",1,1070,451,443,8,0,436,15,1200,749,169,267
22,HUNEDOARA,"MUNICIPIUL VULCAN",87175,VULCAN,"ȘCOALA GIMNAZIALĂ NR. 5",172,"Alegeri Prezidentiale",1,1313,573,554,19,0,560,13,1400,827,223,337
22,HUNEDOARA,"MUNICIPIUL VULCAN",87175,VULCAN,"ȘCOALA GIMNAZIALĂ NR. 5",173,"Alegeri Prezidentiale",1,1489,664,641,21,2,645,19,1550,886,261,384
22,HUNEDOARA,"MUNICIPIUL VULCAN",87175,VULCAN,"STADIONUL CENTRAL",174,"Alegeri Prezidentiale",1,1257,564,546,18,0,547,17,1400,836,223,324
22,HUNEDOARA,"MUNICIPIUL VULCAN",87175,VULCAN,"SALA DE SPORT",175,"Alegeri Prezidentiale",1,1470,591,575,16,0,579,12,1600,1009,232,347
22,HUNEDOARA,"MUNICIPIUL VULCAN",87175,VULCAN,"ȘCOALA GIMNAZIALĂ NR. 6",176,"Alegeri Prezidentiale",1,1245,395,375,20,0,386,9,1350,955,178,208
22,HUNEDOARA,"MUNICIPIUL VULCAN",87175,VULCAN,"ȘCOALA GIMNAZIALĂ NR. 6",177,"Alegeri Prezidentiale",1,1371,464,440,24,0,453,11,1500,1036,181,272
22,HUNEDOARA,"MUNICIPIUL VULCAN",87175,VULCAN,"ȘCOALA GIMNAZIALĂ NR. 6,",178,"Alegeri Prezidentiale",1,1449,522,509,13,0,504,18,1600,1078,198,306
22,HUNEDOARA,"MUNICIPIUL VULCAN",87175,VULCAN,"GRĂDINIȚA CU PROGRAM NORMAL DIN CADRUL ȘCOLII GIMNAZIALE NR. 6",179,"Alegeri Prezidentiale",1,1305,441,421,20,0,435,6,1400,959,184,251
22,HUNEDOARA,"MUNICIPIUL VULCAN",87175,VULCAN,"ȘCOALA GIMNAZIALĂ TEODORA LUCACIU",180,"Alegeri Prezidentiale",1,1215,504,483,21,0,490,14,1350,846,174,316
22,HUNEDOARA,"MUNICIPIUL VULCAN",87175,VULCAN,"ȘCOALA GIMNAZIALĂ TEODORA LUCACIU",181,"Alegeri Prezidentiale",2,944,412,396,16,0,401,11,1000,588,151,250
22,HUNEDOARA,"MUNICIPIUL VULCAN",87175,VULCAN,"CLUBUL COPIILOR ȘI ELEVILOR",182,"Alegeri Prezidentiale",1,957,423,412,11,0,411,12,1050,627,157,254
22,HUNEDOARA,"MUNICIPIUL VULCAN",87175,VULCAN,"ȘCOALA NR. 2",183,"Alegeri Prezidentiale",1,837,350,337,13,0,341,9,900,550,126,215
22,HUNEDOARA,"MUNICIPIUL VULCAN",87175,VULCAN,"ȘCOALA GIMNAZIALĂ NR. 3",184,"Alegeri Prezidentiale",1,1394,702,685,17,0,685,17,1550,848,307,378
22,HUNEDOARA,"ORAŞ ANINOASA",87219,ANINOASA,"SCOALA GIMNAZIALA ”SF. VARVARA” ANINOASA",185,"Alegeri Prezidentiale",1,1536,657,625,31,1,641,16,1700,1043,205,436
22,HUNEDOARA,"ORAŞ ANINOASA",87219,ANINOASA,"STADIONUL ”MINERUL ANINOASA”",186,"Alegeri Prezidentiale",1,888,380,364,16,0,374,6,1000,620,118,256
22,HUNEDOARA,"ORAŞ ANINOASA",87219,ISCRONI,"SCOALA GIMNAZIALA ISCRONI",187,"Alegeri Prezidentiale",1,1303,572,533,36,3,557,15,1400,828,235,322
22,HUNEDOARA,"ORAŞ CĂLAN",87424,CĂLAN,"CONSILIUL LOCAL CĂLAN",188,"Alegeri Prezidentiale",1,1053,489,431,43,15,480,9,1150,661,312,168
22,HUNEDOARA,"ORAŞ CĂLAN",87424,CĂLAN,"ŞCOALA GIMNAZIALĂ",189,"Alegeri Prezidentiale",1,1121,466,445,21,0,458,8,1200,734,268,190
22,HUNEDOARA,"ORAŞ CĂLAN",87424,CĂLAN,"ŞCOALA GIMNAZIALĂ",190,"Alegeri Prezidentiale",1,1461,576,545,31,0,556,20,1600,1024,348,208
22,HUNEDOARA,"ORAŞ CĂLAN",87424,CĂLAN,"LICEU TEHNOLOGIC OVID DENSUŞIANU",191,"Alegeri Prezidentiale",1,1525,645,615,30,0,628,17,1650,1005,376,252
22,HUNEDOARA,"ORAŞ CĂLAN",87424,CĂLAN,"CENTRUL DE SĂNĂTATE MULTIFUNCŢIONAL",192,"Alegeri Prezidentiale",1,1475,658,636,22,0,643,15,1600,942,440,203
22,HUNEDOARA,"ORAŞ CĂLAN",87424,CĂLAN,"CASA CĂSĂTORIILOR",193,"Alegeri Prezidentiale",1,1394,622,585,35,2,612,10,1500,878,368,244
22,HUNEDOARA,"ORAŞ CĂLAN",87424,"NĂDĂŞTIA DE JOS","CĂMINUL CULTURAL",194,"Alegeri Prezidentiale",1,263,168,139,28,1,167,1,300,132,133,34
22,HUNEDOARA,"ORAŞ CĂLAN",87424,"NĂDĂŞTIA DE SUS","CĂMINUL CULTURAL",195,"Alegeri Prezidentiale",2,222,155,115,40,0,151,4,250,95,92,59
22,HUNEDOARA,"ORAŞ CĂLAN",87424,STREI,"CĂMINUL CULTURAL",196,"Alegeri Prezidentiale",1,316,170,145,25,0,169,1,350,180,123,46
22,HUNEDOARA,"ORAŞ CĂLAN",87424,STREI-SĂCEL,"CĂMINUL CULTURAL",197,"Alegeri Prezidentiale",1,156,95,80,15,0,93,2,200,105,62,31
22,HUNEDOARA,"ORAŞ CĂLAN",87424,"VALEA SÂNGEORGIULUI","CĂMINUL CULTURAL",198,"Alegeri Prezidentiale",1,252,151,135,16,0,149,2,300,149,84,65
22,HUNEDOARA,"ORAŞ CĂLAN",87424,BATIZ,"ŞCOALA PRIMARĂ",199,"Alegeri Prezidentiale",1,489,175,143,32,0,172,3,550,375,114,58
22,HUNEDOARA,"ORAŞ CĂLAN",87424,GRID,"ŞCOALA PRIMARĂ",200,"Alegeri Prezidentiale",1,201,139,109,30,0,134,5,250,111,80,54
22,HUNEDOARA,"ORAŞ CĂLAN",87424,SÂNCRAI,"ŞCOALA PRIMARĂ SÎNCRAI",201,"Alegeri Prezidentiale",1,252,119,104,15,0,118,1,300,181,73,45
22,HUNEDOARA,"ORAŞ CĂLAN",87424,"SÂNTĂMĂRIA DE PIATRĂ","CASA PAROHIALĂ",202,"Alegeri Prezidentiale",1,122,76,62,14,0,75,1,150,74,45,30
22,HUNEDOARA,"ORAŞ CĂLAN",87424,STREISÂNGEORGIU,"CĂMINUL CULTURAL STREISÎNGEORGIU",203,"Alegeri Prezidentiale",1,623,354,332,22,0,344,10,700,346,237,107
22,HUNEDOARA,"ORAŞ GEOAGIU",89561,GEOAGIU,"SEDIUL PRIMARIEI GEOAGIU",204,"Alegeri Prezidentiale",1,1196,777,581,79,117,763,14,1300,523,491,272
22,HUNEDOARA,"ORAŞ GEOAGIU",89561,GEOAGIU,"GRĂDINIŢA CU PROGRAM NORMAL NR.1 GEOAGIU,",205,"Alegeri Prezidentiale",1,1183,588,545,43,0,578,10,1250,662,377,201
22,HUNEDOARA,"ORAŞ GEOAGIU",89561,"AUREL VLAICU","CĂMINUL CULTURAL AUREL VLAICU",206,"Alegeri Prezidentiale",1,766,434,372,62,0,428,6,850,416,315,113
22,HUNEDOARA,"ORAŞ GEOAGIU",89561,BOZEŞ,"CĂMINUL CULTURAL BOZES",207,"Alegeri Prezidentiale",1,177,116,85,31,0,114,2,200,84,67,47
22,HUNEDOARA,"ORAŞ GEOAGIU",89561,CIGMĂU,"ŞCOALA PRIMARĂ CIGMAU",208,"Alegeri Prezidentiale",1,84,51,26,25,0,51,0,100,49,31,20
22,HUNEDOARA,"ORAŞ GEOAGIU",89561,GEOAGIU-BĂI,"SCOALA PRIMARA GEOAGIU BAI",209,"Alegeri Prezidentiale",2,361,507,165,342,0,505,2,600,93,311,194
22,HUNEDOARA,"ORAŞ GEOAGIU",89561,GELMAR,"ŞCOALA PRIMARĂ GELMAR",210,"Alegeri Prezidentiale",1,377,223,191,32,0,218,5,400,177,141,77
22,HUNEDOARA,"ORAŞ GEOAGIU",89561,HOMOROD,"CĂMINUL CULTURAL HOMOROD",211,"Alegeri Prezidentiale",1,291,143,136,7,0,141,2,350,207,70,71
22,HUNEDOARA,"ORAŞ GEOAGIU",89561,RENGHET,"CĂMINUL CULTURAL RENGHET",212,"Alegeri Prezidentiale",1,170,98,75,23,0,98,0,201,103,75,23
22,HUNEDOARA,"ORAŞ GEOAGIU",89561,VĂLENI,"ŞCOALA PRIMARĂ VĂLENI",213,"Alegeri Prezidentiale",2,40,25,10,15,0,24,1,50,25,14,10
22,HUNEDOARA,"ORAŞ HAŢEG",87576,HAŢEG,"PRIMĂRIA ORAŞULUI HAŢEG",214,"Alegeri Prezidentiale",1,1529,878,765,113,0,860,18,1700,822,486,374
22,HUNEDOARA,"ORAŞ HAŢEG",87576,HAŢEG,"ȘCOALA GIMNAZIALĂ ”OVID DENSUȘIANU”, HAȚEG",215,"Alegeri Prezidentiale",1,1582,872,725,116,31,850,22,1800,928,480,370
22,HUNEDOARA,"ORAŞ HAŢEG",87576,HAŢEG,"ȘCOALA GIMNAZIALĂ ”ARON DENSUȘIANU”, HAȚEG",216,"Alegeri Prezidentiale",1,1629,853,735,118,0,834,19,1750,897,547,287
22,HUNEDOARA,"ORAŞ HAŢEG",87576,HAŢEG,"COLEGIUL NAŢIONAL ”I.C.BRĂTIANU” HAŢEG",217,"Alegeri Prezidentiale",1,1557,823,745,78,0,800,23,1700,877,484,316
22,HUNEDOARA,"ORAŞ HAŢEG",87576,HAŢEG,"CANTINA SOCIALĂ HAŢEG",218,"Alegeri Prezidentiale",1,1711,922,850,56,16,906,16,1850,928,555,351
22,HUNEDOARA,"ORAŞ HAŢEG",87576,NĂLAŢVAD,"ŞCOALA PRIMARĂ NĂLAŢVAD",219,"Alegeri Prezidentiale",1,307,184,163,21,0,173,11,350,166,117,56
22,HUNEDOARA,"ORAŞ HAŢEG",87576,"SILVAŞU DE JOS","SCOALA PRIMARĂ SIVAŞU DE JOS",220,"Alegeri Prezidentiale",1,311,277,190,87,0,273,4,350,73,177,96
22,HUNEDOARA,"ORAŞ HAŢEG",87576,"SILVAŞU DE SUS","ȘCOALA PRIMARĂ SILVAȘU DE SUS",221,"Alegeri Prezidentiale",1,271,176,137,39,0,170,6,300,124,103,67
22,HUNEDOARA,"ORAŞ PETRILA",87077,PETRILA,"CASA DE CULTURA ”LADISLAU SCHMIDT”",222,"Alegeri Prezidentiale",2,1474,681,647,34,0,660,21,1550,869,252,408
22,HUNEDOARA,"ORAŞ PETRILA",87077,PETRILA,"SC EDIL URBAN SERV SA",223,"Alegeri Prezidentiale",2,1438,594,568,26,0,579,15,1550,956,234,345
22,HUNEDOARA,"ORAŞ PETRILA",87077,PETRILA,"SC EDIL SAL PREST SA",224,"Alegeri Prezidentiale",1,1394,601,581,20,0,585,16,1500,899,222,363
22,HUNEDOARA,"ORAŞ PETRILA",87077,PETRILA,"SCOALA GIMNAZIALA I.D. SARBU",225,"Alegeri Prezidentiale",1,1235,564,536,28,0,546,18,1350,786,199,347
22,HUNEDOARA,"ORAŞ PETRILA",87077,PETRILA,"CLUBUL COPIILOR",226,"Alegeri Prezidentiale",2,1368,615,587,28,0,592,23,1500,885,196,396
22,HUNEDOARA,"ORAŞ PETRILA",87077,PETRILA,"SCOALA GIMNAZIALA NR. 6 SECTIA 1",227,"Alegeri Prezidentiale",1,1266,577,555,22,0,566,11,1400,823,204,362
22,HUNEDOARA,"ORAŞ PETRILA",87077,PETRILA,"SCOALA GIMNAZIALA NR. 6 SECTIA 2",228,"Alegeri Prezidentiale",1,952,386,368,18,0,373,13,1050,664,138,235
22,HUNEDOARA,"ORAŞ PETRILA",87077,PETRILA,"SCOALA GIMNAZIALA NR. 5 SECTIA 1",229,"Alegeri Prezidentiale",1,1413,585,568,17,0,580,5,1550,965,210,370
22,HUNEDOARA,"ORAŞ PETRILA",87077,PETRILA,"SCOALA GIMNAZIALA NR. 5 SECTIA 2",230,"Alegeri Prezidentiale",1,1357,554,526,26,2,538,16,1500,946,201,337
22,HUNEDOARA,"ORAŞ PETRILA",87077,PETRILA,"GRADINITA PN",231,"Alegeri Prezidentiale",1,1316,525,496,29,0,517,8,1450,925,206,311
22,HUNEDOARA,"ORAŞ PETRILA",87077,PETRILA,"COLEGIUL CONSTANTIN BRANCUSI",232,"Alegeri Prezidentiale",2,960,539,517,22,0,530,9,1050,511,191,339
22,HUNEDOARA,"ORAŞ PETRILA",87077,PETRILA,"CASA PENSIONARILOR LONEA",233,"Alegeri Prezidentiale",1,1188,645,631,14,0,633,12,1300,655,196,437
22,HUNEDOARA,"ORAŞ PETRILA",87077,PETRILA,"SCOALA GIMNAZIALA ANA COLDA",234,"Alegeri Prezidentiale",1,1440,671,659,12,0,654,17,1600,929,176,478
22,HUNEDOARA,"ORAŞ PETRILA",87077,CIMPA,"SCOALA PRIMARA NR. 3 CIMPA",235,"Alegeri Prezidentiale",2,1407,825,807,18,0,813,12,1600,775,183,630
22,HUNEDOARA,"ORAŞ PETRILA",87077,PETRILA,"GRADINITA CU PROGRAM NORMAL ANA COLDA",236,"Alegeri Prezidentiale",1,1205,660,623,22,15,642,18,1300,640,222,420
22,HUNEDOARA,"ORAŞ PETRILA",87077,JIEŢ,"SCOALA PRIMARA NR. 4, F.N. , JIET",237,"Alegeri Prezidentiale",1,565,336,327,9,0,325,11,600,264,103,222
22,HUNEDOARA,"ORAŞ SIMERIA",87665,SIMERIA,"SCOALA GIMNAZIALA ”SIGISMUND TODUTA ” SIMERIA",238,"Alegeri Prezidentiale",1,1548,827,731,67,29,803,24,1750,923,516,287
22,HUNEDOARA,"ORAŞ SIMERIA",87665,SIMERIA,"SCOALA GIMNAZIALA ”SIGISMUND TODUTA ” SIMERIA",239,"Alegeri Prezidentiale",1,1465,803,734,68,1,784,19,1650,847,433,351
22,HUNEDOARA,"ORAŞ SIMERIA",87665,SIMERIA,"GRADINITA CU PROGRAM NORMAL NR.1 SIMERIA",240,"Alegeri Prezidentiale",1,1520,760,698,61,1,736,24,1650,890,457,279
22,HUNEDOARA,"ORAŞ SIMERIA",87665,SIMERIA,"GRADINITA P.P.1",241,"Alegeri Prezidentiale",1,1481,776,733,43,0,759,17,1650,874,493,266
22,HUNEDOARA,"ORAŞ SIMERIA",87665,SIMERIA,"OCOLUL SILVIC SIMERIA",242,"Alegeri Prezidentiale",2,1391,702,650,52,0,687,15,1500,798,423,264
22,HUNEDOARA,"ORAŞ SIMERIA",87665,SIMERIA,"COLEGIUL TEHNIC DE TRANSPORT FEROVIAR ”ANGHEL SALIGNY” SIMERIA",243,"Alegeri Prezidentiale",1,1249,607,568,39,0,590,17,1349,742,377,213
22,HUNEDOARA,"ORAŞ SIMERIA",87665,SIMERIA,"STATIA CFR SIMERIA",244,"Alegeri Prezidentiale",2,1019,581,480,101,0,573,8,1080,499,359,214
22,HUNEDOARA,"ORAŞ SIMERIA",87665,"SIMERIA VECHE","SCOALA GENERALA SIMERIA VECHE",245,"Alegeri Prezidentiale",1,349,208,178,30,0,204,4,400,192,132,72
22,HUNEDOARA,"ORAŞ SIMERIA",87665,UROI,"CASA SATULUI UROI",246,"Alegeri Prezidentiale",2,532,278,240,38,0,276,2,600,322,207,69
22,HUNEDOARA,"ORAŞ SIMERIA",87665,SÂNTANDREI,"SCOALA GENERALA SÎNTANDREI",247,"Alegeri Prezidentiale",1,944,504,442,61,1,496,8,1050,546,282,214
22,HUNEDOARA,"ORAŞ URICANI",87139,URICANI,"CENTRUL NAŢIONAL DE INFORMARE ŞI PROMOVARE TURISTICĂ",248,"Alegeri Prezidentiale",1,1891,851,818,33,0,831,20,2000,1149,333,498
22,HUNEDOARA,"ORAŞ URICANI",87139,URICANI,"SCOALA GIMNAZIALA ”BUCURA”",249,"Alegeri Prezidentiale",1,1891,696,673,21,2,676,20,2000,1304,275,401
22,HUNEDOARA,"ORAŞ URICANI",87139,URICANI,"LICEUL TEHNOLOGIC ”RETEZAT”",250,"Alegeri Prezidentiale",1,1786,675,654,18,3,658,17,2000,1325,234,424
22,HUNEDOARA,"ORAŞ URICANI",87139,URICANI,"CASA DE CULTURA, URICANI, SALA PARTER",251,"Alegeri Prezidentiale",1,1720,716,686,26,4,701,15,1900,1184,255,446
22,HUNEDOARA,"ORAŞ URICANI",87139,"CÂMPU LUI NEAG","ŞCOALA PRIMARĂ CÎMPU LUI NEAG",252,"Alegeri Prezidentiale",1,416,298,214,84,0,295,3,450,152,144,151
22,HUNEDOARA,"BAIA DE CRIŞ",87745,"BAIA DE CRIŞ","ŞCOALA GIMNAZIALĂ ”AVRAM IANCU” BAIA DE CRIŞ",253,"Alegeri Prezidentiale",1,605,345,282,55,8,339,6,660,315,174,165
22,HUNEDOARA,"BAIA DE CRIŞ",87745,LUNCA,"SCOALA PRIMARA LUNCA",254,"Alegeri Prezidentiale",1,234,129,111,18,0,129,0,250,121,80,49
22,HUNEDOARA,"BAIA DE CRIŞ",87745,CĂRĂSTĂU,"SCOALA PRIMARA CARASTAU",255,"Alegeri Prezidentiale",1,160,94,74,20,0,92,2,200,106,43,49
22,HUNEDOARA,"BAIA DE CRIŞ",87745,RIŞCA,"CAMIN CULTURAL RISCA",256,"Alegeri Prezidentiale",1,184,121,96,25,0,120,1,200,79,64,56
22,HUNEDOARA,"BAIA DE CRIŞ",87745,RIŞCULIŢA,"SCOALA PRIMARA RISCULITA",257,"Alegeri Prezidentiale",1,402,239,204,34,1,235,4,450,211,129,106
22,HUNEDOARA,"BAIA DE CRIŞ",87745,ŢEBEA,"SCOALA PRIMARA TEBEA",258,"Alegeri Prezidentiale",1,575,377,333,44,0,366,11,650,273,165,201
22,HUNEDOARA,BALŞA,87843,BALŞA,"BALŞA, SEDIUL PRIMĂRIEI COMUNEI",259,"Alegeri Prezidentiale",1,236,121,94,23,4,112,9,250,129,75,37
22,HUNEDOARA,BALŞA,87843,ARDEU,"ARDEU, CĂMINUL CULTURAL",260,"Alegeri Prezidentiale",1,49,49,34,15,0,49,0,70,21,33,16
22,HUNEDOARA,BALŞA,87843,MADA,"MADA, CĂMINUL CULTURAL",261,"Alegeri Prezidentiale",1,92,66,42,24,0,65,1,120,54,46,19
22,HUNEDOARA,BALŞA,87843,VOIA,"VOIA, CĂMINUL CULTURAL",262,"Alegeri Prezidentiale",1,67,69,31,36,2,69,0,100,31,42,27
22,HUNEDOARA,BALŞA,87843,VĂLIŞOARA,"VĂLIŞOARA, ŞCOALA GENERALĂ",263,"Alegeri Prezidentiale",2,47,30,12,18,0,30,0,70,40,21,9
22,HUNEDOARA,BALŞA,87843,"ALMAŞU MIC DE MUNTE","ALMAŞU MIC DE MUNTE, ŞCOALA GENERALĂ",264,"Alegeri Prezidentiale",1,60,43,22,18,3,41,2,80,37,25,16
22,HUNEDOARA,BALŞA,87843,POIANA,"POIANA, CĂMINUL CULTURAL",265,"Alegeri Prezidentiale",1,82,56,35,20,1,56,0,100,44,31,25
22,HUNEDOARA,BALŞA,87843,POIENIŢA,"POIENIŢA, CĂMINUL CULTURAL",266,"Alegeri Prezidentiale",1,65,41,25,16,0,41,0,80,39,19,22
22,HUNEDOARA,BARU,87996,BARU,"SCOALA PRIMARĂ BARU",267,"Alegeri Prezidentiale",1,1600,991,815,162,14,972,19,1700,709,693,279
22,HUNEDOARA,BARU,87996,LIVADIA,"SCOALA PRIMARĂ LIVADIA",268,"Alegeri Prezidentiale",2,523,350,276,66,8,346,4,550,200,240,106
22,HUNEDOARA,BARU,87996,"VALEA LUPULUI","SCOALA PRIMARĂ VALEA LUPULUI",269,"Alegeri Prezidentiale",1,156,138,106,28,4,136,2,200,62,99,37
22,HUNEDOARA,BĂCIA,88047,BĂCIA,"CĂMINUL CULTURAL BĂCIA, NR. 235",270,"Alegeri Prezidentiale",1,821,598,454,144,0,576,22,950,352,313,263
22,HUNEDOARA,BĂCIA,88047,TOTIA,"ŞCOALA PRIMARĂ TOTIA, NR.3",271,"Alegeri Prezidentiale",1,85,93,45,48,0,92,1,120,27,44,48
22,HUNEDOARA,BĂCIA,88047,TÂMPA,"ŞCOALA PRIMARĂ TÎMPA, NR.28",272,"Alegeri Prezidentiale",1,655,430,355,75,0,420,10,700,270,176,244
22,HUNEDOARA,BĂIŢA,88092,BĂIŢA,"ȘCOALA PRIMARĂ BĂIȚA",273,"Alegeri Prezidentiale",1,1010,605,520,80,5,593,12,1100,495,259,334
22,HUNEDOARA,BĂIŢA,88092,HĂRŢĂGANI,"ŞCOALA PRIMARA HĂRŢĂGANI",274,"Alegeri Prezidentiale",1,618,348,279,60,9,342,6,700,352,169,173
22,HUNEDOARA,BĂIŢA,88092,"CĂINELU DE SUS","CĂMINUL CULTURAL CĂINELU DE SUS",275,"Alegeri Prezidentiale",2,340,220,187,21,12,219,1,370,150,102,117
22,HUNEDOARA,BĂIŢA,88092,ORMINDEA,"ŞCOALA PRIMARĂ ORMINDEA",276,"Alegeri Prezidentiale",1,449,240,193,32,15,239,1,500,260,117,122
22,HUNEDOARA,BĂIŢA,88092,FIZEŞ,"CĂMINUL CULTURAL FIZEŞ",277,"Alegeri Prezidentiale",1,254,190,160,30,0,188,2,300,110,91,97
22,HUNEDOARA,BĂIŢA,88092,LUNCA,"CĂMINUL CULTURAL LUNCA",278,"Alegeri Prezidentiale",1,236,176,136,32,8,176,0,270,94,66,110
22,HUNEDOARA,BĂNIŢA,87246,BĂNIŢA,"CĂMIN CULTURAL BĂNIȚA",279,"Alegeri Prezidentiale",1,987,568,504,64,0,551,17,1100,532,285,266
22,HUNEDOARA,BĂTRÂNA,88216,BĂTRÂNA,"PRIMARIA COMUNEI BĂTRÎNA",280,"Alegeri Prezidentiale",1,96,62,50,12,0,62,0,150,88,45,17
22,HUNEDOARA,BERIU,88261,BERIU,"CAMINUL CULTURAL",281,"Alegeri Prezidentiale",1,595,318,261,57,0,308,10,650,332,229,79
22,HUNEDOARA,BERIU,88261,CĂSTĂU,"SCOALA PRIMARĂ",282,"Alegeri Prezidentiale",1,1070,550,501,49,0,544,6,1130,580,406,138
22,HUNEDOARA,BERIU,88261,CUCUIŞ,"SCOALA PRIMARĂ",283,"Alegeri Prezidentiale",2,105,73,62,11,0,73,0,150,77,60,13
22,HUNEDOARA,BERIU,88261,"ORĂŞTIOARA DE JOS","SCOALA PRIMARĂ",284,"Alegeri Prezidentiale",1,297,177,161,16,0,172,5,350,173,118,54
22,HUNEDOARA,BERIU,88261,SERECA,"SCOALA PRIMARĂ",285,"Alegeri Prezidentiale",1,210,131,108,23,0,128,3,250,119,90,38
22,HUNEDOARA,BERIU,88261,SIBIŞEL,"SCOALA PRIMARĂ SIBIŞEL",286,"Alegeri Prezidentiale",1,568,338,290,48,0,336,2,650,312,285,51
22,HUNEDOARA,BLĂJENI,88350,BLĂJENI,"CAMINUL CULTURAL BLAJENI",287,"Alegeri Prezidentiale",1,497,265,215,50,0,260,5,550,285,154,106
22,HUNEDOARA,BLĂJENI,88350,CRIŞ,"SCOALA PRIMARA CRIS",288,"Alegeri Prezidentiale",2,234,117,91,26,0,117,0,250,133,65,52
22,HUNEDOARA,BLĂJENI,88350,BLĂJENI-VULCAN,"SCOALA PRIMARA BLAJENI VULCAN",289,"Alegeri Prezidentiale",2,75,65,45,20,0,64,1,100,35,47,17
22,HUNEDOARA,BLĂJENI,88350,REŢ,"SCOALA PRIMARA RET",290,"Alegeri Prezidentiale",1,76,57,42,15,0,57,0,100,43,40,17
22,HUNEDOARA,BOŞOROD,88449,BOŞOROD,"CĂMINUL CULTURAL BOSOROD",291,"Alegeri Prezidentiale",1,786,497,458,39,0,488,9,850,353,294,194
22,HUNEDOARA,BOŞOROD,88449,CHITID,"CENTRUL LOCAL DE INFORMARE TURISTICĂ",292,"Alegeri Prezidentiale",1,468,251,222,29,0,249,2,500,249,153,96
22,HUNEDOARA,BOŞOROD,88449,LUNCANI,"CĂMINUL CULTURAL LUNCANI",293,"Alegeri Prezidentiale",1,105,57,35,22,0,56,1,140,83,43,13
22,HUNEDOARA,BOŞOROD,88449,URSICI,"CĂMINUL CULTURAL URSICI",294,"Alegeri Prezidentiale",1,51,22,14,8,0,22,0,78,56,14,8
22,HUNEDOARA,BOŞOROD,88449,ALUN,"CĂMINUL CULTURAL ALUN",295,"Alegeri Prezidentiale",1,61,34,21,13,0,33,1,100,66,21,12
22,HUNEDOARA,BOŞOROD,88449,TÂRSA,"CĂMINUL CULTURAL TIRSA",296,"Alegeri Prezidentiale",1,164,113,98,15,0,112,1,200,87,60,52
22,HUNEDOARA,BRĂNIŞCA,88546,BRĂNIŞCA,"CĂMIN CULTURAL BRĂNIŞCA",297,"Alegeri Prezidentiale",1,514,343,242,90,11,336,7,600,257,154,182
22,HUNEDOARA,BRĂNIŞCA,88546,BOZ,"CĂMIN CULTURAL BOZ",298,"Alegeri Prezidentiale",1,369,228,174,54,0,226,2,400,172,89,137
22,HUNEDOARA,BRĂNIŞCA,88546,ROVINA,"CĂMIN CULTURAL ROVINA",299,"Alegeri Prezidentiale",1,185,103,80,23,0,98,5,200,97,57,41
22,HUNEDOARA,BRĂNIŞCA,88546,TÂRNAVA,"CĂMIN CULTURAL TÎRNAVA",300,"Alegeri Prezidentiale",1,98,68,46,22,0,66,2,120,52,31,35
22,HUNEDOARA,BRĂNIŞCA,88546,TÂRNĂVIŢA,"CĂMIN CULTURAL TÎRNĂVIŢA",301,"Alegeri Prezidentiale",1,146,104,76,27,1,101,3,170,66,58,43
22,HUNEDOARA,BRĂNIŞCA,88546,FURCŞOARA,"CĂMIN CULTURAL FURCŞOARA",302,"Alegeri Prezidentiale",2,43,32,14,18,0,31,1,70,38,16,15
22,HUNEDOARA,"BRETEA ROMÂNĂ",88644,"BRETEA ROMÂNĂ","ŞCOALA GIMNAZIALA BRETEA ROMANA",303,"Alegeri Prezidentiale",1,228,161,125,36,0,157,4,250,89,82,75
22,HUNEDOARA,"BRETEA ROMÂNĂ",88644,"BRETEA STREIULUI","CĂMIN CULTURAL",304,"Alegeri Prezidentiale",1,213,134,109,25,0,130,4,250,116,51,79
22,HUNEDOARA,"BRETEA ROMÂNĂ",88644,RUŞI,"CĂMIN CULTURAL",305,"Alegeri Prezidentiale",1,207,153,125,27,1,151,2,225,72,75,76
22,HUNEDOARA,"BRETEA ROMÂNĂ",88644,BĂŢĂLAR,"ŞCOALA PRIMARA",306,"Alegeri Prezidentiale",1,204,140,106,34,0,139,1,250,110,74,65
22,HUNEDOARA,"BRETEA ROMÂNĂ",88644,"OCOLIŞU MARE","ŞCOALA PRIMARA",307,"Alegeri Prezidentiale",1,177,155,113,42,0,152,3,200,45,71,81
22,HUNEDOARA,"BRETEA ROMÂNĂ",88644,COVRAGIU,"CĂMIN CULTURAL COVRAGIU",308,"Alegeri Prezidentiale",1,141,98,73,25,0,96,2,160,62,59,37
22,HUNEDOARA,"BRETEA ROMÂNĂ",88644,GÂNŢAGA,"ŞCOALĂ PRIMARĂ",309,"Alegeri Prezidentiale",1,224,181,144,37,0,178,3,249,68,109,69
22,HUNEDOARA,"BRETEA ROMÂNĂ",88644,MĂCEU,"ŞCOALĂ PRIMARĂ",310,"Alegeri Prezidentiale",1,265,176,150,26,0,170,6,300,124,87,83
22,HUNEDOARA,"BRETEA ROMÂNĂ",88644,PLOPI,"ŞCOALĂ PRIMARĂ",311,"Alegeri Prezidentiale",2,222,186,140,44,2,185,1,250,64,89,96
22,HUNEDOARA,"BRETEA ROMÂNĂ",88644,"VÂLCELELE BUNE","ŞCOALĂ PRIMARĂ",312,"Alegeri Prezidentiale",1,325,206,178,27,1,203,3,351,145,116,87
22,HUNEDOARA,"BRETEA ROMÂNĂ",88644,VÂLCELE,"ŞCOALĂ PRIMARĂ VÎLCELE",313,"Alegeri Prezidentiale",1,218,177,140,37,0,177,0,255,78,62,115
22,HUNEDOARA,BUCEŞ,88788,BUCEŞ,"PRIMĂRIA COMUNEI BUCEŞ",314,"Alegeri Prezidentiale",1,129,101,81,20,0,101,0,150,49,35,66
22,HUNEDOARA,BUCEŞ,88788,BUCEŞ-VULCAN,"SCOALA PRIMARA BUCES-VULCAN",315,"Alegeri Prezidentiale",1,174,104,89,15,0,104,0,200,96,31,73
22,HUNEDOARA,BUCEŞ,88788,DUPĂPIATRĂ,"SCOALA PRIMARA DUPAPIATRA",316,"Alegeri Prezidentiale",1,400,222,201,21,0,220,2,450,228,92,128
22,HUNEDOARA,BUCEŞ,88788,GROHOŢELE,"SCOALA PRIMARA GROHOTELE",317,"Alegeri Prezidentiale",1,163,96,87,9,0,96,0,200,104,44,52
22,HUNEDOARA,BUCEŞ,88788,MIHĂILENI,"SCOALA PRIMARA MIHAILENI",318,"Alegeri Prezidentiale",1,346,192,166,26,0,191,1,380,188,80,111
22,HUNEDOARA,BUCEŞ,88788,STĂNIJA,"SCOALA PRIMARA STANIJA",319,"Alegeri Prezidentiale",1,317,166,152,14,0,165,1,350,184,83,82
22,HUNEDOARA,BUCUREŞCI,88868,BUCUREŞCI,"CAMINUL CULTURAL",320,"Alegeri Prezidentiale",1,497,354,316,38,0,350,4,550,196,224,126
22,HUNEDOARA,BUCUREŞCI,88868,CURECHIU,"CAMINUL CULTURAL",321,"Alegeri Prezidentiale",1,270,209,174,35,0,205,4,300,91,138,67
22,HUNEDOARA,BUCUREŞCI,88868,ROVINA,"CAMINUL CULTURAL",322,"Alegeri Prezidentiale",1,129,90,71,19,0,90,0,150,60,44,46
22,HUNEDOARA,BUCUREŞCI,88868,MERIŞOR,"CAMINUL CULTURAL",323,"Alegeri Prezidentiale",2,71,62,46,15,1,61,1,100,38,31,30
22,HUNEDOARA,BUCUREŞCI,88868,ŞESURI,"CAMINUL CULTURAL",324,"Alegeri Prezidentiale",1,339,244,225,19,0,241,3,350,106,169,72
22,HUNEDOARA,"BULZEŞTII DE SUS",88920,"BULZEŞTII DE SUS","PRIMARIA BULZESTII DE SUS SALA DE SEDINTA",325,"Alegeri Prezidentiale",1,126,113,69,44,0,112,1,150,37,50,62
22,HUNEDOARA,"BULZEŞTII DE SUS",88920,"BULZEŞTII DE JOS","SCOALA PRIMARA BULZESTII DE JOS",326,"Alegeri Prezidentiale",1,94,81,51,30,0,79,2,120,39,41,38
22,HUNEDOARA,BUNILA,89026,BUNILA,"CĂMINUL CULTURAL BUNILA",327,"Alegeri Prezidentiale",1,70,38,28,10,0,38,0,100,62,27,11
22,HUNEDOARA,BUNILA,89026,"CERNIŞOARA FLORESE","CLADIRE DISPENSAR MEDICAL CERNISOARA FLORESE",328,"Alegeri Prezidentiale",1,165,118,79,39,0,117,1,190,72,76,41
22,HUNEDOARA,BUNILA,89026,"POIENIŢA VOINII","CAMINUL CULTURAL POIENITA VOINII",329,"Alegeri Prezidentiale",1,68,70,48,22,0,70,0,100,30,51,19
22,HUNEDOARA,BURJUC,89080,BURJUC,"CAMIN CULTURAL BURJUC",330,"Alegeri Prezidentiale",1,139,126,82,44,0,124,2,160,34,53,71
22,HUNEDOARA,BURJUC,89080,TĂTĂRĂŞTI,"CAMIN CULTURAL TĂTĂRĂŞTI",331,"Alegeri Prezidentiale",1,137,109,71,38,0,104,5,160,51,48,56
22,HUNEDOARA,BURJUC,89080,TISA,"CAMIN CULTURAL TISA",332,"Alegeri Prezidentiale",1,96,110,42,68,0,110,0,130,20,66,44
22,HUNEDOARA,BURJUC,89080,GLODGHILEŞTI,"ŞCOALA PRIMARA GLODGHILEŞTI",333,"Alegeri Prezidentiale",2,175,107,83,24,0,106,1,200,93,55,51
22,HUNEDOARA,BURJUC,89080,BRĂDĂŢEL,"ŞCOALA PRIMARA BRĂDĂŢEL",334,"Alegeri Prezidentiale",1,113,81,55,26,0,80,1,140,59,33,47
22,HUNEDOARA,CÂRJIŢI,86749,CÂRJIŢI,"CĂMINUL CULTURAL CÎRJIŢI",335,"Alegeri Prezidentiale",1,101,73,43,30,0,71,2,130,57,42,29
22,HUNEDOARA,CÂRJIŢI,86749,CHERGHEŞ,"CĂMINUL CULTURAL CHERGHEŞ",336,"Alegeri Prezidentiale",1,76,48,34,14,0,48,0,100,52,31,17
22,HUNEDOARA,CÂRJIŢI,86749,POPEŞTI,"CĂMINUL CULTURAL POPEŞTI",337,"Alegeri Prezidentiale",1,112,76,52,24,0,74,2,140,64,36,38
22,HUNEDOARA,CÂRJIŢI,86749,"ALMAŞU SEC","CĂMINUL CULTURAL ALMAŞU SEC",338,"Alegeri Prezidentiale",1,167,134,96,37,1,129,5,200,66,104,25
22,HUNEDOARA,CÂRJIŢI,86749,COZIA,"CĂMINUL CULTURAL COZIA",339,"Alegeri Prezidentiale",1,134,77,51,26,0,76,1,160,83,50,26
22,HUNEDOARA,CERBĂL,89151,CERBĂL,"CASA COMUNALĂ CERBĂL-SALA DE ŞEDINŢĂ A CONSILIULUI LOCAL CERBĂL",340,"Alegeri Prezidentiale",1,183,144,115,29,0,144,0,200,56,61,83
22,HUNEDOARA,CERBĂL,89151,FEREGI,"ŞCOALA PRIMARĂ FEREGI",341,"Alegeri Prezidentiale",2,111,91,69,22,0,91,0,150,59,27,64
22,HUNEDOARA,CERBĂL,89151,"POIANA RĂCHIŢELII","ŞCOALA PRIMARĂ POIANA RĂCHIŢELII",342,"Alegeri Prezidentiale",1,101,98,76,22,0,97,1,130,32,14,83
22,HUNEDOARA,"CERTEJU DE SUS",89240,"CERTEJU DE SUS","CAMINUL CULTURAL",343,"Alegeri Prezidentiale",1,1230,579,524,51,4,571,8,1350,771,347,224
22,HUNEDOARA,"CERTEJU DE SUS",89240,HONDOL,"CAMINUL CULTURAL",344,"Alegeri Prezidentiale",1,432,213,192,21,0,210,3,452,239,124,86
22,HUNEDOARA,"CERTEJU DE SUS",89240,SĂCĂRÂMB,"CAMINUL CULTURAL",345,"Alegeri Prezidentiale",1,148,93,58,35,0,91,2,169,76,55,36
22,HUNEDOARA,"CERTEJU DE SUS",89240,"BOCŞA MICĂ","SPAȚIU ADMINISTRATIV BOCȘA MICĂ",346,"Alegeri Prezidentiale",1,88,72,55,17,0,71,1,110,38,46,25
22,HUNEDOARA,"CERTEJU DE SUS",89240,MĂGURA-TOPLIŢA,"CĂMINUL CULTURAL",347,"Alegeri Prezidentiale",1,84,57,38,19,0,57,0,110,53,20,37
22,HUNEDOARA,"CERTEJU DE SUS",89240,"TOPLIŢA MUREŞULUI","CĂMINUL CULTURAL",348,"Alegeri Prezidentiale",1,70,81,42,39,0,81,0,100,19,44,37
22,HUNEDOARA,"CERTEJU DE SUS",89240,NOJAG,"SCOALA PRIMARĂ NOJAG",349,"Alegeri Prezidentiale",1,191,125,84,41,0,123,2,220,95,64,59
22,HUNEDOARA,"CERTEJU DE SUS",89240,VĂRMAGA,"SCOALA PRIMARĂ VĂRMAGA",350,"Alegeri Prezidentiale",1,245,162,114,48,0,161,1,261,99,99,62
22,HUNEDOARA,CRIŞCIOR,87362,ZDRAPŢI,"CAMINUL CULTURAL",351,"Alegeri Prezidentiale",1,735,369,339,30,0,361,8,800,431,174,187
22,HUNEDOARA,CRIŞCIOR,87362,CRIŞCIOR,"SCOALA GENERALA NR 1 CRIŞCIOR",352,"Alegeri Prezidentiale",1,1331,678,628,50,0,669,9,1500,822,341,328
22,HUNEDOARA,CRIŞCIOR,87362,CRIŞCIOR,"LICEUL TEHNOLOGIC CRIŞAN CRIŞCIOR",353,"Alegeri Prezidentiale",1,1231,574,539,35,0,562,12,1350,776,256,306
22,HUNEDOARA,DENSUŞ,89348,DENSUŞ,"SCOALA GIMNAZIALA DENSUS",354,"Alegeri Prezidentiale",1,499,352,303,41,8,346,6,550,198,138,208
22,HUNEDOARA,DENSUŞ,89348,PEŞTEANA,"ŞCOALA PRIMARĂ PEŞTEANA",355,"Alegeri Prezidentiale",1,297,227,183,39,5,224,3,322,95,103,121
22,HUNEDOARA,DENSUŞ,89348,PEŞTENIŢA,"SCOALA PRIMARA PESTENITA",356,"Alegeri Prezidentiale",1,220,123,109,14,0,122,1,250,127,71,51
22,HUNEDOARA,DENSUŞ,89348,ŞTEI,"ȘCOALA PRIMARĂ ȘTEI",357,"Alegeri Prezidentiale",1,158,141,105,27,9,138,3,200,59,37,101
22,HUNEDOARA,DENSUŞ,89348,POIENI,"SCOALA PRIMARA POIENI",358,"Alegeri Prezidentiale",1,68,66,46,17,3,66,0,100,34,15,51
22,HUNEDOARA,DOBRA,89428,DOBRA,"CĂMINUL CULTURAL DOBRA",359,"Alegeri Prezidentiale",1,1286,930,673,247,10,911,19,1450,520,521,390
22,HUNEDOARA,DOBRA,89428,LĂPUŞNIC,"CĂMINUL CULTURAL LAPUSNIC",360,"Alegeri Prezidentiale",1,393,264,208,56,0,261,3,450,186,169,92
22,HUNEDOARA,DOBRA,89428,RĂDULEŞTI,"CAMINUL CULTURAL RADULESTI",361,"Alegeri Prezidentiale",1,150,97,84,13,0,96,1,170,73,54,42
22,HUNEDOARA,DOBRA,89428,STÂNCEŞTI,"CĂMINUL CULTURAL STANCESTI",362,"Alegeri Prezidentiale",1,102,68,46,22,0,68,0,130,62,38,30
22,HUNEDOARA,DOBRA,89428,ROŞCANI,"SCOALA PRIMARA ROSCANI",363,"Alegeri Prezidentiale",1,551,367,308,59,0,362,5,600,233,206,156
22,HUNEDOARA,DOBRA,89428,PANC,"CĂMINUL CULTURAL PANC",364,"Alegeri Prezidentiale",1,153,109,85,24,0,108,1,180,71,61,47
22,HUNEDOARA,"GENERAL BERTHELOT",91731,"GENERAL BERTHELOT","SALA DE SEDINTE CONSILIUL LOCAL",365,"Alegeri Prezidentiale",1,544,261,230,31,0,256,5,600,339,167,89
22,HUNEDOARA,"GENERAL BERTHELOT",91731,TUŞTEA,"SCOALA PRIMARA TUSTEA",366,"Alegeri Prezidentiale",1,212,126,104,21,1,123,3,250,124,90,33
22,HUNEDOARA,GHELARI,86883,GHELARI,"PRIMARIA GHELARI",367,"Alegeri Prezidentiale",1,633,348,319,27,2,344,4,700,352,205,139
22,HUNEDOARA,GHELARI,86883,GHELARI,"CĂMINUL CULTURAL ”MINERUL”",368,"Alegeri Prezidentiale",1,881,366,343,22,1,365,1,950,584,202,163
22,HUNEDOARA,GHELARI,86883,RUDA,"CĂMIN CULTURAL",369,"Alegeri Prezidentiale",1,132,92,68,22,2,91,1,150,58,46,45
22,HUNEDOARA,GHELARI,86883,PLOP,"MAGAZIN ABC",370,"Alegeri Prezidentiale",1,22,38,14,24,0,38,0,50,12,16,22
22,HUNEDOARA,GHELARI,86883,GOVĂJDIA,DISPENSAR,371,"Alegeri Prezidentiale",2,76,69,31,38,0,65,4,100,31,36,29
22,HUNEDOARA,GURASADA,89687,GURASADA,"SALĂ DE ŞEDINŢE PRIMARIA COMUNEI GURASADA",372,"Alegeri Prezidentiale",1,598,315,243,72,0,309,6,700,385,123,186
22,HUNEDOARA,GURASADA,89687,CÂMPURI-SURDUC,"CĂMIN CULTURAL CÎMPURI-SURDUC",373,"Alegeri Prezidentiale",1,359,244,154,90,0,237,7,400,156,97,140
22,HUNEDOARA,GURASADA,89687,"BOIU DE SUS","CĂMIN CULTURAL BOIU DE SUS",374,"Alegeri Prezidentiale",1,89,67,48,19,0,65,2,110,43,20,45
22,HUNEDOARA,GURASADA,89687,CĂRMĂZĂNEŞTI,"ŞCOALA GENERALĂ CĂRMĂZĂNEŞTI",375,"Alegeri Prezidentiale",1,90,56,42,14,0,53,3,110,54,24,29
22,HUNEDOARA,HĂRĂU,89801,HĂRĂU,"DISPENSAR MEDICAL HĂRĂU",376,"Alegeri Prezidentiale",1,664,364,306,58,0,358,6,750,386,206,152
22,HUNEDOARA,HĂRĂU,89801,BANPOTOC,"CĂMINUL CULTURAL BANPOTOC",377,"Alegeri Prezidentiale",1,383,255,213,42,0,248,7,450,195,147,101
22,HUNEDOARA,HĂRĂU,89801,BÂRSĂU,"ŞCOALA PRIMARĂ BÎRSĂU",378,"Alegeri Prezidentiale",1,418,266,203,63,0,258,8,450,184,168,90
22,HUNEDOARA,HĂRĂU,89801,CHIMINDIA,"ŞCOALA PRIMARĂ CHIMINDIA",379,"Alegeri Prezidentiale",1,310,195,161,34,0,193,2,350,155,68,125
22,HUNEDOARA,ILIA,89856,ILIA,"CĂMINUL CULTURAL DIN ILIA",380,"Alegeri Prezidentiale",1,1438,881,723,143,15,859,22,1600,719,522,337
22,HUNEDOARA,ILIA,89856,"BRETEA MUREŞANĂ","ȘCOALA PRIMARĂ BRETEA MUREȘANĂ",381,"Alegeri Prezidentiale",1,504,326,246,75,5,317,9,550,224,189,128
22,HUNEDOARA,ILIA,89856,SÂRBI,"CĂMINUL CULTURAL DIN SÎRBI",382,"Alegeri Prezidentiale",1,355,228,202,19,7,224,4,400,172,157,67
22,HUNEDOARA,ILIA,89856,"VALEA LUNGĂ","CĂMINUL CULTURAL DINVALEA LUNGĂ",383,"Alegeri Prezidentiale",1,92,78,54,24,0,74,4,110,32,41,33
22,HUNEDOARA,ILIA,89856,BACEA,"CĂMINUL CULTURAL DIN BACEA",384,"Alegeri Prezidentiale",1,304,165,135,30,0,160,5,350,185,101,59
22,HUNEDOARA,ILIA,89856,BRÂZNIC,"CĂMINUL CULTURAL DIN BRÎZNIC",385,"Alegeri Prezidentiale",1,182,165,118,47,0,164,1,210,45,115,49
22,HUNEDOARA,ILIA,89856,SĂCĂMAŞ,"CĂMINUL CULTURAL DIN SĂCĂMAŞ",386,"Alegeri Prezidentiale",1,175,131,104,22,5,129,2,200,69,97,32
22,HUNEDOARA,"LĂPUGIU DE JOS",89954,"LĂPUGIU DE JOS","CĂMINUL CULTURAL LĂPUGIU DE JOS",387,"Alegeri Prezidentiale",1,370,266,165,100,1,261,5,400,134,180,81
22,HUNEDOARA,"LĂPUGIU DE JOS",89954,OHABA,"CĂMINUL CULTURAL OHABA",388,"Alegeri Prezidentiale",1,402,359,175,184,0,348,11,450,91,233,115
22,HUNEDOARA,"LĂPUGIU DE JOS",89954,"LĂPUGIU DE SUS","CĂMINUL CULTURAL LĂPUGIU DE SUS",389,"Alegeri Prezidentiale",1,307,235,184,51,0,234,1,350,115,92,142
22,HUNEDOARA,LELESE,90066,LELESE,"PRIMARIA COMUNEI LELESE, SALA BIBLIONET",390,"Alegeri Prezidentiale",1,153,97,80,15,2,97,0,200,103,34,63
22,HUNEDOARA,LELESE,90066,CERIŞOR,"CĂMINUL CULTURAL CERIȘOR",391,"Alegeri Prezidentiale",1,80,73,43,30,0,72,1,110,37,18,54
22,HUNEDOARA,LELESE,90066,"RUNCU MARE","CAMIN CULTURAL RUNCU MARE",392,"Alegeri Prezidentiale",1,82,77,52,25,0,76,1,110,33,28,48
22,HUNEDOARA,"LUNCA CERNII DE JOS",90119,"LUNCA CERNII DE JOS","ŞCOALA GIMNAZIALĂ LUNCA CERNII DE JOS",393,"Alegeri Prezidentiale",1,371,178,151,27,0,177,1,400,222,87,90
22,HUNEDOARA,"LUNCA CERNII DE JOS",90119,NEGOIU,"CĂMIN CULTURAL NEGOIU",394,"Alegeri Prezidentiale",1,149,80,67,13,0,78,2,200,120,41,37
22,HUNEDOARA,"LUNCA CERNII DE JOS",90119,MERIA,"CĂMIN CULTURAL MERIA",395,"Alegeri Prezidentiale",1,221,92,85,7,0,92,0,250,158,75,17
22,HUNEDOARA,"LUNCOIU DE JOS",90208,"LUNCOIU DE JOS","CĂMINUL CULTURAL LUNCOIU DE JOS",396,"Alegeri Prezidentiale",1,877,496,450,46,0,488,8,950,454,278,210
22,HUNEDOARA,"LUNCOIU DE JOS",90208,"LUNCOIU DE SUS","CĂMINUL CULTURAL LUNCOIU DE SUS",397,"Alegeri Prezidentiale",2,625,371,334,37,0,367,4,700,329,229,138
22,HUNEDOARA,MĂRTINEŞTI,90262,MĂRTINEŞTI,"SCOALA PRIMARA MĂRTINEŞTI",398,"Alegeri Prezidentiale",1,227,156,121,35,0,153,3,250,94,91,62
22,HUNEDOARA,MĂRTINEŞTI,90262,"DÂNCU MARE","CĂMIN CULTURAL DÎNCU MARE",399,"Alegeri Prezidentiale",1,193,185,130,55,0,183,2,220,35,93,90
22,HUNEDOARA,MĂRTINEŞTI,90262,"DÂNCU MIC","CAMIN CULTURAL DÂNCU MIC",400,"Alegeri Prezidentiale",1,86,83,38,45,0,82,1,120,37,33,49
22,HUNEDOARA,MĂRTINEŞTI,90262,JELEDINŢI,"CAMIN CULTURAL JELEDINŢI",401,"Alegeri Prezidentiale",1,208,152,110,42,0,151,1,250,98,101,50
22,HUNEDOARA,MĂRTINEŞTI,90262,TĂMĂŞASA,"CAMIN CULTURAL TĂMĂŞASA",402,"Alegeri Prezidentiale",1,92,68,47,21,0,65,3,120,52,35,30
22,HUNEDOARA,"ORĂŞTIOARA DE SUS",90342,"ORĂŞTIOARA DE SUS","CAMIN CULTURAL ORASTIOARA DE SUS",403,"Alegeri Prezidentiale",2,415,265,228,36,1,258,7,450,185,189,69
22,HUNEDOARA,"ORĂŞTIOARA DE SUS",90342,BUCIUM,"CAMIN CULTURAL BUCIUM",404,"Alegeri Prezidentiale",1,268,197,165,32,0,194,3,300,103,144,50
22,HUNEDOARA,"ORĂŞTIOARA DE SUS",90342,"LUDEŞTII DE JOS","SCOALA PRIMARA LUDESTII DE JOS",405,"Alegeri Prezidentiale",1,280,169,138,30,1,167,2,300,131,120,47
22,HUNEDOARA,"ORĂŞTIOARA DE SUS",90342,COSTEŞTI,"CAMIN CULTURAL COSTESTI",406,"Alegeri Prezidentiale",1,416,271,204,67,0,270,1,450,179,190,80
22,HUNEDOARA,"ORĂŞTIOARA DE SUS",90342,"GRĂDIŞTEA DE MUNTE","CĂMINUL CULTURAL GRĂDIŞTEA DE MUNTE",407,"Alegeri Prezidentiale",2,136,101,65,35,1,100,1,160,59,78,22
22,HUNEDOARA,"ORĂŞTIOARA DE SUS",90342,"OCOLIŞU MIC","SCOALA PRIMARA OCOLISU MIC",408,"Alegeri Prezidentiale",1,309,211,176,35,0,209,2,350,139,160,49
22,HUNEDOARA,"PESTIŞU MIC",90431,"PESTIŞU MIC","CĂMINUL CULTURAL PESTIȘU MIC",409,"Alegeri Prezidentiale",1,178,142,108,33,1,142,0,174,32,73,69
22,HUNEDOARA,"PESTIŞU MIC",90431,"ALMAŞU MIC","CĂMINUL CULTURAL ALMAŞU MIC",410,"Alegeri Prezidentiale",2,58,64,32,32,0,63,1,80,16,42,21
22,HUNEDOARA,"PESTIŞU MIC",90431,CIULPĂZ,"CĂMINUL CULTURAL CIULPĂZ",411,"Alegeri Prezidentiale",1,92,54,38,16,0,54,0,120,66,21,33
22,HUNEDOARA,"PESTIŞU MIC",90431,JOSANI,"ȘCOALA PRIMARĂ JOSANI",412,"Alegeri Prezidentiale",1,172,134,107,27,0,132,2,200,66,80,52
22,HUNEDOARA,"PESTIŞU MIC",90431,MĂNERĂU,"ȘCOALA PRIMARĂ MĂNERĂU",413,"Alegeri Prezidentiale",1,239,131,114,17,0,130,1,225,94,56,74
22,HUNEDOARA,"PESTIŞU MIC",90431,NANDRU,"ȘCOALA PRIMARĂ NANDRU",414,"Alegeri Prezidentiale",1,139,143,75,66,2,134,9,200,57,58,76
22,HUNEDOARA,"PESTIŞU MIC",90431,"VALEA NANDRULUI","ȘCOALA PRIMARĂ VALEA NANDRULUI",415,"Alegeri Prezidentiale",1,122,128,78,45,5,127,1,150,22,74,53
22,HUNEDOARA,PUI,90538,PUI,"ŞCOALA GIMNAZIALĂ PUI",416,"Alegeri Prezidentiale",1,666,385,312,73,0,378,7,700,315,275,103
22,HUNEDOARA,PUI,90538,RUŞOR,"ŞCOALA PRIMARĂ RUŞOR",417,"Alegeri Prezidentiale",2,270,189,163,26,0,185,4,300,111,123,62
22,HUNEDOARA,PUI,90538,BĂIEŞTI,"ŞCOALA PRIMARĂ BĂIEŞTI",418,"Alegeri Prezidentiale",1,187,139,103,36,0,133,6,200,61,90,43
22,HUNEDOARA,PUI,90538,GALAŢI,"ŞCOALA PRIMARĂ GALAŢI",419,"Alegeri Prezidentiale",1,385,198,174,24,0,196,2,400,202,128,68
22,HUNEDOARA,PUI,90538,FIZEŞTI,"ŞCOALA PRIMARĂ FIZEŞTI",420,"Alegeri Prezidentiale",2,257,125,113,12,0,123,2,300,175,85,38
22,HUNEDOARA,PUI,90538,ŞEREL,"ŞCOALA PRIMARĂ ŞEREL",421,"Alegeri Prezidentiale",1,364,176,158,18,0,173,3,400,224,128,45
22,HUNEDOARA,PUI,90538,"RÂU BĂRBAT","CĂMIN CULTURAL RÎU-BĂRBAT",422,"Alegeri Prezidentiale",1,159,129,87,25,17,127,2,180,51,92,35
22,HUNEDOARA,PUI,90538,HOBIŢA,"ŞCOALA PRIMARĂ HOBIŢA",423,"Alegeri Prezidentiale",1,148,95,80,15,0,93,2,170,75,65,28
22,HUNEDOARA,PUI,90538,URIC,"ŞCOALA PRIMARĂ URIC",424,"Alegeri Prezidentiale",1,254,148,134,14,0,147,1,300,152,88,59
22,HUNEDOARA,PUI,90538,PONOR,"ŞCOALA PRIMARĂ PONOR",425,"Alegeri Prezidentiale",1,368,196,179,17,0,195,1,400,204,118,77
22,HUNEDOARA,PUI,90538,OHABA-PONOR,"ŞCOALA PRIMARĂ OHABA PONOR",426,"Alegeri Prezidentiale",2,208,109,97,12,0,104,5,250,141,81,23
22,HUNEDOARA,PUI,90538,FEDERI,"ŞCOALA PRIMARĂ FEDERI",427,"Alegeri Prezidentiale",1,203,84,76,8,0,84,0,220,136,70,14
22,HUNEDOARA,"RAPOLTU MARE",90663,BOIU,"CAMIN CULTURAL",428,"Alegeri Prezidentiale",1,126,86,63,23,0,84,2,150,64,52,32
22,HUNEDOARA,"RAPOLTU MARE",90663,BOBÂLNA,"CAMIN CULTURAL",429,"Alegeri Prezidentiale",1,392,240,198,42,0,239,1,430,190,148,91
22,HUNEDOARA,"RAPOLTU MARE",90663,FOLT,"CAMIN CULTURAL",430,"Alegeri Prezidentiale",1,137,89,68,21,0,86,3,160,71,61,25
22,HUNEDOARA,"RAPOLTU MARE",90663,RAPOLŢEL,"CAMIN CULTURAL",431,"Alegeri Prezidentiale",1,183,115,86,29,0,114,1,210,95,75,39
22,HUNEDOARA,"RAPOLTU MARE",90663,"RAPOLTU MARE","PRIMARIA RAPOLTU MARE",432,"Alegeri Prezidentiale",1,759,390,346,44,0,387,3,800,410,276,111
22,HUNEDOARA,RĂCHITOVA,90725,RĂCHITOVA,"CAMINUL CULTURAL RĂCHITOVA",433,"Alegeri Prezidentiale",1,519,415,341,74,0,411,4,580,165,106,305
22,HUNEDOARA,RĂCHITOVA,90725,BOIŢA,"SCOALA PRIMARA BOIȚA",434,"Alegeri Prezidentiale",2,356,267,222,45,0,262,5,400,133,149,113
22,HUNEDOARA,RĂCHITOVA,90725,VĂLIOARA,"SCOALA PRIMARA VĂLIOARA",435,"Alegeri Prezidentiale",2,188,138,115,23,0,137,1,220,82,72,65
22,HUNEDOARA,"RÂU DE MORI",90878,"RÂU DE MORI","ŞCOALA GENERALĂ RÎU DE MORI",436,"Alegeri Prezidentiale",1,843,527,447,79,1,518,9,930,403,374,144
22,HUNEDOARA,"RÂU DE MORI",90878,CLOPOTIVA,"ȘCOALA PRIMARĂ CLOPOTIVA",437,"Alegeri Prezidentiale",2,676,411,362,49,0,399,12,730,319,269,130
22,HUNEDOARA,"RÂU DE MORI",90878,OSTROV,"CĂMINUL CULTURAL OSTROV",438,"Alegeri Prezidentiale",1,377,222,203,19,0,218,4,400,178,156,62
22,HUNEDOARA,"RÂU DE MORI",90878,"VALEA DÂLJII","CĂMINUL CULTURAL VALEA DÎLJII",439,"Alegeri Prezidentiale",1,184,131,111,20,0,129,2,220,89,83,46
22,HUNEDOARA,"RÂU DE MORI",90878,UNCIUC,"ȘCOALA PRIMARĂ UNCIUC",440,"Alegeri Prezidentiale",1,184,142,111,31,0,141,1,220,78,101,40
22,HUNEDOARA,"RÂU DE MORI",90878,SIBIŞEL,"ȘCOALA PRIMARĂ SIBIȘEL",441,"Alegeri Prezidentiale",2,316,193,173,20,0,187,6,350,157,109,78
22,HUNEDOARA,RIBIŢA,90805,RIBIŢA,"ȘCOALA GIMNAZIALĂ ”PREOT IOSIF COMȘA” RIBIȚA",442,"Alegeri Prezidentiale",1,505,431,350,66,15,421,10,550,119,250,171
22,HUNEDOARA,RIBIŢA,90805,CRIŞAN,"ŞCOALA PRIMARĂ ”VLAICU BÂRNA” CRIŞAN",443,"Alegeri Prezidentiale",2,354,290,229,48,13,279,11,400,110,92,187
22,HUNEDOARA,RIBIŢA,90805,"DUMBRAVA DE JOS","CĂMINUL CULTURAL DUMBRAVA DE JOS",444,"Alegeri Prezidentiale",1,139,139,96,32,11,139,0,150,11,44,95
22,HUNEDOARA,RIBIŢA,90805,"DUMBRAVA DE SUS","ŞCOALA PRIMARĂ DUMBRAVA DE SUS",445,"Alegeri Prezidentiale",1,65,71,40,31,0,69,2,100,29,8,61
22,HUNEDOARA,RIBIŢA,90805,UIBĂREŞTI,"ŞCOALA PRIMARĂ UIBĂREŞTI",446,"Alegeri Prezidentiale",1,55,57,38,16,3,56,1,80,23,18,38
22,HUNEDOARA,ROMOS,90994,ROMOS,"SCOALA PRIMARA ROMOS",447,"Alegeri Prezidentiale",1,960,639,530,105,4,630,9,1050,411,489,141
22,HUNEDOARA,ROMOS,90994,ROMOŞEL,"SCOALA PRIMARA ROMOSEL",448,"Alegeri Prezidentiale",1,590,377,331,46,0,376,1,650,273,323,53
22,HUNEDOARA,ROMOS,90994,VAIDEI,"SCOALA PRIMARA VAIDEI",449,"Alegeri Prezidentiale",1,521,296,246,49,1,291,5,550,254,219,72
22,HUNEDOARA,ROMOS,90994,PIŞCHINŢI,"SCOALA PRIMARA PISCHINTI",450,"Alegeri Prezidentiale",1,179,129,104,25,0,127,2,200,71,83,44
22,HUNEDOARA,SARMIZEGETUSA,91054,SARMIZEGETUSA,"CAMINUL CULTURAL SARMIZEGETUSA",451,"Alegeri Prezidentiale",1,456,401,281,97,23,397,4,500,99,177,220
22,HUNEDOARA,SARMIZEGETUSA,91054,BREAZOVA,"SCOALA PRIMARA BREAZOVA",452,"Alegeri Prezidentiale",1,150,146,110,34,2,140,6,170,24,60,80
22,HUNEDOARA,SARMIZEGETUSA,91054,HOBIŢA-GRĂDIŞTE,"SCOALA PRIMARA HOBITA-GRADISTE",453,"Alegeri Prezidentiale",1,114,92,72,13,7,92,0,150,58,43,49
22,HUNEDOARA,SARMIZEGETUSA,91054,PĂUCINEŞTI,"CAMINUL CULTURAL PAUCINESTI",454,"Alegeri Prezidentiale",1,139,122,95,18,9,122,0,160,38,41,81
22,HUNEDOARA,SARMIZEGETUSA,91054,ZEICANI,"CAMINUL CULTURAL ZEICANI",455,"Alegeri Prezidentiale",1,104,94,69,22,3,94,0,130,36,45,49
22,HUNEDOARA,"SĂLAŞU DE SUS",91116,"SĂLAŞU DE SUS","CĂMINUL CULTURAL",456,"Alegeri Prezidentiale",1,418,304,235,64,5,300,4,458,154,167,133
22,HUNEDOARA,"SĂLAŞU DE SUS",91116,"SĂLAŞU DE JOS","ŞCOALA PRIMARĂ SĂLAŞU DE JOS",457,"Alegeri Prezidentiale",1,195,129,106,23,0,126,3,220,91,56,70
22,HUNEDOARA,"SĂLAŞU DE SUS",91116,"OHABA DE SUB PIATRĂ","ŞCOALA GENERALĂ OHABA DE SUB PIATRĂ",458,"Alegeri Prezidentiale",1,162,110,93,17,0,108,2,199,89,47,61
22,HUNEDOARA,"SĂLAŞU DE SUS",91116,"RÂU ALB","ŞCOALA PRIMARĂ RÎU ALB",459,"Alegeri Prezidentiale",1,159,96,80,16,0,95,1,190,94,34,61
22,HUNEDOARA,"SĂLAŞU DE SUS",91116,COROIEŞTI,"CĂMIN CULTURAL COROIEŞTI",460,"Alegeri Prezidentiale",1,151,125,102,23,0,124,1,180,55,62,62
22,HUNEDOARA,"SĂLAŞU DE SUS",91116,PAROŞ,"ŞCOALA GENERALĂ PAROŞ",461,"Alegeri Prezidentiale",1,264,176,152,24,0,173,3,300,124,75,98
22,HUNEDOARA,"SĂLAŞU DE SUS",91116,NUCŞOARA,"ŞCOALA PRIMARĂ NUCŞOARA",462,"Alegeri Prezidentiale",1,236,171,131,40,0,168,3,250,79,84,84
22,HUNEDOARA,"SĂLAŞU DE SUS",91116,MĂLĂIEŞTI,"CĂMIN CULTURAL MĂLĂIEŞTI",463,"Alegeri Prezidentiale",2,122,101,91,10,0,97,4,150,49,56,41
22,HUNEDOARA,"SĂLAŞU DE SUS",91116,ZĂVOI,"CĂMIN CULTURAL ZĂVOI",464,"Alegeri Prezidentiale",1,107,87,68,19,0,85,2,131,44,43,42
22,HUNEDOARA,"SĂLAŞU DE SUS",91116,"RÂU MIC","ŞCOALA PRIMARĂ RÎU MIC",465,"Alegeri Prezidentiale",1,146,110,97,13,0,110,0,170,60,55,55
22,HUNEDOARA,SÂNTĂMĂRIA-ORLEA,91232,SÂNTĂMĂRIA-ORLEA,"CĂMINUL CULTURAL SÎNTĂMĂRIA-ORLEA",466,"Alegeri Prezidentiale",1,627,371,336,35,0,361,10,670,299,202,159
22,HUNEDOARA,SÂNTĂMĂRIA-ORLEA,91232,SUBCETATE,"ŞCOALA PRIMARĂ SUBCETATE",467,"Alegeri Prezidentiale",2,470,235,217,16,2,229,6,500,265,107,122
22,HUNEDOARA,SÂNTĂMĂRIA-ORLEA,91232,BUCIUM-ORLEA,"CĂMINUL CULTURAL BUCIUM",468,"Alegeri Prezidentiale",2,174,111,95,14,2,106,5,200,89,45,61
22,HUNEDOARA,SÂNTĂMĂRIA-ORLEA,91232,BALOMIR,"CĂMINUL CULTURAL BALOMIR",469,"Alegeri Prezidentiale",1,267,167,149,18,0,166,1,300,133,69,97
22,HUNEDOARA,SÂNTĂMĂRIA-ORLEA,91232,CIOPEIA,"ŞCOALA PRIMARĂ CIOPEIA",470,"Alegeri Prezidentiale",1,323,150,132,15,3,147,3,350,200,51,96
22,HUNEDOARA,SÂNTĂMĂRIA-ORLEA,91232,"BĂRĂŞTII HAŢEGULUI","ŞCOALA PRIMARĂ BĂRĂŞTII-HAŢEGULUI",471,"Alegeri Prezidentiale",1,311,160,138,22,0,156,4,350,190,82,74
22,HUNEDOARA,SÂNTĂMĂRIA-ORLEA,91232,SĂCEL,"ŞCOALA SĂCEL",472,"Alegeri Prezidentiale",2,224,115,103,12,0,113,2,250,135,62,51
22,HUNEDOARA,SÂNTĂMĂRIA-ORLEA,91232,SÂNPETRU,"CĂMINUL CULTURAL SÎNPETRU",473,"Alegeri Prezidentiale",1,204,131,112,19,0,130,1,230,99,59,71
22,HUNEDOARA,ŞOIMUŞ,91330,ŞOIMUŞ,"CĂMIN CULTURAL,SAT ŞOIMUŞNR. 310",474,"Alegeri Prezidentiale",1,1084,697,552,145,0,685,12,1200,503,421,264
22,HUNEDOARA,ŞOIMUŞ,91330,BĂLATA,"CĂMIN CULTURAL,SAT BĂLATANR. 37",475,"Alegeri Prezidentiale",1,356,242,188,54,0,241,1,400,158,143,98
22,HUNEDOARA,ŞOIMUŞ,91330,BOHOLT,"CĂMIN CULTURAL SAT BOHOLT, NR. 39",476,"Alegeri Prezidentiale",1,268,227,165,62,0,224,3,300,73,138,86
22,HUNEDOARA,ŞOIMUŞ,91330,FORNĂDIA,"CĂMIN CULTURAL SAT FORNĂDIA, NR. 71",477,"Alegeri Prezidentiale",1,179,142,113,28,1,142,0,210,68,89,53
22,HUNEDOARA,ŞOIMUŞ,91330,SULIGHETE,"ŞCOALA PRIMARĂ SAT SULIGHETE NR. 88",478,"Alegeri Prezidentiale",2,227,190,137,53,0,187,3,250,60,135,52
22,HUNEDOARA,ŞOIMUŞ,91330,PĂULIŞ,"CĂMIN CULTURAL , SAT PĂULIŞ, NR. 61",479,"Alegeri Prezidentiale",1,569,383,338,45,0,371,12,600,217,228,143
22,HUNEDOARA,ŞOIMUŞ,91330,CHIŞCĂDAGA,"CĂMIN CULTURAL SAT CHIŞCĂDAGA, NR. 94",480,"Alegeri Prezidentiale",2,294,243,194,49,0,239,4,330,87,162,77
22,HUNEDOARA,"TELIUCU INFERIOR",86936,"TELIUCU INFERIOR","PRIMARIA COMUNEI TELIUCU INFERIOR",481,"Alegeri Prezidentiale",1,1195,604,546,54,4,588,16,1300,696,316,272
22,HUNEDOARA,"TELIUCU INFERIOR",86936,CINCIŞ-CERNA,"CASA TINERETULUI CINCIȘAN",482,"Alegeri Prezidentiale",1,548,348,297,51,0,339,9,600,252,200,139
22,HUNEDOARA,"TELIUCU INFERIOR",86936,IZVOARELE,"CAMIN CULTURAL",483,"Alegeri Prezidentiale",1,73,68,39,29,0,67,1,100,32,32,35
22,HUNEDOARA,"TELIUCU INFERIOR",86936,"TELIUCU SUPERIOR","CAMIN CULTURAL SI RECREATIV PLOSCA",484,"Alegeri Prezidentiale",1,266,162,135,27,0,159,3,300,138,110,49
22,HUNEDOARA,TOMEŞTI,91447,LIVADA,"CĂMIN CULTURAL",485,"Alegeri Prezidentiale",1,97,51,43,8,0,50,1,120,69,18,32
22,HUNEDOARA,TOMEŞTI,91447,TOMEŞTI,"CĂMINUL CULTURAL TOMEŞTI",486,"Alegeri Prezidentiale",1,433,251,231,20,0,249,2,480,229,161,88
22,HUNEDOARA,TOMEŞTI,91447,DOBROŢ,"CĂMIN CULTURAL DOBROŢ",487,"Alegeri Prezidentiale",1,324,227,199,28,0,227,0,350,123,145,82
22,HUNEDOARA,TOPLIŢA,91535,TOPLIŢA,"CAMINUL CULTURAL TOPLITA",488,"Alegeri Prezidentiale",1,149,143,73,70,0,142,1,170,27,100,42
22,HUNEDOARA,TOPLIŢA,91535,HĂŞDĂU,"SCOALA PRIMARA HASDAU",489,"Alegeri Prezidentiale",2,294,216,159,57,0,213,3,320,104,101,112
22,HUNEDOARA,TOPLIŢA,91535,DĂBÂCA,"CAMINUL CULTURAL DABICA",490,"Alegeri Prezidentiale",1,127,94,73,21,0,93,1,150,56,42,51
22,HUNEDOARA,TOPLIŢA,91535,"DEALU MIC","CAMINUL CULTURAL DEALU MIC",491,"Alegeri Prezidentiale",1,41,33,19,14,0,32,1,60,27,12,20
22,HUNEDOARA,TOPLIŢA,91535,VĂLARI,"CĂMIN CULTURAL VĂLARI",492,"Alegeri Prezidentiale",1,27,35,20,15,0,35,0,50,15,26,9
22,HUNEDOARA,TOTEŞTI,91624,TOTEŞTI,"ȘCOALA GIMNAZIALĂ TOTEȘTI",493,"Alegeri Prezidentiale",1,315,262,213,35,14,259,3,350,88,64,195
22,HUNEDOARA,TOTEŞTI,91624,CÂRNEŞTI,"CAMINUL CULTURAL CIRNESTI",494,"Alegeri Prezidentiale",2,379,285,244,30,11,280,5,420,135,89,191
22,HUNEDOARA,TOTEŞTI,91624,PĂCLIŞA,"SCOALA PRIMARA PACLISA",495,"Alegeri Prezidentiale",1,507,406,316,65,25,400,6,550,144,96,304
22,HUNEDOARA,TOTEŞTI,91624,REEA,"SCOALA PRIMARA REEA",496,"Alegeri Prezidentiale",1,350,256,227,27,2,253,3,400,144,60,193
22,HUNEDOARA,TURDAŞ,91688,TURDAŞ,"CĂMINUL CULTURAL TURDAŞ",497,"Alegeri Prezidentiale",1,405,261,218,39,4,258,3,450,189,178,80
22,HUNEDOARA,TURDAŞ,91688,PRICAZ,"CĂMINUL CULTURAL PRICAZ",498,"Alegeri Prezidentiale",1,1036,535,491,43,1,526,9,1100,565,347,179
22,HUNEDOARA,TURDAŞ,91688,SPINI,"ŞCOALA PRIMARĂ SPINI",499,"Alegeri Prezidentiale",1,249,126,102,24,0,124,2,280,154,82,42
22,HUNEDOARA,"VAŢA DE JOS",91795,"VAŢA DE JOS","SCOALA GIMNAZIALA VAŢA DE JOS",500,"Alegeri Prezidentiale",1,860,429,385,44,0,421,8,900,471,181,240
22,HUNEDOARA,"VAŢA DE JOS",91795,CĂZĂNEŞTI,"ŞCOALA PRIMARA",501,"Alegeri Prezidentiale",1,159,91,81,10,0,91,0,200,109,47,44
22,HUNEDOARA,"VAŢA DE JOS",91795,BIRTIN,"ŞCOALA PRIMARA",502,"Alegeri Prezidentiale",1,249,127,114,13,0,122,5,270,143,51,71
22,HUNEDOARA,"VAŢA DE JOS",91795,PRĂVĂLENI,"ŞCOALA PRIMARA",503,"Alegeri Prezidentiale",1,227,143,129,14,0,143,0,250,107,89,54
22,HUNEDOARA,"VAŢA DE JOS",91795,CIUNGANI,"ŞCOALA PRIMARA",504,"Alegeri Prezidentiale",1,198,135,118,12,5,134,1,220,85,56,78
22,HUNEDOARA,"VAŢA DE JOS",91795,PRIHODIŞTE,"ŞCOALA PRIMARA PRIHODIŞTE",505,"Alegeri Prezidentiale",1,309,176,163,13,0,174,2,350,174,53,121
22,HUNEDOARA,"VAŢA DE JOS",91795,"TÂRNAVA DE CRIŞ","ŞCOALA PRIMARA TÎRNAVA DE CRIŞ",506,"Alegeri Prezidentiale",1,659,355,339,16,0,353,2,700,345,186,167
22,HUNEDOARA,"VAŢA DE JOS",91795,OCIU,"ŞCOALA PRIMARA OCIU",507,"Alegeri Prezidentiale",1,397,190,169,21,0,188,2,430,240,98,90
22,HUNEDOARA,VĂLIŞOARA,91937,VĂLIŞOARA,"CĂMINUL CULTURAL VĂLIŞOARA",508,"Alegeri Prezidentiale",1,628,426,327,98,1,419,7,670,244,262,157
22,HUNEDOARA,VĂLIŞOARA,91937,"DEALU MARE","CĂMINUL CULTURAL DEALU MARE",509,"Alegeri Prezidentiale",1,157,126,98,28,0,125,1,200,74,65,60
22,HUNEDOARA,VĂLIŞOARA,91937,SĂLIŞTIOARA,"CĂMINUL CULTURAL SĂLIŞTIOARA",510,"Alegeri Prezidentiale",1,238,186,155,31,0,182,4,250,64,120,62
22,HUNEDOARA,VEŢEL,91982,VEŢEL,"CĂMINUL CULTURAL VEŢEL",511,"Alegeri Prezidentiale",1,902,545,450,95,0,526,19,980,435,300,226
22,HUNEDOARA,VEŢEL,91982,MINTIA,"CĂMINUL CULTURAL MINTIA",512,"Alegeri Prezidentiale",1,890,430,369,61,0,422,8,950,520,253,169
22,HUNEDOARA,VEŢEL,91982,LEŞNIC,"ȘCOALA PRIMARĂ LEȘNIC",513,"Alegeri Prezidentiale",1,459,317,247,70,0,315,2,500,183,180,135
22,HUNEDOARA,VEŢEL,91982,"MUNCELU MIC","ŞCOALA PRIMARĂ MUNCELU MIC",514,"Alegeri Prezidentiale",1,97,65,45,20,0,62,3,120,55,24,38
22,HUNEDOARA,VEŢEL,91982,"MUNCELU MARE","CĂMIN CULTURAL MUNCELU MARE",515,"Alegeri Prezidentiale",1,62,48,31,17,0,47,1,100,52,20,27
22,HUNEDOARA,VORŢA,92097,VORŢA,"CENTRUL DE INFORMARE TURISTICA VORTA",516,"Alegeri Prezidentiale",1,130,91,62,29,0,90,1,150,59,68,22
22,HUNEDOARA,VORŢA,92097,VISCA,"CAMINUL CULTURAL VISCA",517,"Alegeri Prezidentiale",1,296,184,160,24,0,180,4,350,166,109,71
22,HUNEDOARA,VORŢA,92097,"VALEA POIENII","SCOALA PRIMARA VALEA POIENII",518,"Alegeri Prezidentiale",1,110,95,58,37,0,92,3,130,35,40,52
22,HUNEDOARA,VORŢA,92097,COAJA,"IMOBILUL NR 9 DIN SATUL COAJA",519,"Alegeri Prezidentiale",1,103,76,58,18,0,75,1,130,54,43,32
22,HUNEDOARA,ZAM,92177,ZAM,"CĂMINUL CULTURAL ZAM",520,"Alegeri Prezidentiale",1,546,348,261,87,0,343,5,785,437,212,131
22,HUNEDOARA,ZAM,92177,POGĂNEŞTI,"ŞCOALA PRIMARĂ POGĂNEŞTI",521,"Alegeri Prezidentiale",2,210,125,85,40,0,124,1,250,125,72,52
22,HUNEDOARA,ZAM,92177,ALMAŞ-SĂLIŞTE,"CĂMINUL CULTURAL ALMAŞ SĂLIŞTE",522,"Alegeri Prezidentiale",1,118,59,46,13,0,59,0,140,81,45,14
22,HUNEDOARA,ZAM,92177,GODINEŞTI,"CĂMINUL CULTURAL GODINEŞTI",523,"Alegeri Prezidentiale",1,101,61,50,11,0,60,1,130,69,34,26
22,HUNEDOARA,ZAM,92177,SĂLCIVA,"CĂMINUL CULTURAL SĂLCIVA",524,"Alegeri Prezidentiale",1,388,225,185,40,0,222,3,450,225,123,99
23,IALOMIŢA,"MUNICIPIUL SLOBOZIA",92658,SLOBOZIA,"GRUPUL ŞCOLAR ”ALEXANDRU IOAN CUZA” (LICEUL DE CONSTRUCŢII),",1,"Alegeri Prezidentiale",1,1534,855,554,36,265,842,13,1700,845,351,491
23,IALOMIŢA,"MUNICIPIUL SLOBOZIA",92658,SLOBOZIA,"GRUPUL ŞCOLAR ”ALEXANDRU IOAN CUZA” (LICEUL DE CONSTRUCŢII),",2,"Alegeri Prezidentiale",1,1392,656,630,26,0,650,6,1500,844,388,262
23,IALOMIŢA,"MUNICIPIUL SLOBOZIA",92658,SLOBOZIA,"ŞCOALA GENERALÃ NR.3,",3,"Alegeri Prezidentiale",1,1151,587,534,53,0,580,7,1300,713,344,236
23,IALOMIŢA,"MUNICIPIUL SLOBOZIA",92658,SLOBOZIA,"ŞCOALA GENERALÃ NR.3,",4,"Alegeri Prezidentiale",1,946,495,455,40,0,482,13,1000,505,269,213
23,IALOMIŢA,"MUNICIPIUL SLOBOZIA",92658,SLOBOZIA,"COLEGIUL NAŢIONAL ”MIHAI VITEAZU” (LICEUL DE MATEMATICÃ - FIZICÃ)",5,"Alegeri Prezidentiale",1,1184,650,589,61,0,636,14,1300,650,351,285
23,IALOMIŢA,"MUNICIPIUL SLOBOZIA",92658,SLOBOZIA,"LICEUL PEDAGOGIC ”MATEI BASARAB” (ŞCOALA NORMALÃ)",6,"Alegeri Prezidentiale",1,1522,818,774,42,2,804,14,1700,882,449,355
23,IALOMIŢA,"MUNICIPIUL SLOBOZIA",92658,SLOBOZIA,"MUZEUL AGRICULTURII",7,"Alegeri Prezidentiale",1,1565,730,695,35,0,715,15,1700,970,389,326
23,IALOMIŢA,"MUNICIPIUL SLOBOZIA",92658,SLOBOZIA,"LICEUL TEHNOLOGIC ”ÎNĂLŢAREA DOMNULUI” (ŞCOALA GENERALĂ NR. 6)",8,"Alegeri Prezidentiale",1,1581,741,700,41,0,723,18,1700,959,430,293
23,IALOMIŢA,"MUNICIPIUL SLOBOZIA",92658,SLOBOZIA,"LICEUL TEHNOLOGIC ”ÎNĂLŢAREA DOMNULUI” (ŞCOALA GENERALÃ NR.6)",9,"Alegeri Prezidentiale",1,1354,591,559,32,0,577,14,1500,909,306,271
23,IALOMIŢA,"MUNICIPIUL SLOBOZIA",92658,SLOBOZIA,"GRĂDINIŢA CU PROGRAM NORMAL ”LUMEA COPIILOR”",10,"Alegeri Prezidentiale",1,1467,723,693,30,0,706,17,1600,877,358,348
23,IALOMIŢA,"MUNICIPIUL SLOBOZIA",92658,SLOBOZIA,"DIRECȚIA PENTRU AGRICULTURĂ JUDEȚEANĂ IALOMIȚA",11,"Alegeri Prezidentiale",1,1033,428,397,31,0,423,5,1100,672,224,199
23,IALOMIŢA,"MUNICIPIUL SLOBOZIA",92658,SLOBOZIA,"SEMINARUL TEOLOGIC ORTODOX ”SF. IOAN GURĂ DE AUR”,",12,"Alegeri Prezidentiale",1,963,552,512,38,2,537,15,1100,548,277,260
23,IALOMIŢA,"MUNICIPIUL SLOBOZIA",92658,SLOBOZIA,"CASA DE CULTURĂ MUNICIPALĂ (FOSTUL CINEMA ”GALAX”)",13,"Alegeri Prezidentiale",1,1416,606,539,67,0,597,9,1600,994,367,230
23,IALOMIŢA,"MUNICIPIUL SLOBOZIA",92658,SLOBOZIA,"LICEUL TEHNOLOGIC ”MIHAI EMINESCU” (LICEUL DE CHIMIE)",14,"Alegeri Prezidentiale",1,1114,521,466,55,0,515,6,1200,679,291,224
23,IALOMIŢA,"MUNICIPIUL SLOBOZIA",92658,SLOBOZIA,"ŞCOALA GIMNAZIALÃ ”GHEORGHE LAZĂR”",15,"Alegeri Prezidentiale",1,1567,828,745,83,0,818,10,1700,872,487,331
23,IALOMIŢA,"MUNICIPIUL SLOBOZIA",92658,SLOBOZIA,"ŞCOALA GIMNAZIALĂ ”GHEORGHE LAZĂR”",16,"Alegeri Prezidentiale",1,1516,779,624,39,116,766,13,1700,921,440,326
23,IALOMIŢA,"MUNICIPIUL SLOBOZIA",92658,SLOBOZIA,"GRĂDINIŢA CU PROGRAM PRELUNGIT ”PITICOT”",17,"Alegeri Prezidentiale",1,1513,790,756,34,0,772,18,1700,910,440,332
23,IALOMIŢA,"MUNICIPIUL SLOBOZIA",92658,SLOBOZIA,SCELIF,18,"Alegeri Prezidentiale",1,1446,755,704,51,0,745,10,1600,845,400,345
23,IALOMIŢA,"MUNICIPIUL SLOBOZIA",92658,SLOBOZIA,"ŞCOALA GIMNAZIALĂ ”SF. ANDREI”",19,"Alegeri Prezidentiale",1,1547,854,795,58,1,838,16,1700,846,461,377
23,IALOMIŢA,"MUNICIPIUL SLOBOZIA",92658,SLOBOZIA,"ŞCOALA GIMNAZIALA ”SF. ANDREI”",20,"Alegeri Prezidentiale",1,1455,824,765,59,0,806,18,1592,768,451,355
23,IALOMIŢA,"MUNICIPIUL SLOBOZIA",92658,SLOBOZIA,"S.C. DRUMURI ŞI PODURI IALOMIŢA",21,"Alegeri Prezidentiale",1,1696,946,903,42,1,929,17,1900,954,559,370
23,IALOMIŢA,"MUNICIPIUL SLOBOZIA",92658,SLOBOZIA,"PALATUL COPIILOR SLOBOZIA",22,"Alegeri Prezidentiale",1,1471,796,746,50,0,778,18,1600,804,433,345
23,IALOMIŢA,"MUNICIPIUL SLOBOZIA",92658,SLOBOZIA,"PALATUL COPIILOR SLOBOZIA",23,"Alegeri Prezidentiale",1,1234,685,653,32,0,667,18,1400,715,370,297
23,IALOMIŢA,"MUNICIPIUL SLOBOZIA",92658,SLOBOZIA,"LICEUL DE ARTĂ ”IONEL PERLEA” (ŞCOALA GENERALĂ NR. 1 LOCAL NOU)",24,"Alegeri Prezidentiale",1,898,512,465,47,0,504,8,1000,488,286,218
23,IALOMIŢA,"MUNICIPIUL SLOBOZIA",92658,SLOBOZIA,"LICEUL DE ARTĂ ”IONEL PERLEA” (ŞCOALA GENERALÃ NR.1- LOCAL ANEXĂ)",25,"Alegeri Prezidentiale",1,901,529,497,32,0,520,9,1000,471,285,235
23,IALOMIŢA,"MUNICIPIUL SLOBOZIA",92658,SLOBOZIA,"LICEUL DE ARTĂ ”IONEL PERLEA”",26,"Alegeri Prezidentiale",1,1096,566,525,40,1,554,12,1200,634,356,198
23,IALOMIŢA,"MUNICIPIUL SLOBOZIA",92658,SLOBOZIA,"LICEUL DE ARTĂ ”IONEL PERLEA”",27,"Alegeri Prezidentiale",1,1506,751,722,27,2,740,11,1600,849,436,304
23,IALOMIŢA,"MUNICIPIUL SLOBOZIA",92658,SLOBOZIA,"GRÃDINIŢA CU PROGRAM PRELUNGIT ”DUMBRAVA MINUNATĂ”",28,"Alegeri Prezidentiale",1,1407,729,667,61,1,713,16,1500,771,401,312
23,IALOMIŢA,"MUNICIPIUL SLOBOZIA",92658,SLOBOZIA,"ATELIERELE DE CREAŢIE ALE LICEULUI DE ARTĂ",29,"Alegeri Prezidentiale",1,1979,935,898,37,0,919,16,2100,1165,491,428
23,IALOMIŢA,"MUNICIPIUL SLOBOZIA",92658,BORA,"ŞCOALA GIMNAZIALĂ BORA",30,"Alegeri Prezidentiale",1,727,238,213,25,0,227,11,800,562,95,132
23,IALOMIŢA,"MUNICIPIUL SLOBOZIA",92658,BORA,"ŞCOALA GIMNAZIALÃ BORA",31,"Alegeri Prezidentiale",1,1005,331,322,9,0,321,10,1100,769,143,178
23,IALOMIŢA,"MUNICIPIUL SLOBOZIA",92658,"SLOBOZIA NOUĂ","ŞCOALA GIMNAZIALÃ NR.5 SLOBOZIA NOUÃ",32,"Alegeri Prezidentiale",1,1054,484,469,14,1,476,8,1200,716,257,219
23,IALOMIŢA,"MUNICIPIUL SLOBOZIA",92658,"SLOBOZIA NOUĂ","ŞCOALA GIMNAZIALÃ NR.5 SLOBOZIA NOUÃ",33,"Alegeri Prezidentiale",1,980,447,423,24,0,440,7,1100,653,261,179
23,IALOMIŢA,"MUNICIPIUL FETEŞTI",92701,FETEŞTI,"ŞCOALA GIMNAZIALĂ ” MIHAI VITEAZUL”- LOCALUL BULIGA",34,"Alegeri Prezidentiale",1,891,444,420,24,0,440,4,1000,556,152,288
23,IALOMIŢA,"MUNICIPIUL FETEŞTI",92701,FETEŞTI,"ŞCOALA GIMNAZIALĂ ”MIHAI VITEAZUL”- LOCALUL A",35,"Alegeri Prezidentiale",1,1503,437,411,26,0,431,6,1700,1263,196,235
23,IALOMIŢA,"MUNICIPIUL FETEŞTI",92701,FETEŞTI,"SCOALA GIMNAZIALA ”MIHAI VITEAZUL”",36,"Alegeri Prezidentiale",1,1029,359,332,27,0,354,5,1100,741,177,177
23,IALOMIŢA,"MUNICIPIUL FETEŞTI",92701,FETEŞTI,"SCOALA GIMNAZIALA ”MIHAI VITEAZUL” - LOCALUL B",37,"Alegeri Prezidentiale",1,1004,371,360,11,0,364,7,1100,729,182,182
23,IALOMIŢA,"MUNICIPIUL FETEŞTI",92701,FETEŞTI,"SCOALA GIMNAZIALA ”MIHAI VITEAZUL” - LOCALUL C",38,"Alegeri Prezidentiale",1,941,404,375,29,0,398,6,1000,596,218,180
23,IALOMIŢA,"MUNICIPIUL FETEŞTI",92701,FETEŞTI,"PROTOPOPIATUL FETESTI",39,"Alegeri Prezidentiale",1,1124,486,443,43,0,479,7,1200,714,237,242
23,IALOMIŢA,"MUNICIPIUL FETEŞTI",92701,FETEŞTI,"SCOALA GIMNAZIALA ”RADU VODA”",40,"Alegeri Prezidentiale",1,992,367,347,20,0,358,9,1100,733,187,171
23,IALOMIŢA,"MUNICIPIUL FETEŞTI",92701,FETEŞTI,"GRADINIŢA ŞCOLII GIMNAZIALE NR.4",41,"Alegeri Prezidentiale",1,804,296,279,17,0,290,6,900,604,159,131
23,IALOMIŢA,"MUNICIPIUL FETEŞTI",92701,FETEŞTI,"GRADINIŢA ŞCOLII GIMNAZIALE NR.4",42,"Alegeri Prezidentiale",1,967,375,361,14,0,362,13,1100,725,162,200
23,IALOMIŢA,"MUNICIPIUL FETEŞTI",92701,FETEŞTI,"LICEU TEHNOLOGIC ”ANGHEL SALIGNY”",43,"Alegeri Prezidentiale",1,848,463,382,45,36,457,6,900,437,213,244
23,IALOMIŢA,"MUNICIPIUL FETEŞTI",92701,FETEŞTI,"LICEUL TEORETIC ”CAROL I”",44,"Alegeri Prezidentiale",1,1511,711,664,47,0,701,10,1700,989,327,374
23,IALOMIŢA,"MUNICIPIUL FETEŞTI",92701,FETEŞTI,"ŞCOALA GIMNAZIALA ”AUREL VLAICU”",45,"Alegeri Prezidentiale",1,1216,657,603,54,0,635,22,1300,643,311,324
23,IALOMIŢA,"MUNICIPIUL FETEŞTI",92701,FETEŞTI,"LICEUL TEHNOLOGIC DE INDUSTRIE ALIMENTARA",46,"Alegeri Prezidentiale",1,1495,662,622,38,2,649,13,1600,938,301,348
23,IALOMIŢA,"MUNICIPIUL FETEŞTI",92701,FETEŞTI,"GRĂDINIŢA CU PROGRAM PRELUNGIT ”ALBA CA ZAPADA”",47,"Alegeri Prezidentiale",1,1218,519,498,21,0,506,13,1300,781,260,246
23,IALOMIŢA,"MUNICIPIUL FETEŞTI",92701,FETEŞTI,"SALA DE SPORT",48,"Alegeri Prezidentiale",1,1012,491,466,25,0,485,6,1100,609,249,236
23,IALOMIŢA,"MUNICIPIUL FETEŞTI",92701,FETEŞTI,"LICEUL TEHNOLOGIC DE INDUSTRIE ALIMENTARA (FOSTA SCOALA NR. 8)",49,"Alegeri Prezidentiale",1,905,400,372,28,0,398,2,1000,600,195,203
23,IALOMIŢA,"MUNICIPIUL FETEŞTI",92701,FETEŞTI,"LICEUL TEHNOLOGIC DE INDUSTRIE ALIMENTARA (FOSTA SCOALA NR. 8)",50,"Alegeri Prezidentiale",1,919,399,371,28,0,394,5,1000,601,183,211
23,IALOMIŢA,"MUNICIPIUL FETEŞTI",92701,FETEŞTI,"GRĂDINIŢA NR.1",51,"Alegeri Prezidentiale",1,1247,661,601,60,0,652,9,1400,739,311,341
23,IALOMIŢA,"MUNICIPIUL FETEŞTI",92701,FETEŞTI,"ŞCOALA GIMNAZIALA ”DIMITRIE CANTEMIR”",52,"Alegeri Prezidentiale",1,1283,627,613,14,0,607,20,1400,773,276,331
23,IALOMIŢA,"MUNICIPIUL FETEŞTI",92701,FETEŞTI,"ŞCOALA GIMNAZIALA ”DIMITRIE CANTEMIR”",53,"Alegeri Prezidentiale",1,939,487,458,29,0,481,6,1000,513,223,258
23,IALOMIŢA,"MUNICIPIUL FETEŞTI",92701,FETEŞTI,"ŞCOALA GIMNAZIALA ”DIMITRIE CANTEMIR”",54,"Alegeri Prezidentiale",1,968,443,414,29,0,430,13,1100,657,228,202
23,IALOMIŢA,"MUNICIPIUL FETEŞTI",92701,FETEŞTI,"CENTRUL SOCIAL AL PAROHIEI FETESTI GARA II",55,"Alegeri Prezidentiale",1,1336,456,436,20,0,451,5,1500,1044,212,239
23,IALOMIŢA,"MUNICIPIUL FETEŞTI",92701,FETEŞTI,"LICEUL TEHNOLOGIC ”ANGHEL SALIGNY”",56,"Alegeri Prezidentiale",1,1325,403,386,17,0,392,11,1500,1097,214,178
23,IALOMIŢA,"MUNICIPIUL FETEŞTI",92701,FETEŞTI,"LICEUL TEHNOLOGIC ”ANGHEL SALIGNY” (FOSTA SCOALA NR. 5)",57,"Alegeri Prezidentiale",1,1365,446,425,20,1,442,4,1500,1054,231,211
23,IALOMIŢA,"MUNICIPIUL FETEŞTI",92701,FETEŞTI,"LICEUL TEHNOLOGIC ”ANGHEL SALIGNY” (FOSTA SCOALA NR. 5)",58,"Alegeri Prezidentiale",1,1112,372,349,23,0,369,3,1200,828,237,132
23,IALOMIŢA,"MUNICIPIUL URZICENI",100683,URZICENI,"GRĂDINIŢA CU PROGRAM PRELUNGIT",59,"Alegeri Prezidentiale",1,729,378,353,25,0,368,10,800,422,203,165
23,IALOMIŢA,"MUNICIPIUL URZICENI",100683,URZICENI,"ŞCOALA CU CLASELE I-VIII NR.3 DIN URZICENI",60,"Alegeri Prezidentiale",1,1358,552,504,48,0,542,10,1500,948,253,289
23,IALOMIŢA,"MUNICIPIUL URZICENI",100683,URZICENI,"GRĂDINIŢA DE COPII",61,"Alegeri Prezidentiale",1,1038,505,454,51,0,499,6,1300,795,309,190
23,IALOMIŢA,"MUNICIPIUL URZICENI",100683,URZICENI,"CASA DE CULTURĂ",62,"Alegeri Prezidentiale",1,1202,581,530,51,0,570,11,1300,719,284,286
23,IALOMIŢA,"MUNICIPIUL URZICENI",100683,URZICENI,"GRUPUL ŞCOLAR ’’SF. ECATERINA’’",63,"Alegeri Prezidentiale",1,1356,665,632,33,0,649,16,1500,835,373,276
23,IALOMIŢA,"MUNICIPIUL URZICENI",100683,URZICENI,"SCOALA GENERALA ALEXANDRU ODOBESCU",64,"Alegeri Prezidentiale",1,1148,632,554,78,0,620,12,1300,668,399,221
23,IALOMIŢA,"MUNICIPIUL URZICENI",100683,URZICENI,"CLUBUL SINDICATELOR",65,"Alegeri Prezidentiale",1,1671,820,746,74,0,803,17,1900,1080,464,339
23,IALOMIŢA,"MUNICIPIUL URZICENI",100683,URZICENI,"ŞCOALA GENERALĂ ION HELIADE RADULESCU",66,"Alegeri Prezidentiale",1,1499,757,678,79,0,744,13,1700,943,444,300
23,IALOMIŢA,"MUNICIPIUL URZICENI",100683,URZICENI,"ŞCOALA GENERALĂ ION HELIADE RADULESCU",67,"Alegeri Prezidentiale",1,1261,534,498,36,0,522,12,1400,866,282,240
23,IALOMIŢA,"MUNICIPIUL URZICENI",100683,URZICENI,"INTERNATUL COLEGIULUI NATIONAL GRIGORE MOISIL",68,"Alegeri Prezidentiale",1,1130,570,486,49,35,561,9,1300,730,310,251
23,IALOMIŢA,"MUNICIPIUL URZICENI",100683,URZICENI,"LICEUL TEHNOLOGIC URZICENI",69,"Alegeri Prezidentiale",1,1592,595,559,36,0,581,14,1800,1205,333,248
23,IALOMIŢA,"ORAŞ AMARA",92836,AMARA,"GRADINITA CU PROGRAM NORMAL AMARA",70,"Alegeri Prezidentiale",1,1289,563,491,72,0,550,13,1400,837,330,220
23,IALOMIŢA,"ORAŞ AMARA",92836,AMARA,"GRADINITA CU PROGRAM NORMAL AMARA",71,"Alegeri Prezidentiale",1,1051,522,445,77,0,516,6,1200,678,325,191
23,IALOMIŢA,"ORAŞ AMARA",92836,AMARA,"SCOALA GIMNAZIALA GEORGE VALSAN",72,"Alegeri Prezidentiale",1,1363,648,526,122,0,637,11,1500,852,382,255
23,IALOMIŢA,"ORAŞ AMARA",92836,AMARA,"SCOALA GIMNAZIALA GEORGE VALSAN",73,"Alegeri Prezidentiale",1,1399,615,514,101,0,599,16,1500,885,342,257
23,IALOMIŢA,"ORAŞ AMARA",92836,AMARA,"CASA DE CULTURA JAN CACIULA",74,"Alegeri Prezidentiale",1,1424,715,571,144,0,699,16,1600,885,391,308
23,IALOMIŢA,"ORAŞ CĂZĂNEŞTI",93067,CĂZĂNEŞTI,"LICEUL TEHNOLOGIC - CORP B",75,"Alegeri Prezidentiale",1,1462,558,489,68,1,551,7,1600,1042,277,274
23,IALOMIŢA,"ORAŞ CĂZĂNEŞTI",93067,CĂZĂNEŞTI,"LICEUL TEHNOLOGIC",76,"Alegeri Prezidentiale",1,1389,561,515,46,0,558,3,1500,939,287,271
23,IALOMIŢA,"ORAŞ FIERBINŢI-TÂRG",102749,FIERBINŢI-TÂRG,"CĂMINUL CULTURAL",77,"Alegeri Prezidentiale",1,1316,849,608,229,12,837,12,1400,551,424,413
23,IALOMIŢA,"ORAŞ FIERBINŢI-TÂRG",102749,"FIERBINŢII DE SUS","ŞCOALA GENERALĂ CU CLASELE I-IV FIRBINŢI DE SUS",78,"Alegeri Prezidentiale",1,1548,858,723,122,13,849,9,1709,851,440,409
23,IALOMIŢA,"ORAŞ FIERBINŢI-TÂRG",102749,"FIERBINŢII DE JOS","ŞCOALA GENERALĂ CU CLASELE I-IV FIRBINŢI DE JOS",79,"Alegeri Prezidentiale",1,906,506,439,66,1,501,5,1000,494,318,183
23,IALOMIŢA,"ORAŞ ŢĂNDĂREI",92765,ŢĂNDĂREI,"GRUPUL SCOLAR AGRICOL",80,"Alegeri Prezidentiale",1,1417,503,468,35,0,495,8,1600,1097,292,203
23,IALOMIŢA,"ORAŞ ŢĂNDĂREI",92765,ŢĂNDĂREI,"LICEUL TEORETIC ’’PAUL GEORGESCU’’",81,"Alegeri Prezidentiale",1,1139,371,312,36,23,364,7,1300,929,167,197
23,IALOMIŢA,"ORAŞ ŢĂNDĂREI",92765,ŢĂNDĂREI,"LICEUL TEORETIC ’’PAUL GEORGESCU’’",82,"Alegeri Prezidentiale",1,902,329,308,20,1,320,9,1000,671,165,155
23,IALOMIŢA,"ORAŞ ŢĂNDĂREI",92765,ŢĂNDĂREI,"ŞCOALA NR. 2",83,"Alegeri Prezidentiale",1,1589,635,597,38,0,620,15,1800,1165,348,272
23,IALOMIŢA,"ORAŞ ŢĂNDĂREI",92765,ŢĂNDĂREI,"ŞCOALA NR. 2",84,"Alegeri Prezidentiale",1,1511,391,376,15,0,387,4,1700,1309,193,194
23,IALOMIŢA,"ORAŞ ŢĂNDĂREI",92765,ŢĂNDĂREI,"ŞCOALA NR. 1 ŢĂNDĂREI",85,"Alegeri Prezidentiale",1,1490,435,398,37,0,426,9,1600,1165,234,192
23,IALOMIŢA,"ORAŞ ŢĂNDĂREI",92765,ŢĂNDĂREI,"FOST SEDIU PRIMĂRIE",86,"Alegeri Prezidentiale",1,1536,418,398,20,0,414,4,1700,1282,203,211
23,IALOMIŢA,"ORAŞ ŢĂNDĂREI",92765,ŢĂNDĂREI,"ŞCOALA NR. 1",87,"Alegeri Prezidentiale",1,1018,148,122,26,0,145,3,1100,952,57,88
23,IALOMIŢA,"ORAŞ ŢĂNDĂREI",92765,ŢĂNDĂREI,"BIBLIOTECA/DOMENIUL PUBLIC AL UAT TANDAREI",88,"Alegeri Prezidentiale",1,875,77,54,23,0,73,4,1000,923,30,43
23,IALOMIŢA,ADÂNCATA,100754,ADÂNCATA,"SALA DE SPORT DE LÂNGĂ PRIMARIA COMUNEI ADÂNCATA",89,"Alegeri Prezidentiale",1,1373,693,569,124,0,688,5,1500,807,376,312
23,IALOMIŢA,ADÂNCATA,100754,"PATRU FRAŢI","ŞCOALA GENERALĂ ADÂNCATA",90,"Alegeri Prezidentiale",1,622,292,200,92,0,285,7,700,408,162,123
23,IALOMIŢA,ALBEŞTI,92783,ALBEŞTI,"SCOALA GIMNAZIALA ”CONSTANTIN STEFAN”",91,"Alegeri Prezidentiale",1,527,341,270,63,8,330,11,600,259,175,155
23,IALOMIŢA,ALBEŞTI,92783,MARSILIENI,"SCOALA PRIMARA MARSILIENI",92,"Alegeri Prezidentiale",1,428,289,243,40,6,288,1,500,211,127,161
23,IALOMIŢA,ALEXENI,100852,ALEXENI,"ŞCOALA VECHE",93,"Alegeri Prezidentiale",1,890,371,325,41,5,367,4,1000,629,210,157
23,IALOMIŢA,ALEXENI,100852,ALEXENI,"ŞCOALA VECHE",94,"Alegeri Prezidentiale",1,989,469,407,56,6,468,1,1100,631,252,216
23,IALOMIŢA,ANDRĂŞEŞTI,92872,ANDRĂŞEŞTI,"ŞCOALA GENERALA ANDRĂŞEŞTI",95,"Alegeri Prezidentiale",1,1439,610,543,67,0,600,10,1600,990,327,273
23,IALOMIŢA,ANDRĂŞEŞTI,92872,ORBOEŞTI,"ŞCOALA ORBOEŞTI",96,"Alegeri Prezidentiale",1,273,112,84,28,0,111,1,300,188,61,50
23,IALOMIŢA,ARMĂŞEŞTI,100870,ARMĂŞEŞTI,"ȘCOALA GENERALĂ ARMĂȘEȘTI",97,"Alegeri Prezidentiale",1,613,230,167,63,0,228,2,700,470,121,107
23,IALOMIŢA,ARMĂŞEŞTI,100870,"MALU ROŞU","ŞCOALA GENERALĂ MALU ROȘU",98,"Alegeri Prezidentiale",1,1159,388,322,66,0,384,4,1300,912,200,184
23,IALOMIŢA,AXINTELE,100923,AXINTELE,PRIMARIE,99,"Alegeri Prezidentiale",1,544,293,219,74,0,287,6,600,307,87,200
23,IALOMIŢA,AXINTELE,100923,AXINTELE,"SCOALA FRUMUȘICA",100,"Alegeri Prezidentiale",1,790,324,257,67,0,318,6,900,576,167,151
23,IALOMIŢA,AXINTELE,100923,HORIA,"ȘCOALA HORIA",101,"Alegeri Prezidentiale",1,462,168,132,36,0,166,2,500,332,65,101
23,IALOMIŢA,BALACIU,92907,BALACIU,"CAMIN CULTURAL",102,"Alegeri Prezidentiale",1,395,245,158,72,15,242,3,400,155,89,153
23,IALOMIŢA,BALACIU,92907,BALACIU,"ŞCOALA GIMNAZIALĂ ”ARHIMANDRIT TEOFIL” BALACIU",103,"Alegeri Prezidentiale",1,346,141,108,33,0,140,1,400,259,81,59
23,IALOMIŢA,BALACIU,92907,"CRĂSANII DE JOS","SALĂ FESTIVITĂŢI",104,"Alegeri Prezidentiale",2,259,133,85,47,1,130,3,300,167,56,74
23,IALOMIŢA,BALACIU,92907,COPUZU,"GRADINITA COPUZU",105,"Alegeri Prezidentiale",1,247,112,77,35,0,112,0,300,188,82,30
23,IALOMIŢA,BĂRBULEŞTI,180064,BĂRBULEŞTI,"ŞCOALA GIMNAZIALĂ BĂRBULEŞTI",106,"Alegeri Prezidentiale",1,878,183,183,0,0,175,8,1000,817,70,105
23,IALOMIŢA,BĂRBULEŞTI,180064,BĂRBULEŞTI,"ŞCOALA GIMNAZIALĂ BĂRBULEŞTI",107,"Alegeri Prezidentiale",1,991,176,176,0,0,171,5,1100,924,79,92
23,IALOMIŢA,BĂRBULEŞTI,180064,BĂRBULEŞTI,"ŞCOALA GIMNAZIALĂ BĂRBULEŞTI",108,"Alegeri Prezidentiale",1,987,205,205,0,0,195,10,1100,895,59,136
23,IALOMIŢA,BĂRBULEŞTI,180064,BĂRBULEŞTI,"ŞCOALA GIMNAZIALĂ BĂRBULEŞTI",109,"Alegeri Prezidentiale",1,1103,302,249,53,0,299,3,1200,898,148,151
23,IALOMIŢA,BĂRCĂNEŞTI,101056,BĂRCĂNEŞTI,"ŞCOALA GIMNAZIALA BĂRCĂNEŞTI",110,"Alegeri Prezidentiale",1,1295,516,402,114,0,512,4,1400,884,291,221
23,IALOMIŢA,BĂRCĂNEŞTI,101056,CONDEEŞTI,"ŞCOALA GIMNAZIALĂ CONDEEŞTI",111,"Alegeri Prezidentiale",1,1383,473,395,78,0,468,5,1500,1027,245,223
23,IALOMIŢA,BORĂNEŞTI,179784,BORĂNEŞTI,"ŞCOALA GIMNAZIALĂ",112,"Alegeri Prezidentiale",1,975,439,411,28,0,423,16,1100,661,190,233
23,IALOMIŢA,BORĂNEŞTI,179784,BORĂNEŞTI,"ŞCOALA GIMNAZIALĂ",113,"Alegeri Prezidentiale",1,573,285,255,30,0,282,3,600,315,147,135
23,IALOMIŢA,BORĂNEŞTI,179784,BORĂNEŞTI,"ŞCOALA GIMNAZIALĂ BORĂNEŞTI",114,"Alegeri Prezidentiale",1,317,189,152,37,0,188,1,400,211,87,101
23,IALOMIŢA,BORDUŞANI,92989,BORDUŞANI,"LOCALUL ŞCOLII VECHI DIN CENTRUL SATULUI",115,"Alegeri Prezidentiale",1,1380,462,414,48,0,456,6,1500,1038,275,181
23,IALOMIŢA,BORDUŞANI,92989,BORDUŞANI,"LOCALUL GRUPULUI ŞCOLAR BORDUŞANI (ZONA „MOARĂ”)",116,"Alegeri Prezidentiale",1,1439,478,461,17,0,471,7,1600,1122,319,152
23,IALOMIŢA,BORDUŞANI,92989,CEGANI,"LOCALUL ŞCOLII CU CLASELE I- VIII CEGANI",117,"Alegeri Prezidentiale",1,1130,411,367,44,0,411,0,1200,789,247,164
23,IALOMIŢA,BUCU,93021,BUCU,"CĂMINUL CULTURAL",118,"Alegeri Prezidentiale",1,1036,441,387,54,0,436,5,1100,659,252,184
23,IALOMIŢA,BUCU,93021,BUCU,"CĂMINUL CULTURAL",119,"Alegeri Prezidentiale",1,1036,449,392,57,0,443,6,1098,649,254,189
23,IALOMIŢA,BUEŞTI,179793,BUEŞTI,"ŞCOALA CU CLASELE I – IV BUEŞTI",120,"Alegeri Prezidentiale",1,848,557,461,83,13,551,6,900,343,106,445
23,IALOMIŢA,CIOCÂRLIA,100709,CIOCÂRLIA,"ŞCOALA GENERALĂ CIOCÂRLIA",121,"Alegeri Prezidentiale",1,623,248,186,62,0,242,6,700,452,120,122
23,IALOMIŢA,CIOCHINA,93101,CIOCHINA,"CĂMINUL CULTURAL DIN SATUL CIOCHINA",122,"Alegeri Prezidentiale",1,1246,631,528,103,0,624,7,1400,769,353,271
23,IALOMIŢA,CIOCHINA,93101,BORDUŞELU,"CĂMINUL CULTURAL DIN SATUL BORDUŞELU",123,"Alegeri Prezidentiale",1,590,334,275,58,1,331,3,700,366,215,116
23,IALOMIŢA,CIOCHINA,93101,OREZU,"CĂMINUL CULTURAL DIN SATUL OREZU",124,"Alegeri Prezidentiale",1,644,297,251,46,0,296,1,700,403,220,76
23,IALOMIŢA,CIULNIŢA,93156,CIULNIŢA,"CĂMIN CULTURAL CIULNIŢA",125,"Alegeri Prezidentiale",1,920,441,388,53,0,432,9,1000,559,215,217
23,IALOMIŢA,CIULNIŢA,93156,"ION GHICA","CĂMIN CULTURAL ION GHICA",126,"Alegeri Prezidentiale",1,450,202,155,47,0,201,1,500,298,95,106
23,IALOMIŢA,CIULNIŢA,93156,POIANA,"ŞCOALA POIANA",127,"Alegeri Prezidentiale",1,393,185,163,22,0,185,0,400,215,102,83
23,IALOMIŢA,CIULNIŢA,93156,POIANA,"CĂMIN CULTURAL GHIMPAŢI",128,"Alegeri Prezidentiale",1,186,127,91,36,0,127,0,200,73,55,72
23,IALOMIŢA,COCORA,93209,COCORA,"ŞCOALA GIMNAZIALĂ COCORA",129,"Alegeri Prezidentiale",1,786,297,260,37,0,292,5,900,603,167,125
23,IALOMIŢA,COCORA,93209,COCORA,"PRIMARIA COCORA",130,"Alegeri Prezidentiale",1,832,295,242,53,0,290,5,900,605,160,130
23,IALOMIŢA,COLELIA,179971,COLELIA,"ŞCOALA CU CLASELE I-VIII COLELIA",131,"Alegeri Prezidentiale",1,927,562,446,77,39,555,7,1000,438,149,406
23,IALOMIŢA,COSÂMBEŞTI,93236,COSÂMBEŞTI,"CAMINUL CULTURAL DIN SATUL COSÂMBEŞTI",132,"Alegeri Prezidentiale",1,776,430,359,54,17,423,7,900,470,219,204
23,IALOMIŢA,COSÂMBEŞTI,93236,GIMBĂŞANI,"ŞCOALA GIMBĂŞANI",133,"Alegeri Prezidentiale",1,738,415,355,52,8,412,3,800,385,171,241
23,IALOMIŢA,COŞERENI,102240,COŞERENI,"CAMINUL CULTURAL COSERENI",134,"Alegeri Prezidentiale",1,1322,703,573,130,0,689,14,1500,797,415,274
23,IALOMIŢA,COŞERENI,102240,COŞERENI,"ŞCOALA GENERALĂ COSERENI",135,"Alegeri Prezidentiale",1,1272,571,515,56,0,569,2,1400,829,321,248
23,IALOMIŢA,COŞERENI,102240,COŞERENI,"GRADINIŢA PĂTRIME",136,"Alegeri Prezidentiale",1,1045,489,449,40,0,485,4,1100,611,286,199
23,IALOMIŢA,DRĂGOEŞTI,102641,DRĂGOEŞTI,"CĂMINUL CULTURAL DRĂGOEŞTI",137,"Alegeri Prezidentiale",1,750,554,389,165,0,551,3,800,246,229,322
23,IALOMIŢA,DRIDU,102703,DRIDU,"ŞCOALA GIMNAZIALĂ DRIDU",138,"Alegeri Prezidentiale",1,953,489,353,136,0,482,7,1100,611,253,229
23,IALOMIŢA,DRIDU,102703,DRIDU,"GRĂDINIŢA DRIDU – MOARĂ",139,"Alegeri Prezidentiale",1,808,432,355,77,0,420,12,900,468,210,210
23,IALOMIŢA,DRIDU,102703,DRIDU,"GRĂDINIŢA DRIDU – MOVILA",140,"Alegeri Prezidentiale",1,601,281,185,96,0,277,4,700,419,161,116
23,IALOMIŢA,DRIDU,102703,DRIDU-SNAGOV,"GRĂDINIŢA DRIDU –SNAGOV",141,"Alegeri Prezidentiale",1,325,163,123,40,0,160,3,400,237,102,58
23,IALOMIŢA,FĂCĂENI,93575,FĂCĂENI,"SAM FACAENI",142,"Alegeri Prezidentiale",1,1229,565,495,70,0,555,10,1400,835,339,216
23,IALOMIŢA,FĂCĂENI,93575,FĂCĂENI,"SCOALA GENERALA FACAENI - CORP B",143,"Alegeri Prezidentiale",1,1651,574,527,47,0,571,3,1800,1226,358,213
23,IALOMIŢA,FĂCĂENI,93575,FĂCĂENI,"SCOALA GENERALA FACAENI - CORP C",144,"Alegeri Prezidentiale",1,985,426,386,40,0,419,7,1100,674,269,150
23,IALOMIŢA,FĂCĂENI,93575,PROGRESU,"SEDIUL ADMINISTRATIV PRIMARIA FACAENI",145,"Alegeri Prezidentiale",1,506,199,176,23,0,195,4,600,401,88,107
23,IALOMIŢA,GÂRBOVI,103283,GÂRBOVI,"ŞCOALA CU CLASELE I-VIII GÂRBOVI,",146,"Alegeri Prezidentiale",1,1011,353,278,75,0,352,1,1100,747,191,161
23,IALOMIŢA,GÂRBOVI,103283,GÂRBOVI,"ŞCOALA CU CLASELE I-VIII GÂRBOVI,",147,"Alegeri Prezidentiale",1,1004,345,311,34,0,341,4,1100,755,197,144
23,IALOMIŢA,GÂRBOVI,103283,GÂRBOVI,"SCOALA CU CLASELE I-VIII GARBOVI",148,"Alegeri Prezidentiale",1,1075,396,317,79,0,391,5,1200,804,201,190
23,IALOMIŢA,"GHEORGHE DOJA",93600,"GHEORGHE DOJA","ŞCOALA GIMNAZIALĂ GHEORGHE DOJA SITUATĂ ÎN GHEORGHE DOJA",149,"Alegeri Prezidentiale",1,1079,501,435,59,7,495,6,1200,699,224,271
23,IALOMIŢA,"GHEORGHE DOJA",93600,"GHEORGHE DOJA","ŞCOALA GIMNAZIALĂ GHEORGHE DOJA SITUATĂ ÎN GHEORGHE DOJA",150,"Alegeri Prezidentiale",1,1106,468,430,33,5,464,4,1200,732,232,232
23,IALOMIŢA,"GHEORGHE LAZĂR",93628,"GHEORGHE LAZĂR","ŞCOALA GENERALĂ GHEORGHE LAZĂR",151,"Alegeri Prezidentiale",1,1076,518,459,41,18,511,7,1200,682,238,273
23,IALOMIŢA,"GHEORGHE LAZĂR",93628,"GHEORGHE LAZĂR","ŞCOALA GENERALĂ GHEORGHE LAZĂR",152,"Alegeri Prezidentiale",1,781,430,347,64,19,428,2,900,470,203,225
23,IALOMIŢA,GIURGENI,93646,GIURGENI,"ŞCOALA GIMNAZIALĂ GIURGENI",153,"Alegeri Prezidentiale",1,1142,665,588,42,35,650,15,1299,634,325,325
23,IALOMIŢA,GRINDU,93717,GRINDU,"CĂMINUL CULTURAL",154,"Alegeri Prezidentiale",1,803,302,252,50,0,301,1,900,598,118,183
23,IALOMIŢA,GRINDU,93717,GRINDU,"CĂMINUL CULTURAL",155,"Alegeri Prezidentiale",1,805,296,250,46,0,293,3,900,604,125,168
23,IALOMIŢA,GRIVIŢA,93735,GRIVIŢA,"LICEUL TEHNOLOGIC ARETA TEODORESCU",156,"Alegeri Prezidentiale",1,978,377,335,41,1,370,7,1100,723,211,159
23,IALOMIŢA,GRIVIŢA,93735,GRIVIŢA,"LICEUL TEHNOLOGIC ARETA TEODORESCU",157,"Alegeri Prezidentiale",1,951,375,320,52,3,371,4,1100,725,225,146
23,IALOMIŢA,GRIVIŢA,93735,SMIRNA,"ŞCOALA CU CLASELE I-IV",158,"Alegeri Prezidentiale",1,766,292,246,46,0,283,9,800,508,164,119
23,IALOMIŢA,"GURA IALOMIŢEI",180046,"GURA IALOMIŢEI","SCOALA GIMNAZIALA CONSTANTIN GURGU NR. 1",159,"Alegeri Prezidentiale",1,969,451,412,39,0,446,5,1100,649,240,206
23,IALOMIŢA,"GURA IALOMIŢEI",180046,LUCIU,"ŞCOALA GENERALA LUCIU",160,"Alegeri Prezidentiale",1,1092,428,386,42,0,424,4,1200,772,178,246
23,IALOMIŢA,"ION ROATĂ",103862,"ION ROATĂ","ŞCOALA GIMNAZIALA ION ROATA",161,"Alegeri Prezidentiale",1,905,418,356,62,0,413,5,1000,582,266,147
23,IALOMIŢA,"ION ROATĂ",103862,"ION ROATĂ","GRADINITA ION ROATA (LOCALUL VECHI COLINELE)",162,"Alegeri Prezidentiale",1,767,324,273,51,0,320,4,800,476,195,125
23,IALOMIŢA,"ION ROATĂ",103862,BROŞTENI,"ŞCOALA GIMNAZIALA ION ROATA(STRUCTURA BROSTENI)",163,"Alegeri Prezidentiale",1,1177,409,382,27,0,406,3,1300,891,209,197
23,IALOMIŢA,JILAVELE,103960,JILAVELE,"ŞCOALA NR.1 JILAVELE",164,"Alegeri Prezidentiale",1,1197,476,391,85,0,470,6,1300,824,209,261
23,IALOMIŢA,JILAVELE,103960,JILAVELE,"ŞCOALA NR.2 JILAVELE",165,"Alegeri Prezidentiale",1,1254,479,433,46,0,472,7,1400,921,249,223
23,IALOMIŢA,JILAVELE,103960,SLĂTIOARELE,"ŞCOALA DIN SATUL SLĂTIOARELE",166,"Alegeri Prezidentiale",1,297,130,101,29,0,128,2,300,170,67,61
23,IALOMIŢA,MAIA,179800,MAIA,"ŞCOALA CU CLASELE I-VIII, ”BARBU CATARGIU”, MAIA",167,"Alegeri Prezidentiale",1,1361,700,548,152,0,690,10,1500,800,347,343
23,IALOMIŢA,MANASIA,100736,MANASIA,"ŞCOALA NOUĂ",168,"Alegeri Prezidentiale",1,1326,564,513,51,0,556,8,1500,936,289,267
23,IALOMIŢA,MANASIA,100736,MANASIA,"ŞCOALA NOUĂ",169,"Alegeri Prezidentiale",1,1272,567,527,40,0,563,4,1400,833,318,245
23,IALOMIŢA,MANASIA,100736,MANASIA,"ŞCOALA NOUĂ",170,"Alegeri Prezidentiale",1,1177,548,467,81,0,543,5,1300,752,250,293
23,IALOMIŢA,MĂRCULEŞTI,179980,MĂRCULEŞTI,"LOCALUL ŞCOLII GIMNAZIALE DIN COMUNA MĂRCULEŞTI",171,"Alegeri Prezidentiale",1,1320,618,551,44,23,615,3,1400,782,270,345
23,IALOMIŢA,"MIHAIL KOGĂLNICEANU",93995,"MIHAIL KOGĂLNICEANU","CĂMIN CULTURAL MIHAIL KOGĂLNICEANU",172,"Alegeri Prezidentiale",1,1404,599,526,73,0,592,7,1500,901,332,260
23,IALOMIŢA,"MIHAIL KOGĂLNICEANU",93995,"MIHAIL KOGĂLNICEANU","LICEUL TEHNOLOGIC MIHAIL KOGĂLNICEANU",173,"Alegeri Prezidentiale",1,1268,497,453,44,0,494,3,1400,903,321,173
23,IALOMIŢA,MILOŞEŞTI,94045,MILOŞEŞTI,"ŞCOALA GIMNAZIALA MILOŞEŞTI",174,"Alegeri Prezidentiale",1,1443,611,534,50,27,609,2,1600,989,307,302
23,IALOMIŢA,MILOŞEŞTI,94045,NICOLEŞTI,"ŞCOALA GENERALĂ NICOLEŞTI",175,"Alegeri Prezidentiale",1,327,157,129,28,0,156,1,400,243,93,63
23,IALOMIŢA,MILOŞEŞTI,94045,TOVĂRĂŞIA,"ŞCOALA GENERALA TOVĂRĂŞIA",176,"Alegeri Prezidentiale",1,290,170,115,55,0,169,1,330,160,83,86
23,IALOMIŢA,MOLDOVENI,179999,MOLDOVENI,"ŞCOALA CU CLASELE I-VIII MOLDOVENI",177,"Alegeri Prezidentiale",1,881,515,413,102,0,509,6,900,385,182,327
23,IALOMIŢA,MOVILA,94081,MOVILA,"ŞCOALA CU CLASELE I-VIII, MOVILA",178,"Alegeri Prezidentiale",1,1581,762,685,65,12,746,16,1600,838,325,421
23,IALOMIŢA,MOVILIŢA,104270,MOVILIŢA,"SCOALA GIMNAZIALA MOVILITA",179,"Alegeri Prezidentiale",1,1124,515,375,140,0,509,6,1200,685,294,215
23,IALOMIŢA,MOVILIŢA,104270,MOVILIŢA,"SCOALA GIMNAZIALA MOVILITA",180,"Alegeri Prezidentiale",1,832,365,278,87,0,363,2,900,535,190,173
23,IALOMIŢA,MUNTENI-BUZĂU,94107,MUNTENI-BUZĂU,"ŞCOALA GENERALĂ NR. 1",181,"Alegeri Prezidentiale",1,1502,670,555,108,7,666,4,1592,922,400,266
23,IALOMIŢA,MUNTENI-BUZĂU,94107,MUNTENI-BUZĂU,"ŞCOALA GENERALĂ NR. 2",182,"Alegeri Prezidentiale",1,1261,525,450,72,3,521,4,1300,775,330,191
23,IALOMIŢA,OGRADA,179819,OGRADA,"IMOBILUL ŞCOLII CU CLASELE I-VIII ” IONEL PERLEA ”",183,"Alegeri Prezidentiale",1,1230,493,441,31,21,488,5,1400,907,266,222
23,IALOMIŢA,OGRADA,179819,OGRADA,"IMOBILUL SCOLII CU CLASELE I-VIII ” IONEL PERLEA ”",184,"Alegeri Prezidentiale",1,1110,491,416,56,19,486,5,1200,709,263,223
23,IALOMIŢA,PERIEŢI,94161,PERIEŢI,"SCOALA GIMNAZIALA PERIETI",185,"Alegeri Prezidentiale",1,1056,460,409,50,1,452,8,1200,740,223,229
23,IALOMIŢA,PERIEŢI,94161,PĂLTINIŞU,"SCOALA PRIMARA PALTINISU",186,"Alegeri Prezidentiale",1,904,422,345,77,0,413,9,1000,578,238,175
23,IALOMIŢA,PERIEŢI,94161,FUNDATA,"GRADINITA CU PROGRAM NORMAL FUNDATA",187,"Alegeri Prezidentiale",1,385,185,138,47,0,184,1,400,215,102,82
23,IALOMIŢA,PERIEŢI,94161,MISLEANU,"SCOALA PRIMARA MISLEANU",188,"Alegeri Prezidentiale",1,680,310,251,59,0,306,4,800,490,171,135
23,IALOMIŢA,PLATONEŞTI,180000,PLATONEŞTI,"GRĂDINIŢA CU PROGRAM NORMAL PLATONEŞTI",189,"Alegeri Prezidentiale",1,738,322,289,33,0,320,2,800,478,111,209
23,IALOMIŢA,PLATONEŞTI,180000,LĂCUSTENI,"GRĂDINIŢA CU PROGRAM NORMAL",190,"Alegeri Prezidentiale",1,803,399,363,36,0,397,2,900,501,130,267
23,IALOMIŢA,RĂDULEŞTI,101243,BRAZII,"SCOALA GIMNAZIALA RADULESTI",191,"Alegeri Prezidentiale",1,714,401,324,77,0,395,6,800,399,120,275
23,IALOMIŢA,RĂDULEŞTI,101243,RĂSIMNICEA,"ŞCOALA GENERALĂ CU CLASELE I-IV RĂSIMNICEA",192,"Alegeri Prezidentiale",1,203,145,94,51,0,142,3,200,55,39,103
23,IALOMIŢA,REVIGA,94269,REVIGA,"ŞCOALA REVIGA",193,"Alegeri Prezidentiale",1,1083,410,337,73,0,405,5,1100,690,202,203
23,IALOMIŢA,REVIGA,94269,ROVINE,"ŞCOALA ROVINE",194,"Alegeri Prezidentiale",1,734,254,208,46,0,253,1,800,546,163,90
23,IALOMIŢA,REVIGA,94269,CRUNŢI,"ŞCOALA CRUNŢI",195,"Alegeri Prezidentiale",1,379,154,124,30,0,152,2,400,246,86,66
23,IALOMIŢA,ROŞIORI,179828,ROŞIORI,"SCOALA CU CLASELE I-VIII ROŞIORI",196,"Alegeri Prezidentiale",1,920,475,407,59,9,469,6,1000,525,278,191
23,IALOMIŢA,ROŞIORI,179828,ROŞIORI,"ŞCOALA CU CLASELE I-VIII ROŞIORI",197,"Alegeri Prezidentiale",1,639,315,247,59,9,313,2,700,385,175,138
23,IALOMIŢA,SĂLCIOARA,94330,SĂLCIOARA,"ŞCOALA GIMNAZIALĂ",198,"Alegeri Prezidentiale",1,905,344,303,40,1,341,3,1000,656,214,127
23,IALOMIŢA,SĂLCIOARA,94330,RAŞI,"ŞCOALA PRIMARĂ",199,"Alegeri Prezidentiale",1,857,532,411,101,20,527,5,1000,468,177,350
23,IALOMIŢA,SĂRĂŢENI,180019,SĂRĂŢENI,"SCOALA PRIMARA SARATENI",200,"Alegeri Prezidentiale",1,952,526,446,72,8,517,9,1000,474,311,206
23,IALOMIŢA,SĂVENI,94376,SĂVENI,"ŞCOALA ŞĂVENI",201,"Alegeri Prezidentiale",1,1231,505,465,40,0,500,5,1300,795,194,306
23,IALOMIŢA,SĂVENI,94376,SĂVENI,"GRADINIŢA SĂVENI",202,"Alegeri Prezidentiale",1,1238,480,440,40,0,474,6,1300,820,162,312
23,IALOMIŢA,SĂVENI,94376,FRĂŢILEŞTI,"ŞCOALA FRĂŢILEŞTI",203,"Alegeri Prezidentiale",1,337,162,137,25,0,158,4,400,238,57,101
23,IALOMIŢA,SCÂNTEIA,94429,SCÂNTEIA,"GRADINIŢA SCÂNTEIA",204,"Alegeri Prezidentiale",1,1168,556,502,52,2,551,5,1300,744,208,343
23,IALOMIŢA,SCÂNTEIA,94429,SCÂNTEIA,"ŞCOALA GENERALĂ SCÂNTEIA",205,"Alegeri Prezidentiale",1,1063,508,439,65,4,500,8,1200,692,189,311
23,IALOMIŢA,SCÂNTEIA,94429,IAZU,"SCOALA CU CLASELE I-IV IAZU",206,"Alegeri Prezidentiale",1,842,392,337,55,0,387,5,900,508,170,217
23,IALOMIŢA,"SFÂNTU GHEORGHE",94456,"SFÂNTU GHEORGHE","SCOALA PRIMARA SFÂNTU GHEORGHE",207,"Alegeri Prezidentiale",1,650,370,300,70,0,363,7,700,330,218,145
23,IALOMIŢA,"SFÂNTU GHEORGHE",94456,MALU,"CĂMINUL CULTURAL MALU,SALONUL DE NUNŢI SITUATĂ ÎN MALU",208,"Alegeri Prezidentiale",1,877,430,350,80,0,421,9,1000,570,260,161
23,IALOMIŢA,SINEŞTI,105026,SINEŞTI,"CĂMINUL CULTURAL SITUATĂ ÎN SATUL SINEŞTI, SINEŞTI",209,"Alegeri Prezidentiale",1,1218,685,526,159,0,680,5,1300,615,323,357
23,IALOMIŢA,SINEŞTI,105026,LILIECI,"ŞCOALA CU CL.I-IV SITUATĂ ÎN SATUL LILIECI, SINEŞTI",210,"Alegeri Prezidentiale",1,866,466,295,171,0,464,2,900,434,234,230
23,IALOMIŢA,STELNICA,94492,STELNICA,"PRIMĂRIA STELNICA",211,"Alegeri Prezidentiale",1,1492,754,681,64,9,648,106,1600,846,317,331
23,IALOMIŢA,SUDIŢI,94535,SUDIŢI,"SCOALA GIMNAZIALĂ ”APOSTOL D CULEA”",212,"Alegeri Prezidentiale",1,821,394,325,43,26,390,4,900,506,179,211
23,IALOMIŢA,SUDIŢI,94535,SUDIŢI,"SCOALA GIMNAZIALĂ ”APOSTOL D CULEA”",213,"Alegeri Prezidentiale",1,853,392,344,23,25,385,7,900,508,182,203
23,IALOMIŢA,TRAIAN,179702,TRAIAN,"GRĂDINIŢA CU PROGRAM NORMAL TRAIAN",214,"Alegeri Prezidentiale",1,1223,596,524,69,3,593,3,1300,704,251,342
23,IALOMIŢA,TRAIAN,179702,TRAIAN,"ŞCOLA PROFESIONALĂ TRAIAN",215,"Alegeri Prezidentiale",1,1264,575,497,78,0,568,7,1300,725,201,367
23,IALOMIŢA,"VALEA CIORII",94688,"VALEA CIORII","PRIMARIA VALEA CIORII",216,"Alegeri Prezidentiale",2,1441,705,625,45,35,698,7,1500,795,264,434
23,IALOMIŢA,"VALEA MĂCRIŞULUI",105794,"VALEA MĂCRIŞULUI","CĂMIN CULTURAL",217,"Alegeri Prezidentiale",1,958,453,393,60,0,449,4,1100,647,182,267
23,IALOMIŢA,"VALEA MĂCRIŞULUI",105794,GRINDAŞI,"CĂMIN CULTURAL",218,"Alegeri Prezidentiale",1,384,165,127,38,0,163,2,400,235,75,88
23,IALOMIŢA,VLĂDENI,94795,VLĂDENI,"CĂMINUL CULTURAL",219,"Alegeri Prezidentiale",1,891,505,458,47,0,497,8,900,395,303,194
23,IALOMIŢA,VLĂDENI,94795,VLĂDENI,"CĂMINUL CULTURAL",220,"Alegeri Prezidentiale",1,776,424,405,19,0,420,4,900,476,268,152
24,IAŞI,"MUNICIPIUL IAŞI",95060,IAŞI,"GRĂDINIŢA CU PROGRAM NORMAL NR. 15",1,"Alegeri Prezidentiale",1,1563,878,733,145,0,862,16,1700,822,642,220
24,IAŞI,"MUNICIPIUL IAŞI",95060,IAŞI,"GRĂDINIŢA CU PROGRAM NORMAL NR. 15",2,"Alegeri Prezidentiale",1,1356,781,603,178,0,756,25,1500,719,559,197
24,IAŞI,"MUNICIPIUL IAŞI",95060,IAŞI,"ŞCOALA GIMNAZIALĂ ”ELENA CUZA”",3,"Alegeri Prezidentiale",1,1389,848,702,146,0,827,21,1508,660,574,253
24,IAŞI,"MUNICIPIUL IAŞI",95060,IAŞI,"ŞCOALA GIMNAZIALĂ ”ELENA CUZA”",4,"Alegeri Prezidentiale",2,1153,769,569,200,0,753,16,1300,531,557,196
24,IAŞI,"MUNICIPIUL IAŞI",95060,IAŞI,"ŞCOALA GIMNAZIALĂ ”ELENA CUZA”",5,"Alegeri Prezidentiale",1,1530,1025,733,292,0,1002,23,1700,675,714,288
24,IAŞI,"MUNICIPIUL IAŞI",95060,IAŞI,"ŞCOALA GIMNAZIALĂ ”ELENA CUZA”",6,"Alegeri Prezidentiale",1,1449,903,713,189,1,884,19,1600,697,638,246
24,IAŞI,"MUNICIPIUL IAŞI",95060,IAŞI,"GRĂDINIŢA CU PROGRAM PRELUNGIT NR. 14",7,"Alegeri Prezidentiale",1,1308,703,664,39,0,688,15,1400,697,477,211
24,IAŞI,"MUNICIPIUL IAŞI",95060,IAŞI,"GRĂDINIŢA CU PROGRAM PRELUNGIT NR. 14",8,"Alegeri Prezidentiale",1,1411,767,655,112,0,751,16,1500,733,495,256
24,IAŞI,"MUNICIPIUL IAŞI",95060,IAŞI,"GRĂDINIŢA CU PROGRAM PRELUNGIT NR. 14",9,"Alegeri Prezidentiale",1,1580,897,790,107,0,875,22,1700,803,627,248
24,IAŞI,"MUNICIPIUL IAŞI",95060,IAŞI,"GRĂDINIŢA CU PROGRAM PRELUNGIT NR. 14",10,"Alegeri Prezidentiale",1,1681,876,811,65,0,855,21,1800,924,607,248
24,IAŞI,"MUNICIPIUL IAŞI",95060,IAŞI,"ŞCOALA GIMNAZIALĂ ”ION CREANGĂ”",11,"Alegeri Prezidentiale",1,1765,939,855,84,0,915,24,1900,961,724,191
24,IAŞI,"MUNICIPIUL IAŞI",95060,IAŞI,"ŞCOALA GIMNAZIALĂ ”ION CREANGĂ”",12,"Alegeri Prezidentiale",1,1096,748,548,200,0,730,18,1200,452,535,195
24,IAŞI,"MUNICIPIUL IAŞI",95060,IAŞI,"ŞCOALA GIMNAZIALĂ ”ION CREANGĂ”",13,"Alegeri Prezidentiale",1,1160,831,596,235,0,816,15,1300,469,600,216
24,IAŞI,"MUNICIPIUL IAŞI",95060,IAŞI,"ŞCOALA GIMNAZIALĂ ”ION CREANGĂ”",14,"Alegeri Prezidentiale",1,1015,708,517,191,0,691,17,1100,392,508,183
24,IAŞI,"MUNICIPIUL IAŞI",95060,IAŞI,"ŞCOALA GIMNAZIALĂ ”PETRU PONI”",15,"Alegeri Prezidentiale",1,1500,954,803,151,0,929,25,1600,646,666,263
24,IAŞI,"MUNICIPIUL IAŞI",95060,IAŞI,"ŞCOALA GIMNAZIALĂ ”PETRU PONI”",16,"Alegeri Prezidentiale",1,1003,620,456,164,0,608,12,1100,480,426,182
24,IAŞI,"MUNICIPIUL IAŞI",95060,IAŞI,"ŞCOALA GIMNAZIALĂ ”PETRU PONI”",17,"Alegeri Prezidentiale",1,1359,918,743,175,0,902,16,1500,582,633,269
24,IAŞI,"MUNICIPIUL IAŞI",95060,IAŞI,"ŞCOALA GIMNAZIALĂ ”PETRU PONI”",18,"Alegeri Prezidentiale",1,1046,716,546,170,0,703,13,1100,384,502,201
24,IAŞI,"MUNICIPIUL IAŞI",95060,IAŞI,"ŞCOALA GIMNAZIALĂ ”ŞTEFAN BÂRSĂNESCU”",19,"Alegeri Prezidentiale",1,1206,1018,687,331,0,987,31,1300,282,730,257
24,IAŞI,"MUNICIPIUL IAŞI",95060,IAŞI,"ŞCOALA GIMNAZIALĂ ”ŞTEFAN BÂRSĂNESCU”",20,"Alegeri Prezidentiale",1,1106,707,483,224,0,687,20,1200,493,534,153
24,IAŞI,"MUNICIPIUL IAŞI",95060,IAŞI,"ŞCOALA GIMNAZIALĂ ”ŞTEFAN BÂRSĂNESCU”",21,"Alegeri Prezidentiale",1,820,512,399,113,0,503,9,900,388,338,165
24,IAŞI,"MUNICIPIUL IAŞI",95060,IAŞI,"ŞCOALA GIMNAZIALĂ ”ŞTEFAN BÂRSĂNESCU”",22,"Alegeri Prezidentiale",1,966,663,509,154,0,648,15,1100,437,465,183
24,IAŞI,"MUNICIPIUL IAŞI",95060,IAŞI,"ŞCOALA GIMNAZIALĂ ”ŞTEFAN BÂRSĂNESCU”",23,"Alegeri Prezidentiale",1,1248,392,198,194,0,385,7,1400,1008,277,108
24,IAŞI,"MUNICIPIUL IAŞI",95060,IAŞI,"COLEGIUL NAŢIONAL",24,"Alegeri Prezidentiale",1,1301,1143,635,373,135,1114,29,1400,257,793,321
24,IAŞI,"MUNICIPIUL IAŞI",95060,IAŞI,"COLEGIUL NAŢIONAL",25,"Alegeri Prezidentiale",1,988,915,503,269,143,898,17,1100,185,614,284
24,IAŞI,"MUNICIPIUL IAŞI",95060,IAŞI,"COLEGIUL NAŢIONAL",26,"Alegeri Prezidentiale",1,851,781,410,256,115,762,19,900,119,521,241
24,IAŞI,"MUNICIPIUL IAŞI",95060,IAŞI,"COLEGIUL NAŢIONAL",27,"Alegeri Prezidentiale",1,1706,729,615,114,0,718,11,1900,1171,518,200
24,IAŞI,"MUNICIPIUL IAŞI",95060,IAŞI,"COLEGIUL NAŢIONAL",28,"Alegeri Prezidentiale",1,1079,611,515,93,3,593,18,1200,589,409,184
24,IAŞI,"MUNICIPIUL IAŞI",95060,IAŞI,"GRĂDINIŢA CU PROGRAM PRELUNGIT NR.4",29,"Alegeri Prezidentiale",1,1487,894,753,141,0,869,25,1600,706,624,245
24,IAŞI,"MUNICIPIUL IAŞI",95060,IAŞI,"ŞCOALA PRIMARĂ ”GHEORGHE ASACHI”",30,"Alegeri Prezidentiale",1,1033,1151,387,764,0,1122,29,1900,749,854,268
24,IAŞI,"MUNICIPIUL IAŞI",95060,IAŞI,"COLEGIUL NATIONAL ”COSTACHE NEGRUZZI’’",31,"Alegeri Prezidentiale",1,947,1346,451,778,117,1306,40,1800,454,1045,261
24,IAŞI,"MUNICIPIUL IAŞI",95060,IAŞI,"COLEGIUL NATIONAL ”COSTACHE NEGRUZZI’’",32,"Alegeri Prezidentiale",1,880,891,489,402,0,869,22,1800,909,715,154
24,IAŞI,"MUNICIPIUL IAŞI",95060,IAŞI,"COLEGIUL NATIONAL ”GARABET IBRĂILEANU”",33,"Alegeri Prezidentiale",1,1098,1050,531,357,162,1024,26,2000,950,701,323
24,IAŞI,"MUNICIPIUL IAŞI",95060,IAŞI,"COLEGIUL NATIONAL ”GARABET IBRĂILEANU”",34,"Alegeri Prezidentiale",1,1148,920,629,167,124,891,29,1300,380,604,287
24,IAŞI,"MUNICIPIUL IAŞI",95060,IAŞI,"COLEGIUL NATIONAL ”GARABET IBRĂILEANU”",35,"Alegeri Prezidentiale",1,1108,774,585,139,50,753,21,2000,1226,480,273
24,IAŞI,"MUNICIPIUL IAŞI",95060,IAŞI,"COLEGIUL NATIONAL ”GARABET IBRĂILEANU”",36,"Alegeri Prezidentiale",1,1769,687,135,492,60,671,16,1900,1213,549,122
24,IAŞI,"MUNICIPIUL IAŞI",95060,IAŞI,"UNIVERSITATEA DE STIINTE AGRICOLE SI MEDICINA VETERINARĂ ”ION IONESCU DE LA BRAD”",37,"Alegeri Prezidentiale",2,1884,1962,1053,909,0,1921,41,2100,138,1511,410
24,IAŞI,"MUNICIPIUL IAŞI",95060,IAŞI,"LICEUL TEORETIC DE INFORMATICĂ ”GRIGORE MOISIL”",38,"Alegeri Prezidentiale",1,1649,1718,787,931,0,1691,27,1800,82,1404,287
24,IAŞI,"MUNICIPIUL IAŞI",95060,IAŞI,"COLEGIUL NAŢIONAL ”MIHAI EMINESCU”",39,"Alegeri Prezidentiale",1,996,606,536,69,1,587,19,1100,494,413,174
24,IAŞI,"MUNICIPIUL IAŞI",95060,IAŞI,"COLEGIUL NAŢIONAL ”MIHAI EMINESCU”",40,"Alegeri Prezidentiale",1,932,714,506,117,91,702,12,1000,286,494,208
24,IAŞI,"MUNICIPIUL IAŞI",95060,IAŞI,"ŞCOALA GIMNAZIALĂ”MIHAI CODREANU”",41,"Alegeri Prezidentiale",1,431,262,212,49,1,256,6,500,238,165,91
24,IAŞI,"MUNICIPIUL IAŞI",95060,IAŞI,"ŞCOALA GIMNAZIALĂ”MIHAI CODREANU”",42,"Alegeri Prezidentiale",1,520,307,259,48,0,305,2,600,293,192,113
24,IAŞI,"MUNICIPIUL IAŞI",95060,IAŞI,"LICEUL TEHNOLOGIC UCECOM ”SPIRU HARET”",43,"Alegeri Prezidentiale",1,1294,593,552,41,0,575,18,1400,807,425,150
24,IAŞI,"MUNICIPIUL IAŞI",95060,IAŞI,"LICEUL TEHNOLOGIC UCECOM ”SPIRU HARET”",44,"Alegeri Prezidentiale",1,998,546,454,92,0,538,8,1100,554,383,155
24,IAŞI,"MUNICIPIUL IAŞI",95060,IAŞI,"LICEUL TEHNOLOGIC UCECOM ”SPIRU HARET”",45,"Alegeri Prezidentiale",1,1201,691,578,113,0,669,22,1300,609,529,140
24,IAŞI,"MUNICIPIUL IAŞI",95060,IAŞI,"COLEGIUL ECONOMIC ADMINISTRATIV",46,"Alegeri Prezidentiale",1,909,597,444,153,0,578,19,1000,403,427,151
24,IAŞI,"MUNICIPIUL IAŞI",95060,IAŞI,"COLEGIUL ECONOMIC ADMINISTRATIV",47,"Alegeri Prezidentiale",1,908,553,489,64,0,540,13,1000,447,353,187
24,IAŞI,"MUNICIPIUL IAŞI",95060,IAŞI,"LICEUL TEORETIC ‘’VASILE ALECSANDRI’’",48,"Alegeri Prezidentiale",1,1102,814,596,217,1,795,19,1200,386,565,230
24,IAŞI,"MUNICIPIUL IAŞI",95060,IAŞI,"LICEUL TEORETIC ‘’VASILE ALECSANDRI’’",49,"Alegeri Prezidentiale",1,566,623,291,331,1,610,13,1400,777,479,131
24,IAŞI,"MUNICIPIUL IAŞI",95060,IAŞI,"LICEUL TEORETIC ‘’VASILE ALECSANDRI’’",50,"Alegeri Prezidentiale",1,1256,815,629,184,2,801,14,1000,185,548,253
24,IAŞI,"MUNICIPIUL IAŞI",95060,IAŞI,"LICEUL TEHNOLOGIC SPECIAL ”VASILE PAVELCU”",51,"Alegeri Prezidentiale",1,752,433,370,61,2,425,8,800,367,274,151
24,IAŞI,"MUNICIPIUL IAŞI",95060,IAŞI,"LICEUL TEHNOLOGIC SPECIAL ”VASILE PAVELCU”",52,"Alegeri Prezidentiale",1,652,410,321,89,0,400,10,700,290,271,129
24,IAŞI,"MUNICIPIUL IAŞI",95060,IAŞI,"COLEGIUL NATIONAL DE ARTĂ ”OCTACV BĂNCILĂ”",53,"Alegeri Prezidentiale",1,675,468,344,124,0,457,11,700,232,310,147
24,IAŞI,"MUNICIPIUL IAŞI",95060,IAŞI,"COLEGIUL NATIONAL DE ARTĂ ”OCTAV BĂNCILĂ”",54,"Alegeri Prezidentiale",1,736,552,343,154,55,534,18,800,248,380,154
24,IAŞI,"MUNICIPIUL IAŞI",95060,IAŞI,"ŞCOALA GIMNAZIALĂ ”ION SIMIONESCU”",55,"Alegeri Prezidentiale",1,1207,851,609,242,0,840,11,1300,449,602,238
24,IAŞI,"MUNICIPIUL IAŞI",95060,IAŞI,"ŞCOALA GIMNAZIALĂ ”ION SIMIONESCU”",56,"Alegeri Prezidentiale",1,1197,712,592,120,0,685,27,1300,588,516,169
24,IAŞI,"MUNICIPIUL IAŞI",95060,IAŞI,"ŞCOALA GIMNAZIALĂ ”ION SIMIONESCU”",57,"Alegeri Prezidentiale",1,1199,660,617,43,0,644,16,1300,640,405,239
24,IAŞI,"MUNICIPIUL IAŞI",95060,IAŞI,"ŞCOALA GIMNAZIALĂ ”ION SIMIONESCU”",58,"Alegeri Prezidentiale",1,1219,619,574,43,2,603,16,1292,673,398,205
24,IAŞI,"MUNICIPIUL IAŞI",95060,IAŞI,"ŞCOALA GIMNAZIALĂ ”ION SIMIONESCU”",59,"Alegeri Prezidentiale",1,1691,817,783,34,0,808,9,1900,1083,609,199
24,IAŞI,"MUNICIPIUL IAŞI",95060,IAŞI,"ŞCOALA GIMNAZIALĂ ”ION SIMIONESCU”",60,"Alegeri Prezidentiale",1,1685,900,829,70,1,884,16,1800,900,674,210
24,IAŞI,"MUNICIPIUL IAŞI",95060,IAŞI,"GRĂDINIŢA CU PROGRAM PRELUNGIT NR. 28",61,"Alegeri Prezidentiale",1,1210,649,570,79,0,643,6,1300,651,435,208
24,IAŞI,"MUNICIPIUL IAŞI",95060,IAŞI,"GRĂDINIŢA CU PROGRAM PRELUNGIT NR. 28",62,"Alegeri Prezidentiale",1,1370,715,678,37,0,699,16,1500,785,450,249
24,IAŞI,"MUNICIPIUL IAŞI",95060,IAŞI,"GRĂDINIŢA CU PROGRAM PRELUNGIT NR. 28",63,"Alegeri Prezidentiale",1,1210,676,645,31,0,653,23,1300,624,409,244
24,IAŞI,"MUNICIPIUL IAŞI",95060,IAŞI,"GRĂDINIŢA CU PROGRAM PRELUNGIT NR. 25",64,"Alegeri Prezidentiale",1,1454,911,800,111,0,894,17,1600,689,606,288
24,IAŞI,"MUNICIPIUL IAŞI",95060,IAŞI,"GRĂDINIŢA CU PROGRAM PRELUNGIT NR. 25",65,"Alegeri Prezidentiale",1,1218,630,507,123,0,624,6,1300,670,454,170
24,IAŞI,"MUNICIPIUL IAŞI",95060,IAŞI,"GRĂDINIŢA CU PROGRAM NORMAL NR.21",66,"Alegeri Prezidentiale",1,867,559,439,119,1,541,18,1000,441,363,178
24,IAŞI,"MUNICIPIUL IAŞI",95060,IAŞI,"GRĂDINIŢA CU PROGRAM NORMAL NR.21",67,"Alegeri Prezidentiale",1,776,570,395,175,0,564,6,900,330,401,163
24,IAŞI,"MUNICIPIUL IAŞI",95060,IAŞI,"GRĂDINIŢA CU PROGRAM NORMAL NR.21",68,"Alegeri Prezidentiale",1,880,439,389,50,0,425,14,1000,561,289,136
24,IAŞI,"MUNICIPIUL IAŞI",95060,IAŞI,"GRĂDINIŢA CU PROGRAM NORMAL NR.21",69,"Alegeri Prezidentiale",1,849,437,404,33,0,430,7,900,463,258,172
24,IAŞI,"MUNICIPIUL IAŞI",95060,IAŞI,"GRĂDINIŢA CU PROGRAM PRELUNGIT NR.21",70,"Alegeri Prezidentiale",1,993,518,481,37,0,512,6,1100,582,338,174
24,IAŞI,"MUNICIPIUL IAŞI",95060,IAŞI,"GRĂDINIŢA CU PROGRAM PRELUNGIT NR.21",71,"Alegeri Prezidentiale",1,880,508,460,48,0,497,11,1100,592,331,166
24,IAŞI,"MUNICIPIUL IAŞI",95060,IAŞI,"GRĂDINIŢA CU PROGRAM NORMAL NR. 7",72,"Alegeri Prezidentiale",1,641,398,330,68,0,390,8,700,302,279,111
24,IAŞI,"MUNICIPIUL IAŞI",95060,IAŞI,"GRĂDINIŢA CU PROGRAM NORMAL NR. 7",73,"Alegeri Prezidentiale",1,707,393,320,73,0,384,9,800,407,278,106
24,IAŞI,"MUNICIPIUL IAŞI",95060,IAŞI,"LICEUL TEHNOLOGIC ECONOMIC ”VIRGIL MADGEARU” - CORP B",74,"Alegeri Prezidentiale",1,1141,517,492,25,0,508,9,1300,783,311,197
24,IAŞI,"MUNICIPIUL IAŞI",95060,IAŞI,"LICEUL TEHNOLOGIC ECONOMIC ”VIRGIL MADGEARU” - CORP B",75,"Alegeri Prezidentiale",1,1148,533,475,58,0,524,9,1300,767,363,161
24,IAŞI,"MUNICIPIUL IAŞI",95060,IAŞI,"LICEUL TEHNOLOGIC ECONOMIC ”VIRGIL MADGEARU” - CORP B",76,"Alegeri Prezidentiale",1,1388,701,572,129,0,694,7,1500,799,478,216
24,IAŞI,"MUNICIPIUL IAŞI",95060,IAŞI,"LICEUL TEHNOLOGIC ECONOMIC ”VIRGIL MADGEARU” - CORP B",77,"Alegeri Prezidentiale",1,1209,647,521,126,0,635,12,1300,653,459,176
24,IAŞI,"MUNICIPIUL IAŞI",95060,IAŞI,"LICEUL TEHNOLOGIC ECONOMIC ”VIRGIL MADGEARU” - CORP B",78,"Alegeri Prezidentiale",1,1232,614,545,69,0,606,8,1400,786,415,191
24,IAŞI,"MUNICIPIUL IAŞI",95060,IAŞI,"ŞCOALA GIMNAZIALĂ ”ALEXANDRU CEL BUN”",79,"Alegeri Prezidentiale",1,1111,675,488,185,2,662,13,1200,525,466,196
24,IAŞI,"MUNICIPIUL IAŞI",95060,IAŞI,"ŞCOALA GIMNAZIALĂ ”ALEXANDRU CEL BUN”",80,"Alegeri Prezidentiale",1,1256,746,673,71,2,734,12,1400,654,460,274
24,IAŞI,"MUNICIPIUL IAŞI",95060,IAŞI,"ŞCOALA GIMNAZIALĂ ”ALEXANDRU CEL BUN”",81,"Alegeri Prezidentiale",1,1333,744,703,41,0,732,12,1500,756,429,303
24,IAŞI,"MUNICIPIUL IAŞI",95060,IAŞI,"ŞCOALA GIMNAZIALĂ ”ALEXANDRU CEL BUN”",82,"Alegeri Prezidentiale",1,1312,558,512,46,0,548,10,1400,842,399,149
24,IAŞI,"MUNICIPIUL IAŞI",95060,IAŞI,"LICEUL TEORETIC ”MIRON COSTIN”",83,"Alegeri Prezidentiale",1,1058,637,485,152,0,622,15,1200,563,440,182
24,IAŞI,"MUNICIPIUL IAŞI",95060,IAŞI,"LICEUL TEORETIC ”MIRON COSTIN”",84,"Alegeri Prezidentiale",1,1370,857,704,153,0,831,26,1508,651,589,242
24,IAŞI,"MUNICIPIUL IAŞI",95060,IAŞI,"LICEUL TEORETIC ”MIRON COSTIN”",85,"Alegeri Prezidentiale",1,1233,821,707,114,0,803,18,1400,579,528,275
24,IAŞI,"MUNICIPIUL IAŞI",95060,IAŞI,"LICEUL TEORETIC ”MIRON COSTIN”",86,"Alegeri Prezidentiale",1,1417,679,638,41,0,667,12,1600,921,426,241
24,IAŞI,"MUNICIPIUL IAŞI",95060,IAŞI,"LICEUL TEORETIC ”MIRON COSTIN”",87,"Alegeri Prezidentiale",1,1506,797,732,65,0,777,20,1700,903,529,248
24,IAŞI,"MUNICIPIUL IAŞI",95060,IAŞI,"LICEUL TEHNOLOGIC ECONOMIC DE TURISM - CORP A",88,"Alegeri Prezidentiale",1,996,505,432,72,1,496,9,1100,595,333,163
24,IAŞI,"MUNICIPIUL IAŞI",95060,IAŞI,"LICEUL TEHNOLOGIC ECONOMIC DE TURISM - CORP A",89,"Alegeri Prezidentiale",1,1332,667,578,89,0,659,8,1500,833,465,194
24,IAŞI,"MUNICIPIUL IAŞI",95060,IAŞI,"LICEUL TEHNOLOGIC ECONOMIC DE TURISM - CORP A",90,"Alegeri Prezidentiale",1,1074,593,546,47,0,579,14,1200,607,387,192
24,IAŞI,"MUNICIPIUL IAŞI",95060,IAŞI,"LICEUL TEHNOLOGIC ECONOMIC DE TURISM - CORP A",91,"Alegeri Prezidentiale",1,1046,513,451,62,0,502,11,1100,587,322,180
24,IAŞI,"MUNICIPIUL IAŞI",95060,IAŞI,"ŞCOALA GIMNAZIALĂ ”GEORGE COŞBUC”",92,"Alegeri Prezidentiale",1,1084,612,544,68,0,599,13,1200,588,418,181
24,IAŞI,"MUNICIPIUL IAŞI",95060,IAŞI,"ŞCOALA GIMNAZIALĂ ”GEORGE COŞBUC”",93,"Alegeri Prezidentiale",1,1118,730,557,173,0,719,11,1200,470,533,186
24,IAŞI,"MUNICIPIUL IAŞI",95060,IAŞI,"ŞCOALA GIMNAZIALĂ ”GEORGE COŞBUC”",94,"Alegeri Prezidentiale",1,1063,453,387,66,0,445,8,1200,747,306,139
24,IAŞI,"MUNICIPIUL IAŞI",95060,IAŞI,"ŞCOALA GIMNAZIALĂ ”GEORGE COŞBUC”",95,"Alegeri Prezidentiale",1,1103,534,495,39,0,527,7,1200,666,364,163
24,IAŞI,"MUNICIPIUL IAŞI",95060,IAŞI,"ŞCOALA GIMNAZIALĂ ”GEORGE COŞBUC”",96,"Alegeri Prezidentiale",1,1105,592,561,31,0,584,8,1200,608,365,219
24,IAŞI,"MUNICIPIUL IAŞI",95060,IAŞI,"ŞCOALA GIMNAZIALĂ ”GEORGE COŞBUC”",97,"Alegeri Prezidentiale",1,1184,581,561,20,0,573,8,1300,719,362,211
24,IAŞI,"MUNICIPIUL IAŞI",95060,IAŞI,"ŞCOALA GIMNAZIALĂ ”GEORGE COŞBUC”",98,"Alegeri Prezidentiale",1,1151,592,563,29,0,587,5,1300,708,365,222
24,IAŞI,"MUNICIPIUL IAŞI",95060,IAŞI,"ŞCOALA GIMNAZIALĂ ”GEORGE COŞBUC”",99,"Alegeri Prezidentiale",1,981,479,465,14,0,469,10,1100,621,321,148
24,IAŞI,"MUNICIPIUL IAŞI",95060,IAŞI,"ŞCOALA GIMNAZIALĂ ”GEORGE COŞBUC”",100,"Alegeri Prezidentiale",1,1011,492,473,19,0,486,6,1100,608,329,157
24,IAŞI,"MUNICIPIUL IAŞI",95060,IAŞI,"ŞCOALA GIMNAZIALĂ ”GEORGE CĂLINESCU”",101,"Alegeri Prezidentiale",1,1001,692,490,63,139,674,18,1100,408,338,336
24,IAŞI,"MUNICIPIUL IAŞI",95060,IAŞI,"ŞCOALA GIMNAZIALĂ ”GEORGE CĂLINESCU”",102,"Alegeri Prezidentiale",1,803,629,336,133,160,616,13,900,271,366,250
24,IAŞI,"MUNICIPIUL IAŞI",95060,IAŞI,"ŞCOALA GIMNAZIALĂ ”GEORGE CĂLINESCU”",103,"Alegeri Prezidentiale",1,871,680,409,139,132,665,15,1000,320,383,282
24,IAŞI,"MUNICIPIUL IAŞI",95060,IAŞI,"ŞCOALA GIMNAZIALĂ ”GEORGE CĂLINESCU”",104,"Alegeri Prezidentiale",1,1014,527,479,48,0,518,9,1100,573,358,160
24,IAŞI,"MUNICIPIUL IAŞI",95060,IAŞI,"ŞCOALA GIMNAZIALĂ ”GEORGE CĂLINESCU”",105,"Alegeri Prezidentiale",1,744,528,369,28,131,516,12,800,272,303,213
24,IAŞI,"MUNICIPIUL IAŞI",95060,IAŞI,"ŞCOALA GIMNAZIALĂ ”GEORGE CĂLINESCU”",106,"Alegeri Prezidentiale",1,1103,599,555,44,0,591,8,1200,601,395,196
24,IAŞI,"MUNICIPIUL IAŞI",95060,IAŞI,"ŞCOALA GIMNAZIALĂ ”GEORGE CĂLINESCU”",107,"Alegeri Prezidentiale",1,1348,794,712,82,0,771,23,1500,706,507,264
24,IAŞI,"MUNICIPIUL IAŞI",95060,IAŞI,"ŞCOALA GIMNAZIALĂ ”GEORGE CĂLINESCU”",108,"Alegeri Prezidentiale",1,1430,753,681,72,0,740,13,1600,847,525,215
24,IAŞI,"MUNICIPIUL IAŞI",95060,IAŞI,"ŞCOALA GIMNAZIALĂ ”GEORGE CĂLINESCU”",109,"Alegeri Prezidentiale",1,1218,607,545,62,0,596,11,1300,693,410,186
24,IAŞI,"MUNICIPIUL IAŞI",95060,IAŞI,"ŞCOALA GIMNAZIALĂ ”GEORGE CĂLINESCU”",110,"Alegeri Prezidentiale",1,1328,665,637,28,0,652,13,1500,835,453,199
24,IAŞI,"MUNICIPIUL IAŞI",95060,IAŞI,"ŞCOALA GIMNAZIALĂ ”GEORGE CĂLINESCU”",111,"Alegeri Prezidentiale",1,1180,655,601,54,0,642,13,1300,645,465,177
24,IAŞI,"MUNICIPIUL IAŞI",95060,IAŞI,"LICEUL TEHNOLOGIC ECONOMIC DE TURISM - CORP B",112,"Alegeri Prezidentiale",1,1436,586,530,56,0,581,5,1600,1014,417,164
24,IAŞI,"MUNICIPIUL IAŞI",95060,IAŞI,"LICEUL TEHNOLOGIC ECONOMIC DE TURISM - CORP B",113,"Alegeri Prezidentiale",1,1283,636,575,61,0,622,14,1400,764,444,178
24,IAŞI,"MUNICIPIUL IAŞI",95060,IAŞI,"LICEUL TEHNOLOGIC ECONOMIC DE TURISM - CORP B",114,"Alegeri Prezidentiale",1,1339,795,657,138,0,776,19,1497,702,535,241
24,IAŞI,"MUNICIPIUL IAŞI",95060,IAŞI,"GRĂDINIŢA CU PROGRAM PRELUNGIT NR. 24",115,"Alegeri Prezidentiale",1,1151,625,554,70,1,616,9,1230,605,427,189
24,IAŞI,"MUNICIPIUL IAŞI",95060,IAŞI,"GRADINIŢA CU PROGRAM PRELUNGIT NR. 24",116,"Alegeri Prezidentiale",1,1366,633,607,25,1,618,15,1500,867,435,183
24,IAŞI,"MUNICIPIUL IAŞI",95060,IAŞI,"PT MIRCEA CEL BĂTRÂN",117,"Alegeri Prezidentiale",1,1483,578,509,60,9,563,15,1600,1022,392,171
24,IAŞI,"MUNICIPIUL IAŞI",95060,IAŞI,"PT MIRCEA CEL BĂTRÂN",118,"Alegeri Prezidentiale",1,1263,463,436,27,0,456,7,1400,937,300,156
24,IAŞI,"MUNICIPIUL IAŞI",95060,IAŞI,"ŞCOALA GIMNAZIALĂ ”CARMEN SYLVA”",119,"Alegeri Prezidentiale",1,1320,852,682,170,0,833,19,1400,548,574,259
24,IAŞI,"MUNICIPIUL IAŞI",95060,IAŞI,"ŞCOALA GIMNAZIALĂ ”CARMEN SYLVA”",120,"Alegeri Prezidentiale",1,1019,759,523,185,51,742,17,1100,341,543,199
24,IAŞI,"MUNICIPIUL IAŞI",95060,IAŞI,"ŞCOALA GIMNAZIALĂ ”CALISTRAT HOGAŞ”",121,"Alegeri Prezidentiale",1,1956,1054,955,99,0,1032,22,2100,1046,707,325
24,IAŞI,"MUNICIPIUL IAŞI",95060,IAŞI,"ŞCOALA GIMNAZIALĂ ”CALISTRAT HOGAŞ”",122,"Alegeri Prezidentiale",1,1952,340,282,58,0,334,6,2100,1760,251,83
24,IAŞI,"MUNICIPIUL IAŞI",95060,IAŞI,"ŞCOALA GIMNAZIALĂ ”CALISTRAT HOGAŞ”",123,"Alegeri Prezidentiale",1,1894,788,720,67,1,777,11,2100,1312,601,176
24,IAŞI,"MUNICIPIUL IAŞI",95060,IAŞI,"ŞCOALA PRIMARĂ ”COSTACHE NEGRI”",124,"Alegeri Prezidentiale",1,1467,826,689,104,33,816,10,1600,774,573,243
24,IAŞI,"MUNICIPIUL IAŞI",95060,IAŞI,"ŞCOALA PRIMARĂ ”COSTACHE NEGRI”",125,"Alegeri Prezidentiale",1,1425,673,526,147,0,653,20,1500,827,471,182
24,IAŞI,"MUNICIPIUL IAŞI",95060,IAŞI,"ŞCOALA GIMNAZIALĂ ”BOGDAN PETRICEICU HAŞDEU”",126,"Alegeri Prezidentiale",1,1379,1040,646,293,101,1020,20,1500,460,753,267
24,IAŞI,"MUNICIPIUL IAŞI",95060,IAŞI,"ŞCOALA GIMNAZIALĂ ”BOGDAN PETRICEICU HAŞDEU”",127,"Alegeri Prezidentiale",1,983,271,100,171,0,267,4,1100,829,216,51
24,IAŞI,"MUNICIPIUL IAŞI",95060,IAŞI,"ŞCOALA GIMNAZIALĂ ”BOGDAN PETRICEICU HAŞDEU”",128,"Alegeri Prezidentiale",1,1471,728,595,133,0,706,22,1600,872,504,202
24,IAŞI,"MUNICIPIUL IAŞI",95060,IAŞI,"ŞCOALA GIMNAZIALĂ ”BOGDAN PETRICEICU HAŞDEU”",129,"Alegeri Prezidentiale",1,1404,784,606,99,79,766,18,1500,716,590,176
24,IAŞI,"MUNICIPIUL IAŞI",95060,IAŞI,"LICEUL TEORETIC ”ALEXANDRU IOAN CUZA”",130,"Alegeri Prezidentiale",1,1854,1072,982,90,0,1053,19,2000,928,725,328
24,IAŞI,"MUNICIPIUL IAŞI",95060,IAŞI,"LICEUL TEORETIC ”ALEXANDRU IOAN CUZA”",131,"Alegeri Prezidentiale",1,1985,543,412,129,2,533,10,2200,1657,365,168
24,IAŞI,"MUNICIPIUL IAŞI",95060,IAŞI,"LICEUL TEORETIC ”ALEXANDRU IOAN CUZA”",132,"Alegeri Prezidentiale",1,1950,79,14,65,0,78,1,1300,1221,67,11
24,IAŞI,"MUNICIPIUL IAŞI",95060,IAŞI,"LICEUL TEORETIC ”ALEXANDRU IOAN CUZA”",133,"Alegeri Prezidentiale",1,1926,431,403,28,0,417,14,2100,1669,246,171
24,IAŞI,"MUNICIPIUL IAŞI",95060,IAŞI,"LICEUL TEORETIC ”ALEXANDRU IOAN CUZA”",134,"Alegeri Prezidentiale",1,1930,528,498,30,0,508,20,2100,1572,319,189
24,IAŞI,"MUNICIPIUL IAŞI",95060,IAŞI,"ŞCOALA PRIMARA ”COSTACHE CONACHI”",135,"Alegeri Prezidentiale",1,1273,770,584,185,1,745,25,1400,630,559,186
24,IAŞI,"MUNICIPIUL IAŞI",95060,IAŞI,"ŞCOALA PRIMARA ”COSTACHE CONACHI”",136,"Alegeri Prezidentiale",1,1650,897,752,145,0,873,24,1800,903,695,178
24,IAŞI,"MUNICIPIUL IAŞI",95060,IAŞI,"ŞCOALA PRIMARA ”COSTACHE CONACHI”",137,"Alegeri Prezidentiale",1,1348,714,613,100,1,700,14,1500,786,515,185
24,IAŞI,"MUNICIPIUL IAŞI",95060,IAŞI,"ŞCOALA PRIMARA ”COSTACHE CONACHI”",138,"Alegeri Prezidentiale",1,1321,637,558,78,1,622,15,1500,863,462,160
24,IAŞI,"MUNICIPIUL IAŞI",95060,IAŞI,"ŞCOALA PRIMARA ”COSTACHE CONACHI”",139,"Alegeri Prezidentiale",1,1461,610,522,88,0,596,14,1600,990,426,170
24,IAŞI,"MUNICIPIUL IAŞI",95060,IAŞI,"DIRECTIA JUDETEANA PENTRU SPORT SI TINERET - COMPLEX SPORTIV GRADINARI",140,"Alegeri Prezidentiale",1,1047,960,476,484,0,941,19,1100,140,760,181
24,IAŞI,"MUNICIPIUL IAŞI",95060,IAŞI,"DIRECTIA JUDETEANA PENTRU SPORT SI TINERET - COMPLEX SPORTIV GRADINARI",141,"Alegeri Prezidentiale",1,1345,874,598,276,0,855,19,1500,626,658,197
24,IAŞI,"MUNICIPIUL IAŞI",95060,IAŞI,"DIRECTIA JUDETEANA PENTRU SPORT SI TINERET - COMPLEX SPORTIV GRADINARI",142,"Alegeri Prezidentiale",1,1773,868,568,300,0,854,14,1900,1032,678,176
24,IAŞI,"MUNICIPIUL IAŞI",95060,IAŞI,"DIRECTIA JUDETEANA PENTRU SPORT SI TINERET - COMPLEX SPORTIV GRADINARI",143,"Alegeri Prezidentiale",1,1404,1021,707,313,1,993,28,1500,479,760,233
24,IAŞI,"MUNICIPIUL IAŞI",95060,IAŞI,"DIRECTIA JUDETEANA PENTRU SPORT SI TINERET - COMPLEX SPORTIV GRADINARI",144,"Alegeri Prezidentiale",1,1415,804,622,182,0,786,18,1500,696,572,214
24,IAŞI,"MUNICIPIUL IAŞI",95060,IAŞI,"DIRECTIA JUDETEANA PENTRU SPORT SI TINERET - COMPLEX SPORTIV GRADINARI",145,"Alegeri Prezidentiale",1,1392,913,610,286,17,898,15,1500,586,697,201
24,IAŞI,"MUNICIPIUL IAŞI",95060,IAŞI,"ŞCOALA GIMNAZIALĂ ”IONEL TEODOREANU”",146,"Alegeri Prezidentiale",1,1535,679,596,82,1,666,13,1700,1021,463,203
24,IAŞI,"MUNICIPIUL IAŞI",95060,IAŞI,"ŞCOALA GIMNAZIALĂ ”IONEL TEODOREANU”",147,"Alegeri Prezidentiale",1,1476,823,644,179,0,806,17,1600,777,585,221
24,IAŞI,"MUNICIPIUL IAŞI",95060,IAŞI,"ŞCOALA GIMNAZIALĂ ”IONEL TEODOREANU”",148,"Alegeri Prezidentiale",1,1310,818,562,256,0,798,20,1400,582,604,194
24,IAŞI,"MUNICIPIUL IAŞI",95060,IAŞI,"ŞCOALA GIMNAZIALĂ ”IONEL TEODOREANU”",149,"Alegeri Prezidentiale",1,1642,715,628,87,0,704,11,1800,1085,495,209
24,IAŞI,"MUNICIPIUL IAŞI",95060,IAŞI,"ŞCOALA GIMNAZIALĂ ”IONEL TEODOREANU”",150,"Alegeri Prezidentiale",1,1777,423,315,108,0,418,5,2000,1577,312,106
24,IAŞI,"MUNICIPIUL IAŞI",95060,IAŞI,"ŞCOALA GIMNAZIALĂ ”GHEORGHE I. BRĂTIANU”",151,"Alegeri Prezidentiale",1,1748,814,770,44,0,793,21,1900,1086,530,263
24,IAŞI,"MUNICIPIUL IAŞI",95060,IAŞI,"ŞCOALA GIMNAZIALĂ ”GHEORGHE I. BRĂTIANU”",152,"Alegeri Prezidentiale",1,1795,705,580,124,1,689,16,2000,1295,484,205
24,IAŞI,"MUNICIPIUL IAŞI",95060,IAŞI,"ŞCOALA GIMNAZIALĂ ”GHEORGHE I. BRĂTIANU”",153,"Alegeri Prezidentiale",1,1889,213,16,197,0,210,3,1300,1087,183,27
24,IAŞI,"MUNICIPIUL IAŞI",95060,IAŞI,"ŞCOALA GIMNAZIALĂ ”GHEORGHE I. BRĂTIANU”",154,"Alegeri Prezidentiale",1,1880,138,20,118,0,137,1,1108,970,123,14
24,IAŞI,"MUNICIPIUL IAŞI",95060,IAŞI,"ŞCOALA GIMNAZIALĂ ”GHEORGHE I. BRĂTIANU”",155,"Alegeri Prezidentiale",1,1764,903,857,46,0,887,16,1900,997,682,205
24,IAŞI,"MUNICIPIUL IAŞI",95060,IAŞI,"ŞCOALA GIMNAZIALĂ ”GHEORGHE I. BRĂTIANU”",156,"Alegeri Prezidentiale",1,1861,681,640,41,0,670,11,2000,1319,493,177
24,IAŞI,"MUNICIPIUL IAŞI",95060,IAŞI,"ŞCOALA GIMNAZIALĂ ”GHEORGHE I. BRĂTIANU”",157,"Alegeri Prezidentiale",1,1855,497,462,35,0,477,20,2000,1503,335,142
24,IAŞI,"MUNICIPIUL IAŞI",95060,IAŞI,"UNIVERSITATEA TEHNICĂ ”GHEORGHE ASACHI”",158,"Alegeri Prezidentiale",1,1403,2185,358,1827,0,2128,57,2679,494,1890,238
24,IAŞI,"MUNICIPIUL IAŞI",95060,IAŞI,"UNIVERSITATEA TEHNICĂ ”GHEORGHE ASACHI”",159,"Alegeri Prezidentiale",1,747,566,378,188,0,546,20,1600,1034,392,154
24,IAŞI,"MUNICIPIUL IAŞI",95060,IAŞI,"UNIVERSITATEA TEHNICĂ ”GHEORGHE ASACHI”",160,"Alegeri Prezidentiale",1,787,569,407,162,0,558,11,900,331,397,161
24,IAŞI,"MUNICIPIUL IAŞI",95060,IAŞI,"UNIVERSITATEA TEHNICĂ ”GHEORGHE ASACHI”",161,"Alegeri Prezidentiale",1,1164,743,627,116,0,721,22,1300,557,495,226
24,IAŞI,"MUNICIPIUL IAŞI",95060,IAŞI,"ŞCOALA GIMNAZIALĂ ”ION GHICA”",162,"Alegeri Prezidentiale",1,1452,792,631,161,0,780,12,1600,808,504,276
24,IAŞI,"MUNICIPIUL IAŞI",95060,IAŞI,"ŞCOALA GIMNAZIALĂ ”ION GHICA”",163,"Alegeri Prezidentiale",1,569,441,277,164,0,435,6,600,159,322,113
24,IAŞI,"MUNICIPIUL IAŞI",95060,IAŞI,"ŞCOALA GIMNAZIALĂ ”ION GHICA”",164,"Alegeri Prezidentiale",2,576,412,270,142,0,406,6,600,188,305,101
24,IAŞI,"MUNICIPIUL IAŞI",95060,IAŞI,"LICEUL TEHNOLOGIC DE MECATRONICA SI AUTOMATIZARI",165,"Alegeri Prezidentiale",1,1709,340,250,70,20,333,7,1900,1560,251,82
24,IAŞI,"MUNICIPIUL IAŞI",95060,IAŞI,"LICEUL TEHNOLOGIC DE MECATRONICA SI AUTOMATIZARI",166,"Alegeri Prezidentiale",1,1682,108,46,62,0,106,2,1000,892,74,32
24,IAŞI,"MUNICIPIUL IAŞI",95060,IAŞI,"LICEUL TEHNOLOGIC DE MECATRONICA SI AUTOMATIZARI",167,"Alegeri Prezidentiale",1,1601,450,410,40,0,439,11,1800,1350,301,138
24,IAŞI,"MUNICIPIUL IAŞI",95060,IAŞI,"LICEUL TEHNOLOGIC DE MECATRONICA SI AUTOMATIZARI",168,"Alegeri Prezidentiale",1,1311,618,574,44,0,599,19,1400,782,398,201
24,IAŞI,"MUNICIPIUL IAŞI",95060,IAŞI,"COLEGIUL TEHNIC ”IOAN C.ŞTEFĂNESCU”",169,"Alegeri Prezidentiale",1,1492,691,436,255,0,671,20,1600,909,484,187
24,IAŞI,"MUNICIPIUL IAŞI",95060,IAŞI,"COLEGIUL TEHNIC ”IOAN C.ŞTEFĂNESCU”",170,"Alegeri Prezidentiale",1,1868,355,300,55,0,352,3,2000,1645,269,83
24,IAŞI,"MUNICIPIUL IAŞI",95060,IAŞI,"COLEGIUL TEHNIC ”IOAN C.ŞTEFĂNESCU”",171,"Alegeri Prezidentiale",1,1057,380,338,42,0,374,6,1200,820,277,97
24,IAŞI,"MUNICIPIUL IAŞI",95060,IAŞI,"LICEUL TEHNOLOGIC ”PETRU PONI”",172,"Alegeri Prezidentiale",1,964,576,410,166,0,562,14,1100,524,409,153
24,IAŞI,"MUNICIPIUL IAŞI",95060,IAŞI,"LICEUL TEHNOLOGIC ”PETRU PONI”",173,"Alegeri Prezidentiale",1,975,556,410,145,1,550,6,1100,544,387,163
24,IAŞI,"MUNICIPIUL IAŞI",95060,IAŞI,"LICEUL TEHNOLOGIC ”PETRU PONI”",174,"Alegeri Prezidentiale",1,791,373,327,46,0,362,11,900,527,256,106
24,IAŞI,"MUNICIPIUL IAŞI",95060,IAŞI,"LICEUL TEHNOLOGIC ”PETRU PONI”",175,"Alegeri Prezidentiale",1,897,477,412,65,0,470,7,1000,523,333,137
24,IAŞI,"MUNICIPIUL IAŞI",95060,IAŞI,"COLEGIUL TEHNIC ELECTRONICĂ ŞI TELECOMUNICAŢII ”GHEORGHE MÂRZESCU”",176,"Alegeri Prezidentiale",1,1398,779,666,112,1,769,10,1500,721,519,250
24,IAŞI,"MUNICIPIUL IAŞI",95060,IAŞI,"COLEGIUL TEHNIC ELECTRONICĂ ŞI TELECOMUNICAŢII ”GHEORGHE MÂRZESCU”",177,"Alegeri Prezidentiale",1,1386,518,410,108,0,510,8,1500,982,401,109
24,IAŞI,"MUNICIPIUL IAŞI",95060,IAŞI,"GRĂDINIŢA CU PROGRAM NORMAL NR. 26",178,"Alegeri Prezidentiale",1,1840,397,212,185,0,392,5,2000,1603,315,77
24,IAŞI,"MUNICIPIUL IAŞI",95060,IAŞI,"GRĂDINIŢA CU PROGRAM NORMAL NR. 26",179,"Alegeri Prezidentiale",1,1679,909,842,67,0,891,18,1800,891,647,244
24,IAŞI,"MUNICIPIUL IAŞI",95060,IAŞI,"GRĂDINIŢA CU PROGRAM NORMAL NR. 26",180,"Alegeri Prezidentiale",1,1607,827,773,54,0,805,22,1800,973,625,180
24,IAŞI,"MUNICIPIUL IAŞI",95060,IAŞI,"ŞCOALA GIMNAZIALĂ ”NICOLAE IORGA”",181,"Alegeri Prezidentiale",1,1842,629,449,180,0,618,11,2000,1371,462,156
24,IAŞI,"MUNICIPIUL IAŞI",95060,IAŞI,"ŞCOALA GIMNAZIALĂ ”NICOLAE IORGA”",182,"Alegeri Prezidentiale",1,1918,186,112,74,0,185,1,2100,1914,161,24
24,IAŞI,"MUNICIPIUL IAŞI",95060,IAŞI,"ŞCOALA GIMNAZIALĂ ”NICOLAE IORGA”",183,"Alegeri Prezidentiale",1,1689,1049,890,124,35,1020,29,1900,851,796,224
24,IAŞI,"MUNICIPIUL IAŞI",95060,IAŞI,"ŞCOALA GIMNAZIALĂ ”NICOLAE IORGA”",184,"Alegeri Prezidentiale",1,1818,66,3,63,0,65,1,1200,1134,61,4
24,IAŞI,"MUNICIPIUL IAŞI",95060,IAŞI,"ŞCOALA GIMNAZIALĂ ”NICOLAE IORGA”",185,"Alegeri Prezidentiale",1,1588,798,747,51,0,774,24,1700,902,581,193
24,IAŞI,"MUNICIPIUL IAŞI",95060,IAŞI,"ŞCOALA GIMNAZIALĂ ”NICOLAE IORGA”",186,"Alegeri Prezidentiale",2,1715,763,729,34,0,748,15,1900,1137,554,194
24,IAŞI,"MUNICIPIUL IAŞI",95060,IAŞI,"ŞCOALA GIMNAZIALĂ ”NICOLAE IORGA”",187,"Alegeri Prezidentiale",1,1704,593,568,25,0,587,6,1900,1307,422,165
24,IAŞI,"MUNICIPIUL IAŞI",95060,IAŞI,"ŞCOALA GIMNAZIALĂ ”NICOLAE IORGA”",188,"Alegeri Prezidentiale",1,1647,855,811,44,0,844,11,1800,945,661,183
24,IAŞI,"MUNICIPIUL IAŞI",95060,IAŞI,"ŞCOALA GIMNAZIALĂ ”VERONICA MICLE”",189,"Alegeri Prezidentiale",1,1682,1240,945,178,117,1219,21,1800,560,956,263
24,IAŞI,"MUNICIPIUL IAŞI",95060,IAŞI,"ŞCOALA GIMNAZIALĂ ”VERONICA MICLE”",190,"Alegeri Prezidentiale",1,1553,964,847,93,24,940,24,1700,736,676,264
24,IAŞI,"MUNICIPIUL IAŞI",95060,IAŞI,"ŞCOALA GIMNAZIALĂ ”VERONICA MICLE”",191,"Alegeri Prezidentiale",1,1618,980,853,98,29,956,24,1775,795,708,248
24,IAŞI,"MUNICIPIUL IAŞI",95060,IAŞI,"ŞCOALA GIMNAZIALĂ ”VERONICA MICLE”",192,"Alegeri Prezidentiale",1,1567,928,827,101,0,907,21,1700,772,680,227
24,IAŞI,"MUNICIPIUL IAŞI",95060,IAŞI,"CENTRUL DE CARTIER FRUMOASA",193,"Alegeri Prezidentiale",1,1237,778,669,109,0,759,19,1400,622,590,169
24,IAŞI,"MUNICIPIUL IAŞI",95060,IAŞI,"ŞCOALA GIMNAZIALĂ ”DIMITRIE A. STURDZA”",194,"Alegeri Prezidentiale",1,955,480,399,81,0,473,7,1000,520,363,110
24,IAŞI,"MUNICIPIUL IAŞI",95060,IAŞI,"ŞCOALA GIMNAZIALĂ ”DIMITRIE A. STURDZA”",195,"Alegeri Prezidentiale",2,887,397,370,27,0,391,6,1000,603,268,123
24,IAŞI,"MUNICIPIUL IAŞI",95060,IAŞI,"ŞCOALA GIMNAZIALĂ ”DIMITRIE A. STURDZA”",196,"Alegeri Prezidentiale",1,755,237,196,41,0,233,4,800,563,181,52
24,IAŞI,"MUNICIPIUL IAŞI",95060,IAŞI,"ŞCOALA GIMNAZIALĂ ”DIMITRIE A. STURDZA”",197,"Alegeri Prezidentiale",2,1337,494,436,58,0,484,10,1500,1006,375,109
24,IAŞI,"MUNICIPIUL IAŞI",95060,IAŞI,"ŞCOALA GIMNAZIALĂ ”DIMITRIE A. STURDZA”",198,"Alegeri Prezidentiale",1,1103,389,326,63,0,384,5,1196,807,292,92
24,IAŞI,"MUNICIPIUL IAŞI",95060,IAŞI,"ŞCOALA GIMNAZIALĂ ”DIMITRIE A.STURDZA”",199,"Alegeri Prezidentiale",1,863,516,451,65,0,511,5,900,384,379,132
24,IAŞI,"MUNICIPIUL IAŞI",95060,IAŞI,"ŞCOALA GIMNAZIALĂ ”DIMITRIE A.STURDZA”",200,"Alegeri Prezidentiale",1,1170,529,491,38,0,524,5,1300,771,378,146
24,IAŞI,"MUNICIPIUL IAŞI",95060,IAŞI,"ŞCOALA GIMNAZIALĂ ”DIMITRIE A.STURDZA”",201,"Alegeri Prezidentiale",1,1262,617,582,35,0,598,19,1400,783,442,156
24,IAŞI,"MUNICIPIUL IAŞI",95060,IAŞI,"ŞCOALA GIMNAZIALĂ ”DIMITRIE A.STURDZA”",202,"Alegeri Prezidentiale",1,1482,790,725,65,0,777,13,1600,810,572,205
24,IAŞI,"MUNICIPIUL IAŞI",95060,IAŞI,"ŞCOALA GIMNAZIALĂ ”ALECU RUSSO”",203,"Alegeri Prezidentiale",1,1133,565,538,27,0,544,21,1200,635,393,151
24,IAŞI,"MUNICIPIUL IAŞI",95060,IAŞI,"ŞCOALA GIMNAZIALĂ ”ALECU RUSSO”",204,"Alegeri Prezidentiale",1,1228,690,644,46,0,683,7,1300,610,473,210
24,IAŞI,"MUNICIPIUL IAŞI",95060,IAŞI,"ŞCOALA GIMNAZIALĂ ”ALECU RUSSO”",205,"Alegeri Prezidentiale",1,1332,659,559,100,0,646,13,1498,839,479,167
24,IAŞI,"MUNICIPIUL IAŞI",95060,IAŞI,"ŞCOALA GIMNAZIALĂ ”ALECU RUSSO”",206,"Alegeri Prezidentiale",1,1330,711,610,101,0,700,11,1500,789,472,228
24,IAŞI,"MUNICIPIUL IAŞI",95060,IAŞI,"ŞCOALA GIMNAZIALĂ ”ALECU RUSSO”",207,"Alegeri Prezidentiale",1,1500,529,372,157,0,512,17,1600,1071,351,161
24,IAŞI,"MUNICIPIUL IAŞI",95060,IAŞI,"ŞCOALA GIMNAZIALĂ ” ALECU RUSSO”",208,"Alegeri Prezidentiale",1,1041,552,486,66,0,539,13,1100,548,383,156
24,IAŞI,"MUNICIPIUL IAŞI",95060,IAŞI,"ŞCOALA PRIMARA ”GHEORGHE GHIBANESCU”",209,"Alegeri Prezidentiale",1,1123,733,551,182,0,712,21,1200,467,551,161
24,IAŞI,"MUNICIPIUL IAŞI",95060,IAŞI,"ŞCOALA PRIMARA ”GHEORGHE GHIBANESCU”",210,"Alegeri Prezidentiale",1,1163,638,542,96,0,622,16,1300,662,471,151
24,IAŞI,"MUNICIPIUL IAŞI",95060,IAŞI,"ŞCOALA PRIMARA ”GHEORGHE GHIBANESCU”",211,"Alegeri Prezidentiale",1,1114,599,529,70,0,578,21,1200,601,425,153
24,IAŞI,"MUNICIPIUL IAŞI",95060,IAŞI,"ŞCOALA PRIMARA ”GHEORGHE GHIBANESCU”",212,"Alegeri Prezidentiale",1,1272,695,659,36,0,684,11,1400,705,519,165
24,IAŞI,"MUNICIPIUL IAŞI",95060,IAŞI,"ŞCOALA PRIMARA ”GHEORGHE GHIBANESCU”",213,"Alegeri Prezidentiale",1,1199,581,554,26,1,568,13,1300,719,386,182
24,IAŞI,"MUNICIPIUL IAŞI",95060,IAŞI,"GRĂDINIŢA CU PROGRAM PRELUNGIT NR.1",214,"Alegeri Prezidentiale",1,815,636,405,231,0,626,10,900,264,487,139
24,IAŞI,"MUNICIPIUL IAŞI",95060,IAŞI,"GRĂDINIŢA CU PROGRAM PRELUNGIT NR.1",215,"Alegeri Prezidentiale",1,1004,704,497,207,0,685,19,1100,396,523,162
24,IAŞI,"MUNICIPIUL IAŞI",95060,IAŞI,"ŞCOALA GIMNAZIALĂ ”OTILIA CAZIMIR”",216,"Alegeri Prezidentiale",1,1138,596,508,87,1,582,14,1200,604,407,175
24,IAŞI,"MUNICIPIUL IAŞI",95060,IAŞI,"ŞCOALA GIMNAZIALĂ ”OTILIA CAZIMIR”",217,"Alegeri Prezidentiale",1,1082,588,512,76,0,580,8,1200,612,430,150
24,IAŞI,"MUNICIPIUL IAŞI",95060,IAŞI,"ŞCOALA GIMNAZIALĂ ”OTILIA CAZIMIR”",218,"Alegeri Prezidentiale",1,1161,686,483,203,0,671,15,1300,614,483,188
24,IAŞI,"MUNICIPIUL IAŞI",95060,IAŞI,"ŞCOALA GIMNAZIALĂ ”OTILIA CAZIMIR”",219,"Alegeri Prezidentiale",1,1268,662,588,74,0,652,10,1400,738,430,222
24,IAŞI,"MUNICIPIUL IAŞI",95060,IAŞI,"COLEGIUL NAŢIONAL ”EMIL RACOVIŢĂ”",220,"Alegeri Prezidentiale",1,1923,397,42,355,0,389,8,1300,903,358,31
24,IAŞI,"MUNICIPIUL IAŞI",95060,IAŞI,"COLEGIUL NAŢIONAL ”EMIL RACOVIŢĂ”",221,"Alegeri Prezidentiale",1,1964,353,158,195,0,350,3,1300,947,278,72
24,IAŞI,"MUNICIPIUL IAŞI",95060,IAŞI,"COLEGIUL NAŢIONAL ”EMIL RACOVIŢĂ”",222,"Alegeri Prezidentiale",1,1732,637,565,70,2,627,10,1900,1263,415,212
24,IAŞI,"MUNICIPIUL IAŞI",95060,IAŞI,"COLEGIUL NAŢIONAL ”EMIL RACOVIŢĂ”",223,"Alegeri Prezidentiale",1,1762,845,766,79,0,828,17,1900,1055,550,278
24,IAŞI,"MUNICIPIUL IAŞI",95060,IAŞI,"COLEGIUL NAŢIONAL ”EMIL RACOVIŢĂ”",224,"Alegeri Prezidentiale",1,1764,623,555,68,0,609,14,1900,1277,417,192
24,IAŞI,"MUNICIPIUL IAŞI",95060,IAŞI,"LICEUL TEORETIC ”DIMITRIE CANTEMIR”",225,"Alegeri Prezidentiale",1,1338,763,664,99,0,742,21,1500,737,520,222
24,IAŞI,"MUNICIPIUL IAŞI",95060,IAŞI,"LICEUL TEORETIC ”DIMITRIE CANTEMIR”",226,"Alegeri Prezidentiale",1,1307,736,626,109,1,719,17,1400,664,539,180
24,IAŞI,"MUNICIPIUL IAŞI",95060,IAŞI,"LICEUL TEORETIC ”DIMITRIE CANTEMIR”",227,"Alegeri Prezidentiale",1,1213,749,635,114,0,730,19,1300,551,482,248
24,IAŞI,"MUNICIPIUL IAŞI",95060,IAŞI,"LICEUL TEORETIC ”DIMITRIE CANTEMIR”",228,"Alegeri Prezidentiale",1,1368,705,653,51,1,687,18,1500,795,492,195
24,IAŞI,"MUNICIPIUL IAŞI",95060,IAŞI,"ŞCOALA GIMNAZIALĂ ”TITU MAIORESCU”",229,"Alegeri Prezidentiale",1,771,547,333,214,0,538,9,800,253,416,122
24,IAŞI,"MUNICIPIUL IAŞI",95060,IAŞI,"ŞCOALA GIMNAZIALĂ ”TITU MAIORESCU”",230,"Alegeri Prezidentiale",1,787,431,328,103,0,416,15,900,469,298,118
24,IAŞI,"MUNICIPIUL IAŞI",95060,IAŞI,"ŞCOALA GIMNAZIALĂ ”TITU MAIORESCU”",231,"Alegeri Prezidentiale",1,1246,489,426,63,0,480,9,1400,911,319,161
24,IAŞI,"MUNICIPIUL IAŞI",95060,IAŞI,"GRĂDINIŢA CU PROGRAM PRELUNGIT ”CUV. PARASCHEVA”",232,"Alegeri Prezidentiale",1,834,698,395,303,0,681,17,900,202,542,139
24,IAŞI,"MUNICIPIUL IAŞI",95060,IAŞI,"ŞCOALA GIMNAZIALĂ ”ION NECULCE”",233,"Alegeri Prezidentiale",1,1254,607,499,108,0,587,20,1400,793,377,210
24,IAŞI,"MUNICIPIUL IAŞI",95060,IAŞI,"ŞCOALA GIMNAZIALĂ ”ION NECULCE”",234,"Alegeri Prezidentiale",1,1032,557,507,50,0,544,13,1100,543,382,162
24,IAŞI,"MUNICIPIUL IAŞI",95060,IAŞI,"ŞCOALA GIMNAZIALĂ ”ION NECULCE”",235,"Alegeri Prezidentiale",1,1095,626,583,43,0,612,14,1200,574,410,202
24,IAŞI,"MUNICIPIUL IAŞI",95060,IAŞI,"ŞCOALA GIMNAZIALĂ ”ION NECULCE”",236,"Alegeri Prezidentiale",1,1089,395,364,31,0,385,10,1200,805,252,133
24,IAŞI,"MUNICIPIUL IAŞI",95060,IAŞI,"ŞCOALA PRIMARA NR.1 ”VASILE CONTA”",237,"Alegeri Prezidentiale",1,743,464,321,143,0,452,12,800,336,355,97
24,IAŞI,"MUNICIPIUL IAŞI",95060,IAŞI,"ŞCOALA PRIMARA NR.1 ”VASILE CONTA”",238,"Alegeri Prezidentiale",1,1167,687,562,125,0,677,10,1300,613,460,217
24,IAŞI,"MUNICIPIUL IAŞI",95060,IAŞI,"ŞCOALA PRIMARA NR.1 ”VASILE CONTA”",239,"Alegeri Prezidentiale",1,1694,769,660,109,0,755,14,1908,1139,534,221
24,IAŞI,"MUNICIPIUL IAŞI",95060,IAŞI,"ŞCOALA GIMNAZIALĂ ”VASILE CONTA”",240,"Alegeri Prezidentiale",1,1356,857,652,205,0,838,19,1500,643,614,224
24,IAŞI,"MUNICIPIUL IAŞI",95060,IAŞI,"ŞCOALA GIMNAZIALĂ ”VASILE CONTA”",241,"Alegeri Prezidentiale",1,1364,840,618,222,0,819,21,1500,660,595,224
24,IAŞI,"MUNICIPIUL IAŞI",95060,IAŞI,"ŞCOALA GIMNAZIALĂ ”VASILE CONTA”",242,"Alegeri Prezidentiale",1,1447,697,597,100,0,682,15,1600,903,498,184
24,IAŞI,"MUNICIPIUL IAŞI",95060,IAŞI,"ŞCOALA GIMNAZIALĂ ”VASILE CONTA”",243,"Alegeri Prezidentiale",1,1470,783,714,68,1,769,14,1600,817,528,241
24,IAŞI,"MUNICIPIUL IAŞI",95060,IAŞI,"COLEGIUL TEHNIC ”ION HOLBAN”",244,"Alegeri Prezidentiale",1,1560,1012,768,161,83,996,16,1700,688,662,334
24,IAŞI,"MUNICIPIUL IAŞI",95060,IAŞI,"COLEGIUL TEHNIC ”ION HOLBAN”",245,"Alegeri Prezidentiale",1,1263,770,544,155,71,753,17,1400,630,497,256
24,IAŞI,"MUNICIPIUL IAŞI",95060,IAŞI,"COLEGIUL TEHNIC ”ION HOLBAN”",246,"Alegeri Prezidentiale",1,1461,733,542,108,83,720,13,1600,867,463,257
24,IAŞI,"MUNICIPIUL IAŞI",95060,IAŞI,"PT 27 - TATARASI",247,"Alegeri Prezidentiale",1,1890,105,6,99,0,105,0,1300,1195,89,16
24,IAŞI,"MUNICIPIUL PAŞCANI",95391,PAŞCANI,"CASA DE CULTURA MIHAIL SADOVEANU",248,"Alegeri Prezidentiale",1,1215,573,551,22,0,555,18,1300,727,322,233
24,IAŞI,"MUNICIPIUL PAŞCANI",95391,PAŞCANI,"CASA DE CULTURA MIHAIL SADOVEANU",249,"Alegeri Prezidentiale",1,1339,613,569,44,0,595,18,1500,887,308,287
24,IAŞI,"MUNICIPIUL PAŞCANI",95391,PAŞCANI,"SCOALA ION CREANGA",250,"Alegeri Prezidentiale",1,1344,626,586,40,0,611,15,1500,874,331,280
24,IAŞI,"MUNICIPIUL PAŞCANI",95391,PAŞCANI,"GRADINITA NR. 1",251,"Alegeri Prezidentiale",1,1158,480,456,23,1,470,10,1300,820,230,240
24,IAŞI,"MUNICIPIUL PAŞCANI",95391,PAŞCANI,"SCOALA NR.3 IORDACHI CANTACUZINO",252,"Alegeri Prezidentiale",1,1444,691,641,50,0,672,19,1600,909,354,318
24,IAŞI,"MUNICIPIUL PAŞCANI",95391,PAŞCANI,"SCOALA NR.3 IORDACHI CANTACUZINO",253,"Alegeri Prezidentiale",1,1199,499,468,31,0,484,15,1300,801,290,194
24,IAŞI,"MUNICIPIUL PAŞCANI",95391,PAŞCANI,"GRADINITA VATRA",254,"Alegeri Prezidentiale",1,1379,708,551,38,119,695,13,1500,792,363,332
24,IAŞI,"MUNICIPIUL PAŞCANI",95391,PAŞCANI,"COLEGIUL NAȚIONAL MIHAIL SADOVEANU",255,"Alegeri Prezidentiale",1,1313,540,530,10,0,528,12,1400,860,264,264
24,IAŞI,"MUNICIPIUL PAŞCANI",95391,PAŞCANI,"COLEGIUL NAȚIONAL MIHAIL SADOVEANU",256,"Alegeri Prezidentiale",1,1381,627,620,7,0,604,23,1500,873,331,273
24,IAŞI,"MUNICIPIUL PAŞCANI",95391,PAŞCANI,"COLEGIUL NAȚIONAL MIHAIL SADOVEANU",257,"Alegeri Prezidentiale",1,1626,32,0,32,0,32,0,1800,1768,28,4
24,IAŞI,"MUNICIPIUL PAŞCANI",95391,PAŞCANI,"COLEGIUL NAȚIONAL MIHAIL SADOVEANU",258,"Alegeri Prezidentiale",1,1635,38,0,38,0,37,1,1700,1662,24,13
24,IAŞI,"MUNICIPIUL PAŞCANI",95391,PAŞCANI,"GRADINITA SIIRETUL",259,"Alegeri Prezidentiale",1,1562,603,553,50,0,583,20,1700,1097,310,273
24,IAŞI,"MUNICIPIUL PAŞCANI",95391,PAŞCANI,"SCOALA DE ARTE SI MESERII NICOLAE IORGA",260,"Alegeri Prezidentiale",1,1685,813,701,60,52,797,16,1800,987,456,341
24,IAŞI,"MUNICIPIUL PAŞCANI",95391,PAŞCANI,"SCOALA SPECIALA",261,"Alegeri Prezidentiale",1,1676,701,674,27,0,680,21,1800,1099,320,360
24,IAŞI,"MUNICIPIUL PAŞCANI",95391,PAŞCANI,"COLEGIU TEHNIC DE CAI FERATE UNIREA",262,"Alegeri Prezidentiale",1,1568,639,597,42,0,623,16,1700,1061,317,306
24,IAŞI,"MUNICIPIUL PAŞCANI",95391,PAŞCANI,"COLEGIU TEHNIC DE CAI FERATE UNIREA",263,"Alegeri Prezidentiale",1,1096,454,442,12,0,436,18,1200,746,234,202
24,IAŞI,"MUNICIPIUL PAŞCANI",95391,PAŞCANI,"GRADINITA CU PROGRAM PRELUNGIT NR. 3",264,"Alegeri Prezidentiale",1,1081,471,444,27,0,461,10,1200,729,216,245
24,IAŞI,"MUNICIPIUL PAŞCANI",95391,PAŞCANI,"GRADINITA CU PROGRAM PRELUNGIT NR. 3",265,"Alegeri Prezidentiale",1,1302,504,475,29,0,487,17,1400,896,287,200
24,IAŞI,"MUNICIPIUL PAŞCANI",95391,PAŞCANI,"LICEUL MIRON COSTIN",266,"Alegeri Prezidentiale",1,1303,552,501,51,0,538,14,1400,848,292,246
24,IAŞI,"MUNICIPIUL PAŞCANI",95391,PAŞCANI,"LICEUL MIRON COSTIN",267,"Alegeri Prezidentiale",1,1246,547,496,51,0,534,13,1400,853,240,294
24,IAŞI,"MUNICIPIUL PAŞCANI",95391,PAŞCANI,"GRUP SCOLAR MIHAI BUSUIOC",268,"Alegeri Prezidentiale",1,1245,544,513,30,1,535,9,1400,856,290,245
24,IAŞI,"MUNICIPIUL PAŞCANI",95391,PAŞCANI,"GRUP SCOLAR MIHAI BUSUIOC",269,"Alegeri Prezidentiale",1,1118,466,442,24,0,454,12,1200,734,229,225
24,IAŞI,"MUNICIPIUL PAŞCANI",95391,BLĂGEŞTI,"SCOALA BLAGESTI",270,"Alegeri Prezidentiale",1,1133,555,529,26,0,546,9,1200,645,322,224
24,IAŞI,"MUNICIPIUL PAŞCANI",95391,GÂŞTEŞTI,"SCOALA GISTESTI",271,"Alegeri Prezidentiale",1,1064,426,412,14,0,416,10,1200,774,225,191
24,IAŞI,"MUNICIPIUL PAŞCANI",95391,GÂŞTEŞTI,"GRADINITA GISTESTI",272,"Alegeri Prezidentiale",1,1470,561,542,19,0,554,7,1608,1047,282,272
24,IAŞI,"MUNICIPIUL PAŞCANI",95391,LUNCA,"SCOALA LUNCA",273,"Alegeri Prezidentiale",1,1107,466,447,19,0,458,8,1200,734,201,257
24,IAŞI,"MUNICIPIUL PAŞCANI",95391,LUNCA,"SCOALA LUNCA",274,"Alegeri Prezidentiale",1,1038,478,460,17,1,469,9,1100,622,191,278
24,IAŞI,"MUNICIPIUL PAŞCANI",95391,SODOMENI,"SCOALA SODOMENI",275,"Alegeri Prezidentiale",1,952,391,378,13,0,380,11,1000,609,198,182
24,IAŞI,"MUNICIPIUL PAŞCANI",95391,BOŞTENI,"SCOALA BOSTENI",276,"Alegeri Prezidentiale",1,1244,522,506,16,0,514,8,1400,878,269,245
24,IAŞI,"ORAŞ HÂRLĂU",95355,HÂRLĂU,"LICEUL TEHNOLOGIC HÎRLĂU",277,"Alegeri Prezidentiale",1,1673,464,420,44,0,452,12,1800,1336,195,257
24,IAŞI,"ORAŞ HÂRLĂU",95355,HÂRLĂU,"COLEGIUL NAŢIONAL ŞTEFAN CEL MARE HÎRLĂU",278,"Alegeri Prezidentiale",1,2031,478,427,36,15,470,8,2200,1722,220,250
24,IAŞI,"ORAŞ HÂRLĂU",95355,HÂRLĂU,"ŞCOALA GIMNAZIALĂ PETRU RAREŞ - CORP VECHI",279,"Alegeri Prezidentiale",1,1862,563,520,43,0,543,20,2000,1437,273,270
24,IAŞI,"ORAŞ HÂRLĂU",95355,HÂRLĂU,"ŞCOALA GIMNAZIALĂ PETRU RAREŞ-CORP GRĂDINIŢĂ CU PROGRAM PRELUNGIT",280,"Alegeri Prezidentiale",1,1893,577,532,45,0,566,11,2100,1523,277,289
24,IAŞI,"ORAŞ HÂRLĂU",95355,HÂRLĂU,"ŞCOALA GIMNAZIALĂ PETRU RAREŞ - CORP NOU",281,"Alegeri Prezidentiale",1,1545,608,563,45,0,594,14,1700,1092,235,359
24,IAŞI,"ORAŞ HÂRLĂU",95355,PÂRCOVACI,"ŞCOALA GIMNAZIALĂ PÎRCOVACI - CORP GRADINIŢĂ",282,"Alegeri Prezidentiale",1,1481,687,675,12,0,677,10,1600,913,286,391
24,IAŞI,"ORAŞ HÂRLĂU",95355,PÂRCOVACI,"ŞCOALA GIMNAZIALĂ PÎRCOVACI - CORP ŞCOALĂ",283,"Alegeri Prezidentiale",1,1328,574,545,29,0,567,7,1400,826,273,294
24,IAŞI,"ORAŞ PODU ILOAIEI",98373,"PODU ILOAIEI","ŞCOALA AL. I. CUZA",284,"Alegeri Prezidentiale",1,601,252,230,13,9,250,2,700,448,164,86
24,IAŞI,"ORAŞ PODU ILOAIEI",98373,"PODU ILOAIEI","ŞCOALA AL. I. CUZA",285,"Alegeri Prezidentiale",1,1262,488,476,12,0,477,11,1400,912,317,160
24,IAŞI,"ORAŞ PODU ILOAIEI",98373,"PODU ILOAIEI","ŞCOALA AL. I. CUZA",286,"Alegeri Prezidentiale",2,961,339,281,58,0,337,2,1100,761,200,137
24,IAŞI,"ORAŞ PODU ILOAIEI",98373,"PODU ILOAIEI","ŞCOALA AL. I. CUZA",287,"Alegeri Prezidentiale",1,866,328,304,24,0,319,9,1000,672,231,88
24,IAŞI,"ORAŞ PODU ILOAIEI",98373,"PODU ILOAIEI","ŞCOALA AL. I. CUZA",288,"Alegeri Prezidentiale",1,903,333,319,14,0,328,5,1000,667,234,94
24,IAŞI,"ORAŞ PODU ILOAIEI",98373,"PODU ILOAIEI","ŞCOALA AL. I. CUZA",289,"Alegeri Prezidentiale",1,1134,456,437,18,1,453,3,1200,744,330,123
24,IAŞI,"ORAŞ PODU ILOAIEI",98373,"PODU ILOAIEI","ŞCOALA HENCI",290,"Alegeri Prezidentiale",1,452,187,161,26,0,186,1,500,313,135,51
24,IAŞI,"ORAŞ PODU ILOAIEI",98373,HOLM,"ŞCOALA HOLM",291,"Alegeri Prezidentiale",1,247,108,90,18,0,107,1,300,192,82,25
24,IAŞI,"ORAŞ PODU ILOAIEI",98373,SCOBÂLŢENI,"IMOBIL PRIVAT SAMSON NECULAI",292,"Alegeri Prezidentiale",1,996,393,363,30,0,385,8,1100,707,249,136
24,IAŞI,"ORAŞ PODU ILOAIEI",98373,BUDĂI,"ŞCOALA BUDĂI",293,"Alegeri Prezidentiale",1,781,373,296,44,33,366,7,900,527,266,100
24,IAŞI,"ORAŞ PODU ILOAIEI",98373,COSIŢENI,"ŞCOALA COSIŢENI",294,"Alegeri Prezidentiale",1,259,118,100,18,0,116,2,300,182,70,46
24,IAŞI,"ORAŞ TÂRGU FRUMOS",95471,"TÂRGU FRUMOS","SCOALA GENERALA ION CREANGA",295,"Alegeri Prezidentiale",1,1666,714,665,49,0,701,13,1800,1086,376,325
24,IAŞI,"ORAŞ TÂRGU FRUMOS",95471,"TÂRGU FRUMOS","SCOALA GENERALA ION CREANGA",296,"Alegeri Prezidentiale",1,897,313,262,51,0,307,6,1000,687,169,138
24,IAŞI,"ORAŞ TÂRGU FRUMOS",95471,"TÂRGU FRUMOS","SCOALA GENERALA GARABET IBRAILEANU",297,"Alegeri Prezidentiale",1,1380,430,401,29,0,424,6,1500,1070,253,171
24,IAŞI,"ORAŞ TÂRGU FRUMOS",95471,"TÂRGU FRUMOS","SCOALA GENERALA GARABET IBRAILEANU",298,"Alegeri Prezidentiale",1,1163,449,407,42,0,436,13,1300,851,253,183
24,IAŞI,"ORAŞ TÂRGU FRUMOS",95471,"TÂRGU FRUMOS","COMPLEX SERVICII SOCIALE PENTRU COPII - TARGU FRUMOS",299,"Alegeri Prezidentiale",1,1562,624,597,27,0,607,17,1700,1076,364,243
24,IAŞI,"ORAŞ TÂRGU FRUMOS",95471,"TÂRGU FRUMOS","CASA DE CULTURA ”GARABET IBRAILEANU”",300,"Alegeri Prezidentiale",1,1549,596,546,50,0,578,18,1700,1104,398,180
24,IAŞI,"ORAŞ TÂRGU FRUMOS",95471,"TÂRGU FRUMOS","CASA DE CULTURA ”GARABET IBRAILEANU”",301,"Alegeri Prezidentiale",1,1918,614,577,37,0,599,15,2100,1486,377,222
24,IAŞI,"ORAŞ TÂRGU FRUMOS",95471,"TÂRGU FRUMOS","LICEUL TEORETIC ”ION NECULCE”",302,"Alegeri Prezidentiale",1,1515,648,563,85,0,636,12,1700,1052,392,244
24,IAŞI,"ALEXANDRU I. CUZA",95612,"ALEXANDRU I. CUZA","GRĂDINIȚA CU PROGRAM NORMAL AL.I.CUZA",303,"Alegeri Prezidentiale",1,636,272,252,20,0,267,5,700,428,107,160
24,IAŞI,"ALEXANDRU I. CUZA",95612,SCHEIA,"SCOALA GIMNAZIALA SCHEIA",304,"Alegeri Prezidentiale",1,1077,379,340,39,0,370,9,1200,821,226,144
24,IAŞI,"ALEXANDRU I. CUZA",95612,VOLINTIREŞTI,"SCOALA PRIMARA VOLINTIRESTI",305,"Alegeri Prezidentiale",1,589,258,221,37,0,251,7,600,342,120,131
24,IAŞI,ANDRIEŞENI,95667,ANDRIEŞENI,"SCOALA GIMNAZIALA GH. CIOBANU ANDRIESENI",306,"Alegeri Prezidentiale",1,1336,554,509,45,0,550,4,1500,946,352,198
24,IAŞI,ANDRIEŞENI,95667,BUHĂENI,"SCOALA PRIMARA BUHAENI",307,"Alegeri Prezidentiale",1,502,164,136,28,0,160,4,600,436,94,66
24,IAŞI,ANDRIEŞENI,95667,SPINENI,"SCOALA GIMNAZIALA SPINENI",308,"Alegeri Prezidentiale",1,786,266,230,36,0,263,3,900,634,129,134
24,IAŞI,ANDRIEŞENI,95667,GLĂVĂNEŞTI,"SCOALA GIMNAZIALA GLAVANESTI",309,"Alegeri Prezidentiale",1,567,211,189,22,0,208,3,600,389,95,113
24,IAŞI,ARONEANU,95747,ARONEANU,"ȘCOALA GIMNAZIALĂ ARON-VODA DIN SAT ARONEANU",310,"Alegeri Prezidentiale",1,1422,982,779,203,0,966,16,1600,618,746,220
24,IAŞI,ARONEANU,95747,DOROBANŢ,"ȘCOALA GIMNAZIALĂ ARON-VODĂ DIN SAT DOROBANȚ",311,"Alegeri Prezidentiale",1,1181,593,509,84,0,589,4,1300,707,495,94
24,IAŞI,ARONEANU,95747,"REDIU ALDEI","ȘCOALA GIMNAZIALĂ ARON-VODĂ DIN SAT REDIU ALDEI",312,"Alegeri Prezidentiale",1,353,217,182,35,0,216,1,400,183,176,40
24,IAŞI,ARONEANU,95747,ŞOROGARI,"BAZA SPORTIVĂ MULTIFUNCȚIONALĂ - ȘOROGARI",313,"Alegeri Prezidentiale",1,340,163,108,55,0,160,3,399,236,130,30
24,IAŞI,BALŞ,100273,BALŞ,"SCOALA GIMNAZIALA CLASELE I-VIII BALS",314,"Alegeri Prezidentiale",1,1206,520,462,45,13,516,4,1300,780,290,226
24,IAŞI,BALŞ,100273,BOURENI,"SCOALA GIMNAZIALA CLASELE I-VIII BOURENI",315,"Alegeri Prezidentiale",2,1385,596,553,29,14,587,9,1500,904,348,239
24,IAŞI,BALŞ,100273,"COASTA MĂGURII","SCOALA PRIMARA CLASELE I-IV COASTA MAGURII",316,"Alegeri Prezidentiale",1,179,103,77,20,6,103,0,200,97,49,54
24,IAŞI,BĂLŢAŢI,95792,BĂLŢAŢI,"CENTRU DE ZI BĂLȚAȚI",317,"Alegeri Prezidentiale",1,1603,827,737,52,38,810,17,1800,973,480,330
24,IAŞI,BĂLŢAŢI,95792,MĂDÂRJEŞTI,"ȘCOALA PRIMARĂ - SAT MĂDÎRJEȘTI",318,"Alegeri Prezidentiale",1,933,446,362,71,13,441,5,1000,554,279,162
24,IAŞI,BĂLŢAŢI,95792,PODIŞU,"ȘCOALA PRIMARĂ - SAT PODIȘU",319,"Alegeri Prezidentiale",1,499,238,209,29,0,233,5,500,262,170,63
24,IAŞI,BĂLŢAŢI,95792,SÂRCA,"ȘCOALA GIMNAZIALĂ - SAT SÎRCA",320,"Alegeri Prezidentiale",1,869,446,413,27,6,442,4,900,454,306,136
24,IAŞI,BĂLŢAŢI,95792,"VALEA OILOR","ȘCOALA GIMNAZIALĂ - SAT VALEA OILOR",321,"Alegeri Prezidentiale",1,535,274,237,28,9,269,5,600,326,147,122
24,IAŞI,BÂRNOVA,95088,BÂRNOVA,"CAMIN CULTURAL BIRNOVA",322,"Alegeri Prezidentiale",1,1131,651,507,144,0,642,9,1200,549,431,211
24,IAŞI,BÂRNOVA,95088,CERCU,"SCOALA PRIMARA CERCU",323,"Alegeri Prezidentiale",1,569,304,261,43,0,298,6,600,296,222,76
24,IAŞI,BÂRNOVA,95088,PĂUN,"SCOALA PRIMARA PAUN",324,"Alegeri Prezidentiale",1,1112,688,496,192,0,680,8,1200,512,493,187
24,IAŞI,BÂRNOVA,95088,PIETRĂRIA,"SCOALA PRIMARA PIETRARIA",325,"Alegeri Prezidentiale",1,833,505,384,121,0,489,16,900,395,377,112
24,IAŞI,BÂRNOVA,95088,TODIREL,"SCOALA PRIMARA TODIREL",326,"Alegeri Prezidentiale",1,449,209,189,20,0,208,1,500,291,120,88
24,IAŞI,BÂRNOVA,95088,VIŞAN,"SCOALA PRIMARA VISAN",327,"Alegeri Prezidentiale",1,1397,746,607,139,0,735,11,1500,754,588,147
24,IAŞI,BELCEŞTI,95872,BELCEŞTI,"SCOALA BELCEŞTI",328,"Alegeri Prezidentiale",1,1112,410,385,25,0,404,6,1200,790,248,156
24,IAŞI,BELCEŞTI,95872,BELCEŞTI,"SCOALA BELCEŞTI",329,"Alegeri Prezidentiale",1,1223,460,415,45,0,456,4,1300,840,271,185
24,IAŞI,BELCEŞTI,95872,BELCEŞTI,"SCOALA RUSI",330,"Alegeri Prezidentiale",2,1245,477,430,47,0,473,4,1400,923,296,177
24,IAŞI,BELCEŞTI,95872,"SATU NOU","ŞCOALA SATU – NOU",331,"Alegeri Prezidentiale",1,1562,543,510,33,0,535,8,1700,1157,382,153
24,IAŞI,BELCEŞTI,95872,MUNTENI,"ŞCOALA MUNTENI",332,"Alegeri Prezidentiale",1,837,287,262,25,0,285,2,900,613,135,150
24,IAŞI,BELCEŞTI,95872,TANSA,"MAGAZIN CONSUMCOOP",333,"Alegeri Prezidentiale",1,817,340,312,28,0,337,3,900,560,192,145
24,IAŞI,BELCEŞTI,95872,LITENI,"ŞCOALA LITENI",334,"Alegeri Prezidentiale",1,1086,320,298,22,0,319,1,1200,880,192,127
24,IAŞI,BELCEŞTI,95872,ULMI,"SCOALA ULMI",335,"Alegeri Prezidentiale",1,496,217,199,18,0,213,4,500,283,107,106
24,IAŞI,BIVOLARI,95943,BIVOLARI,"ŞCOALA GIMNAZIALĂ CU CLASELE I-VIII BIVOLARI",336,"Alegeri Prezidentiale",1,916,344,296,39,9,338,6,1000,656,213,125
24,IAŞI,BIVOLARI,95943,BIVOLARI,"ŞCOALA GIMNAZIALĂ CU CLASELE I-VIII BIVOLARI",337,"Alegeri Prezidentiale",1,924,344,299,38,7,344,0,1000,656,222,122
24,IAŞI,BIVOLARI,95943,TABĂRA,"ŞCOALA GIMNAZIALĂ CU CLASELE I-VIII TABĂRA",338,"Alegeri Prezidentiale",1,882,366,317,49,0,365,1,1000,634,183,182
24,IAŞI,BIVOLARI,95943,SOLONEŢ,"ŞCOALA CU CLASELE I - IV SOLONEŢ",339,"Alegeri Prezidentiale",1,604,233,214,19,0,231,2,700,467,124,107
24,IAŞI,BRĂEŞTI,96058,BRĂEŞTI,"LICEUL TEHNOLOGIC BRAESTI",340,"Alegeri Prezidentiale",2,938,372,323,32,17,366,6,1000,628,251,115
24,IAŞI,BRĂEŞTI,96058,BUDA,"SCOALA CU CLASELE I-IV",341,"Alegeri Prezidentiale",1,201,69,58,11,0,66,3,300,231,47,19
24,IAŞI,BRĂEŞTI,96058,CRISTEŞTI,"ŞCOALA GENERALĂ CRISTEŞTI",342,"Alegeri Prezidentiale",1,774,284,253,22,9,276,8,900,616,186,90
24,IAŞI,BRĂEŞTI,96058,ALBEŞTI,"ŞCOALA CU CL. I-IV ALBEŞTI",343,"Alegeri Prezidentiale",1,577,233,204,29,0,230,3,600,367,139,91
24,IAŞI,BUTEA,96110,BUTEA,"CAMIN CULTURAL BUTEA",344,"Alegeri Prezidentiale",1,1618,438,403,35,0,433,5,1800,1362,258,175
24,IAŞI,BUTEA,96110,BUTEA,"ŞCOALA GIMNAZIALĂ BUTEA-ÎNVĂŢĂMÂNT GIMNAZIAL",345,"Alegeri Prezidentiale",1,1525,439,405,34,0,430,9,1700,1261,290,140
24,IAŞI,BUTEA,96110,MICLĂUŞENI,"SCOALA PRIMARA MICLAUSENI",346,"Alegeri Prezidentiale",1,345,147,99,48,0,144,3,400,253,87,57
24,IAŞI,CEPLENIŢA,96147,CEPLENIŢA,"SCOALA GIMNAZIALA ”GRIGORE URECHE” CEPLENITA",347,"Alegeri Prezidentiale",1,1163,446,419,27,0,445,1,1300,854,248,197
24,IAŞI,CEPLENIŢA,96147,BUHALNIŢA,"SCOALA GIMNAZIALA ”NICOLAE IORGA” BUHALNITA",348,"Alegeri Prezidentiale",1,1172,463,418,45,0,459,4,1300,837,257,202
24,IAŞI,CEPLENIŢA,96147,"POIANA MĂRULUI","ȘCOALA PRIMARĂ POIANA MĂRULUI",349,"Alegeri Prezidentiale",1,792,313,293,20,0,310,3,900,587,199,111
24,IAŞI,CEPLENIŢA,96147,ZLODICA,"GRADINITA CU PROGRAM NORMAL ZLODICA",350,"Alegeri Prezidentiale",1,229,103,84,19,0,99,4,300,197,62,37
24,IAŞI,CIOHORĂNI,100362,CIOHORĂNI,"CĂMINUL CULTURAL CIOHORĂNI",351,"Alegeri Prezidentiale",1,1493,565,491,46,28,556,9,1600,1035,201,355
24,IAŞI,CIORTEŞTI,96192,CIORTEŞTI,"CAMINUL CULTURAL CIORTEŞTI",352,"Alegeri Prezidentiale",1,847,400,338,62,0,396,4,900,500,242,154
24,IAŞI,CIORTEŞTI,96192,COROPCENI,"ŞCOALA GIMNAZIALĂ COROPCENI",353,"Alegeri Prezidentiale",1,884,408,377,30,1,403,5,1000,592,238,165
24,IAŞI,CIORTEŞTI,96192,DELENI,"ŞCOALA PRIMARĂ DELENI",354,"Alegeri Prezidentiale",1,394,201,179,22,0,196,5,400,199,122,74
24,IAŞI,CIORTEŞTI,96192,ROTĂRIA,"ŞCOALA PRIMARĂ ROTĂRIA",355,"Alegeri Prezidentiale",1,303,140,132,8,0,140,0,400,260,83,57
24,IAŞI,CIORTEŞTI,96192,ŞERBEŞTI,"ŞCOALA GIMANAZIALĂ ŞERBEŞTI",356,"Alegeri Prezidentiale",1,635,307,274,33,0,306,1,702,395,205,101
24,IAŞI,CIUREA,96254,CIUREA,"SCOALA GIMNAZIALA CIUREA",357,"Alegeri Prezidentiale",1,1032,416,380,36,0,413,3,1100,684,295,118
24,IAŞI,CIUREA,96254,CIUREA,"SCOALA GIMNAZIALA CIUREA",358,"Alegeri Prezidentiale",1,1067,472,432,40,0,458,14,1200,728,339,119
24,IAŞI,CIUREA,96254,CURĂTURI,"GRADINITA CU PROGRAM NORMAL NR. 3 CURATURI",359,"Alegeri Prezidentiale",1,218,134,95,39,0,131,3,300,166,94,37
24,IAŞI,CIUREA,96254,DUMBRAVA,"CORP A ŞCOALA GIMNAZIALĂ DUMBRAVA",360,"Alegeri Prezidentiale",1,1195,549,503,46,0,541,8,1300,751,430,111
24,IAŞI,CIUREA,96254,HLINCEA,"PROPR MACOVEI",361,"Alegeri Prezidentiale",1,734,438,333,105,0,430,8,800,362,327,103
24,IAŞI,CIUREA,96254,"LUNCA CETĂŢUII","ŞCOALA GIMNAZIALĂ ” COMANDOR ALEXANDRU CĂTUNEANU” LUNCA CETĂŢUII",362,"Alegeri Prezidentiale",1,1799,1082,784,298,0,1067,15,2000,918,813,254
24,IAŞI,CIUREA,96254,"LUNCA CETĂŢUII","ŞCOALA GIMNAZIALĂ ” COMANDOR ALEXANDRU CĂTUNEANU” LUNCA CETĂŢUII",363,"Alegeri Prezidentiale",1,1688,995,866,129,0,983,12,1800,805,780,203
24,IAŞI,CIUREA,96254,"LUNCA CETĂŢUII","ŞCOALA GIMNAZIALĂ ” COMANDOR ALEXANDRU CĂTUNEANU” LUNCA CETĂŢUII",364,"Alegeri Prezidentiale",1,1972,1086,1016,70,0,1079,7,2195,1109,835,244
24,IAŞI,CIUREA,96254,"LUNCA CETĂŢUII","ŞCOALA GIMNAZIALĂ ” COMANDOR ALEXANDRU CĂTUNEANU” LUNCA CETĂŢUII",365,"Alegeri Prezidentiale",1,2033,1117,1037,80,0,1098,19,2200,1083,863,235
24,IAŞI,CIUREA,96254,"LUNCA CETĂŢUII","SCOALA PRIMARA NR.2 LUNCA CETAŢUII ( ZANEA)",366,"Alegeri Prezidentiale",1,494,309,280,29,0,308,1,500,191,18,290
24,IAŞI,CIUREA,96254,"PICIORU LUPULUI","CENTRUL DE ZI PENTRU COPIII AFLAȚI ÎN SITUAȚIE DE RISC ” SCUFIȚA ROȘIE”",367,"Alegeri Prezidentiale",1,488,227,195,32,0,221,6,506,279,104,117
24,IAŞI,CIUREA,96254,SLOBOZIA,"SCOALA PRIMARA NR. 2 SLOBOZIA",368,"Alegeri Prezidentiale",1,360,190,171,19,0,188,2,399,209,110,78
24,IAŞI,"COARNELE CAPREI",96334,"COARNELE CAPREI","SCOALA GENERALA NR.1. SAT.COARNELE CAPREI",369,"Alegeri Prezidentiale",1,884,436,395,36,5,435,1,1000,564,208,227
24,IAŞI,"COARNELE CAPREI",96334,"COARNELE CAPREI","SCOALA GENERALA NR. 1. SAT.COARNELE CAPREI",370,"Alegeri Prezidentiale",1,823,422,384,30,8,413,9,900,478,203,210
24,IAŞI,"COARNELE CAPREI",96334,ARAMA,"ŞCOALA GENERALA SAT. ARAMA",371,"Alegeri Prezidentiale",1,418,211,194,14,3,211,0,500,289,119,92
24,IAŞI,"COARNELE CAPREI",96334,PETROŞICA,"ŞCOALA GENERALA SAT. PETROSICA",372,"Alegeri Prezidentiale",1,64,45,32,12,1,45,0,100,55,20,25
24,IAŞI,COMARNA,96370,OSOI,"ŞCOALA OSOI",373,"Alegeri Prezidentiale",1,1565,722,636,86,0,713,9,1700,978,479,234
24,IAŞI,COMARNA,96370,STÂNCA,"ŞCOALA STÂNCA",374,"Alegeri Prezidentiale",1,186,95,75,20,0,93,2,200,105,55,38
24,IAŞI,COMARNA,96370,COMARNA,"SCOALA CLASELE I-VII COMARNA I-CORP C2",375,"Alegeri Prezidentiale",1,922,126,95,31,0,126,0,1000,874,76,50
24,IAŞI,COMARNA,96370,COMARNA,"SCOALA CLASELE I-IV COMARNA II",376,"Alegeri Prezidentiale",1,1150,372,326,42,4,369,3,1300,928,233,136
24,IAŞI,COMARNA,96370,CURAGĂU,"ŞCOALA CURAGĂU",377,"Alegeri Prezidentiale",1,121,69,55,14,0,69,0,200,131,35,34
24,IAŞI,COMARNA,96370,COMARNA,"GRĂDINIȚA CU PROGRAM NORMAL COMARNA NR.1",378,"Alegeri Prezidentiale",1,1788,393,328,56,9,390,3,2000,1607,269,121
24,IAŞI,COSTEŞTI,100282,COSTEŞTI,"ȘCOALA GIMNAZIALA NR. 1 COSTEȘTI-CORP A",379,"Alegeri Prezidentiale",1,1039,565,498,67,0,561,4,1100,535,206,355
24,IAŞI,COSTEŞTI,100282,GIURGEŞTI,"ȘCOALA PRIMARA GIURGESTI",380,"Alegeri Prezidentiale",1,374,208,183,25,0,204,4,400,192,82,122
24,IAŞI,COSTULENI,96423,COSTULENI,"SCOALA GIMNAZIALĂ COSTULENI",381,"Alegeri Prezidentiale",1,1310,536,489,47,0,534,2,1400,864,275,259
24,IAŞI,COSTULENI,96423,COVASNA,"GRĂDINIȚA COVASNA",382,"Alegeri Prezidentiale",1,850,416,366,50,0,412,4,900,484,195,217
24,IAŞI,COSTULENI,96423,COZIA,"GRĂDINIȚA COZIA",383,"Alegeri Prezidentiale",1,1789,164,147,17,0,163,1,2000,1836,106,57
24,IAŞI,COSTULENI,96423,COZIA,"GRĂDINIȚA COZIA",384,"Alegeri Prezidentiale",1,1705,182,159,23,0,182,0,1900,1718,128,54
24,IAŞI,COSTULENI,96423,HILIŢA,"SCOALA PRIMARĂ HILIȚA",385,"Alegeri Prezidentiale",1,581,299,247,52,0,295,4,600,301,212,83
24,IAŞI,COTNARI,96478,COTNARI,"CAMIN CULTURAL COTNARI",386,"Alegeri Prezidentiale",1,1461,612,568,44,0,603,9,1600,988,416,187
24,IAŞI,COTNARI,96478,BAHLUIU,"CASA DE PRAZNUIRE BAHLUI",387,"Alegeri Prezidentiale",1,267,125,105,20,0,124,1,300,175,81,43
24,IAŞI,COTNARI,96478,HODORA,"SCOALA HODORA",388,"Alegeri Prezidentiale",1,1287,467,432,35,0,455,12,1400,933,271,184
24,IAŞI,COTNARI,96478,HORODIŞTEA,"SCOALA HORODISTEA",389,"Alegeri Prezidentiale",1,455,144,126,18,0,142,2,500,356,96,46
24,IAŞI,COTNARI,96478,CÂRJOAIA,"SCOALA CIRJOAIA",390,"Alegeri Prezidentiale",1,1357,420,391,29,0,417,3,1500,1080,260,157
24,IAŞI,COTNARI,96478,"VALEA RACULUI","SCOALA VALEA RACULUI",391,"Alegeri Prezidentiale",1,261,103,96,7,0,100,3,300,197,45,55
24,IAŞI,COTNARI,96478,ZBERENI,"SCOALA ZBERENI",392,"Alegeri Prezidentiale",1,623,219,202,17,0,214,5,700,481,129,85
24,IAŞI,COTNARI,96478,LUPĂRIA,"SCOALA LUPARIA",393,"Alegeri Prezidentiale",1,274,115,93,22,0,113,2,300,185,50,63
24,IAŞI,COZMEŞTI,96593,COZMEŞTI,"GRUP ŞCOLAR COZMESTI",394,"Alegeri Prezidentiale",1,1161,469,421,48,0,462,7,1300,831,237,225
24,IAŞI,COZMEŞTI,96593,"PODOLENII DE SUS","CASA DE PRAZNUIRE A PAROHIEI ”SF. VOIEVOZI”, PODOLENII DE SUS",395,"Alegeri Prezidentiale",1,756,288,261,27,0,286,2,800,512,177,109
24,IAŞI,COZMEŞTI,96593,"PODOLENII DE JOS","SCOALA PODOLENII DE JOS",396,"Alegeri Prezidentiale",1,260,118,105,13,0,117,1,300,182,86,31
24,IAŞI,CRISTEŞTI,96637,CRISTEŞTI,"SCOALA PROFESIONALA CRISTEŞTI",397,"Alegeri Prezidentiale",1,1304,543,519,24,0,537,6,1400,857,229,308
24,IAŞI,CRISTEŞTI,96637,CRISTEŞTI,"SCOALA PROFESIONALA CRISTEŞTI",398,"Alegeri Prezidentiale",1,1026,418,390,28,0,414,4,1100,682,211,203
24,IAŞI,CRISTEŞTI,96637,CRISTEŞTI,"ŞCOALA PRIMARA HEREŞTI",399,"Alegeri Prezidentiale",1,602,296,268,28,0,293,3,700,404,124,169
24,IAŞI,CRISTEŞTI,96637,HOMIŢA,"ŞCOALA HOMIŢA",400,"Alegeri Prezidentiale",1,281,131,108,23,0,129,2,301,170,65,64
24,IAŞI,CUCUTENI,96664,CUCUTENI,"GRĂDINIŢA CUCUTENI",401,"Alegeri Prezidentiale",1,719,265,220,41,4,264,1,800,535,151,113
24,IAŞI,CUCUTENI,96664,SĂCĂREŞTI,"ŞCOALA SĂCĂREŞTI",402,"Alegeri Prezidentiale",1,348,195,136,47,12,194,1,400,205,49,145
24,IAŞI,DAGÂŢA,96717,DAGÂŢA,"ȘCOALA PROFESIONALA DAGÎȚA - CORP NOU",403,"Alegeri Prezidentiale",1,1329,569,537,32,0,567,2,1500,931,402,165
24,IAŞI,DAGÂŢA,96717,MĂNĂSTIREA,"SCOALA GENERALĂ MĂNĂSTIREA",404,"Alegeri Prezidentiale",1,896,290,271,19,0,287,3,1000,710,179,108
24,IAŞI,DAGÂŢA,96717,BĂLUŞEŞTI,"LOCUINȚĂ PROPRIETATE MARDARE ELENA",405,"Alegeri Prezidentiale",1,144,78,59,19,0,76,2,200,122,40,36
24,IAŞI,DAGÂŢA,96717,BOATCA,"SCOALA PRIMARĂ BOATCA",406,"Alegeri Prezidentiale",2,216,100,85,15,0,100,0,300,200,67,33
24,IAŞI,DAGÂŢA,96717,"PISCU RUSULUI","SCOALA PRIMARĂ PISCU RUSULUI-SEDIUL NOU",407,"Alegeri Prezidentiale",1,400,141,124,17,0,139,2,400,259,99,40
24,IAŞI,DAGÂŢA,96717,POIENILE,"CENTRU DE ORGANIZARE PENTRU INTEGRARE SI INFORMARE - C.O.P.I.I. PENTRU COMUNITATEA POIENILE",408,"Alegeri Prezidentiale",1,228,148,127,21,0,146,2,300,152,130,16
24,IAŞI,DAGÂŢA,96717,"ZECE PRĂJINI","SCOALA PRIMARĂ ZECE PRAJINI",409,"Alegeri Prezidentiale",1,389,144,132,12,0,141,3,400,256,81,60
24,IAŞI,DELENI,96815,DELENI,"SCOALA GIMNAZIALA DELENI",410,"Alegeri Prezidentiale",1,1619,551,514,37,0,543,8,1800,1249,334,209
24,IAŞI,DELENI,96815,DELENI,"GRADINITA CU PROGRAM NORMAL DELENI ( SEDIUL NOU)",411,"Alegeri Prezidentiale",1,1890,623,586,37,0,615,8,2100,1477,444,171
24,IAŞI,DELENI,96815,MAXUT,"SCOALA GIMNAZIALA MAXUT",412,"Alegeri Prezidentiale",1,1092,441,410,31,0,437,4,1200,759,265,172
24,IAŞI,DELENI,96815,MAXUT,"GRADINITA CU PROGRAM NORMAL MAXUT",413,"Alegeri Prezidentiale",1,784,314,289,25,0,312,2,900,586,195,117
24,IAŞI,DELENI,96815,SLOBOZIA,"SCOALA GIMNAZIALA SLOBOZIA",414,"Alegeri Prezidentiale",1,945,331,305,26,0,330,1,1000,669,217,113
24,IAŞI,DELENI,96815,FEREDENI,"SCOALA GIMNAZIALA FEREDENI",415,"Alegeri Prezidentiale",1,645,243,219,22,2,239,4,700,457,146,93
24,IAŞI,DELENI,96815,POIANA,"GRADINITA CU PROGRAM NORMAL POIANA",416,"Alegeri Prezidentiale",1,898,345,328,17,0,343,2,1000,655,188,155
24,IAŞI,DOBROVĂŢ,96888,DOBROVĂŢ,"ŞCOALA GENERALĂ NR.1 MOLDOVENI",417,"Alegeri Prezidentiale",1,1075,432,344,88,0,424,8,1200,768,250,174
24,IAŞI,DOBROVĂŢ,96888,DOBROVĂŢ,"CENTRU DE ZI AFTER SCHOOL RUSI",418,"Alegeri Prezidentiale",1,791,300,245,55,0,295,5,900,600,166,129
24,IAŞI,DOLHEŞTI,96904,DOLHEŞTI,"ŞCOALA DOLHEŞTI",419,"Alegeri Prezidentiale",1,563,245,222,23,0,245,0,600,355,163,82
24,IAŞI,DOLHEŞTI,96904,BRĂDICEŞTI,"ŞCOALA BRĂDICEŞTI",420,"Alegeri Prezidentiale",1,768,284,253,31,0,281,3,800,516,157,124
24,IAŞI,DOLHEŞTI,96904,PIETRIŞ,"ŞCOALA PIETRIŞ",421,"Alegeri Prezidentiale",1,772,283,253,30,0,279,4,800,517,115,164
24,IAŞI,DRĂGUŞENI,100308,DRĂGUŞENI,"CĂMINUL CULTURAL DRĂGUŞENI",422,"Alegeri Prezidentiale",1,747,251,213,20,18,249,2,800,549,98,151
24,IAŞI,DRĂGUŞENI,100308,FRENCIUGI,"ŞCOALA FRENCIUGI",423,"Alegeri Prezidentiale",1,414,173,146,27,0,172,1,500,327,95,77
24,IAŞI,DUMEŞTI,96940,DUMEŞTI,"LICEUL TEHNOLOGIC DUMESTI",424,"Alegeri Prezidentiale",1,1375,551,507,44,0,541,10,1500,949,379,162
24,IAŞI,DUMEŞTI,96940,PĂUŞEŞTI,"SCOALA GIMNAZIALA PAUSESTI",425,"Alegeri Prezidentiale",1,1391,530,495,35,0,519,11,1500,970,351,168
24,IAŞI,DUMEŞTI,96940,CHILIŞOAIA,"GRADINITA CU PROGRAM NORMAL CHILISOAIA",426,"Alegeri Prezidentiale",1,158,84,68,16,0,83,1,200,116,45,38
24,IAŞI,DUMEŞTI,96940,HOISEŞTI,"SCOALA PRIMARA HOISESTI",427,"Alegeri Prezidentiale",1,622,214,195,19,0,210,4,700,486,162,48
24,IAŞI,DUMEŞTI,96940,BANU,"CLADIREA FOSTEI SCOLI PRIMARE BANU",428,"Alegeri Prezidentiale",1,324,182,147,35,0,178,4,400,218,125,53
24,IAŞI,ERBICENI,97009,ERBICENI,"SCOALA GENERALA ERBICENI CORP CLADIRE",429,"Alegeri Prezidentiale",1,904,330,287,43,0,323,7,1000,670,195,128
24,IAŞI,ERBICENI,97009,ERBICENI,"SCOALA GENERALA ERBICENI CORP CLADIRE",430,"Alegeri Prezidentiale",1,1058,352,325,27,0,346,6,1200,848,215,131
24,IAŞI,ERBICENI,97009,BÂRLEŞTI,"SCOALA GENERALA BIRLESTI",431,"Alegeri Prezidentiale",1,587,258,192,66,0,255,3,600,342,162,93
24,IAŞI,ERBICENI,97009,TOTOEŞTI,"SCOALA GENERALA TOTOESTI",432,"Alegeri Prezidentiale",1,1294,473,424,49,0,468,5,1400,927,324,144
24,IAŞI,ERBICENI,97009,SPINOASA,"SCOALA NR. 2 SPINOASA",433,"Alegeri Prezidentiale",1,245,126,90,36,0,123,3,300,174,89,34
24,IAŞI,ERBICENI,97009,SPRÂNCEANA,"SCOALA NR. 2 SPRANCEANA",434,"Alegeri Prezidentiale",1,318,158,130,28,0,156,2,400,242,100,56
24,IAŞI,FÂNTÂNELE,100317,FÂNTÂNELE,"GRĂDINIŢA NR.1 FÂNTÂNELE",435,"Alegeri Prezidentiale",1,1516,752,698,44,10,741,11,1700,948,347,394
24,IAŞI,FOCURI,97063,FOCURI,"CĂMINUL CULTURAL",436,"Alegeri Prezidentiale",1,1517,532,469,63,0,525,7,1700,1168,316,209
24,IAŞI,FOCURI,97063,FOCURI,"GRĂDINIŢA NR. 2, PĂŞCĂNENI",437,"Alegeri Prezidentiale",1,1465,508,468,40,0,503,5,1600,1092,276,227
24,IAŞI,GOLĂIEŞTI,97090,GOLĂIEŞTI,"SCOALA GIMNAZIALA GOLAIESTI",438,"Alegeri Prezidentiale",1,1560,685,641,44,0,681,4,1700,1015,426,255
24,IAŞI,GOLĂIEŞTI,97090,GRĂDINARI,"SCOALA PRIMARA GRADINARI",439,"Alegeri Prezidentiale",1,309,167,135,32,0,167,0,400,233,83,84
24,IAŞI,GOLĂIEŞTI,97090,"COTU LUI IVAN","SCOALA PRIMARA COTU LUI IVAN",440,"Alegeri Prezidentiale",1,322,159,144,15,0,155,4,400,241,55,100
24,IAŞI,GOLĂIEŞTI,97090,PETREŞTI,"SCOALA PRIMARA PETRESTI",441,"Alegeri Prezidentiale",1,238,138,116,22,0,137,1,300,162,51,86
24,IAŞI,GOLĂIEŞTI,97090,"PODU JIJIEI","SCOALA PRIMARA PODU JIJIEI",442,"Alegeri Prezidentiale",1,208,135,112,23,0,133,2,300,165,63,70
24,IAŞI,GOLĂIEŞTI,97090,CILIBIU,"SCOALA PRIMARA CILIBIU",443,"Alegeri Prezidentiale",1,394,185,158,27,0,182,3,400,215,118,64
24,IAŞI,GORBAN,97189,GORBAN,"SCOALA GIMNAZIALA",444,"Alegeri Prezidentiale",1,601,244,206,38,0,241,3,700,456,118,123
24,IAŞI,GORBAN,97189,"PODU HAGIULUI","ȘCOALA PRIMARĂ",445,"Alegeri Prezidentiale",1,502,215,190,25,0,213,2,600,385,144,69
24,IAŞI,GORBAN,97189,SCOPOSENI,"ȘCOALA PRIMARĂ SCOPOSENI",446,"Alegeri Prezidentiale",1,605,228,209,19,0,227,1,700,472,115,112
24,IAŞI,GORBAN,97189,SCOPOSENI,"ȘCOALA PRIMARĂ SCOPOSENI",447,"Alegeri Prezidentiale",1,402,127,112,15,0,125,2,400,273,60,65
24,IAŞI,GORBAN,97189,ZBEROAIA,"ȘCOALA PRIMARĂ",448,"Alegeri Prezidentiale",1,277,125,108,17,0,125,0,300,175,73,52
24,IAŞI,GRAJDURI,97241,GRAJDURI,"SCOALA GIMNAZIALA GRAJDURI",449,"Alegeri Prezidentiale",1,1289,182,157,25,0,179,3,1400,1218,120,59
24,IAŞI,GRAJDURI,97241,GRAJDURI,"SCOALA GIMNAZIALA GRAJDURI",450,"Alegeri Prezidentiale",1,1199,212,198,14,0,210,2,1300,1088,75,135
24,IAŞI,GRAJDURI,97241,"VALEA SATULUI","SCOALA PRIMARA VALEA SATULUI",451,"Alegeri Prezidentiale",1,1533,112,88,24,0,111,1,1700,1588,61,50
24,IAŞI,GRAJDURI,97241,"VALEA SATULUI","SCOALA PRIMARA VALEA SATULUI",452,"Alegeri Prezidentiale",1,1617,122,110,12,0,119,3,1800,1678,62,57
24,IAŞI,GRAJDURI,97241,CĂRBUNARI,"SCOALA PRIMARA CARBUNARI",453,"Alegeri Prezidentiale",1,869,105,90,15,0,104,1,1000,895,64,40
24,IAŞI,GRAJDURI,97241,PĂDURENI,"SCOALA PRIMARA PADURENI",454,"Alegeri Prezidentiale",1,1040,95,77,18,0,94,1,1100,1005,65,29
24,IAŞI,GRAJDURI,97241,PĂDURENI,"SCOALA PRIMARA PADURENI",455,"Alegeri Prezidentiale",1,727,91,75,16,0,89,2,800,709,61,28
24,IAŞI,GRAJDURI,97241,"POIANA CU CETATE","SCOALA PRIMARA POIANA CU CETATE",456,"Alegeri Prezidentiale",1,136,75,52,23,0,70,5,200,125,45,25
24,IAŞI,GROPNIŢA,97321,GROPNIŢA,"ȘCOALA GROPNIŢA",457,"Alegeri Prezidentiale",1,339,141,128,13,0,139,2,400,259,57,82
24,IAŞI,GROPNIŢA,97321,BULBUCANI,"SEDIUL PRIMĂRIEI",458,"Alegeri Prezidentiale",1,518,246,221,25,0,243,3,600,354,112,131
24,IAŞI,GROPNIŢA,97321,FORĂŞTI,"CĂMIN CULTURAL FORĂŞTI",459,"Alegeri Prezidentiale",1,427,181,168,13,0,178,3,500,319,70,108
24,IAŞI,GROPNIŢA,97321,MĂLĂEŞTI,"GRĂDINIȚA MĂLĂEŞTI",460,"Alegeri Prezidentiale",1,326,191,170,21,0,190,1,400,209,85,105
24,IAŞI,GROPNIŢA,97321,SĂVENI,"ŞCOALA SĂVENI",461,"Alegeri Prezidentiale",1,599,260,242,18,0,260,0,700,440,149,111
24,IAŞI,GROPNIŢA,97321,SÂNGERI,"ŞCOALA SÎNGERI",462,"Alegeri Prezidentiale",1,312,166,152,14,0,166,0,400,234,46,120
24,IAŞI,GROZEŞTI,97394,GROZEŞTI,"SC. GIMNAZIALA GROZESTI",463,"Alegeri Prezidentiale",1,926,287,269,18,0,284,3,1000,713,145,139
24,IAŞI,GROZEŞTI,97394,"COLŢU CORNII","GRADINITA COLTU-CORNII",464,"Alegeri Prezidentiale",1,448,160,147,13,0,158,2,500,340,94,64
24,IAŞI,HĂLĂUCEŞTI,97438,HĂLĂUCEŞTI,"SCOALA GENERALA HALAUCESTI",465,"Alegeri Prezidentiale",1,1413,448,423,25,0,442,6,1500,1052,324,118
24,IAŞI,HĂLĂUCEŞTI,97438,HĂLĂUCEŞTI,"CAMIN CULTURAL HALAUCESTI",466,"Alegeri Prezidentiale",1,1343,436,368,68,0,432,4,1500,1064,309,123
24,IAŞI,HĂLĂUCEŞTI,97438,HĂLĂUCEŞTI,"CAMIN CULTURAL HALAUCESTI",467,"Alegeri Prezidentiale",1,1186,377,352,25,0,373,4,1300,923,264,109
24,IAŞI,HĂLĂUCEŞTI,97438,LUNCAŞI,"SCOALA GENERALA LUNCASI",468,"Alegeri Prezidentiale",1,773,295,267,28,0,292,3,800,505,210,82
24,IAŞI,HĂRMĂNEŞTI,100326,"HĂRMĂNEŞTII VECHI","GRĂDINIȚA CU PROGRAM NORMAL HĂRMĂNEȘTII VECHI",469,"Alegeri Prezidentiale",1,1265,496,451,45,0,493,3,1400,904,275,218
24,IAŞI,HĂRMĂNEŞTI,100326,"HĂRMĂNEŞTII NOI","ŞCOALA HĂRMĂNEŞTII NOI",470,"Alegeri Prezidentiale",1,699,304,276,28,0,303,1,800,496,189,114
24,IAŞI,HELEŞTENI,97465,HELEŞTENI,"SCOALA GIMNAZIALA HELESTENI",471,"Alegeri Prezidentiale",1,655,285,265,19,1,275,10,700,415,149,126
24,IAŞI,HELEŞTENI,97465,HĂRMĂNEASA,"CENTRUL EDUCATIV PENTRU COPII SARACI HARMANEASA",472,"Alegeri Prezidentiale",1,582,257,240,17,0,251,6,600,343,131,120
24,IAŞI,HELEŞTENI,97465,OBOROCENI,"SCOALA GIMNAZIALA OBOROCENI",473,"Alegeri Prezidentiale",1,617,233,216,17,0,230,3,700,467,100,130
24,IAŞI,HELEŞTENI,97465,MOVILENI,"CASA DE PRAZNUIRE",474,"Alegeri Prezidentiale",1,161,82,61,21,0,82,0,200,118,40,42
24,IAŞI,HOLBOCA,95159,"RUSENII VECHI","SCOALA CU CLASELE I-VIII",475,"Alegeri Prezidentiale",1,540,192,171,21,0,190,2,600,408,152,38
24,IAŞI,HOLBOCA,95159,HOLBOCA,"SCOALA HOLBOCA",476,"Alegeri Prezidentiale",1,1500,740,665,75,0,732,8,1600,860,524,208
24,IAŞI,HOLBOCA,95159,HOLBOCA,"SCOALA HOLBOCA",477,"Alegeri Prezidentiale",1,1454,745,643,102,0,739,6,1600,855,554,185
24,IAŞI,HOLBOCA,95159,DANCU,"GRADINITA CU PROGRAM NORMAL DANCU",478,"Alegeri Prezidentiale",1,1323,631,587,44,0,626,5,1400,769,430,196
24,IAŞI,HOLBOCA,95159,DANCU,"GRADINITA CU PROGRAM NORMAL DANCU",479,"Alegeri Prezidentiale",1,1424,682,621,61,0,669,13,1600,918,440,229
24,IAŞI,HOLBOCA,95159,DANCU,"SCOALA STEFAN CEL MARE",480,"Alegeri Prezidentiale",1,1268,689,591,98,0,677,12,1400,711,460,217
24,IAŞI,HOLBOCA,95159,DANCU,"SCOALA STEFAN CEL MARE",481,"Alegeri Prezidentiale",1,1506,703,646,57,0,695,8,1600,897,468,227
24,IAŞI,HOLBOCA,95159,DANCU,"SCOALA STEFAN CEL MARE",482,"Alegeri Prezidentiale",1,1430,681,638,43,0,673,8,1600,919,472,201
24,IAŞI,HOLBOCA,95159,"RUSENII NOI","SCOALA CU CLASELE I-IV",483,"Alegeri Prezidentiale",2,345,156,132,24,0,156,0,400,244,121,35
24,IAŞI,HOLBOCA,95159,ORZENI,"SPAȚIU COMERCIAL PROPRIETATE GOLĂESCU MARIA",484,"Alegeri Prezidentiale",1,614,227,205,22,0,223,4,700,473,172,51
24,IAŞI,HOLBOCA,95159,CRISTEŞTI,"SCOALA CU CLASELE I-IV",485,"Alegeri Prezidentiale",1,633,271,231,40,0,268,3,700,429,210,58
24,IAŞI,HOLBOCA,95159,"VALEA LUNGĂ","SCAOALA VALEA LUNGA",486,"Alegeri Prezidentiale",1,262,166,126,40,0,162,4,300,134,117,45
24,IAŞI,HORLEŞTI,97517,HORLEŞTI,"ŞCOALA GIMNAZIALĂ HORLEŞTI CORP B",487,"Alegeri Prezidentiale",1,1140,433,395,38,0,432,1,1200,767,311,121
24,IAŞI,HORLEŞTI,97517,HORLEŞTI,"ŞCOALA GIMNAZIALĂ HORLEŞTI CORP B",488,"Alegeri Prezidentiale",1,409,123,102,21,0,119,4,500,377,72,47
24,IAŞI,HORLEŞTI,97517,BOGDĂNEŞTI,"CENTRU PLASAMENT ”BOGDANA” BOGDĂNEŞTI",489,"Alegeri Prezidentiale",1,515,220,179,41,0,220,0,600,380,133,87
24,IAŞI,HORLEŞTI,97517,SCOPOSENI,"FOSTA ŞCOALĂ SATUL SCOPOSENI",490,"Alegeri Prezidentiale",1,231,97,84,13,0,96,1,300,203,54,42
24,IAŞI,"ION NECULCE",95499,RĂZBOIENI,"SCOALA GIMNAZIALĂ ”CONSTANTIN TEODORESCU” RAZBOIENI",491,"Alegeri Prezidentiale",1,1696,831,788,43,0,814,17,1900,1069,468,346
24,IAŞI,"ION NECULCE",95499,BUZNEA,"SCOALA GIMNAZIALA BUZNEA",492,"Alegeri Prezidentiale",1,1414,613,571,42,0,599,14,1600,987,333,266
24,IAŞI,"ION NECULCE",95499,DĂDEŞTI,"SCOALA PRIMARA DADESTI",493,"Alegeri Prezidentiale",1,215,120,100,20,0,118,2,300,180,45,73
24,IAŞI,"ION NECULCE",95499,GĂNEŞTI,"SCOALA GĂNEŞTI",494,"Alegeri Prezidentiale",1,620,295,266,29,0,291,4,700,405,127,164
24,IAŞI,"ION NECULCE",95499,"ION NECULCE","CASA SOCIALA ION NECULCE",495,"Alegeri Prezidentiale",1,154,93,70,23,0,93,0,200,107,47,46
24,IAŞI,"ION NECULCE",95499,PRIGORENI,"SCOALA PRIMARA PRIGORENI",496,"Alegeri Prezidentiale",1,531,262,243,19,0,261,1,600,338,128,133
24,IAŞI,IPATELE,97553,IPATELE,"SCOLA GIMNAZIALA”ION HAULICA”IPATELE",497,"Alegeri Prezidentiale",1,507,239,202,28,9,235,4,600,361,76,159
24,IAŞI,IPATELE,97553,"CUZA VODĂ","PUNCT SANITAR CUZA-VODĂ",498,"Alegeri Prezidentiale",1,375,179,136,33,10,177,2,400,221,70,107
24,IAŞI,IPATELE,97553,BÂCU,"CĂMIN CULTURAL BÎCU",499,"Alegeri Prezidentiale",1,433,234,199,25,10,234,0,500,266,81,153
24,IAŞI,LESPEZI,97606,LESPEZI,"LICEUL TEHNOLOGIC LESPEZI",500,"Alegeri Prezidentiale",1,811,275,252,23,0,272,3,900,625,134,138
24,IAŞI,LESPEZI,97606,HECI,"SCOALA GIMNAZIALA HECI",501,"Alegeri Prezidentiale",1,930,330,305,25,0,324,6,1000,670,168,156
24,IAŞI,LESPEZI,97606,HECI,"SCOALA GIMNAZIALA HECI",502,"Alegeri Prezidentiale",1,858,300,280,20,0,296,4,900,600,154,142
24,IAŞI,LESPEZI,97606,BUDA,"ȘCOALA GIMNAZIALĂ BUDA",503,"Alegeri Prezidentiale",1,866,330,298,32,0,326,4,900,570,182,144
24,IAŞI,LESPEZI,97606,BURSUC-DEAL,"SCOALA PRIMARĂ BERSUC DEAL",504,"Alegeri Prezidentiale",1,672,286,262,24,0,285,1,700,414,131,154
24,IAŞI,LESPEZI,97606,DUMBRAVA,"SCOALA PRIMARĂ DUMBRAVA",505,"Alegeri Prezidentiale",1,564,230,201,29,0,228,2,600,370,110,118
24,IAŞI,LEŢCANI,97679,LEŢCANI,"SCOALA GIMNAZIALA LETCANI",506,"Alegeri Prezidentiale",1,1920,1074,986,88,0,1057,17,2100,1026,828,229
24,IAŞI,LEŢCANI,97679,LEŢCANI,"SCOALA GIMNAZIALA LETCANI",507,"Alegeri Prezidentiale",1,1695,903,811,92,0,889,14,1900,997,684,205
24,IAŞI,LEŢCANI,97679,BOGONOS,"SCOALA PRIMARA BOGONOS",508,"Alegeri Prezidentiale",1,648,323,296,27,0,321,2,700,377,235,86
24,IAŞI,LEŢCANI,97679,COGEASCA,"SCOALA GIMNAZIALA COGEASCA",509,"Alegeri Prezidentiale",1,1591,669,622,47,0,658,11,1700,1031,465,193
24,IAŞI,LEŢCANI,97679,CUCUTENI,"SCOALA PRIMARA CUCUTENI",510,"Alegeri Prezidentiale",1,383,194,162,32,0,193,1,400,206,133,60
24,IAŞI,LUNGANI,97722,LUNGANI,"LICEUL TEHNOLOGIC LUNGANI",511,"Alegeri Prezidentiale",1,866,378,340,37,1,372,6,900,522,256,116
24,IAŞI,LUNGANI,97722,CRUCEA,"SCOALA GIMNAZIALA CRUCEA",512,"Alegeri Prezidentiale",1,1234,546,531,15,0,521,25,1400,854,206,315
24,IAŞI,LUNGANI,97722,GOEŞTI,"GRADINITA DIN CADRUL SCOLII GIMNAZIALE GOESTI",513,"Alegeri Prezidentiale",1,699,366,329,32,5,362,4,800,434,109,253
24,IAŞI,LUNGANI,97722,ZMEU,"SCOALA GIMNAZIALA ZMEU",514,"Alegeri Prezidentiale",1,1353,679,649,30,0,675,4,1500,821,164,511
24,IAŞI,MĂDÂRJAC,97777,MĂDÂRJAC,"CAMINUL CULTURAL MADIRJAC",515,"Alegeri Prezidentiale",1,1170,481,448,31,2,480,1,1300,819,197,283
24,IAŞI,MIRCEŞTI,97811,MIRCEŞTI,"ŞCOALA GIMNAZIALA VASILE ALECSANDRI MIRCESTI",516,"Alegeri Prezidentiale",1,1265,459,418,41,0,451,8,1400,941,304,147
24,IAŞI,MIRCEŞTI,97811,IUGANI,"ŞCOALA GIMNAZIALĂ IUGANI - ŞCOALA NOUĂ",517,"Alegeri Prezidentiale",1,1320,525,499,26,0,523,2,1400,875,484,39
24,IAŞI,MIRCEŞTI,97811,IUGANI,"ŞCOALA GIMNAZIALĂ IUGANI - ŞCOALA NOUĂ",518,"Alegeri Prezidentiale",1,508,204,182,22,0,204,0,600,396,180,24
24,IAŞI,MIRONEASA,97875,MIRONEASA,"SCOALA GIMNAZIALA MIRONEASA",519,"Alegeri Prezidentiale",1,1435,271,254,17,0,267,4,1600,1329,190,77
24,IAŞI,MIRONEASA,97875,MIRONEASA,"SCOALA GIMNAZIALA MIRONEASA",520,"Alegeri Prezidentiale",1,1300,375,352,23,0,369,6,1400,1025,248,121
24,IAŞI,MIRONEASA,97875,MIRONEASA,"SCOALA GIMNAZIALA MIRONEASA",521,"Alegeri Prezidentiale",1,1135,291,273,18,0,285,6,1300,1009,191,94
24,IAŞI,MIRONEASA,97875,URŞIŢA,"SCOALA GIMNAZIALA URSITA",522,"Alegeri Prezidentiale",1,479,221,168,53,0,219,2,500,279,127,92
24,IAŞI,MIROSLAVA,97919,MIROSLAVA,"SCOALA GIMNAZIALA ” COLONEL CONSTANTIN LANGA ”-MIROSLAVA",523,"Alegeri Prezidentiale",1,1782,954,811,143,0,940,14,1900,946,734,206
24,IAŞI,MIROSLAVA,97919,MIROSLAVA,"SCOALA GIMNAZIALA ”COLONEL CONSTANTIN LANGA”-MIROSLAVA",524,"Alegeri Prezidentiale",1,1750,1064,789,275,0,1041,23,1900,836,864,177
24,IAŞI,MIROSLAVA,97919,BALCIU,"SALA DE SPORT -MIROSLAVA",525,"Alegeri Prezidentiale",1,1166,843,584,259,0,825,18,1309,466,676,149
24,IAŞI,MIROSLAVA,97919,BRĂTULENI,"SCOALA CU CLASELE I-IV BRĂTULENI",526,"Alegeri Prezidentiale",1,317,189,144,45,0,186,3,400,211,143,43
24,IAŞI,MIROSLAVA,97919,CIURBEŞTI,"SCOALA CU CLASELE I-IV CIURBESTI",527,"Alegeri Prezidentiale",2,1011,465,397,68,0,459,6,1100,635,336,123
24,IAŞI,MIROSLAVA,97919,CORNEŞTI,"SCOALA GIMNAZIALĂ ”DIMITRIE ANGHEL”- CORNESTI",528,"Alegeri Prezidentiale",1,1047,400,366,34,0,397,3,1100,700,326,71
24,IAŞI,MIROSLAVA,97919,HORPAZ,"GRADINITA CU PROGRAM NORMAL -HORPAZ",529,"Alegeri Prezidentiale",1,1185,877,628,249,0,868,9,1300,423,690,178
24,IAŞI,MIROSLAVA,97919,URICANI,"SCOALA GIMNAZIALA ”MIRON BARNOVSCHI”-URICANI",530,"Alegeri Prezidentiale",1,958,512,434,77,1,497,15,1100,588,347,150
24,IAŞI,MIROSLAVA,97919,"VALEA ADÂNCĂ","GRADINITA CU PROGRAM NORMAL-VALEA ADINCA",531,"Alegeri Prezidentiale",1,1645,971,829,142,0,956,15,1800,829,803,153
24,IAŞI,MIROSLAVA,97919,"VALEA ADÂNCĂ","GRADINITA CU PROGRAM NORMAL-VALEA ADINCA",532,"Alegeri Prezidentiale",1,1803,1059,892,167,0,1043,16,2000,941,861,182
24,IAŞI,MIROSLAVA,97919,"VALEA ADÂNCĂ","MAGAZIN MOBILA TOFAN",533,"Alegeri Prezidentiale",1,1996,1563,1130,433,0,1524,39,2200,637,1204,320
24,IAŞI,MIROSLAVA,97919,VOROVEŞTI,"SCOALA PRIMARA-VOROVESTI",534,"Alegeri Prezidentiale",1,797,398,332,66,0,392,6,900,502,294,98
24,IAŞI,MIROSLAVA,97919,HORPAZ,"GRĂDINIŢA CU PROGRAM NORMAL",535,"Alegeri Prezidentiale",1,1129,667,585,82,0,655,12,1200,533,518,137
24,IAŞI,MIROSLOVEŞTI,98051,MIROSLOVEŞTI,"SCOALA GIMNAZIALA MIROSLOVESTI",536,"Alegeri Prezidentiale",1,1500,534,465,69,0,518,16,1600,1066,236,282
24,IAŞI,MIROSLOVEŞTI,98051,SOCI,"SCOALA GIMNAZIALA SOCI",537,"Alegeri Prezidentiale",1,1056,446,403,43,0,444,2,1200,754,218,226
24,IAŞI,MIROSLOVEŞTI,98051,VERŞENI,"SCOALA GIMNAZIALA VERSENI",538,"Alegeri Prezidentiale",1,953,341,287,54,0,337,4,1000,659,176,161
24,IAŞI,MOGOŞEŞTI,98113,MOGOŞEŞTI,"LICEUL TEHNOLOGIC DUMITRU POPA - MOGOȘEȘTI",539,"Alegeri Prezidentiale",1,1344,608,536,72,0,601,7,1500,892,402,199
24,IAŞI,MOGOŞEŞTI,98113,MOGOŞEŞTI,"LICEUL TEHNOLOGIC DUMITRU POPA - MOGOȘEȘTI",540,"Alegeri Prezidentiale",1,1020,396,333,63,0,392,4,1100,704,248,144
24,IAŞI,MOGOŞEŞTI,98113,MÂNJEŞTI,"ŞCOALA GIMNAZIALĂ MÎNJEȘTI, CORP CLĂDIRE NR. 2",541,"Alegeri Prezidentiale",1,496,222,184,38,0,222,0,500,278,174,48
24,IAŞI,MOGOŞEŞTI,98113,HADÂMBU,"ȘCOALA GIMNAZIALĂ HADÂMBU",542,"Alegeri Prezidentiale",1,812,357,279,78,0,350,7,900,543,239,111
24,IAŞI,MOGOŞEŞTI,98113,BUDEŞTI,"CASA SOCIALA BISERICA SF.PARASCHEVA BUDESTI",543,"Alegeri Prezidentiale",1,300,153,137,16,0,152,1,300,147,112,40
24,IAŞI,MOGOŞEŞTI-SIRET,98168,MOGOŞEŞTI-SIRET,"SCOALA GIMNAZIALA MOGOSESTI-SIRET",544,"Alegeri Prezidentiale",1,1377,564,532,32,0,558,6,1500,936,362,196
24,IAŞI,MOGOŞEŞTI-SIRET,98168,"MUNCELU DE SUS","SCOALA GIMNAZIALA MUNCELU DE SUS",545,"Alegeri Prezidentiale",1,902,376,351,25,0,374,2,1000,624,233,141
24,IAŞI,MOGOŞEŞTI-SIRET,98168,"MUNCELU DE SUS","SCOALA GIMNAZIALA MUNCELU DE SUS",546,"Alegeri Prezidentiale",1,860,361,340,21,0,352,9,900,539,249,103
24,IAŞI,MOŞNA,98202,MOŞNA,"ŞCOALA GIMNAZIALĂ MOŞNA",547,"Alegeri Prezidentiale",1,1525,108,99,9,0,106,2,1700,1592,50,56
24,IAŞI,MOŞNA,98202,MOŞNA,"ȘCOALA GIMNAZIALĂ MOȘNA",548,"Alegeri Prezidentiale",1,1492,284,274,10,0,279,5,1600,1316,138,141
24,IAŞI,MOŞNA,98202,MOŞNA,"ȘCOALA GIMNAZIALĂ MOȘNA",549,"Alegeri Prezidentiale",1,1335,149,149,0,0,146,3,1500,1351,62,84
24,IAŞI,MOŞNA,98202,MOŞNA,"ȘCOALA GIMNAZIALĂ MOȘNA",550,"Alegeri Prezidentiale",1,1480,39,0,39,0,37,2,1600,1561,25,12
24,IAŞI,MOŞNA,98202,MOŞNA,"ȘCOALA GIMNAZIALĂ MOȘNA",551,"Alegeri Prezidentiale",1,1781,50,36,14,0,49,1,2000,1950,23,26
24,IAŞI,MOŢCA,98220,MOŢCA,"CĂMIN CULTURAL",552,"Alegeri Prezidentiale",1,1587,665,625,39,1,646,19,1700,1035,308,338
24,IAŞI,MOŢCA,98220,MOŢCA,"CĂMIN CULTURAL",553,"Alegeri Prezidentiale",1,1451,553,512,39,2,545,8,1600,1047,237,308
24,IAŞI,MOŢCA,98220,BOURENI,"GRADINITA CU PROGRAM NORMAL BOURENI",554,"Alegeri Prezidentiale",1,1165,452,422,30,0,437,15,1300,848,158,279
24,IAŞI,MOVILENI,98257,MOVILENI,"BIBLIOTECA COMUNALA",555,"Alegeri Prezidentiale",1,431,170,157,13,0,168,2,500,330,74,94
24,IAŞI,MOVILENI,98257,IEPURENI,"SCOALA PRIMARA IEPURENI",556,"Alegeri Prezidentiale",1,695,303,274,29,0,299,4,800,497,143,156
24,IAŞI,MOVILENI,98257,LARGA-JIJIA,"SCOALA GIMNAZIALA LARGA JIJIA",557,"Alegeri Prezidentiale",1,602,252,221,31,0,249,3,700,448,151,98
24,IAŞI,MOVILENI,98257,POTÂNGENI,"SCOALA PRIMARA POTINGENI",558,"Alegeri Prezidentiale",1,734,297,270,27,0,289,8,800,503,170,119
24,IAŞI,OŢELENI,98300,OŢELENI,"CĂMIN CULTURAL - SALA I OTELENI",559,"Alegeri Prezidentiale",1,990,430,381,46,3,428,2,1100,670,248,180
24,IAŞI,OŢELENI,98300,OŢELENI,"CĂMIN CULTURAL - SALA II OTELENI",560,"Alegeri Prezidentiale",1,1052,436,403,27,6,433,3,1200,764,252,181
24,IAŞI,OŢELENI,98300,HÂNDREŞTI,"SCOALA GIMNAZIALA HINDRESTI",561,"Alegeri Prezidentiale",1,862,382,336,45,1,377,5,900,518,220,157
24,IAŞI,PLUGARI,98337,PLUGARI,"LICEUL TEHNOLOGIC PLUGARI",562,"Alegeri Prezidentiale",1,1491,640,528,47,65,634,6,1600,960,450,184
24,IAŞI,PLUGARI,98337,BOROSOAIA,"SCOALA GIMNAZIALA BOROSOAIA",563,"Alegeri Prezidentiale",1,1207,511,422,41,48,506,5,1300,789,316,190
24,IAŞI,POPEŞTI,98435,POPEŞTI,"SCOALA GENERALA ” DIMITRIE STURDZA ”POPESTI",564,"Alegeri Prezidentiale",1,893,347,314,33,0,340,7,1000,653,202,138
24,IAŞI,POPEŞTI,98435,POPEŞTI,"SCOALA GENERALA ”DIMITRIE STURDZA”POPESTI",565,"Alegeri Prezidentiale",1,899,304,284,20,0,301,3,1000,696,158,143
24,IAŞI,POPEŞTI,98435,OBRIJENI,"ŞCOALA PRIMARA ”NICOLAIE BUTESCU” OBRIJENI",566,"Alegeri Prezidentiale",1,1522,66,46,20,0,65,1,1700,1634,40,25
24,IAŞI,POPEŞTI,98435,OBRIJENI,"ŞCOALA PRIMARA ”NICOLAIE BUTESCU” OBRIJENI",567,"Alegeri Prezidentiale",1,1298,42,32,10,0,42,0,1400,1358,22,20
24,IAŞI,POPEŞTI,98435,DOROŞCANI,"ŞCOALA PRIMARA DOROSCANI",568,"Alegeri Prezidentiale",1,462,156,141,15,0,151,5,500,344,83,68
24,IAŞI,POPEŞTI,98435,HĂRPĂŞEŞTI,"ŞCOALA GIMNAZIALA HARPASESTI,CORP CLADIRE NOU,SALA DIN PARTEA DREAPTA,PARTER",569,"Alegeri Prezidentiale",1,751,189,166,22,1,188,1,800,611,86,102
24,IAŞI,POPRICANI,98505,POPRICANI,"SCOALA GIMNAZIALA POPRICANI",570,"Alegeri Prezidentiale",1,1252,631,548,80,3,623,8,1400,769,391,232
24,IAŞI,POPRICANI,98505,POPRICANI,"SCOALA GIMNAZIALA POPRICANI",571,"Alegeri Prezidentiale",1,1179,508,466,36,6,503,5,1300,792,346,157
24,IAŞI,POPRICANI,98505,MOIMEŞTI,"SCOALA GIMNAZIALA POPRICANI",572,"Alegeri Prezidentiale",1,386,196,164,32,0,196,0,400,204,115,81
24,IAŞI,POPRICANI,98505,ŢIPILEŞTI,"SCOALA PRIMARA TIPILESTI",573,"Alegeri Prezidentiale",1,306,174,144,26,4,170,4,400,226,78,92
24,IAŞI,POPRICANI,98505,"COTU MORII","SCOALA PRIMARA COTU MORII",574,"Alegeri Prezidentiale",1,233,115,98,17,0,112,3,300,185,65,47
24,IAŞI,POPRICANI,98505,VÂNĂTORI,"SCOALA GIMNAZIALA VINATORI",575,"Alegeri Prezidentiale",1,1270,607,555,51,1,596,11,1401,794,382,214
24,IAŞI,POPRICANI,98505,VULTURI,"SCOALA GIMNAZIALA VINATORI",576,"Alegeri Prezidentiale",1,849,404,359,39,6,401,3,901,497,257,144
24,IAŞI,POPRICANI,98505,CÂRLIG,"SCOALA PRIMARA CIRLIG",577,"Alegeri Prezidentiale",1,703,388,321,67,0,386,2,800,412,270,116
24,IAŞI,POPRICANI,98505,"CUZA VODĂ","SCOALA PRIMARA CUZA- VODA",578,"Alegeri Prezidentiale",1,519,236,213,23,0,235,1,600,364,173,62
24,IAŞI,PRISĂCANI,98603,PRISĂCANI,"GRADINITA CU PROGRAM NORMAL PRISĂCANI",579,"Alegeri Prezidentiale",1,1394,622,569,53,0,619,3,1500,878,364,255
24,IAŞI,PRISĂCANI,98603,MĂCĂREŞTI,"SCOALA GIMNAZIALA MACARESTI",580,"Alegeri Prezidentiale",1,1756,203,170,33,0,196,7,1900,1697,101,95
24,IAŞI,PRISĂCANI,98603,MORENI,"SCOALA PRIMARA MORENI",581,"Alegeri Prezidentiale",1,797,394,346,48,0,389,5,900,506,276,113
24,IAŞI,PROBOTA,98649,PROBOTA,"SCOLA GIMNAZIALA”PETRU ANGHEL”PROBOTA",582,"Alegeri Prezidentiale",1,979,401,376,25,0,394,7,1100,699,293,101
24,IAŞI,PROBOTA,98649,BĂLTENI,"ȘCOALA PRIMARĂ BĂLTENI",583,"Alegeri Prezidentiale",1,632,297,259,38,0,295,2,700,403,240,55
24,IAŞI,PROBOTA,98649,PERIENI,"SCOLA GIMNAZIALA PERIENI",584,"Alegeri Prezidentiale",1,1251,494,435,59,0,489,5,1400,906,294,195
24,IAŞI,RĂCHITENI,100335,RĂCHITENI,"SCOALA NOUA RACHITENI",585,"Alegeri Prezidentiale",1,1553,477,454,23,0,476,1,1700,1223,379,97
24,IAŞI,RĂCHITENI,100335,IZVOARELE,"SCOALA IZVOARELE",586,"Alegeri Prezidentiale",1,1153,379,360,19,0,373,6,1300,921,246,127
24,IAŞI,RĂDUCĂNENI,98685,RĂDUCĂNENI,"LICEUL TEORETIC LASCAR ROSETTI",587,"Alegeri Prezidentiale",1,1248,407,364,43,0,403,4,1400,993,279,124
24,IAŞI,RĂDUCĂNENI,98685,RĂDUCĂNENI,"LICEUL TEORETIC LASCAR ROSETTI",588,"Alegeri Prezidentiale",1,1222,445,384,18,43,440,5,1300,855,174,266
24,IAŞI,RĂDUCĂNENI,98685,RĂDUCĂNENI,"ŞCOALA GENERALA RADUCANENI",589,"Alegeri Prezidentiale",1,1203,412,387,25,0,408,4,1297,885,257,151
24,IAŞI,RĂDUCĂNENI,98685,RĂDUCĂNENI,"ŞCOALA GENERALA BAZGA",590,"Alegeri Prezidentiale",1,1215,462,431,31,0,455,7,1300,838,233,222
24,IAŞI,RĂDUCĂNENI,98685,BOHOTIN,"SCOALA GENERALA BOHOTIN",591,"Alegeri Prezidentiale",1,1282,412,382,30,0,409,3,1400,988,217,192
24,IAŞI,RĂDUCĂNENI,98685,ROŞU,"ŞCOALA GENERALA ROŞU",592,"Alegeri Prezidentiale",1,554,144,132,12,0,140,4,600,456,65,75
24,IAŞI,RĂDUCĂNENI,98685,ISAIIA,"ŞCOALA GENERALĂ ISAIIA",593,"Alegeri Prezidentiale",1,254,111,93,18,0,109,2,300,189,66,43
24,IAŞI,REDIU,95239,REDIU,"SCOALA GIMNAZIALA REDIU",594,"Alegeri Prezidentiale",1,1753,793,599,194,0,782,11,1900,1107,579,203
24,IAŞI,REDIU,95239,REDIU,"SCOALA GIMNAZIALA REDIU",595,"Alegeri Prezidentiale",1,1268,581,462,118,1,568,13,1400,819,425,143
24,IAŞI,REDIU,95239,BREAZU,"GRADINITA CU PROGRAM NORMAL BREAZU",596,"Alegeri Prezidentiale",1,1662,958,825,133,0,948,10,1800,842,704,244
24,IAŞI,REDIU,95239,HORLEŞTI,"SCOALA GIMNAZIALA HORLESTI",597,"Alegeri Prezidentiale",1,1061,422,363,59,0,414,8,1200,778,295,119
24,IAŞI,ROMÂNEŞTI,98738,ROMÂNEŞTI,"SCOALA GIMNAZIALA ”IOANID ROMANESCU” ROMANESTI",598,"Alegeri Prezidentiale",1,704,342,292,50,0,339,3,800,458,241,98
24,IAŞI,ROMÂNEŞTI,98738,AVÂNTU,"SCOALA PRIMARA AVINTU",599,"Alegeri Prezidentiale",1,380,195,151,35,9,192,3,400,205,114,78
24,IAŞI,ROMÂNEŞTI,98738,URSOAIA,"SCOALA GIMNAZIALA URSOAIA",600,"Alegeri Prezidentiale",1,339,173,128,45,0,173,0,400,227,90,83
24,IAŞI,ROŞCANI,100344,RĂDENI,"GRĂDINITA CU PROGRAM NORMAL RADENI",601,"Alegeri Prezidentiale",1,583,282,246,36,0,282,0,600,318,146,136
24,IAŞI,ROŞCANI,100344,ROŞCANI,"ȘCOALA PRIMARĂ ROȘCANI, NR. 1",602,"Alegeri Prezidentiale",1,557,260,237,23,0,258,2,600,340,124,134
24,IAŞI,RUGINOASA,98774,RUGINOASA,"ŞCOALA GIMNAZIALĂ RUGINOASA",603,"Alegeri Prezidentiale",1,854,371,334,36,1,366,5,900,529,176,190
24,IAŞI,RUGINOASA,98774,RUGINOASA,"ŞCOALA GIMNAZIALĂ RUGINOASA",604,"Alegeri Prezidentiale",1,684,244,218,26,0,244,0,700,456,124,120
24,IAŞI,RUGINOASA,98774,DUMBRĂVIŢA,"ŞCOALA GIMNAZIALĂ DUMBRĂVIŢA",605,"Alegeri Prezidentiale",1,1173,422,396,26,0,419,3,1300,878,209,210
24,IAŞI,RUGINOASA,98774,DUMBRĂVIŢA,"ŞCOALA GIMNAZIALĂ DUMBRĂVIŢA",606,"Alegeri Prezidentiale",1,898,286,264,21,1,283,3,1000,714,142,141
24,IAŞI,RUGINOASA,98774,REDIU,"ŞCOALA GIMNAZIALĂ REDIU",607,"Alegeri Prezidentiale",1,979,346,321,24,1,340,6,1100,754,170,170
24,IAŞI,RUGINOASA,98774,VASCANI,"ŞCOALA VASCANI",608,"Alegeri Prezidentiale",1,399,184,167,17,0,183,1,400,216,86,97
24,IAŞI,SCÂNTEIA,98916,SCÂNTEIA,"ȘCOALA GIMNAZIALĂ „AXINTE URICARIUL” SCÂNTEIA - CORP A",609,"Alegeri Prezidentiale",1,1418,146,132,14,0,145,1,1500,1354,124,21
24,IAŞI,SCÂNTEIA,98916,SCÂNTEIA,"ȘCOALA GIMNAZIALĂ „AXINTE URICARIUL” SCÂNTEIA - CORP A",610,"Alegeri Prezidentiale",1,1742,275,251,24,0,269,6,1900,1625,184,85
24,IAŞI,SCÂNTEIA,98916,SCÂNTEIA,"GRĂDINIȚA CU PROGRAM NORMAL SCÂNTEIA",611,"Alegeri Prezidentiale",1,1451,125,104,19,2,123,2,1600,1475,89,34
24,IAŞI,SCÂNTEIA,98916,BODEŞTI,"ŞCOALA GIMNAZIALĂ BODEŞTI",612,"Alegeri Prezidentiale",1,411,158,142,16,0,155,3,500,342,100,55
24,IAŞI,SCÂNTEIA,98916,BOROŞEŞTI,"CĂMINUL CULTURAL BOROSEŞTI",613,"Alegeri Prezidentiale",1,714,264,240,24,0,264,0,800,536,197,67
24,IAŞI,SCÂNTEIA,98916,CIOCÂRLEŞTI,"ŞCOALA PRIMARĂ CIOCÂRLEŞTI",614,"Alegeri Prezidentiale",1,242,108,87,21,0,107,1,300,192,70,37
24,IAŞI,SCÂNTEIA,98916,"LUNCA RATEŞ","ŞCOALA PRIMARĂ LUNCA RATEŞ",615,"Alegeri Prezidentiale",1,333,101,85,16,0,98,3,400,299,73,25
24,IAŞI,SCÂNTEIA,98916,REDIU,"ŞCOALA PRIMARĂ REDIU",616,"Alegeri Prezidentiale",1,176,65,48,17,0,63,2,200,135,41,22
24,IAŞI,SCÂNTEIA,98916,"TUFEŞTII DE SUS","ŞCOALA PRIMARĂ TUFEŞTII DE SUS",617,"Alegeri Prezidentiale",1,208,73,59,14,0,73,0,300,227,33,40
24,IAŞI,SCÂNTEIA,98916,SCÂNTEIA,"CĂMINUL CULTURAL SCÂNTEIA",618,"Alegeri Prezidentiale",1,1588,98,77,21,0,95,3,1700,1602,74,21
24,IAŞI,"SCHITU DUCA",98827,"SCHITU DUCA","SCOALA PRIMARA SCHITU DUCA",619,"Alegeri Prezidentiale",1,462,257,190,67,0,255,2,500,243,151,104
24,IAŞI,"SCHITU DUCA",98827,POIENI,"SCOALA GIMNAZIALA POIENI",620,"Alegeri Prezidentiale",1,679,316,264,52,0,308,8,700,384,200,108
24,IAŞI,"SCHITU DUCA",98827,"DUMITREŞTII GĂLĂŢII","SCOALA GIMNAZIALA DUMITRESTII GALATII",621,"Alegeri Prezidentiale",1,541,289,263,26,0,286,3,600,311,138,148
24,IAŞI,"SCHITU DUCA",98827,POCREACA,"SCOALA GIMNAZIALA POCREACA",622,"Alegeri Prezidentiale",1,328,168,135,33,0,159,9,400,232,72,87
24,IAŞI,"SCHITU DUCA",98827,POIANA,"SCOALA PRIMARA POIANA",623,"Alegeri Prezidentiale",1,359,213,154,59,0,209,4,401,188,136,73
24,IAŞI,"SCHITU DUCA",98827,"SATU NOU","SCOALA GIMNAZIALA SATU NOU",624,"Alegeri Prezidentiale",1,433,188,160,28,0,186,2,500,312,109,77
24,IAŞI,"SCHITU DUCA",98827,SLOBOZIA,"SCOALA PRIMARA SLOBOZIA",625,"Alegeri Prezidentiale",1,343,182,155,27,0,177,5,409,227,71,106
24,IAŞI,SCOBINŢI,98998,SCOBINŢI,"SAT SCOBINTI, SEDIU SCOALA VECHE SCOBINTI",626,"Alegeri Prezidentiale",1,1144,406,388,18,0,402,4,1300,894,200,202
24,IAŞI,SCOBINŢI,98998,SCOBINŢI,"SAT SCOBINTI, SEDIU SCOALA ZVARICI- SCOBINTI",627,"Alegeri Prezidentiale",1,372,176,149,27,0,174,2,300,124,80,94
24,IAŞI,SCOBINŢI,98998,BĂDENI,"SAT BADENI, SEDIU SCOALA BADENI",628,"Alegeri Prezidentiale",1,1033,398,361,37,0,391,7,1100,702,182,209
24,IAŞI,SCOBINŢI,98998,FETEŞTI,"SAT FETESTI, SEDIU SCOALA COORD.",629,"Alegeri Prezidentiale",1,1053,357,329,28,0,352,5,1200,843,227,125
24,IAŞI,SCOBINŢI,98998,STICLĂRIA,"SAT STICLARIA, SEDIU SCOALA STICLARIA",630,"Alegeri Prezidentiale",1,1158,452,413,39,0,447,5,1300,848,212,235
24,IAŞI,SCOBINŢI,98998,STICLĂRIA,"SAT STICLARIA, SEDIU SCOALA REDIU",631,"Alegeri Prezidentiale",1,300,136,108,28,0,130,6,300,164,52,78
24,IAŞI,SCOBINŢI,98998,ZAGAVIA,"SAT .ZAGAVIA ,CU SEDIUL LA SCOALA ZAGAVIA",632,"Alegeri Prezidentiale",1,938,326,304,22,0,322,4,1000,674,193,129
24,IAŞI,SINEŞTI,99058,OSOI,"ŞCOALA GIMNAZIALA OSOI",633,"Alegeri Prezidentiale",1,830,182,159,23,0,181,1,900,718,90,91
24,IAŞI,SINEŞTI,99058,SINEŞTI,"SALA DE SPORT SINEŞTI",634,"Alegeri Prezidentiale",1,1275,468,428,40,0,461,7,1400,932,331,130
24,IAŞI,SINEŞTI,99058,BOCNIŢA,"ŞCOALA PRIMARA BOCNIŢA",635,"Alegeri Prezidentiale",1,266,133,116,17,0,133,0,300,167,76,57
24,IAŞI,SINEŞTI,99058,STORNEŞTI,"ŞCOALA GIMNAZIALA STORNEŞTI",636,"Alegeri Prezidentiale",1,811,335,306,29,0,327,8,900,565,246,81
24,IAŞI,SIREŢEL,99101,SIREŢEL,"ŞCOALA GENERALĂ",637,"Alegeri Prezidentiale",1,903,304,273,31,0,302,2,1000,696,165,137
24,IAŞI,SIREŢEL,99101,SIREŢEL,"ŞCOALA GENERALĂ",638,"Alegeri Prezidentiale",1,1007,277,277,0,0,269,8,1100,823,161,108
24,IAŞI,SIREŢEL,99101,SLOBOZIA,"ŞCOALA GENERALĂ SLOBOZIA",639,"Alegeri Prezidentiale",1,646,193,178,15,0,191,2,700,507,137,54
24,IAŞI,SIREŢEL,99101,HUMOSU,"ŞCOALA GENERALĂ HUMOSU",640,"Alegeri Prezidentiale",1,591,226,217,9,0,224,2,600,374,129,95
24,IAŞI,STOLNICENI-PRĂJESCU,99165,STOLNICENI-PRĂJESCU,"BIBLIOTECA MATEI MILLO",641,"Alegeri Prezidentiale",2,1268,524,489,35,0,512,12,1400,853,229,283
24,IAŞI,STOLNICENI-PRĂJESCU,99165,BRĂTEŞTI,"SCOALA CU CLASELE I-IV SALA 1",642,"Alegeri Prezidentiale",1,822,350,333,17,0,346,4,900,550,216,130
24,IAŞI,STOLNICENI-PRĂJESCU,99165,BRĂTEŞTI,"SCOALA CU CLASELE I-VIII SALA NR.1",643,"Alegeri Prezidentiale",1,552,230,219,11,0,228,2,600,370,125,103
24,IAŞI,STOLNICENI-PRĂJESCU,99165,COZMEŞTI,"SCOALA GIMNAZIALA COZMESTI",644,"Alegeri Prezidentiale",1,936,327,301,26,0,325,2,1000,673,154,171
24,IAŞI,STOLNICENI-PRĂJESCU,99165,COZMEŞTI,"SCOALA GIMNAZIALA COZMESTI",645,"Alegeri Prezidentiale",1,787,249,231,18,0,244,5,900,651,142,102
24,IAŞI,STRUNGA,99209,STRUNGA,"SCOALA GIMNAZIALA STRUNGA",646,"Alegeri Prezidentiale",1,493,211,194,17,0,207,4,500,289,116,91
24,IAŞI,STRUNGA,99209,BRĂTULEŞTI,"SCOALA PRIMARA BRATULESTI",647,"Alegeri Prezidentiale",1,572,255,209,46,0,251,4,600,345,119,132
24,IAŞI,STRUNGA,99209,CRIVEŞTI,"MAGAZIN CRIVESTI",648,"Alegeri Prezidentiale",1,252,86,68,18,0,84,2,300,214,31,53
24,IAŞI,STRUNGA,99209,HĂBĂŞEŞTI,"ŞCOALA HĂBĂŞEŞTI",649,"Alegeri Prezidentiale",1,320,134,119,15,0,134,0,400,266,70,64
24,IAŞI,STRUNGA,99209,CUCOVA,"SCOALA CUCOVA",650,"Alegeri Prezidentiale",1,125,66,43,23,0,66,0,200,134,36,30
24,IAŞI,STRUNGA,99209,FĂRCĂŞENI,"SCOALA GIMNAZIALA FARCASENI",651,"Alegeri Prezidentiale",1,814,255,246,9,0,246,9,900,645,147,99
24,IAŞI,STRUNGA,99209,FĂRCĂŞENI,"SCOALA GIMNAZIALA FARCASENI",652,"Alegeri Prezidentiale",1,825,263,253,10,0,261,2,900,637,139,122
24,IAŞI,ŞCHEIA,99290,ŞCHEIA,"GRUP SCOLAR SCHEIA",653,"Alegeri Prezidentiale",1,916,355,309,46,0,350,5,1000,645,149,201
24,IAŞI,ŞCHEIA,99290,CĂUEŞTI,"SCOALA GENERALĂ CĂUESTI",654,"Alegeri Prezidentiale",1,434,149,124,25,0,147,2,500,351,87,60
24,IAŞI,ŞCHEIA,99290,CIOCA-BOCA,"SCOALA GENERALĂ CIOCA-BOCA",655,"Alegeri Prezidentiale",1,392,165,148,17,0,164,1,400,235,87,77
24,IAŞI,ŞCHEIA,99290,"POIANA ŞCHEII","SCOALA GENERALĂ POIANA-SCHEII",656,"Alegeri Prezidentiale",1,396,170,148,22,0,169,1,400,230,113,56
24,IAŞI,ŞCHEIA,99290,"SATU NOU","SCOALA GENERALĂ SATU-NOU",657,"Alegeri Prezidentiale",1,292,93,80,13,0,92,1,300,207,65,27
24,IAŞI,ŞIPOTE,99370,ŞIPOTE,"SCOALA GIMNAZIALA SIPOTE",658,"Alegeri Prezidentiale",1,709,301,268,33,0,296,5,800,499,144,152
24,IAŞI,ŞIPOTE,99370,"IAZU NOU","SCOALA GIMNAZIALA IAZU NOU",659,"Alegeri Prezidentiale",1,823,304,279,18,7,300,4,900,596,120,180
24,IAŞI,ŞIPOTE,99370,CHIŞCĂRENI,"SCOALA GIMNAZIALA- CORP GRĂDINIȚĂ",660,"Alegeri Prezidentiale",1,1239,524,496,28,0,522,2,1400,876,201,321
24,IAŞI,ŞIPOTE,99370,HĂLCENI,"SCOALA GIMNAZIALA HALCENI",661,"Alegeri Prezidentiale",1,1188,470,419,51,0,468,2,1300,830,247,221
24,IAŞI,TANSA,99441,TANSA,"ȘCOALA GIMNAZIALĂ TANSA",662,"Alegeri Prezidentiale",1,1583,580,495,59,26,572,8,1700,1120,318,254
24,IAŞI,TANSA,99441,SUHULEŢ,"ŞCOALA GIMNAZIALĂ CL.I-VIII SUHULEŢ",663,"Alegeri Prezidentiale",1,899,509,422,47,40,496,13,1000,491,330,166
24,IAŞI,TĂTĂRUŞI,99478,TĂTĂRUŞI,"CENTRUL CULTURAL ”ALEXANDRU VASILIU-TATARUSI”",664,"Alegeri Prezidentiale",1,1386,670,581,72,17,659,11,1500,830,221,438
24,IAŞI,TĂTĂRUŞI,99478,UDA,"ȘCOALA GIMNAZIALĂ UDA - CORP A",665,"Alegeri Prezidentiale",1,1263,511,465,40,6,508,3,1400,889,184,324
24,IAŞI,TĂTĂRUŞI,99478,PIETROSU,"SCOALA GIMNAZIALA PIETROSU",666,"Alegeri Prezidentiale",1,1134,517,476,36,5,514,3,1200,683,202,312
24,IAŞI,TĂTĂRUŞI,99478,IORCANI,"SCOALA PRIMARA IORCANI",667,"Alegeri Prezidentiale",2,679,306,275,24,7,304,2,700,394,119,185
24,IAŞI,TODIREŞTI,99539,TODIREŞTI,"SCOALA CU CLASELE I-VIII NR.1 TODIRESTI CORP A",668,"Alegeri Prezidentiale",1,1969,619,588,31,0,606,13,2200,1581,379,227
24,IAŞI,TODIREŞTI,99539,TODIREŞTI,"SCOALA PRIMARA NR.2 TODIRESTI",669,"Alegeri Prezidentiale",1,1220,396,373,23,0,392,4,1300,904,244,148
24,IAŞI,TODIREŞTI,99539,BĂICENI,"SCOALA PRIMARA BAICENI",670,"Alegeri Prezidentiale",2,269,114,98,16,0,113,1,300,186,61,52
24,IAŞI,TODIREŞTI,99539,STROEŞTI,"ȘCOALA PRIMARĂ STROEȘTI -ANEXA",671,"Alegeri Prezidentiale",1,338,117,109,8,0,113,4,400,283,64,49
24,IAŞI,TOMEŞTI,95293,TOMEŞTI,"PRIMARIA COMUNEI TOMESTI",672,"Alegeri Prezidentiale",1,1154,566,488,78,0,562,4,1300,734,416,146
24,IAŞI,TOMEŞTI,95293,TOMEŞTI,"SEDIUL SC.D.D.PATRASCANU",673,"Alegeri Prezidentiale",1,1824,892,809,83,0,875,17,2000,1108,670,205
24,IAŞI,TOMEŞTI,95293,TOMEŞTI,"SEDIUL SC.D.D.PATRASCANU",674,"Alegeri Prezidentiale",1,1548,739,625,114,0,724,15,1700,961,514,210
24,IAŞI,TOMEŞTI,95293,TOMEŞTI,"SEDIUL SC.D.D.PATRASCANU",675,"Alegeri Prezidentiale",1,1214,569,532,37,0,560,9,1300,731,412,148
24,IAŞI,TOMEŞTI,95293,TOMEŞTI,"SEDIUL SC.D.D.PATRASCANU",676,"Alegeri Prezidentiale",1,1690,769,710,59,0,751,18,1900,1131,515,236
24,IAŞI,TOMEŞTI,95293,TOMEŞTI,"SEDIUL SC.D.D.PATRASCANU",677,"Alegeri Prezidentiale",1,1328,641,603,38,0,630,11,1500,859,442,188
24,IAŞI,TOMEŞTI,95293,CHICEREA,"SEDIUL SCOALA GIMNAZIALA CHICEREA, SAT.CHICEREA, COM.TOMEŞTI",678,"Alegeri Prezidentiale",1,1096,547,471,76,0,534,13,1200,653,369,165
24,IAŞI,TOMEŞTI,95293,GORUNI,"SEDIUL SCOALA GIMNAZIALA GORUNI, SATUL GORUNI, COM.TOMEŞTI",679,"Alegeri Prezidentiale",1,1019,448,398,50,0,441,7,1100,652,293,148
24,IAŞI,TOMEŞTI,95293,VLĂDICENI,"SEDIUL SCOALA PRIMARA VLĂDICENI, SAT. VLĂDICENI, COM.TOMEŞTI",680,"Alegeri Prezidentiale",1,593,324,256,68,0,316,8,600,276,216,100
24,IAŞI,TRIFEŞTI,99600,TRIFEŞTI,"GRĂDINIȚA CU PROGRAM NORMAL TRIFEȘTI",681,"Alegeri Prezidentiale",1,1382,528,471,57,0,521,7,1500,972,373,148
24,IAŞI,TRIFEŞTI,99600,ZABOLOTENI,"ȘCOALA PRIMARĂ ZABOLOTENI",682,"Alegeri Prezidentiale",1,597,299,286,13,0,297,2,700,401,235,62
24,IAŞI,TRIFEŞTI,99600,HERMEZIU,"ŞCOALA GIMNAZIALĂ HERMEZIU",683,"Alegeri Prezidentiale",1,760,369,341,27,1,366,3,800,431,271,95
24,IAŞI,TRIFEŞTI,99600,VLADOMIRA,"ŞCOALA PRIMARĂ VLADOMIRA",684,"Alegeri Prezidentiale",1,193,116,98,18,0,116,0,200,84,92,24
24,IAŞI,ŢIBANA,99673,ŢIBANA,"LICEUL TEHNOLOGIC DE INDUSTRIE ALIMENTARĂ ŢIBANA",685,"Alegeri Prezidentiale",1,726,268,242,26,0,262,6,800,532,134,128
24,IAŞI,ŢIBANA,99673,"POIANA MĂNĂSTIRII","SCOALA GIMNAZIALĂ POIANA MĂNĂSTIRII",686,"Alegeri Prezidentiale",1,365,132,119,13,0,132,0,400,268,48,84
24,IAŞI,ŢIBANA,99673,ALEXENI,"ŞCOALA GIMNAZIALĂ ALEXENI",687,"Alegeri Prezidentiale",1,622,187,176,11,0,185,2,700,513,63,122
24,IAŞI,ŢIBANA,99673,"POIANA DE SUS","ŞCOALA PRIMARĂ POIANA DE SUS",688,"Alegeri Prezidentiale",1,445,172,159,13,0,172,0,500,328,81,91
24,IAŞI,ŢIBANA,99673,DOMNIŢA,"ŞCOALA GIMNAZIALĂ DOMNIŢA",689,"Alegeri Prezidentiale",1,1071,306,275,31,0,301,5,1200,894,180,121
24,IAŞI,ŢIBANA,99673,RUNCU,"ŞCOALA GIMNAZIALĂ RUNCU",690,"Alegeri Prezidentiale",1,409,169,155,14,0,168,1,500,331,59,109
24,IAŞI,ŢIBANA,99673,GÂRBEŞTI,"ŞCOALA GIMNAZIALĂ GÎRBEŞTI",691,"Alegeri Prezidentiale",1,847,255,243,12,0,255,0,900,645,149,106
24,IAŞI,ŢIBANA,99673,GÂRBEŞTI,"ŞCOALA PRIMARĂ GÎRBEŞTI",692,"Alegeri Prezidentiale",1,957,314,293,21,0,313,1,1101,787,159,154
24,IAŞI,ŢIBANA,99673,"VADU VEJEI","ŞCOALA PRIMARĂ VADU VEJEI",693,"Alegeri Prezidentiale",1,274,115,107,8,0,115,0,300,185,47,68
24,IAŞI,ŢIBĂNEŞTI,99780,ŢIBĂNEŞTI,"GRĂDINIȚA CU PROGRAM NORMAL ȚIBĂNEȘTI",694,"Alegeri Prezidentiale",1,892,392,344,44,4,388,4,1000,608,249,139
24,IAŞI,ŢIBĂNEŞTI,99780,ŢIBĂNEŞTI,"GRĂDINIȚA CU PROGRAM NORMAL ȚIBĂNEȘTI",695,"Alegeri Prezidentiale",1,951,381,354,23,4,376,5,1000,619,246,130
24,IAŞI,ŢIBĂNEŞTI,99780,RĂSBOIENI,"ȘCOALA GIMNAZIALĂ RĂSBOIENI",696,"Alegeri Prezidentiale",1,764,313,298,11,4,309,4,800,487,175,134
24,IAŞI,ŢIBĂNEŞTI,99780,"GLODENII GÂNDULUI","ȘCOALA GIMNAZIALĂ GLODENII GÎNDULUI",697,"Alegeri Prezidentiale",1,1057,404,383,21,0,396,8,1200,796,289,107
24,IAŞI,ŢIBĂNEŞTI,99780,"GLODENII GÂNDULUI","ȘCOALA GIMNAZIALĂ GLODENII GÎNDULUI",698,"Alegeri Prezidentiale",1,1017,412,404,8,0,405,7,1100,688,266,139
24,IAŞI,ŢIBĂNEŞTI,99780,JIGORENI,"ȘCOALA GIMNAZIALĂ ”DR. PETRU BRÂNZEI” JIGORENI",699,"Alegeri Prezidentiale",1,568,257,243,14,0,256,1,600,343,134,122
24,IAŞI,ŢIBĂNEŞTI,99780,VĂLENII,"GRĂDINIȚA CU PROGRAM NORMAL VĂLENII",700,"Alegeri Prezidentiale",1,219,111,88,22,1,110,1,300,189,61,49
24,IAŞI,ŢIBĂNEŞTI,99780,TUNGUJEI,"GRĂDINIȚA CU PROGRAM NORMAL TUNGUJEI",701,"Alegeri Prezidentiale",1,473,210,192,18,0,207,3,500,290,88,119
24,IAŞI,ŢIBĂNEŞTI,99780,RECEA,"GRĂDINIȚA CU PROGRAM NORMAL RECEA",702,"Alegeri Prezidentiale",1,117,68,57,11,0,67,1,200,132,27,40
24,IAŞI,ŢIBĂNEŞTI,99780,GRIEŞTI,"GRĂDINIȚA CU PROGRAM NORMAL GRIEȘTI",703,"Alegeri Prezidentiale",1,204,104,89,15,0,104,0,300,196,46,58
24,IAŞI,ŢIGĂNAŞI,99879,CÂRNICENI,"SCOALA GENERALA CIRNICENI",704,"Alegeri Prezidentiale",1,1249,554,496,58,0,553,1,1400,846,356,197
24,IAŞI,ŢIGĂNAŞI,99879,"MIHAIL KOGĂLNICEANU","SCOALA GENERALA MIHAIL KOGALNICEANU",705,"Alegeri Prezidentiale",1,1113,380,345,35,0,374,6,1200,820,147,227
24,IAŞI,ŢIGĂNAŞI,99879,STEJARII,"SCOALA PRIMARA STEJARII",706,"Alegeri Prezidentiale",1,242,143,107,36,0,142,1,300,157,55,87
24,IAŞI,ŢIGĂNAŞI,99879,ŢIGĂNAŞI,"SCOALA GIMNAZIALA ”COSTACHE ANTONIU”TIGANASI",707,"Alegeri Prezidentiale",1,1150,513,468,45,0,506,7,1300,787,266,240
24,IAŞI,ŢUŢORA,99922,ŢUŢORA,"SCOALA GIMNAZIALĂ ȚUȚORA",708,"Alegeri Prezidentiale",1,963,455,375,80,0,453,2,1100,645,252,201
24,IAŞI,ŢUŢORA,99922,CHIPEREŞTI,"SCOALA GIMNAZIALA CHIPEREȘTI",709,"Alegeri Prezidentiale",1,312,212,154,58,0,208,4,400,188,121,87
24,IAŞI,ŢUŢORA,99922,OPRIŞENI,"ȘCOALA GIMNAZIALĂ OPRIȘENI",710,"Alegeri Prezidentiale",1,546,278,229,49,0,276,2,600,322,199,77
24,IAŞI,UNGHENI,96003,BOSIA,"SCOALA GIMNAZIALA BOSIA",711,"Alegeri Prezidentiale",1,848,334,311,23,0,332,2,900,566,208,124
24,IAŞI,UNGHENI,96003,BOSIA,"SCOALA GIMNAZIALA BOSIA",712,"Alegeri Prezidentiale",1,704,313,287,26,0,311,2,800,487,186,125
24,IAŞI,UNGHENI,96003,"GOADA STÂNCII","SCOALA PRIMARA COADA STÎNCII",713,"Alegeri Prezidentiale",2,542,214,184,30,0,213,1,600,386,141,72
24,IAŞI,UNGHENI,96003,MÂNZĂTEŞTI,"SCOALA PRIMARA MÎNZĂTEŞTI",714,"Alegeri Prezidentiale",1,843,419,378,41,0,414,5,900,481,316,98
24,IAŞI,UNGHENI,96003,UNGHENI,"SCOALA PRIMARA UNGHENI",715,"Alegeri Prezidentiale",1,527,236,195,41,0,236,0,600,364,152,84
24,IAŞI,"VALEA LUPULUI",100353,"VALEA LUPULUI","ȘCOALA GIMNAZIALĂ”PROF.MIHAI DUMITRIU”",716,"Alegeri Prezidentiale",2,2019,1441,1133,306,2,1407,34,2200,759,1163,244
24,IAŞI,"VALEA LUPULUI",100353,"VALEA LUPULUI","ȘCOALA GIMNAZIALĂ”PROF.MIHAI DUMITRIU”",717,"Alegeri Prezidentiale",1,1970,1289,1060,229,0,1265,24,2100,811,1000,265
24,IAŞI,"VALEA LUPULUI",100353,"VALEA LUPULUI","ȘCOALA GIMNAZIALĂ”PROF.MIHAI DUMITRIU”",718,"Alegeri Prezidentiale",1,2022,1370,1114,256,0,1349,21,2200,830,1079,270
24,IAŞI,"VALEA LUPULUI",100353,"VALEA LUPULUI","ȘCOALA GIMNAZIALA ”PROF.MIHAI DUMITRIU”",719,"Alegeri Prezidentiale",1,1765,1136,910,224,2,1113,23,1900,764,826,287
24,IAŞI,"VALEA SEACĂ",99968,"VALEA SEACĂ","SCOALA GIMNAZIALA VALEA SEACA",720,"Alegeri Prezidentiale",1,1639,671,636,35,0,656,15,1800,1129,363,293
24,IAŞI,"VALEA SEACĂ",99968,CONŢEŞTI,"SCOALA GIMNAZIALA CONTESTI",721,"Alegeri Prezidentiale",1,1458,535,512,23,0,531,4,1600,1065,286,245
24,IAŞI,"VALEA SEACĂ",99968,TOPILE,"SCOALA GIMNAZIALA TOPILE",722,"Alegeri Prezidentiale",1,1837,713,661,52,0,700,13,2000,1287,319,381
24,IAŞI,VÂNĂTORI,100086,VÂNĂTORI,"CAMINUL CULTURAL VINATORI",723,"Alegeri Prezidentiale",2,908,386,348,38,0,381,5,1000,614,195,186
24,IAŞI,VÂNĂTORI,100086,CRIVEŞTI,"ȘCOALA CU CLASELE I-VIII CRIVEȘTI",724,"Alegeri Prezidentiale",1,1215,494,457,37,0,493,1,1300,806,302,191
24,IAŞI,VÂNĂTORI,100086,"GURA BÂDILIŢEI","SCOALA CU CLASELE I-IV GURA-BIDILITEI",725,"Alegeri Prezidentiale",1,507,206,185,21,0,201,5,600,394,99,102
24,IAŞI,VÂNĂTORI,100086,HÂRTOAPE,"ȘCOALA GIMNAZIALĂ HÎRTOAPE",726,"Alegeri Prezidentiale",1,928,428,383,45,0,421,7,1000,572,170,251
24,IAŞI,VÂNĂTORI,100086,VLĂDNICUŢ,"ȘCOALA PRIMARĂ VLĂDNICUȚ",727,"Alegeri Prezidentiale",1,108,73,59,14,0,72,1,200,127,29,43
24,IAŞI,VICTORIA,100004,STÂNCA,"ŞCOALA STÂNCA",728,"Alegeri Prezidentiale",1,445,198,185,13,0,196,2,500,302,126,70
24,IAŞI,VICTORIA,100004,VICTORIA,"ȘCOALA VICTORIA",729,"Alegeri Prezidentiale",1,1269,521,443,78,0,512,9,1400,879,296,216
24,IAŞI,VICTORIA,100004,VICTORIA,"ŞCOALA VICTORIA",730,"Alegeri Prezidentiale",1,334,138,114,24,0,135,3,400,262,84,51
24,IAŞI,VICTORIA,100004,FRĂSULENI,"ŞCOALA FRĂSULENI",731,"Alegeri Prezidentiale",1,311,136,117,19,0,136,0,400,264,92,44
24,IAŞI,VICTORIA,100004,FRĂSULENI,"ŞCOALA FRĂSULENI",732,"Alegeri Prezidentiale",1,245,81,57,24,0,77,4,300,219,45,32
24,IAŞI,VICTORIA,100004,ICUŞENI,"ŞCOALA ICUŞENI",733,"Alegeri Prezidentiale",1,392,166,139,27,0,164,2,400,234,97,67
24,IAŞI,VICTORIA,100004,ICUŞENI,"ŞCOALA ICUȘENI",734,"Alegeri Prezidentiale",1,419,166,147,19,0,164,2,500,334,93,71
24,IAŞI,VLĂDENI,100148,VLĂDENI,"LICEUL TEHNOLOGIC VLADENI",735,"Alegeri Prezidentiale",1,1413,578,525,53,0,573,5,1500,922,365,208
24,IAŞI,VLĂDENI,100148,BORŞA,"SCOALA CU CLASELE I-VIII BORSA",736,"Alegeri Prezidentiale",1,668,257,232,25,0,256,1,700,443,146,110
24,IAŞI,VLĂDENI,100148,IACOBENI,"SCOALA CU CLASELE I-IV IACOBENI",737,"Alegeri Prezidentiale",1,173,85,64,21,0,85,0,200,115,47,38
24,IAŞI,VLĂDENI,100148,"ALEXANDRU CEL BUN","SCOALA CU CLASELE I-IV ALEXANDRU CEL BUN",738,"Alegeri Prezidentiale",1,398,179,156,23,0,175,4,400,221,98,77
24,IAŞI,VLĂDENI,100148,BROŞTENI,"SCOALA CU CLASELE I-IV BROSTENI",739,"Alegeri Prezidentiale",1,334,142,126,16,0,140,2,401,259,80,60
24,IAŞI,VLĂDENI,100148,VÂLCELELE,"SCOALA PRIMARA VILCELELE",740,"Alegeri Prezidentiale",1,329,142,126,16,0,140,2,404,262,87,53
24,IAŞI,VOINEŞTI,100219,VOINEŞTI,"ŞCOALA GIMNAZIALĂ ”IOANID ROMANESCU” VOINEŞTI",741,"Alegeri Prezidentiale",1,1136,404,357,47,0,399,5,1200,796,257,142
24,IAŞI,VOINEŞTI,100219,VOINEŞTI,"ŞCOALA GIMNAZIALĂ ”IOANID ROMANESCU” VOINEŞTI",742,"Alegeri Prezidentiale",2,786,276,246,29,1,274,2,900,624,180,94
24,IAŞI,VOINEŞTI,100219,VOINEŞTI,"ŞCOALA GIMNAZIALĂ ”IOANID ROMANESCU” VOINEŞTI",743,"Alegeri Prezidentiale",1,962,322,298,24,0,320,2,1100,778,175,145
24,IAŞI,VOINEŞTI,100219,SLOBOZIA,"ŞCOALA GIMNAZIALĂ SLOBOZIA DEAL",744,"Alegeri Prezidentiale",1,818,173,160,13,0,170,3,900,727,61,109
24,IAŞI,VOINEŞTI,100219,SLOBOZIA,"ŞCOALA GIMNAZIALĂ SLOBOZIA DEAL",745,"Alegeri Prezidentiale",1,797,194,175,19,0,193,1,900,706,82,111
24,IAŞI,VOINEŞTI,100219,LUNGANI,"ŞCOALA PRIMARĂ LUNGANI",746,"Alegeri Prezidentiale",1,483,199,168,31,0,199,0,500,301,82,117
24,IAŞI,VOINEŞTI,100219,"SCHITU STAVNIC","ŞCOALA PRIMARĂ SCHITU-STAVNIC",747,"Alegeri Prezidentiale",1,448,184,160,24,0,182,2,500,316,102,80
24,IAŞI,VOINEŞTI,100219,VOCOTEŞTI,"IMOBIL PROPRIETATE PRIVATA VRABIE CALIPSA",748,"Alegeri Prezidentiale",1,104,91,51,40,0,87,4,200,109,43,44
25,ILFOV,"ORAŞ BRAGADIRU",179221,BRAGADIRU,"SCOALA GIMNAZIALA NR. 1 BRAGADIRU",1,"Alegeri Prezidentiale",3,1811,1152,832,320,0,1129,23,1607,455,697,432
25,ILFOV,"ORAŞ BRAGADIRU",179221,BRAGADIRU,"SCOALA GIMNAZIALA NR. 1 BRAGADIRU",2,"Alegeri Prezidentiale",1,1825,1204,892,312,0,1187,17,1600,396,744,443
25,ILFOV,"ORAŞ BRAGADIRU",179221,BRAGADIRU,"SCOALA GIMNAZIALA NR. 1 BRAGADIRU",3,"Alegeri Prezidentiale",1,1567,1019,775,244,0,1002,17,1700,681,696,306
25,ILFOV,"ORAŞ BRAGADIRU",179221,BRAGADIRU,"SCOALA GIMNAZIALA NR. 1 BRAGADIRU",4,"Alegeri Prezidentiale",1,1146,709,585,124,0,692,17,1300,591,453,239
25,ILFOV,"ORAŞ BRAGADIRU",179221,BRAGADIRU,"SCOALA GIMNAZIALA NR. 1 BRAGADIRU",5,"Alegeri Prezidentiale",1,1847,969,843,125,1,961,8,2000,1031,651,310
25,ILFOV,"ORAŞ BRAGADIRU",179221,BRAGADIRU,"SC GAD SPECIAL CONSTRUCT SRL",6,"Alegeri Prezidentiale",2,1035,1547,559,988,0,1511,36,1700,153,1167,344
25,ILFOV,"ORAŞ BRAGADIRU",179221,BRAGADIRU,"SC GAD SPECIAL CONSTRUCT SRL",7,"Alegeri Prezidentiale",2,1039,917,534,383,0,899,18,1099,182,718,181
25,ILFOV,"ORAŞ BRAGADIRU",179221,BRAGADIRU,"SC GAD SPECIAL CONSTRUCT SRL",8,"Alegeri Prezidentiale",1,1842,1344,981,363,0,1311,33,1800,456,991,320
25,ILFOV,"ORAŞ BRAGADIRU",179221,BRAGADIRU,"GRĂDINIȚA CU PROGRAM PRELUNGIT NR 3",9,"Alegeri Prezidentiale",1,1233,1309,680,629,0,1286,23,1400,91,940,346
25,ILFOV,"ORAŞ BRAGADIRU",179221,BRAGADIRU,"GRADINITA CU PROGRAM PRELUNGIT NR 3",10,"Alegeri Prezidentiale",1,1134,1520,646,874,0,1491,29,1599,79,1161,330
25,ILFOV,"ORAŞ BRAGADIRU",179221,BRAGADIRU,"GRADINITA CU PROGRAM PRELUNGIT NR 3",11,"Alegeri Prezidentiale",1,1984,1370,920,450,0,1333,37,2100,730,967,366
25,ILFOV,"ORAŞ BRAGADIRU",179221,BRAGADIRU,"GRADINITA CU PROGRAM PRELUNGIT NR 3",12,"Alegeri Prezidentiale",1,1930,1309,929,380,0,1279,30,2100,791,908,371
25,ILFOV,"ORAŞ BRAGADIRU",179221,BRAGADIRU,"SPAȚIU COMERCIAL",13,"Alegeri Prezidentiale",1,1225,810,583,227,0,796,14,1300,490,555,241
25,ILFOV,"ORAŞ BUFTEA",100576,BUFTEA,"ȘCOALA GIMNAZIALĂ NR. 1 BUFTEA",14,"Alegeri Prezidentiale",1,1709,866,779,68,19,854,12,1900,1034,509,345
25,ILFOV,"ORAŞ BUFTEA",100576,BUFTEA,"ȘCOALA GIMNAZIALĂ NR. 1 BUFTEA",15,"Alegeri Prezidentiale",4,1827,999,878,118,3,977,22,2000,1001,612,365
25,ILFOV,"ORAŞ BUFTEA",100576,BUFTEA,"ȘCOALA GIMNAZIALĂ NR. 1 BUFTEA",16,"Alegeri Prezidentiale",1,1701,871,735,129,7,847,24,1900,1029,527,320
25,ILFOV,"ORAŞ BUFTEA",100576,BUFTEA,"LICEUL TEHNOLOGIC ”DUMITRU DUMITRESCU” BUFTEA",17,"Alegeri Prezidentiale",1,1097,614,494,117,3,589,25,1200,586,359,230
25,ILFOV,"ORAŞ BUFTEA",100576,BUFTEA,"LICEUL TEHNOLOGIC ”DUMITRU DUMITRESCU” BUFTEA",18,"Alegeri Prezidentiale",1,1439,804,731,58,15,793,11,1600,796,498,295
25,ILFOV,"ORAŞ BUFTEA",100576,BUFTEA,"ȘCOALA GIMNAZIALĂ NR. 2 BUFTEA",19,"Alegeri Prezidentiale",1,1247,809,612,192,5,796,13,1400,591,489,307
25,ILFOV,"ORAŞ BUFTEA",100576,BUFTEA,"ȘCOALA GIMNAZIALĂ NR. 2 BUFTEA",20,"Alegeri Prezidentiale",1,1564,913,773,139,1,893,20,1700,787,540,353
25,ILFOV,"ORAŞ BUFTEA",100576,BUFTEA,"ȘCOALA GIMNAZIALĂ NR. 2 BUFTEA",21,"Alegeri Prezidentiale",1,1616,945,855,86,4,926,19,1800,855,589,337
25,ILFOV,"ORAŞ BUFTEA",100576,BUFTEA,"ȘCOALA GIMNAZIALĂ NR. 2 BUFTEA",22,"Alegeri Prezidentiale",1,1605,883,779,104,0,869,14,1800,917,549,320
25,ILFOV,"ORAŞ BUFTEA",100576,BUFTEA,"ȘCOALA GIMNAZIALĂ NR. 4 BUFTEA",23,"Alegeri Prezidentiale",1,975,625,536,81,8,606,19,1100,475,432,174
25,ILFOV,"ORAŞ BUFTEA",100576,BUFTEA,"SEDIU TÂRG - PRIMĂRIA BUFTEA",24,"Alegeri Prezidentiale",1,1329,824,752,72,0,813,11,1450,626,524,289
25,ILFOV,"ORAŞ BUFTEA",100576,BUFTEA,"ȘCOALA GIMNAZIALĂ NR. 3 BUFTEA",25,"Alegeri Prezidentiale",1,1964,1267,1026,238,3,1241,26,2100,833,819,422
25,ILFOV,"ORAŞ BUFTEA",100576,BUFTEA,"PROPRIETATE PRIVATĂ: TUTUNARU GHEORGHE",26,"Alegeri Prezidentiale",2,451,212,165,47,0,206,6,500,288,112,94
25,ILFOV,"ORAŞ CHITILA",179285,CHITILA,"GRĂDINIŢA CU PROGRAM PRELUNGIT ”VOINICEL”",27,"Alegeri Prezidentiale",1,1247,717,617,99,1,704,13,1400,683,442,262
25,ILFOV,"ORAŞ CHITILA",179285,CHITILA,"ŞCOALA GIMNAZIALĂ CU CLASELE I-VIII NR.1 ”PROF.ION VIŞOIU”",28,"Alegeri Prezidentiale",2,1636,1175,788,385,2,1143,32,1800,625,701,442
25,ILFOV,"ORAŞ CHITILA",179285,CHITILA,"ŞCOALA GIMNAZIALĂ CU CLASELE I-VIII NR.1 ”PROF. ION VIŞOIU”",29,"Alegeri Prezidentiale",1,1625,1234,904,330,0,1207,27,1800,566,864,343
25,ILFOV,"ORAŞ CHITILA",179285,RUDENI,"ŞCOALA GIMNAZIALĂ CU CLASELE I-VIII NR.1 ”PROF. ION VIŞOIU”",30,"Alegeri Prezidentiale",2,1126,578,480,98,0,568,10,1200,622,404,164
25,ILFOV,"ORAŞ CHITILA",179285,CHITILA,"ŞCOALA GIMNAZIALĂ CU CLASELE I- VIII NR.1 ”PROF. ION VIŞOIU” -",31,"Alegeri Prezidentiale",1,1604,764,609,153,2,748,16,1750,986,447,301
25,ILFOV,"ORAŞ CHITILA",179285,CHITILA,"SCOALA GIMNAZIALA CU CLASELE I-VIII NR. 1 PROF. ION VISOIU, STRUCTURA CU CLASELE I-IV SI GRUPE DE PRESCOLARI ION OLTEANU-CHITILA",32,"Alegeri Prezidentiale",1,1206,845,630,215,0,835,10,1300,455,628,207
25,ILFOV,"ORAŞ CHITILA",179285,CHITILA,"SERVICIUL IMPOZITE ȘI TAXE",33,"Alegeri Prezidentiale",1,1849,1024,881,143,0,1007,17,2000,976,624,383
25,ILFOV,"ORAŞ CHITILA",179285,CHITILA,"ŞCOALA GIMNAZIALĂ CU CLASELE I- VIII NR.1 ”PROF. ION VIŞOIU”",34,"Alegeri Prezidentiale",1,1095,633,504,129,0,621,12,1200,567,375,246
25,ILFOV,"ORAŞ CHITILA",179285,CHITILA,"GRĂDINIŢA ”PRICHINDEL”",35,"Alegeri Prezidentiale",1,1121,583,537,46,0,569,14,1200,617,398,171
25,ILFOV,"ORAŞ MĂGURELE",179409,MĂGURELE,"GRADINITA NR 2 MAGURELE",36,"Alegeri Prezidentiale",3,1333,972,749,223,0,953,19,1508,536,673,280
25,ILFOV,"ORAŞ MĂGURELE",179409,MĂGURELE,"LICEUL TEORETIC ”HORIA HULUBEI”",37,"Alegeri Prezidentiale",1,865,736,552,184,0,716,20,950,214,468,248
25,ILFOV,"ORAŞ MĂGURELE",179409,MĂGURELE,"PRIMĂRIA ORAŞULUI MĂGURELE",38,"Alegeri Prezidentiale",1,1866,1635,1016,615,4,1599,36,2000,365,1140,459
25,ILFOV,"ORAŞ MĂGURELE",179409,MĂGURELE,"PRIMĂRIA ORAŞULUI MĂGURELE",39,"Alegeri Prezidentiale",1,953,883,453,430,0,867,16,1000,117,589,278
25,ILFOV,"ORAŞ MĂGURELE",179409,ALUNIŞU,"CLĂDIRE PARC ALUNIŞ",40,"Alegeri Prezidentiale",1,1200,800,591,209,0,786,14,1300,500,505,281
25,ILFOV,"ORAŞ MĂGURELE",179409,VÂRTEJU,"SCOALA PRIMARA NR 1 VARTEJU",41,"Alegeri Prezidentiale",1,982,678,521,157,0,667,11,1100,422,424,243
25,ILFOV,"ORAŞ MĂGURELE",179409,VÂRTEJU,"GRADINITA NR 3 VARTEJU",42,"Alegeri Prezidentiale",1,1306,1106,710,396,0,1086,20,1400,294,735,351
25,ILFOV,"ORAŞ MĂGURELE",179409,DUMITRANA,"SCOALA PRIMARA NR 2 DUMITRANA",43,"Alegeri Prezidentiale",1,890,713,507,206,0,706,7,1000,287,441,265
25,ILFOV,"ORAŞ OTOPENI",179481,ODĂILE,"GRĂDINIŢIA CU PROGRAM PRELUNGIT NR. 2",44,"Alegeri Prezidentiale",1,962,916,529,387,0,899,17,1100,184,659,240
25,ILFOV,"ORAŞ OTOPENI",179481,ODĂILE,"GRĂDINIȚA CU PROGRAM PRELUNGIT NR.2",45,"Alegeri Prezidentiale",1,1087,1000,688,312,0,981,19,1200,200,795,186
25,ILFOV,"ORAŞ OTOPENI",179481,OTOPENI,"LICEUL TEORETIC ”IOAN PETRUŞ”",46,"Alegeri Prezidentiale",1,1397,1367,769,598,0,1341,26,1500,133,1035,306
25,ILFOV,"ORAŞ OTOPENI",179481,OTOPENI,"LICEUL TEORETIC ”IOAN PETRUŞ”",47,"Alegeri Prezidentiale",1,962,928,523,313,92,911,17,1100,172,648,263
25,ILFOV,"ORAŞ OTOPENI",179481,OTOPENI,"LICEUL TEORETIC ”IOAN PETRUŞ”",48,"Alegeri Prezidentiale",1,1136,850,630,220,0,836,14,1200,350,654,182
25,ILFOV,"ORAŞ OTOPENI",179481,OTOPENI,"LICEUL TEORETIC ”IOAN PETRUŞ”",49,"Alegeri Prezidentiale",1,1007,1174,547,626,1,1145,29,1200,26,866,279
25,ILFOV,"ORAŞ OTOPENI",179481,OTOPENI,"PRIMĂRIA ORAŞULUI OTOPENI",50,"Alegeri Prezidentiale",1,1283,1129,706,423,0,1100,29,1400,271,833,267
25,ILFOV,"ORAŞ OTOPENI",179481,OTOPENI,"PRIMĂRIA ORAŞULUI OTOPENI",51,"Alegeri Prezidentiale",1,1173,867,669,108,90,843,24,1300,433,592,251
25,ILFOV,"ORAŞ OTOPENI",179481,OTOPENI,"SALA DE SPORT OTOPENI",52,"Alegeri Prezidentiale",1,1629,1262,942,320,0,1243,19,1750,488,942,301
25,ILFOV,"ORAŞ OTOPENI",179481,OTOPENI,"GRĂDINIŢA CU PROGRAM NORMAL NR. 2",53,"Alegeri Prezidentiale",1,1286,1030,749,281,0,1013,17,1400,370,778,235
25,ILFOV,"ORAŞ OTOPENI",179481,OTOPENI,"GRĂDINIŢA CU PROGRAM NORMAL NR. 2",54,"Alegeri Prezidentiale",1,1214,1044,747,297,0,1022,22,1300,256,792,230
25,ILFOV,"ORAŞ OTOPENI",179481,OTOPENI,"PROPRIETATE PRIVATĂ: FARR MIHAELA DANA",55,"Alegeri Prezidentiale",1,972,836,519,256,61,822,14,1100,264,547,275
25,ILFOV,"ORAŞ PANTELIMON",179515,PANTELIMON,"ŞCOALA GENERALĂ NR.1",56,"Alegeri Prezidentiale",2,1477,735,655,80,0,728,7,1600,865,408,320
25,ILFOV,"ORAŞ PANTELIMON",179515,PANTELIMON,"ŞCOALA GENERALĂ NR.1",57,"Alegeri Prezidentiale",1,1584,713,610,103,0,703,10,1700,987,425,278
25,ILFOV,"ORAŞ PANTELIMON",179515,PANTELIMON,"ŞCOALA GENERALĂ NR.1",58,"Alegeri Prezidentiale",1,1640,896,768,128,0,884,12,1800,904,557,327
25,ILFOV,"ORAŞ PANTELIMON",179515,PANTELIMON,"ŞCOALA GENERALĂ NR.1",59,"Alegeri Prezidentiale",1,1703,1001,736,265,0,979,22,1900,899,600,379
25,ILFOV,"ORAŞ PANTELIMON",179515,PANTELIMON,"ŞCOALA GENERALĂ NR.1",60,"Alegeri Prezidentiale",1,1793,940,748,192,0,918,22,2000,1060,538,380
25,ILFOV,"ORAŞ PANTELIMON",179515,PANTELIMON,"ŞCOALA GENERALĂ NR.1",61,"Alegeri Prezidentiale",1,1383,654,590,64,0,651,3,1500,846,367,284
25,ILFOV,"ORAŞ PANTELIMON",179515,PANTELIMON,"ŞCOALA GENERALĂ NR.1",62,"Alegeri Prezidentiale",1,1426,649,526,123,0,644,5,1550,901,396,248
25,ILFOV,"ORAŞ PANTELIMON",179515,PANTELIMON,"ŞCOALA GENERALĂ NR.1",63,"Alegeri Prezidentiale",1,1891,1041,825,216,0,1028,13,2100,1059,578,450
25,ILFOV,"ORAŞ PANTELIMON",179515,PANTELIMON,"ŞCOALA GENERALĂ NR.1",64,"Alegeri Prezidentiale",1,1866,1321,884,437,0,1302,19,2000,679,793,509
25,ILFOV,"ORAŞ PANTELIMON",179515,PANTELIMON,"ŞCOALA GENERALĂ NR.1",65,"Alegeri Prezidentiale",1,1911,1148,831,317,0,1128,20,2100,952,711,417
25,ILFOV,"ORAŞ PANTELIMON",179515,PANTELIMON,"GRĂDINIŢA DE COPII NR.1",66,"Alegeri Prezidentiale",2,1421,807,597,210,0,792,15,1600,793,476,316
25,ILFOV,"ORAŞ PANTELIMON",179515,PANTELIMON,"GRĂDINIŢA DE COPII NR.1",67,"Alegeri Prezidentiale",1,1224,637,530,107,0,626,11,1300,663,325,301
25,ILFOV,"ORAŞ PANTELIMON",179515,PANTELIMON,"GRĂDINIŢA DE COPII NR.1",68,"Alegeri Prezidentiale",1,1236,616,515,101,0,611,5,1400,784,393,218
25,ILFOV,"ORAŞ PANTELIMON",179515,PANTELIMON,"GRĂDINIŢA DE COPII NR.1",69,"Alegeri Prezidentiale",1,1729,828,739,89,0,810,18,1900,1072,427,383
25,ILFOV,"ORAŞ PANTELIMON",179515,PANTELIMON,"GRĂDINIŢA DE COPII NR.1",70,"Alegeri Prezidentiale",1,1776,850,763,87,0,837,13,1950,1100,451,386
25,ILFOV,"ORAŞ POPEŞTI-LEORDENI",179533,POPEŞTI-LEORDENI,"FUNDAŢIA LEONARDO MURIALDO",71,"Alegeri Prezidentiale",1,1822,1347,841,506,0,1328,19,2000,653,1113,215
25,ILFOV,"ORAŞ POPEŞTI-LEORDENI",179533,POPEŞTI-LEORDENI,"FUNDAŢIA LEONARDO MURIALDO",72,"Alegeri Prezidentiale",1,1918,1444,910,534,0,1422,22,2100,656,1219,203
25,ILFOV,"ORAŞ POPEŞTI-LEORDENI",179533,POPEŞTI-LEORDENI,"FUNDATIA LEONARDO MURIALDO",73,"Alegeri Prezidentiale",1,2022,1422,1020,402,0,1394,28,2200,778,1185,209
25,ILFOV,"ORAŞ POPEŞTI-LEORDENI",179533,POPEŞTI-LEORDENI,"FUNDATIA LEORNARDO MURIALDO",74,"Alegeri Prezidentiale",1,1755,1412,883,529,0,1381,31,1900,488,1205,176
25,ILFOV,"ORAŞ POPEŞTI-LEORDENI",179533,POPEŞTI-LEORDENI,"ŞCOALA GIMNAZIALĂ IOAN BĂDESCU",75,"Alegeri Prezidentiale",1,1215,957,664,292,1,937,20,1300,343,678,259
25,ILFOV,"ORAŞ POPEŞTI-LEORDENI",179533,POPEŞTI-LEORDENI,"ŞCOALA GIMNAZIALĂ IOAN BĂDESCU",76,"Alegeri Prezidentiale",1,1826,1290,1017,273,0,1252,38,2000,710,895,357
25,ILFOV,"ORAŞ POPEŞTI-LEORDENI",179533,POPEŞTI-LEORDENI,"ȘCOALA GIMNAZIALĂ IOAN BĂDESCU",77,"Alegeri Prezidentiale",1,1812,1147,967,180,0,1130,17,2000,853,829,301
25,ILFOV,"ORAŞ POPEŞTI-LEORDENI",179533,POPEŞTI-LEORDENI,"LICEUL TEORETIC RADU POPESCU",78,"Alegeri Prezidentiale",1,1665,1017,912,105,0,993,24,1800,783,693,300
25,ILFOV,"ORAŞ POPEŞTI-LEORDENI",179533,POPEŞTI-LEORDENI,"LICEUL TEORETIC RADU POPESCU",79,"Alegeri Prezidentiale",1,1661,1123,913,210,0,1096,27,1800,677,748,348
25,ILFOV,"ORAŞ POPEŞTI-LEORDENI",179533,POPEŞTI-LEORDENI,"LICEUL TEORETIC RADU POPESCU CORP E",80,"Alegeri Prezidentiale",1,1651,1006,804,202,0,983,23,1800,794,628,355
25,ILFOV,"ORAŞ POPEŞTI-LEORDENI",179533,POPEŞTI-LEORDENI,"ŞCOALA GIMNAZIALĂ NR. 3",81,"Alegeri Prezidentiale",1,1449,888,743,145,0,877,11,1600,712,538,339
25,ILFOV,"ORAŞ POPEŞTI-LEORDENI",179533,POPEŞTI-LEORDENI,"ŞCOALA GIMNAZIALĂ NR. 3",82,"Alegeri Prezidentiale",1,1490,829,631,197,1,813,16,1200,371,510,303
25,ILFOV,"ORAŞ POPEŞTI-LEORDENI",179533,POPEŞTI-LEORDENI,"SC MIKY&JASMIN SRL",83,"Alegeri Prezidentiale",1,1771,945,826,119,0,930,15,1950,1005,565,365
25,ILFOV,"ORAŞ POPEŞTI-LEORDENI",179533,POPEŞTI-LEORDENI,"S.C. AGROPOL S.A.",84,"Alegeri Prezidentiale",1,443,244,194,50,0,243,1,500,256,189,54
25,ILFOV,"ORAŞ POPEŞTI-LEORDENI",179533,POPEŞTI-LEORDENI,"GRADINITA NR.3",85,"Alegeri Prezidentiale",1,1223,780,526,254,0,764,16,1350,570,609,155
25,ILFOV,"ORAŞ POPEŞTI-LEORDENI",179533,POPEŞTI-LEORDENI,"DIRECȚIA DE ASISTENȚĂ SOCIALĂ POPEȘTI-LEORDFENI",86,"Alegeri Prezidentiale",1,1912,1334,1010,324,0,1313,21,2100,766,1041,272
25,ILFOV,"ORAŞ POPEŞTI-LEORDENI",179533,POPEŞTI-LEORDENI,"SC RAFFAELLO SHOES FACTORY SRL",87,"Alegeri Prezidentiale",1,1164,1639,549,1090,0,1601,38,1649,10,1394,207
25,ILFOV,"ORAŞ POPEŞTI-LEORDENI",179533,POPEŞTI-LEORDENI,"DIRECȚIA IMPOZITE ȘI TAXE LOCALE",88,"Alegeri Prezidentiale",1,1901,1441,831,610,0,1411,30,2100,659,1191,220
25,ILFOV,"ORAŞ POPEŞTI-LEORDENI",179533,POPEŞTI-LEORDENI,"DIRECȚIA IMPOZITE ȘI TAXE LOCALE",89,"Alegeri Prezidentiale",1,1859,1438,876,562,0,1415,23,2000,562,1223,192
25,ILFOV,"ORAŞ POPEŞTI-LEORDENI",179533,POPEŞTI-LEORDENI,"ȘCOALA GIMNAZIALĂ ”IOAN BĂDESCU”",90,"Alegeri Prezidentiale",1,920,903,460,443,0,890,13,1000,97,706,184
25,ILFOV,"ORAŞ VOLUNTARI",179551,VOLUNTARI,"ŞCOALA GIMNAZIALĂ NR. 3",91,"Alegeri Prezidentiale",1,1775,1336,890,446,0,1320,16,1900,564,1000,320
25,ILFOV,"ORAŞ VOLUNTARI",179551,VOLUNTARI,"ŞCOALA GIMNAZIALĂ NR. 3",92,"Alegeri Prezidentiale",1,1989,1434,920,512,2,1411,23,2200,766,1047,364
25,ILFOV,"ORAŞ VOLUNTARI",179551,VOLUNTARI,"ŞCOALA GIMNAZIALĂ NR. 3",93,"Alegeri Prezidentiale",3,1846,1411,935,476,0,1384,27,2000,589,983,401
25,ILFOV,"ORAŞ VOLUNTARI",179551,VOLUNTARI,"ŞCOALA GIMNAZIALĂ NR. 3",94,"Alegeri Prezidentiale",2,1879,1334,1029,304,1,1306,28,2050,716,952,354
25,ILFOV,"ORAŞ VOLUNTARI",179551,VOLUNTARI,"SALA DE SPORT ”ANDREEA ISĂRESCU”",95,"Alegeri Prezidentiale",1,1838,1192,934,258,0,1164,28,2050,858,588,576
25,ILFOV,"ORAŞ VOLUNTARI",179551,VOLUNTARI,"ŞCOALA GIMNAZIALĂ NR. 1",96,"Alegeri Prezidentiale",1,1961,1265,1030,233,2,1249,16,2200,935,718,531
25,ILFOV,"ORAŞ VOLUNTARI",179551,VOLUNTARI,"ŞCOALA GIMNAZIALĂ NR. 1",97,"Alegeri Prezidentiale",1,1957,1012,916,96,0,993,19,2200,1188,573,420
25,ILFOV,"ORAŞ VOLUNTARI",179551,VOLUNTARI,"ŞCOALA GIMNAZIALĂ NR. 1",98,"Alegeri Prezidentiale",1,1824,1114,884,230,0,1094,20,2000,886,710,384
25,ILFOV,"ORAŞ VOLUNTARI",179551,VOLUNTARI,"ŞCOALA GIMNAZIALĂ NR. 1",99,"Alegeri Prezidentiale",1,1751,1146,942,204,0,1117,29,1900,754,644,473
25,ILFOV,"ORAŞ VOLUNTARI",179551,VOLUNTARI,"ŞCOALA GIMNAZIALĂ NR. 1",100,"Alegeri Prezidentiale",1,1674,947,833,114,0,922,25,1800,853,554,368
25,ILFOV,"ORAŞ VOLUNTARI",179551,VOLUNTARI,"ŞCOALA GIMNAZIALĂ NR. 1",101,"Alegeri Prezidentiale",2,1931,1061,910,151,0,1049,12,2100,1039,581,468
25,ILFOV,"ORAŞ VOLUNTARI",179551,VOLUNTARI,"ŞCOALA GIMNAZIALĂ NR. 1",102,"Alegeri Prezidentiale",1,1788,1010,909,98,3,982,28,2000,990,522,460
25,ILFOV,"ORAŞ VOLUNTARI",179551,VOLUNTARI,"CASA DE CULTURĂ",103,"Alegeri Prezidentiale",1,1939,1274,989,284,1,1246,28,2100,826,720,526
25,ILFOV,"ORAŞ VOLUNTARI",179551,VOLUNTARI,"ŞCOALA GIMNAZIALĂ NR. 2",104,"Alegeri Prezidentiale",1,1854,1122,975,147,0,1092,30,2000,878,648,444
25,ILFOV,"ORAŞ VOLUNTARI",179551,VOLUNTARI,"ŞCOALA GIMNAZIALĂ NR. 2",105,"Alegeri Prezidentiale",1,1794,1104,972,132,0,1072,32,2000,896,629,443
25,ILFOV,"ORAŞ VOLUNTARI",179551,VOLUNTARI,"ŞCOALA GIMNAZIALĂ NR. 2",106,"Alegeri Prezidentiale",1,1810,1085,945,140,0,1047,38,2000,915,631,416
25,ILFOV,"ORAŞ VOLUNTARI",179551,VOLUNTARI,"FOSTUL SEDIU AL PRIMĂRIEI",107,"Alegeri Prezidentiale",1,1763,1163,941,222,0,1125,38,1900,737,661,464
25,ILFOV,"ORAŞ VOLUNTARI",179551,VOLUNTARI,"PRIMĂRIA ORAŞULUI VOLUNTARI",108,"Alegeri Prezidentiale",1,1565,1053,790,263,0,1033,20,1700,647,570,463
25,ILFOV,"ORAŞ VOLUNTARI",179551,VOLUNTARI,"SCOALA GIMNAZIALĂ NR. 3",109,"Alegeri Prezidentiale",1,1737,1159,942,216,1,1139,20,1900,741,892,247
25,ILFOV,"1 DECEMBRIE",102543,"1 DECEMBRIE","ŞCOALA GIMNAZIALA NR. 1, CORP A",110,"Alegeri Prezidentiale",1,1955,1140,878,262,0,1125,15,2158,1018,702,423
25,ILFOV,"1 DECEMBRIE",102543,"1 DECEMBRIE","ŞCOALA GIMNAZIALA NR. 1, CORP A",111,"Alegeri Prezidentiale",1,1522,852,644,208,0,827,25,1700,848,513,314
25,ILFOV,"1 DECEMBRIE",102543,"1 DECEMBRIE","ŞCOALA GIMNAZIALA NR. 1, CORP B",112,"Alegeri Prezidentiale",2,1626,947,789,158,0,926,21,1800,853,520,406
25,ILFOV,"1 DECEMBRIE",102543,"1 DECEMBRIE","ŞCOALA GIMNAZIALA NR. 1, CORP B",113,"Alegeri Prezidentiale",1,1535,870,677,192,1,849,21,1700,830,475,374
25,ILFOV,AFUMAŢI,100834,AFUMAŢI,"ȘCOALA GENERALĂ NR.1",114,"Alegeri Prezidentiale",1,764,595,418,175,2,590,5,850,255,432,158
25,ILFOV,AFUMAŢI,100834,AFUMAŢI,"ŞCOALA GENERALĂ NR. 1 CU CLASELE V - VIII",115,"Alegeri Prezidentiale",1,1131,755,615,138,2,748,7,1250,495,552,196
25,ILFOV,AFUMAŢI,100834,AFUMAŢI,"ŞCOALA GENERALĂ NR. 3 CU CLASELE I - IV",116,"Alegeri Prezidentiale",1,1653,1046,902,131,13,1036,10,1800,754,760,276
25,ILFOV,AFUMAŢI,100834,AFUMAŢI,"ŞCOALA GENERALĂ NR. 2 CU CLASELE I - IV",117,"Alegeri Prezidentiale",1,1642,1019,843,171,5,1002,17,1800,781,748,254
25,ILFOV,AFUMAŢI,100834,AFUMAŢI,"SCOALA CU CLASELE I-IV",118,"Alegeri Prezidentiale",1,1312,790,675,111,4,771,19,1400,610,587,184
25,ILFOV,BALOTEŞTI,100969,BALOTEŞTI,"CLĂDIRE POLICLINICĂ",119,"Alegeri Prezidentiale",1,1620,1302,882,331,89,1284,18,1800,498,848,436
25,ILFOV,BALOTEŞTI,100969,BALOTEŞTI,"ŞCOALA GIMNAZIALĂ NR. 1 BALOTEŞTI",120,"Alegeri Prezidentiale",1,1209,927,611,313,3,908,19,1300,373,568,340
25,ILFOV,BALOTEŞTI,100969,BALOTEŞTI,"ŞCOALA GIMNAZIALĂ NR. 1 BALOTEŞTI",121,"Alegeri Prezidentiale",1,936,721,533,186,2,709,12,1000,279,424,285
25,ILFOV,BALOTEŞTI,100969,BALOTEŞTI,"ŞCOALA PRIMARĂ NR. 2 BALOTEŞTI",122,"Alegeri Prezidentiale",1,1150,867,645,222,0,855,12,1300,433,570,285
25,ILFOV,BALOTEŞTI,100969,SĂFTICA,"ŞCOALA PRIMARĂ NR. 1 SĂFTICA",123,"Alegeri Prezidentiale",1,1155,891,622,236,33,879,12,1300,409,489,390
25,ILFOV,BALOTEŞTI,100969,BALOTEŞTI,"ŞCOALA PRIMARĂ NR.2 BALOTEŞTI",124,"Alegeri Prezidentiale",1,1042,829,512,317,0,816,13,1099,270,518,298
25,ILFOV,BERCENI,101145,BERCENI,"SCOALA PRIMARA NR. 2",125,"Alegeri Prezidentiale",2,1931,1734,1069,665,0,1706,28,2100,366,1155,551
25,ILFOV,BERCENI,101145,BERCENI,"SCOALA PRIMARA NR. 2",126,"Alegeri Prezidentiale",2,1411,1439,777,662,0,1416,23,1550,111,1010,406
25,ILFOV,BERCENI,101145,BERCENI,"ŞCOALA GIMNAZIALA NR. 1",127,"Alegeri Prezidentiale",1,1417,1296,808,488,0,1262,34,1550,254,841,421
25,ILFOV,BERCENI,101145,BERCENI,"SCOALA GIMNAZIALA NR. 1",128,"Alegeri Prezidentiale",1,1662,1386,981,405,0,1361,25,1800,414,915,446
25,ILFOV,BRĂNEŞTI,101298,BRĂNEŞTI,"ŞCOALA GIMNAZIALA NR.1",129,"Alegeri Prezidentiale",1,792,652,408,244,0,641,11,850,198,419,222
25,ILFOV,BRĂNEŞTI,101298,BRĂNEŞTI,"ŞCOALA GENERALĂ DIN CARTIERUL BĂJENARI",130,"Alegeri Prezidentiale",1,1819,1149,959,190,0,1131,18,2000,851,823,308
25,ILFOV,BRĂNEŞTI,101298,BRĂNEŞTI,"SCOALA GIMNAZIALA NR.1 BRANESTI",131,"Alegeri Prezidentiale",1,1357,785,645,140,0,769,16,1500,715,497,272
25,ILFOV,BRĂNEŞTI,101298,BRĂNEŞTI,"LICEUL TEORETIC ”TRAIAN LALESCU”",132,"Alegeri Prezidentiale",1,1824,1352,963,389,0,1325,27,2000,648,911,414
25,ILFOV,BRĂNEŞTI,101298,PASĂREA,"GRADINITA NR.2",133,"Alegeri Prezidentiale",1,908,650,435,215,0,639,11,1000,350,417,222
25,ILFOV,BRĂNEŞTI,101298,ISLAZ,"GRĂDINIŢA NR.1",134,"Alegeri Prezidentiale",1,1191,745,600,145,0,728,17,1300,555,396,332
25,ILFOV,CERNICA,101742,CERNICA,"ŞCOALA GIMNAZIALĂ NR.1",135,"Alegeri Prezidentiale",1,796,690,455,235,0,674,16,900,210,452,222
25,ILFOV,CERNICA,101742,CERNICA,"ŞCOALA GIMNAZIALĂ NR.1",136,"Alegeri Prezidentiale",1,830,570,447,123,0,562,8,900,330,399,163
25,ILFOV,CERNICA,101742,CERNICA,"ŞCOALA GIMNAZIALĂ NR.1",137,"Alegeri Prezidentiale",1,904,585,473,112,0,573,12,1000,415,405,168
25,ILFOV,CERNICA,101742,BĂLĂCEANCA,"ŞCOALA GIMNAZIALĂ NR.3",138,"Alegeri Prezidentiale",1,1391,765,615,150,0,757,8,1500,735,469,288
25,ILFOV,CERNICA,101742,BĂLĂCEANCA,"ŞCOALA GIMNAZIALĂ NR.3",139,"Alegeri Prezidentiale",1,1181,710,572,108,30,695,15,1300,590,422,273
25,ILFOV,CERNICA,101742,CĂLDĂRARU,"GRĂDINIŢA NR.5",140,"Alegeri Prezidentiale",1,920,735,532,203,0,711,24,1000,265,471,240
25,ILFOV,CERNICA,101742,TÂNGANU,"ŞCOALA GIMNAZIALĂ NR.2",141,"Alegeri Prezidentiale",1,1275,673,614,59,0,663,10,1400,727,463,200
25,ILFOV,CERNICA,101742,TÂNGANU,"ŞCOALA GIMNAZIALĂ NR.2",142,"Alegeri Prezidentiale",1,1307,698,593,105,0,686,12,1400,702,426,260
25,ILFOV,CHIAJNA,179249,CHIAJNA,"SALA DE SPORT ”CONCORDIA CHIAJNA",143,"Alegeri Prezidentiale",1,1661,1220,912,307,1,1186,34,1592,372,821,365
25,ILFOV,CHIAJNA,179249,CHIAJNA,"SALA DE SPORT ”CONCORDIA CHIAJNA”",144,"Alegeri Prezidentiale",1,1231,948,648,300,0,928,20,1350,402,619,309
25,ILFOV,CHIAJNA,179249,CHIAJNA,"SALA DE SPORT ”CONCORDIA CHIAJNA”",145,"Alegeri Prezidentiale",1,1776,1081,773,308,0,1060,21,1900,819,865,195
25,ILFOV,CHIAJNA,179249,CHIAJNA,"SALA DE SPORT ”CONCORDIA CHIAJNA”",146,"Alegeri Prezidentiale",2,1540,1033,759,274,0,1017,16,1700,667,682,335
25,ILFOV,CHIAJNA,179249,CHIAJNA,"SALA DE SPORT ”CONCORDIA CHIAJNA”",147,"Alegeri Prezidentiale",1,1909,1272,982,290,0,1236,36,2100,828,880,356
25,ILFOV,CHIAJNA,179249,ROŞU,"SALA DE SPORT A LICEULUI TEHNOLOGIC ”DOAMNA CHIAJNA”",148,"Alegeri Prezidentiale",1,1824,1275,940,335,0,1253,22,2000,725,844,409
25,ILFOV,CHIAJNA,179249,ROŞU,"SALA DE SPORT A LICEULUI TEHNOLOGIC ”DOAMNA CHIAJNA”",149,"Alegeri Prezidentiale",1,1775,1167,869,298,0,1142,25,1592,425,787,355
25,ILFOV,CHIAJNA,179249,ROŞU,"SALA DE SPORT A LICEULUI TEHNOLOGIC ”DOAMNA CHIAJNA”",150,"Alegeri Prezidentiale",1,1196,969,579,390,0,942,27,1300,331,587,355
25,ILFOV,CHIAJNA,179249,ROŞU,"SALA DE SPORT A LICEULUI TEHNOLOGIC ”DOAMNA CHIAJNA”",151,"Alegeri Prezidentiale",2,1789,1231,918,313,0,1204,27,1600,369,969,235
25,ILFOV,CHIAJNA,179249,ROŞU,"GRADINITA ”KIDS CLUB”",152,"Alegeri Prezidentiale",1,1423,1612,748,864,0,1576,36,1751,139,1308,268
25,ILFOV,CHIAJNA,179249,ROŞU,"GRADINITA ”KIDS CLUB”",153,"Alegeri Prezidentiale",2,1600,1799,792,1007,0,1769,30,2100,301,1441,328
25,ILFOV,CHIAJNA,179249,ROŞU,"GRADINITA ”KIDS CLUB”",154,"Alegeri Prezidentiale",1,1854,2169,791,1378,0,2128,41,2300,131,1767,361
25,ILFOV,CHIAJNA,179249,DUDU,"SEDIU ”POLITIA COMUNITARA CHIAJNA”",155,"Alegeri Prezidentiale",1,1899,1054,644,410,0,1029,25,2050,996,866,163
25,ILFOV,CHIAJNA,179249,DUDU,"SEDIU” POLITIA COMUNITARA CHIAJNA”",156,"Alegeri Prezidentiale",1,753,641,301,340,0,631,10,800,159,493,138
25,ILFOV,CIOLPANI,101902,CIOLPANI,"CĂMINUL CULTURAL CIOLPANI",157,"Alegeri Prezidentiale",1,1906,1085,859,225,1,1068,17,2100,1015,697,371
25,ILFOV,CIOLPANI,101902,PISCU,"CAMIN CULTURAL",158,"Alegeri Prezidentiale",1,772,491,369,122,0,483,8,850,359,332,151
25,ILFOV,CIOLPANI,101902,CIOLPANI,"GRADINITA NR.4",159,"Alegeri Prezidentiale",1,1170,690,506,148,36,682,8,1300,610,480,202
25,ILFOV,CIOLPANI,101902,IZVORANI,"GRADINITA NR.3",160,"Alegeri Prezidentiale",1,635,456,238,218,0,438,18,700,244,278,160
25,ILFOV,CIOROGÂRLA,101957,CIOROGÂRLA,"ŞCOALA GIMNAZIALĂ NR. 1 CIOROGÂRLA",161,"Alegeri Prezidentiale",1,1315,1146,649,497,0,1131,15,1400,254,743,388
25,ILFOV,CIOROGÂRLA,101957,CIOROGÂRLA,"ŞCOALA GIMNAZIALĂ NR. 1 CIOROGÂRLA",162,"Alegeri Prezidentiale",1,1814,1225,885,340,0,1205,20,2000,775,801,404
25,ILFOV,CIOROGÂRLA,101957,DÂRVARI,"ŞCOALA GIMNAZIALĂ NR. 2 DÂRVARI",163,"Alegeri Prezidentiale",1,1710,811,629,182,0,801,10,1900,1089,484,317
25,ILFOV,CLINCENI,102035,CLINCENI,"LICEUL CU PROGRAM SPORTIV NR 1 CLINCENI",164,"Alegeri Prezidentiale",2,1553,1000,801,199,0,983,17,1692,692,592,391
25,ILFOV,CLINCENI,102035,CLINCENI,"LICEUL CU PROGRAM SPORTIV NR. 1 CLINCENI",165,"Alegeri Prezidentiale",1,1104,813,529,284,0,804,9,1200,387,522,282
25,ILFOV,CLINCENI,102035,OLTENI,"LICEUL CU PROGRAM SPORTIV NR. 1CLINCENI",166,"Alegeri Prezidentiale",1,1724,1295,853,442,0,1270,25,1900,605,925,345
25,ILFOV,CLINCENI,102035,CLINCENI,"LICEUL CU PROGRAM SPORTIV NR. 1CLINCENI",167,"Alegeri Prezidentiale",1,1306,902,666,236,0,894,8,1400,498,580,314
25,ILFOV,COPĂCENI,179588,COPĂCENI,"AȘEZĂMÂNTUL SOCIAL AL BISERICII SF. DUMITRU",168,"Alegeri Prezidentiale",1,1436,918,739,179,0,903,15,1600,682,478,425
25,ILFOV,COPĂCENI,179588,COPĂCENI,"SCOALA GIMNAZIALA NR. 1",169,"Alegeri Prezidentiale",1,1021,576,490,86,0,569,7,1100,524,275,294
25,ILFOV,CORBEANCA,102160,CORBEANCA,"ŞCOALA GIMNAZIALĂ NR. 1",170,"Alegeri Prezidentiale",1,961,910,400,510,0,894,16,1100,190,667,227
25,ILFOV,CORBEANCA,102160,CORBEANCA,"ŞCOALA GIMNAZIALĂ NR. 1",171,"Alegeri Prezidentiale",2,1332,1088,777,311,0,1068,20,1450,362,839,229
25,ILFOV,CORBEANCA,102160,TAMAŞI,"ŞCOALA GIMNAZIALĂ NR. 2",172,"Alegeri Prezidentiale",1,1938,1425,1016,409,0,1408,17,1850,425,1051,357
25,ILFOV,CORBEANCA,102160,OSTRATU,"CLĂDIREA AFTER SCHOOL",173,"Alegeri Prezidentiale",1,1272,1522,779,743,0,1487,35,1550,28,1190,297
25,ILFOV,CORBEANCA,102160,PETREŞTI,"GRĂDINIŢA NR. 1",174,"Alegeri Prezidentiale",1,775,966,456,510,0,949,17,1150,184,694,255
25,ILFOV,CORNETU,102213,CORNETU,"ŞCOALA GIMNAZIALĂ NR.1",175,"Alegeri Prezidentiale",1,1051,668,512,156,0,659,9,1150,482,420,239
25,ILFOV,CORNETU,102213,CORNETU,"ŞCOALA GIMNAZIALĂ NR.1",176,"Alegeri Prezidentiale",1,889,544,425,119,0,532,12,1000,456,350,182
25,ILFOV,CORNETU,102213,CORNETU,"ŞCOALA GIMNAZIALĂ NR.1",177,"Alegeri Prezidentiale",1,937,566,432,134,0,561,5,1000,434,365,196
25,ILFOV,CORNETU,102213,CORNETU,"ŞCOALA GIMNAZIALĂ NR.1",178,"Alegeri Prezidentiale",1,944,582,456,126,0,574,8,1000,418,386,188
25,ILFOV,CORNETU,102213,CORNETU,"ŞCOALA GIMNAZIALĂ NR.1",179,"Alegeri Prezidentiale",1,1110,676,490,186,0,668,8,1200,524,415,253
25,ILFOV,DASCĂLU,102473,DASCĂLU,"ŞCOALA GIMNAZIALĂ DASCĂLU",180,"Alegeri Prezidentiale",1,1734,1121,808,312,1,1101,20,1900,779,754,347
25,ILFOV,DASCĂLU,102473,GAGU,"GRĂDINIŢA NR. 2 GAGU",181,"Alegeri Prezidentiale",1,645,298,236,62,0,294,4,700,402,212,82
25,ILFOV,DĂRĂŞTI-ILFOV,102525,DĂRĂŞTI-ILFOV,"ŞCOALA GENERALĂ NR. 1",182,"Alegeri Prezidentiale",2,1050,759,565,193,1,748,11,1150,391,485,263
25,ILFOV,DĂRĂŞTI-ILFOV,102525,DĂRĂŞTI-ILFOV,"ŞCOALA GENERALĂ NR. 1",183,"Alegeri Prezidentiale",1,1221,926,692,234,0,895,31,1300,374,481,414
25,ILFOV,DOBROEŞTI,179310,DOBROEŞTI,"ŞCOALA GIMNAZIALĂ NR. 1",184,"Alegeri Prezidentiale",1,1361,1070,762,306,2,1039,31,1500,430,674,365
25,ILFOV,DOBROEŞTI,179310,DOBROEŞTI,"ŞCOALA GIMNAZIALĂ NR. 1",185,"Alegeri Prezidentiale",1,1697,1206,889,317,0,1182,24,1900,694,807,375
25,ILFOV,DOBROEŞTI,179310,DOBROEŞTI,"ŞCOALA GIMNAZIALĂ NR. 1",186,"Alegeri Prezidentiale",2,1413,989,747,242,0,968,21,1550,561,646,322
25,ILFOV,DOBROEŞTI,179310,DOBROEŞTI,"SCOALA GIMNAZIALA NR. 2 CAMPUS SCOLAR DOBROESTI",187,"Alegeri Prezidentiale",1,1554,983,732,250,1,969,14,1700,717,749,220
25,ILFOV,DOBROEŞTI,179310,DOBROEŞTI,"SCOALA GIMNAZIALA NR. 2 CAMPUS SCOLAR DOBROESTI",188,"Alegeri Prezidentiale",1,1675,1109,831,277,1,1093,16,1800,691,821,272
25,ILFOV,DOBROEŞTI,179310,DOBROEŞTI,"SCOALA GIMNAZIALA NR. 2 CAMPUS SCOLAR DOBROESTI",189,"Alegeri Prezidentiale",1,1406,958,678,280,0,944,14,1550,592,681,263
25,ILFOV,DOMNEŞTI,102570,DOMNEŞTI,"CĂMINUL CULTURAL DOMNEȘTI",190,"Alegeri Prezidentiale",1,1932,1286,947,339,0,1262,24,2100,814,904,358
25,ILFOV,DOMNEŞTI,102570,DOMNEŞTI,"CĂMINUL CULTURAL DOMNEȘTI",191,"Alegeri Prezidentiale",1,1627,1323,799,524,0,1300,23,1800,477,899,401
25,ILFOV,DOMNEŞTI,102570,DOMNEŞTI,"ȘCOALA GIMNAZIALĂ ”GHEORGHE CORNELIU”",192,"Alegeri Prezidentiale",1,1525,1271,787,484,0,1249,22,1700,429,860,389
25,ILFOV,DOMNEŞTI,102570,DOMNEŞTI,"ȘCOALA GIMNAZIALĂ GHEORGHE CORNELIU",193,"Alegeri Prezidentiale",1,1925,1326,972,353,1,1304,22,2100,774,902,402
25,ILFOV,DOMNEŞTI,102570,ŢEGHEŞ,"ȘCOALA PRIMARĂ NR. 2 - ȘCOALA ȚEGHEȘ",194,"Alegeri Prezidentiale",1,816,672,470,202,0,653,19,900,228,513,140
25,ILFOV,DRAGOMIREŞTI-VALE,102605,DRAGOMIREŞTI-DEAL,"ȘCOALA GENERALĂ NR. 2",195,"Alegeri Prezidentiale",1,1309,1004,691,313,0,989,15,1400,396,660,329
25,ILFOV,DRAGOMIREŞTI-VALE,102605,ZURBAUA,"ȘCOALA GENERALĂ NR. 3",196,"Alegeri Prezidentiale",1,809,601,458,143,0,595,6,900,299,445,150
25,ILFOV,DRAGOMIREŞTI-VALE,102605,DRAGOMIREŞTI-VALE,"GRUPUL ȘCOLAR ”VINTILĂ BRĂTIANU”",197,"Alegeri Prezidentiale",1,1319,963,689,274,0,948,15,1450,487,681,267
25,ILFOV,DRAGOMIREŞTI-VALE,102605,DRAGOMIREŞTI-DEAL,"ȘCOALA VECHE",198,"Alegeri Prezidentiale",1,1017,786,579,207,0,769,17,1100,314,521,248
25,ILFOV,GĂNEASA,103130,GĂNEASA,"ŞCOALA GĂNEASA",199,"Alegeri Prezidentiale",1,772,504,325,179,0,491,13,850,346,364,127
25,ILFOV,GĂNEASA,103130,"MOARA DOMNEASCĂ","ŞCOALA MOARA DOMNEASCĂ",200,"Alegeri Prezidentiale",1,535,345,265,80,0,341,4,600,255,245,96
25,ILFOV,GĂNEASA,103130,COZIENI,"ŞCOALA COZIENI",201,"Alegeri Prezidentiale",1,634,340,282,58,0,328,12,700,360,211,117
25,ILFOV,GĂNEASA,103130,ŞINDRILIŢA,"GRĂDINIŢA ŞINDRILIŢA",202,"Alegeri Prezidentiale",1,1061,477,425,52,0,475,2,1150,673,286,189
25,ILFOV,GĂNEASA,103130,PITEASCA,"ŞCOALA PITEASCA",203,"Alegeri Prezidentiale",1,1053,599,525,74,0,591,8,1150,551,383,208
25,ILFOV,GLINA,179347,GLINA,"ŞCOALA GIMNAZIALĂ NR. 1",204,"Alegeri Prezidentiale",1,1661,913,754,159,0,895,18,1800,887,614,281
25,ILFOV,GLINA,179347,GLINA,"ŞCOALA GIMNAZIALĂ NR. 1",205,"Alegeri Prezidentiale",1,1408,777,635,142,0,767,10,1550,773,548,219
25,ILFOV,GLINA,179347,GLINA,"ŞCOALA GIMNAZIALĂ NR. 3",206,"Alegeri Prezidentiale",2,1537,670,580,90,0,660,10,1700,1030,432,228
25,ILFOV,GLINA,179347,CĂŢELU,"ŞCOALA GIMNAZIALĂ NR. 2",207,"Alegeri Prezidentiale",1,1265,790,583,207,0,776,14,1400,610,529,247
25,ILFOV,GLINA,179347,CĂŢELU,"ŞCOALA GIMNAZIALĂ NR. 2",208,"Alegeri Prezidentiale",1,933,704,457,247,0,685,19,1000,296,471,214
25,ILFOV,GRĂDIŞTEA,103443,GRĂDIŞTEA,"CĂMINUL CULTURAL MULTIFUNCŢIONAL",209,"Alegeri Prezidentiale",1,1671,935,758,177,0,925,10,1850,915,543,382
25,ILFOV,GRĂDIŞTEA,103443,SITARU,"ŞCOALA PRIMARĂ NR. 1 SITARU",210,"Alegeri Prezidentiale",1,863,437,351,86,0,429,8,900,463,238,191
25,ILFOV,GRUIU,103513,LIPIA,"GRĂDINIŢA DE COPII",211,"Alegeri Prezidentiale",1,1776,1035,827,208,0,1015,20,1950,915,616,399
25,ILFOV,GRUIU,103513,GRUIU,"ŞCOALA DE 4 ANI",212,"Alegeri Prezidentiale",1,1578,942,721,220,1,934,8,1700,758,651,283
25,ILFOV,GRUIU,103513,ŞANŢU-FLOREŞTI,"ŞCOALA DE 4 ANI",213,"Alegeri Prezidentiale",1,586,439,354,85,0,431,8,650,211,313,118
25,ILFOV,GRUIU,103513,"SILIŞTEA SNAGOVULUI","ŞCOALA DE 8 ANI",214,"Alegeri Prezidentiale",1,1781,1184,855,329,0,1153,31,1950,766,793,360
25,ILFOV,JILAVA,179383,JILAVA,"S.C. PROGRESU S.A.",215,"Alegeri Prezidentiale",1,1664,1008,664,136,208,990,18,2017,1009,487,503
25,ILFOV,JILAVA,179383,JILAVA,"ȘCOALA NR.2",216,"Alegeri Prezidentiale",1,1412,1034,755,100,179,1016,18,1818,784,532,484
25,ILFOV,JILAVA,179383,JILAVA,"ȘCOALA NR.1",217,"Alegeri Prezidentiale",1,1907,1249,835,232,182,1222,27,2317,1068,641,581
25,ILFOV,JILAVA,179383,JILAVA,"ȘCOALA NR.3",218,"Alegeri Prezidentiale",1,1871,1158,833,151,174,1136,22,2219,1061,533,603
25,ILFOV,JILAVA,179383,JILAVA,"INCINTA FOSTULUI CAP",219,"Alegeri Prezidentiale",1,1816,1219,753,158,308,1197,22,2330,1111,514,683
25,ILFOV,"MOARA VLĂSIEI",104243,"MOARA VLĂSIEI","ŞCOALA GIMNAZIALA NR. 2 MOARA VLASIEI",220,"Alegeri Prezidentiale",2,1817,1123,978,144,1,1103,20,2001,878,809,294
25,ILFOV,"MOARA VLĂSIEI",104243,"MOARA VLĂSIEI","ŞCOALA GIMNAZIALA NR. 1 MOARA VLASIEI",221,"Alegeri Prezidentiale",2,1751,1005,853,150,2,995,10,1800,795,718,277
25,ILFOV,"MOARA VLĂSIEI",104243,CĂCIULAŢI,"ŞCOALA GIMNAZIALA NR. 3 ”AL. DIMITRIE GHICA ”",222,"Alegeri Prezidentiale",1,1561,986,792,194,0,974,12,1600,614,758,216
25,ILFOV,MOGOŞOAIA,179463,MOGOŞOAIA,"SCOALA GIMNAZIALA NR.1 MOGOSOAIA",223,"Alegeri Prezidentiale",1,1222,1055,666,389,0,1030,25,1300,245,738,292
25,ILFOV,MOGOŞOAIA,179463,MOGOŞOAIA,"SCOALA GIMNAZIALA NR.1 MOGOSOAIA",224,"Alegeri Prezidentiale",1,1141,1008,614,394,0,991,17,1250,242,715,276
25,ILFOV,MOGOŞOAIA,179463,MOGOŞOAIA,"SCOALA GIMNAZIALA NR.1 MOGOSOAIA",225,"Alegeri Prezidentiale",1,1044,761,537,224,0,743,18,1150,389,533,210
25,ILFOV,MOGOŞOAIA,179463,MOGOŞOAIA,"SCOALA GIMNAZIALA NR.1 MOGOSOAIA",226,"Alegeri Prezidentiale",1,1609,894,766,128,0,880,14,1800,906,669,211
25,ILFOV,MOGOŞOAIA,179463,MOGOŞOAIA,"SCOALA GIMNAZIALA NR.1 MOGOSOAIA",227,"Alegeri Prezidentiale",1,1710,1119,947,172,0,1095,24,1900,781,853,242
25,ILFOV,NUCI,104421,MICŞUNEŞTII-MOARA,"ŞCOALA DIN SATUL MICŞUNEŞTII-MOARĂ",228,"Alegeri Prezidentiale",1,1330,973,718,217,38,961,12,1500,527,638,323
25,ILFOV,NUCI,104421,"MERII PETCHII","ŞCOALA DIN SATUL MERII PETCHII",229,"Alegeri Prezidentiale",1,894,705,475,172,58,696,9,1000,295,517,179
25,ILFOV,PERIŞ,104546,PERIŞ,"LICEUL PERIŞ",230,"Alegeri Prezidentiale",1,1915,947,754,193,0,931,16,2100,1153,586,345
25,ILFOV,PERIŞ,104546,PERIŞ,"ŞCOALA NR. 2 PERIS",231,"Alegeri Prezidentiale",1,2002,1107,894,213,0,1088,19,2200,1093,724,364
25,ILFOV,PERIŞ,104546,PERIŞ,"FOSTA ŞCOALA NR. 3 PERIS",232,"Alegeri Prezidentiale",1,616,424,307,117,0,414,10,700,276,282,132
25,ILFOV,PERIŞ,104546,BURIAŞ,"ŞCOALA NR. 4 BURIAŞ",233,"Alegeri Prezidentiale",1,1071,669,554,115,0,657,12,1200,531,478,179
25,ILFOV,PERIŞ,104546,BĂLTENI,"ŞCOALA NR. 5 BĂLTENI",234,"Alegeri Prezidentiale",1,414,317,216,101,0,312,5,450,133,197,115
25,ILFOV,PETRĂCHIOAIA,104582,PETRĂCHIOAIA,"STRUCTURA CU GRUPE DE PREŞCOLARI",235,"Alegeri Prezidentiale",1,1636,1055,832,223,0,1038,17,1808,753,714,324
25,ILFOV,PETRĂCHIOAIA,104582,MĂINEASCA,"STRUCTURA CU CLASELE I-IV ŞI GRUPE DE PREŞCOLARI",236,"Alegeri Prezidentiale",1,288,240,172,68,0,240,0,300,60,203,37
25,ILFOV,PETRĂCHIOAIA,104582,VÂNĂTORI,"STRUCTURA CU CLASELE I-IV ŞI GRUPE DE PREŞCOLARI",237,"Alegeri Prezidentiale",1,375,319,217,102,0,316,3,400,81,224,92
25,ILFOV,PETRĂCHIOAIA,104582,SURLARI,"STRUCTURA CU CLASELE I-IV ŞI GRUPE DE PREŞCOLARI",238,"Alegeri Prezidentiale",2,449,354,261,93,0,346,8,500,146,245,101
25,ILFOV,SNAGOV,105160,SNAGOV,"ŞCOALA GENERALĂ SNAGOV",239,"Alegeri Prezidentiale",1,1762,1259,833,425,1,1239,20,1950,691,775,464
25,ILFOV,SNAGOV,105160,GHERMĂNEŞTI,"CASA DE CULTURĂ GHERMĂNEŞTI",240,"Alegeri Prezidentiale",1,1282,960,664,295,1,946,14,1392,432,591,355
25,ILFOV,SNAGOV,105160,GHERMĂNEŞTI,"CASA DE CULTURĂ GHERMĂNEŞTI",241,"Alegeri Prezidentiale",1,1143,898,608,289,1,883,15,1300,402,555,328
25,ILFOV,SNAGOV,105160,CIOFLICENI,"GRĂDINIŢA NR. 1 CIOFLICENI",242,"Alegeri Prezidentiale",1,1026,717,501,216,0,695,22,1100,383,440,255
25,ILFOV,SNAGOV,105160,TÂNCĂBEŞTI,"ŞCOALA GIMNAZIALĂ ”CONSTANTIN I.BĂICOIANU”",243,"Alegeri Prezidentiale",2,1452,825,598,227,0,803,22,1600,775,499,304
25,ILFOV,"ŞTEFĂNEŞTII DE JOS",105419,"ŞTEFĂNEŞTII DE JOS","ŞCOALA GIMNAZIALĂ NR. 1 ȘTEFĂNEȘTII DE JOS",244,"Alegeri Prezidentiale",1,1325,897,647,250,0,878,19,1100,203,645,233
25,ILFOV,"ŞTEFĂNEŞTII DE JOS",105419,"ŞTEFĂNEŞTII DE JOS","ŞCOALA GIMNAZIALĂ NR. 1 ȘTEFĂNEȘTII DE JOS",245,"Alegeri Prezidentiale",1,1344,839,630,209,0,825,14,1500,661,455,370
25,ILFOV,"ŞTEFĂNEŞTII DE JOS",105419,CREŢULEASCA,"ŞCOALA GIMNAZIALĂ NR. 1 ȘTEFĂNEȘTII DE JOS",246,"Alegeri Prezidentiale",1,1848,936,792,144,0,927,9,2000,1064,588,339
25,ILFOV,"ŞTEFĂNEŞTII DE JOS",105419,"ŞTEFĂNEŞTII DE SUS","GRĂDINIȚA NR. 1 ȘTEFĂNEȘTII DE JOS",247,"Alegeri Prezidentiale",1,826,560,414,146,0,553,7,716,156,410,143
25,ILFOV,"ŞTEFĂNEŞTII DE JOS",105419,"ŞTEFĂNEŞTII DE JOS","COMPLEX REZIDENȚIAL COSMOPOLIS - COSMOPOLIS PLAZA",248,"Alegeri Prezidentiale",1,1399,1892,713,1179,0,1864,28,2008,116,1594,270
25,ILFOV,TUNARI,105570,TUNARI,"ȘCOALA GIMNAZIALĂ NR. 1 TUNARI - CORP A",249,"Alegeri Prezidentiale",1,1540,1515,800,715,0,1487,28,1700,185,1018,469
25,ILFOV,TUNARI,105570,TUNARI,"ŞCOALA GIMNAZIALĂ NR. 1 TUNARI - CORP C",250,"Alegeri Prezidentiale",1,1525,1216,743,473,0,1199,17,1600,384,843,356
25,ILFOV,TUNARI,105570,TUNARI,"ȘCOALA GIMNAZIALĂ NR. 1 TUNARI - CORP B",251,"Alegeri Prezidentiale",1,1798,1602,1022,580,0,1567,35,2000,398,1100,467
25,ILFOV,TUNARI,105570,DIMIENI,"CENTRUL DE ASISTENȚĂ DUPĂ PROGROMUL ȘCOLAR",252,"Alegeri Prezidentiale",1,256,304,143,160,1,301,3,400,96,209,92
25,ILFOV,VIDRA,105936,VIDRA,"ŞCOALA GENERALĂ NR. 304 VIDRA",253,"Alegeri Prezidentiale",1,711,392,280,112,0,390,2,792,400,274,116
25,ILFOV,VIDRA,105936,VIDRA,"ŞCOALA GENERALĂ NR. 304 VIDRA",254,"Alegeri Prezidentiale",2,1190,635,553,82,0,629,6,1300,665,427,202
25,ILFOV,VIDRA,105936,VIDRA,"ŞCOALA GENERALĂ NR. 301 VIDRA",255,"Alegeri Prezidentiale",1,1267,751,596,155,0,737,14,1400,649,522,215
25,ILFOV,VIDRA,105936,CREŢEŞTI,"ŞCOALA GENERALĂ NR. 302 CREŢEŞTI",256,"Alegeri Prezidentiale",1,1175,572,464,107,1,563,9,1300,728,349,214
25,ILFOV,VIDRA,105936,CREŢEŞTI,"ŞCOALA GENERALĂ NR. 302 CREŢEŞTI",257,"Alegeri Prezidentiale",1,857,400,353,47,0,397,3,900,500,271,126
25,ILFOV,VIDRA,105936,SINTEŞTI,"ŞCOALA GENERALĂ NR. 303 SINTEŞTI",258,"Alegeri Prezidentiale",1,843,413,310,103,0,409,4,900,487,224,185
25,ILFOV,VIDRA,105936,SINTEŞTI,"ŞCOALA GENERALĂ NR. 303 SINTEŞTI",259,"Alegeri Prezidentiale",1,1073,459,398,61,0,452,7,1161,702,152,300
26,MARAMUREŞ,"MUNICIPIUL BAIA MARE",106318,"BAIA MARE","AGENȚIA DE PLĂȚI ȘI INTERVENȚIE PENTRU AGRICULTURĂ MARAMUREȘ",1,"Alegeri Prezidentiale",1,1739,875,824,51,0,860,15,1800,925,650,210
26,MARAMUREŞ,"MUNICIPIUL BAIA MARE",106318,"BAIA MARE","ŞCOALA GIMNAZIALĂ „DR. VICTOR BABEȘ”",2,"Alegeri Prezidentiale",1,1951,1086,955,131,0,1063,23,2100,1014,808,255
26,MARAMUREŞ,"MUNICIPIUL BAIA MARE",106318,"BAIA MARE","ŞCOALA GIMNAZIALĂ „DR. VICTOR BABEȘ”",3,"Alegeri Prezidentiale",1,1972,1014,954,60,0,990,24,2100,1086,763,227
26,MARAMUREŞ,"MUNICIPIUL BAIA MARE",106318,"BAIA MARE","COLEGIUL TEHNIC „AUREL VLAICU”",4,"Alegeri Prezidentiale",1,1658,617,545,72,0,612,5,1800,1183,463,149
26,MARAMUREŞ,"MUNICIPIUL BAIA MARE",106318,"BAIA MARE","COLEGIUL TEHNIC „AUREL VLAICU”",5,"Alegeri Prezidentiale",1,1664,710,678,32,0,699,11,1800,1090,511,188
26,MARAMUREŞ,"MUNICIPIUL BAIA MARE",106318,"BAIA MARE","CENTRUL UNIVERSITAR NORD - „FACULTATEA TEHNICĂ”",6,"Alegeri Prezidentiale",1,1344,680,585,95,0,668,12,1500,820,509,159
26,MARAMUREŞ,"MUNICIPIUL BAIA MARE",106318,"BAIA MARE","ŞCOALA GIMNAZIALĂ „NICHITA STĂNESCU”",7,"Alegeri Prezidentiale",1,1607,961,831,80,50,949,12,1800,839,702,247
26,MARAMUREŞ,"MUNICIPIUL BAIA MARE",106318,"BAIA MARE","ŞCOALA GIMNAZIALĂ „NICHITA STĂNESCU”",8,"Alegeri Prezidentiale",1,1550,877,726,103,48,862,15,1700,823,635,227
26,MARAMUREŞ,"MUNICIPIUL BAIA MARE",106318,"BAIA MARE","ŞCOALA GIMNAZIALĂ „AVRAM IANCU”",9,"Alegeri Prezidentiale",1,1036,485,463,21,1,479,6,1100,615,370,109
26,MARAMUREŞ,"MUNICIPIUL BAIA MARE",106318,"BAIA MARE","ŞCOALA GIMNAZIALĂ „AVRAM IANCU”",10,"Alegeri Prezidentiale",1,1086,582,548,34,0,573,9,1200,618,419,154
26,MARAMUREŞ,"MUNICIPIUL BAIA MARE",106318,"BAIA MARE","ŞCOALA GIMNAZIALĂ „AVRAM IANCU”",11,"Alegeri Prezidentiale",1,975,515,475,40,0,503,12,1000,485,383,120
26,MARAMUREŞ,"MUNICIPIUL BAIA MARE",106318,"BAIA MARE","ŞCOALA GIMNAZIALĂ „AVRAM IANCU”",12,"Alegeri Prezidentiale",1,1361,707,670,37,0,695,12,1500,793,503,192
26,MARAMUREŞ,"MUNICIPIUL BAIA MARE",106318,"BAIA MARE","CENTRUL UNIVERSITAR NORD - „FACULTATEA DE LITERE”",13,"Alegeri Prezidentiale",1,1395,780,682,97,1,772,8,1500,720,588,184
26,MARAMUREŞ,"MUNICIPIUL BAIA MARE",106318,"BAIA MARE","CENTRUL UNIVERSITAR NORD - „FACULTATEA DE LITERE”",14,"Alegeri Prezidentiale",1,889,549,459,88,2,535,14,1000,451,419,116
26,MARAMUREŞ,"MUNICIPIUL BAIA MARE",106318,"BAIA MARE","ŞCOALA GIMNAZIALĂ „GEORGE COȘBUC”",15,"Alegeri Prezidentiale",1,1196,587,532,55,0,580,7,1300,713,427,153
26,MARAMUREŞ,"MUNICIPIUL BAIA MARE",106318,"BAIA MARE","ŞCOALA GIMNAZIALĂ „GEORGE COȘBUC”",16,"Alegeri Prezidentiale",1,1095,588,534,54,0,571,17,1200,612,412,159
26,MARAMUREŞ,"MUNICIPIUL BAIA MARE",106318,"BAIA MARE","ŞCOALA GIMNAZIALĂ „NICOLAE IORGA”",17,"Alegeri Prezidentiale",1,904,491,405,49,37,484,7,1000,509,354,130
26,MARAMUREŞ,"MUNICIPIUL BAIA MARE",106318,"BAIA MARE","ŞCOALA GIMNAZIALĂ „NICOLAE IORGA”",18,"Alegeri Prezidentiale",1,1177,642,577,42,23,628,14,1300,658,478,150
26,MARAMUREŞ,"MUNICIPIUL BAIA MARE",106318,"BAIA MARE","GRĂDINIȚA CU PROGRAM NORMAL NR. 20",19,"Alegeri Prezidentiale",1,1534,829,749,78,2,817,12,1700,871,595,222
26,MARAMUREŞ,"MUNICIPIUL BAIA MARE",106318,"BAIA MARE","LICEUL TEORETIC „EMIL RACOVIȚĂ”",20,"Alegeri Prezidentiale",1,1483,692,623,35,34,677,15,1700,1008,478,199
26,MARAMUREŞ,"MUNICIPIUL BAIA MARE",106318,"BAIA MARE","LICEUL TEORETIC „EMIL RACOVIȚĂ”",21,"Alegeri Prezidentiale",1,1487,809,682,83,44,798,11,1700,891,579,219
26,MARAMUREŞ,"MUNICIPIUL BAIA MARE",106318,"BAIA MARE","ŞCOALA GIMNAZIALĂ „ALEXANDRU IOAN CUZA”",22,"Alegeri Prezidentiale",1,1442,752,656,59,37,738,14,1600,848,545,193
26,MARAMUREŞ,"MUNICIPIUL BAIA MARE",106318,"BAIA MARE","ŞCOALA GIMNAZIALĂ „ALEXANDRU IOAN CUZA”",23,"Alegeri Prezidentiale",1,1564,868,697,84,87,855,13,1700,832,580,275
26,MARAMUREŞ,"MUNICIPIUL BAIA MARE",106318,"BAIA MARE","GRĂDINIȚA CU PROGRAM PRELUNGIT „MICUL PRINŢ”",24,"Alegeri Prezidentiale",1,1521,776,653,66,57,771,5,1600,824,583,188
26,MARAMUREŞ,"MUNICIPIUL BAIA MARE",106318,"BAIA MARE","ŞCOALA GIMNAZIALĂ NR. 18",25,"Alegeri Prezidentiale",1,1488,857,733,124,0,845,12,1600,743,653,192
26,MARAMUREŞ,"MUNICIPIUL BAIA MARE",106318,"BAIA MARE","ŞCOALA GIMNAZIALĂ NR. 18",26,"Alegeri Prezidentiale",1,1472,675,638,37,0,663,12,1600,925,491,172
26,MARAMUREŞ,"MUNICIPIUL BAIA MARE",106318,"BAIA MARE","REGISTRU AUTO ROMÂN, REPREZENTANȚA MARAMUREȘ",27,"Alegeri Prezidentiale",1,1396,522,472,50,0,513,9,1500,978,377,136
26,MARAMUREŞ,"MUNICIPIUL BAIA MARE",106318,"BAIA MARE","GRĂDINIȚA CU PROGRAM PRELUNGIT NR. 28",28,"Alegeri Prezidentiale",1,1468,657,597,59,1,646,11,1600,943,464,182
26,MARAMUREŞ,"MUNICIPIUL BAIA MARE",106318,"BAIA MARE","GRĂDINIȚA CU PROGRAM PRELUNGIT NR. 25",29,"Alegeri Prezidentiale",1,1443,635,574,61,0,631,4,1600,965,490,141
26,MARAMUREŞ,"MUNICIPIUL BAIA MARE",106318,"BAIA MARE","GRĂDINIȚA CU PROGRAM PRELUNGIT NR. 25",30,"Alegeri Prezidentiale",1,1290,624,582,42,0,620,4,1400,776,455,165
26,MARAMUREŞ,"MUNICIPIUL BAIA MARE",106318,"BAIA MARE","ŞCOALA GIMNAZIALĂ „ION LUCA CARAGIALE”",31,"Alegeri Prezidentiale",1,884,394,363,31,0,391,3,1000,606,276,115
26,MARAMUREŞ,"MUNICIPIUL BAIA MARE",106318,"BAIA MARE","ŞCOALA GIMNAZIALĂ „ION LUCA CARAGIALE”",32,"Alegeri Prezidentiale",1,1350,664,606,58,0,658,6,1400,736,473,185
26,MARAMUREŞ,"MUNICIPIUL BAIA MARE",106318,"BAIA MARE","ŞCOALA GIMNAZIALĂ „ION LUCA CARAGIALE”",33,"Alegeri Prezidentiale",1,1274,505,467,38,0,495,10,1400,895,362,133
26,MARAMUREŞ,"MUNICIPIUL BAIA MARE",106318,"BAIA MARE","GRĂDINIȚA CU PROGRAM PRELUNGIT NR. 34",34,"Alegeri Prezidentiale",1,1430,704,669,35,0,694,10,1500,796,509,185
26,MARAMUREŞ,"MUNICIPIUL BAIA MARE",106318,"BAIA MARE","GRĂDINIȚA CU PROGRAM PRELUNGIT „FLOARE DE COLŢ”",35,"Alegeri Prezidentiale",1,1470,642,603,39,0,630,12,1600,958,471,159
26,MARAMUREŞ,"MUNICIPIUL BAIA MARE",106318,"BAIA MARE","ŞCOALA GIMNAZIALĂ „ALEXANDRU IVASIUC”",36,"Alegeri Prezidentiale",1,1452,642,573,69,0,631,11,1600,958,491,140
26,MARAMUREŞ,"MUNICIPIUL BAIA MARE",106318,"BAIA MARE","ŞCOALA GIMNAZIALĂ „ALEXANDRU IVASIUC”",37,"Alegeri Prezidentiale",1,1429,689,666,23,0,678,11,1600,911,477,201
26,MARAMUREŞ,"MUNICIPIUL BAIA MARE",106318,"BAIA MARE","ŞCOALA GIMNAZIALĂ „DIMITRIE CANTEMIR”",38,"Alegeri Prezidentiale",1,1464,731,675,56,0,714,17,1600,869,524,190
26,MARAMUREŞ,"MUNICIPIUL BAIA MARE",106318,"BAIA MARE","ŞCOALA GIMNAZIALĂ „DIMITRIE CANTEMIR”",39,"Alegeri Prezidentiale",1,1416,651,593,57,1,636,15,1500,849,438,198
26,MARAMUREŞ,"MUNICIPIUL BAIA MARE",106318,"BAIA MARE","ŞCOALA GIMNAZIALĂ „DIMITRIE CANTEMIR”",40,"Alegeri Prezidentiale",1,1505,747,641,106,0,731,16,1600,853,541,190
26,MARAMUREŞ,"MUNICIPIUL BAIA MARE",106318,"BAIA MARE","ANSAMBLUL FOLCLORIC NAȚIONAL „TRANSILVANIA”",41,"Alegeri Prezidentiale",1,1391,744,669,74,1,734,10,1500,756,521,213
26,MARAMUREŞ,"MUNICIPIUL BAIA MARE",106318,"BAIA MARE","LICEUL CU PROGRAM SPORTIV",42,"Alegeri Prezidentiale",1,1443,733,668,65,0,722,11,1592,859,542,180
26,MARAMUREŞ,"MUNICIPIUL BAIA MARE",106318,"BAIA MARE","LICEUL CU PROGRAM SPORTIV",43,"Alegeri Prezidentiale",1,1246,567,520,47,0,552,15,1400,833,407,145
26,MARAMUREŞ,"MUNICIPIUL BAIA MARE",106318,"BAIA MARE","LICEUL CU PROGRAM SPORTIV",44,"Alegeri Prezidentiale",1,850,422,390,32,0,417,5,900,478,316,101
26,MARAMUREŞ,"MUNICIPIUL BAIA MARE",106318,"BAIA MARE","CENTRUL SOCIAL „ASSOC”",45,"Alegeri Prezidentiale",1,1537,725,699,26,0,716,9,1700,975,516,200
26,MARAMUREŞ,"MUNICIPIUL BAIA MARE",106318,"BAIA MARE","ADMINISTRAȚIA BAZELOR SPORTIVE",46,"Alegeri Prezidentiale",1,1486,780,735,45,0,760,20,1600,820,552,208
26,MARAMUREŞ,"MUNICIPIUL BAIA MARE",106318,"BAIA MARE","SALA SPORTURILOR „LASCĂR PANĂ”",47,"Alegeri Prezidentiale",1,1370,638,566,72,0,627,11,1500,862,471,156
26,MARAMUREŞ,"MUNICIPIUL BAIA MARE",106318,"BAIA MARE","SALA SPORTURILOR „LASCĂR PANĂ”",48,"Alegeri Prezidentiale",1,1587,738,697,41,0,718,20,1700,962,531,187
26,MARAMUREŞ,"MUNICIPIUL BAIA MARE",106318,"BAIA MARE","BIBLIOTECA JUDEȚEANĂ „PETRE DULFU”",49,"Alegeri Prezidentiale",1,1261,716,664,52,0,691,25,1400,684,529,162
26,MARAMUREŞ,"MUNICIPIUL BAIA MARE",106318,"BAIA MARE","LICEUL DE ARTE",50,"Alegeri Prezidentiale",1,1140,637,587,49,1,620,17,1200,563,502,118
26,MARAMUREŞ,"MUNICIPIUL BAIA MARE",106318,"BAIA MARE","LICEUL DE ARTE",51,"Alegeri Prezidentiale",1,1153,619,590,29,0,604,15,1200,581,497,107
26,MARAMUREŞ,"MUNICIPIUL BAIA MARE",106318,"BAIA MARE","LICEUL TEORETIC SANITAR",52,"Alegeri Prezidentiale",1,1361,688,638,50,0,669,19,1500,812,539,130
26,MARAMUREŞ,"MUNICIPIUL BAIA MARE",106318,"BAIA MARE","GRĂDINIȚA CU PROGRAM NORMAL NR. 12",53,"Alegeri Prezidentiale",1,1640,825,790,35,0,814,11,1800,975,630,184
26,MARAMUREŞ,"MUNICIPIUL BAIA MARE",106318,"BAIA MARE","ŞCOALA GIMNAZIALĂ „NICOLAE BĂLCESCU”",54,"Alegeri Prezidentiale",2,1527,649,616,33,0,631,18,1700,1051,487,144
26,MARAMUREŞ,"MUNICIPIUL BAIA MARE",106318,"BAIA MARE","ŞCOALA GIMNAZIALĂ „NICOLAE BĂLCESCU”",55,"Alegeri Prezidentiale",1,1333,601,585,16,0,596,5,1400,799,434,162
26,MARAMUREŞ,"MUNICIPIUL BAIA MARE",106318,"BAIA MARE","ŞCOALA GIMNAZIALĂ „MIHAIL SADOVEANU”",56,"Alegeri Prezidentiale",1,1241,543,521,22,0,530,13,1300,757,368,162
26,MARAMUREŞ,"MUNICIPIUL BAIA MARE",106318,"BAIA MARE","ŞCOALA GIMNAZIALĂ „MIHAIL SADOVEANU”",57,"Alegeri Prezidentiale",1,1189,537,523,14,0,524,13,1300,763,382,142
26,MARAMUREŞ,"MUNICIPIUL BAIA MARE",106318,"BAIA MARE","ŞCOALA GIMNAZIALĂ NR. 13",58,"Alegeri Prezidentiale",1,1354,647,618,29,0,638,9,1500,853,429,209
26,MARAMUREŞ,"MUNICIPIUL BAIA MARE",106318,"BAIA MARE","ŞCOALA GIMNAZIALĂ „OCTAVIAN GOGA”",59,"Alegeri Prezidentiale",1,1126,552,486,66,0,538,14,1200,648,432,106
26,MARAMUREŞ,"MUNICIPIUL BAIA MARE",106318,"BAIA MARE","ŞCOALA GIMNAZIALĂ „OCTAVIAN GOGA”",60,"Alegeri Prezidentiale",1,1236,659,568,30,61,643,16,1300,641,498,145
26,MARAMUREŞ,"MUNICIPIUL BAIA MARE",106318,"BAIA MARE","COLEGIUL NAȚIONAL „GHEORGHE ȘINCAI”",61,"Alegeri Prezidentiale",1,1620,889,786,88,15,875,14,1800,911,662,213
26,MARAMUREŞ,"MUNICIPIUL BAIA MARE",106318,"BAIA MARE","COLEGIUL NAȚIONAL „VASILE LUCACIU”",62,"Alegeri Prezidentiale",1,1436,714,619,95,0,699,15,1600,886,534,165
26,MARAMUREŞ,"MUNICIPIUL BAIA MARE",106318,"BAIA MARE","COLEGIUL TEHNIC „GEORGE BARIȚIU”",63,"Alegeri Prezidentiale",1,1438,840,707,133,0,818,22,1600,760,598,220
26,MARAMUREŞ,"MUNICIPIUL BAIA MARE",106318,"BAIA MARE","ȘCOALA GIMNAZIALĂ „LUCIAN BLAGA”",64,"Alegeri Prezidentiale",1,1123,585,535,37,13,573,12,1300,715,432,141
26,MARAMUREŞ,"MUNICIPIUL BAIA MARE",106318,"BAIA MARE","ȘCOALA GIMNAZIALĂ „LUCIAN BLAGA”",65,"Alegeri Prezidentiale",1,1041,524,481,43,0,511,13,1200,676,360,151
26,MARAMUREŞ,"MUNICIPIUL BAIA MARE",106318,"BAIA MARE","ȘCOALA GIMNAZIALĂ „LUCIAN BLAGA”",66,"Alegeri Prezidentiale",1,1705,946,890,56,0,927,19,1899,953,693,234
26,MARAMUREŞ,"MUNICIPIUL BAIA MARE",106318,"BAIA MARE","ȘCOALA GIMNAZIALĂ „LUCIAN BLAGA”",67,"Alegeri Prezidentiale",1,1612,745,692,53,0,731,14,1700,955,594,137
26,MARAMUREŞ,"MUNICIPIUL BAIA MARE",106318,"BAIA MARE","COLEGIUL TEHNIC „ANGHEL SALIGNY”",68,"Alegeri Prezidentiale",1,1651,977,858,117,2,959,18,1800,823,747,212
26,MARAMUREŞ,"MUNICIPIUL BAIA MARE",106318,"BAIA MARE","SC DRUMURI ȘI PODURI MARAMUREȘ SA",69,"Alegeri Prezidentiale",1,1434,523,464,59,0,510,13,1600,1077,370,140
26,MARAMUREŞ,"MUNICIPIUL BAIA MARE",106318,"BAIA MARE","CENTRUL „PHOENIX”",70,"Alegeri Prezidentiale",1,1432,524,476,47,1,520,4,1500,976,413,107
26,MARAMUREŞ,"MUNICIPIUL BAIA MARE",106318,"BAIA MARE","ŞCOALA GIMNAZIALĂ „VASILE ALECSANDRI”",71,"Alegeri Prezidentiale",1,1495,710,613,97,0,699,11,1600,890,571,128
26,MARAMUREŞ,"MUNICIPIUL BAIA MARE",106318,"BAIA MARE","ŞCOALA GIMNAZIALĂ „VASILE ALECSANDRI”",72,"Alegeri Prezidentiale",1,1536,687,619,67,1,677,10,1692,1005,553,124
26,MARAMUREŞ,"MUNICIPIUL BAIA MARE",106318,"BAIA MARE","ŞCOALA GIMNAZIALĂ „VASILE ALECSANDRI”",73,"Alegeri Prezidentiale",1,1450,614,579,35,0,604,10,1600,986,493,111
26,MARAMUREŞ,"MUNICIPIUL BAIA MARE",106318,"BAIA MARE","ŞCOALA GIMNAZIALĂ „VASILE ALECSANDRI”",74,"Alegeri Prezidentiale",1,1571,685,652,33,0,669,16,1700,1015,573,96
26,MARAMUREŞ,"MUNICIPIUL BAIA MARE",106318,"BAIA MARE","ŞCOALA GIMNAZIALĂ „VASILE ALECSANDRI”",75,"Alegeri Prezidentiale",1,1297,503,468,35,0,493,10,1400,897,387,106
26,MARAMUREŞ,"MUNICIPIUL BAIA MARE",106318,"BAIA MARE","GRĂDINIȚA CU PROGRAM PRELUNGIT „OTILIA CAZIMIR”",76,"Alegeri Prezidentiale",1,1627,821,765,56,0,800,21,1800,979,617,183
26,MARAMUREŞ,"MUNICIPIUL BAIA MARE",106318,"BAIA MARE","GRĂDINIȚA CU PROGRAM PRELUNGIT „OTILIA CAZIMIR”",77,"Alegeri Prezidentiale",1,1333,541,498,43,0,532,9,1500,959,434,98
26,MARAMUREŞ,"MUNICIPIUL BAIA MARE",106318,"BAIA MARE","CENTRUL „SFÂNTUL FRANCISC DE ASSISI”",78,"Alegeri Prezidentiale",1,1532,619,569,50,0,608,11,1700,1081,505,103
26,MARAMUREŞ,"MUNICIPIUL BAIA MARE",106318,"BAIA MARE","GRĂDINIȚA CU PROGRAM PRELUNGIT NR. 27",79,"Alegeri Prezidentiale",1,1775,822,751,71,0,809,13,1900,1078,663,146
26,MARAMUREŞ,"MUNICIPIUL BAIA MARE",106318,"BAIA MARE","ŞCOALA GIMNAZIALĂ „SIMION BĂRNUȚIU”",80,"Alegeri Prezidentiale",1,1817,803,738,65,0,795,8,2000,1197,652,143
26,MARAMUREŞ,"MUNICIPIUL BAIA MARE",106318,"BAIA MARE","ŞCOALA GIMNAZIALĂ „SIMION BĂRNUȚIU”",81,"Alegeri Prezidentiale",1,1907,955,908,47,0,935,20,2100,1145,705,230
26,MARAMUREŞ,"MUNICIPIUL BAIA MARE",106318,"BAIA MARE","CENTRUL „SALVAȚI FAMILIA”",82,"Alegeri Prezidentiale",1,1914,907,847,60,0,897,10,2100,1193,745,152
26,MARAMUREŞ,"MUNICIPIUL BAIA MARE",106318,"BAIA MARE","CENTRUL COMUNITAR ROMANII",83,"Alegeri Prezidentiale",1,1231,350,329,21,0,338,12,1300,950,252,86
26,MARAMUREŞ,"MUNICIPIUL BAIA MARE",106318,"BAIA MARE","COLEGIUL TEHNIC „COSTIN D. NENIȚESCU”",84,"Alegeri Prezidentiale",3,1512,561,513,48,0,551,10,1600,1039,419,132
26,MARAMUREŞ,"MUNICIPIUL BAIA MARE",106318,"BAIA MARE","COLEGIUL TEHNIC „COSTIN D. NENIȚESCU”",85,"Alegeri Prezidentiale",1,1310,617,594,23,0,611,6,1400,783,495,116
26,MARAMUREŞ,"MUNICIPIUL SIGHETU MARMAŢIEI",106559,"SIGHETU MARMAŢIEI","ȘCOALA GENERALĂ NR. 8",86,"Alegeri Prezidentiale",1,1124,392,375,17,0,387,5,1200,808,228,159
26,MARAMUREŞ,"MUNICIPIUL SIGHETU MARMAŢIEI",106559,"SIGHETU MARMAŢIEI","ȘCOALA GENERALĂ NR. 1",87,"Alegeri Prezidentiale",1,1448,521,497,24,0,516,5,1600,1079,348,168
26,MARAMUREŞ,"MUNICIPIUL SIGHETU MARMAŢIEI",106559,"SIGHETU MARMAŢIEI","ȘCOALA GENERALĂ NR. 11",88,"Alegeri Prezidentiale",1,1103,423,405,18,0,417,6,1200,777,299,118
26,MARAMUREŞ,"MUNICIPIUL SIGHETU MARMAŢIEI",106559,"SIGHETU MARMAŢIEI","GRĂDINIȚA NR. 12",89,"Alegeri Prezidentiale",1,1449,573,544,29,0,560,13,1600,1027,395,165
26,MARAMUREŞ,"MUNICIPIUL SIGHETU MARMAŢIEI",106559,"SIGHETU MARMAŢIEI","UNIVERSITATEA „BABEȘ-BOLYAI”",90,"Alegeri Prezidentiale",1,1211,493,398,50,45,482,11,1400,907,349,133
26,MARAMUREŞ,"MUNICIPIUL SIGHETU MARMAŢIEI",106559,"SIGHETU MARMAŢIEI","UNIVERSITATEA „BABEȘ-BOLYAI”",91,"Alegeri Prezidentiale",1,537,238,185,14,39,233,5,600,362,155,78
26,MARAMUREŞ,"MUNICIPIUL SIGHETU MARMAŢIEI",106559,"SIGHETU MARMAŢIEI","LICEUL „REGELE FERDINAND”",92,"Alegeri Prezidentiale",1,898,312,257,55,0,307,5,1000,688,232,75
26,MARAMUREŞ,"MUNICIPIUL SIGHETU MARMAŢIEI",106559,"SIGHETU MARMAŢIEI","LICEUL „REGELE FERDINAND”",93,"Alegeri Prezidentiale",1,1052,458,444,14,0,448,10,1200,742,280,168
26,MARAMUREŞ,"MUNICIPIUL SIGHETU MARMAŢIEI",106559,"SIGHETU MARMAŢIEI","COLEGIUL NAȚIONAL „DRAGOȘ VODĂ”",94,"Alegeri Prezidentiale",1,915,375,348,27,0,368,7,1000,625,257,111
26,MARAMUREŞ,"MUNICIPIUL SIGHETU MARMAŢIEI",106559,"SIGHETU MARMAŢIEI","COLEGIUL NAȚIONAL „DRAGOȘ VODĂ”",95,"Alegeri Prezidentiale",1,811,364,341,23,0,358,6,900,536,283,75
26,MARAMUREŞ,"MUNICIPIUL SIGHETU MARMAŢIEI",106559,"SIGHETU MARMAŢIEI","COLEGIUL NAȚIONAL „DRAGOȘ VODĂ”",96,"Alegeri Prezidentiale",1,1494,548,504,43,1,539,9,1600,1052,390,149
26,MARAMUREŞ,"MUNICIPIUL SIGHETU MARMAŢIEI",106559,"SIGHETU MARMAŢIEI","LICEUL „TARAS SEVCENCO”",97,"Alegeri Prezidentiale",1,1227,540,490,50,0,529,11,1300,760,403,126
26,MARAMUREŞ,"MUNICIPIUL SIGHETU MARMAŢIEI",106559,"SIGHETU MARMAŢIEI","LICEUL „TARAS SEVCENCO”",98,"Alegeri Prezidentiale",1,1275,558,531,25,2,545,13,1400,842,361,184
26,MARAMUREŞ,"MUNICIPIUL SIGHETU MARMAŢIEI",106559,"SIGHETU MARMAŢIEI","ȘCOALA GENERALĂ NR. 2",99,"Alegeri Prezidentiale",1,1419,560,523,37,0,550,10,1500,940,396,154
26,MARAMUREŞ,"MUNICIPIUL SIGHETU MARMAŢIEI",106559,"SIGHETU MARMAŢIEI","GRĂDINIȚA NR. 9",100,"Alegeri Prezidentiale",1,1582,721,681,40,0,711,10,1700,979,529,182
26,MARAMUREŞ,"MUNICIPIUL SIGHETU MARMAŢIEI",106559,"SIGHETU MARMAŢIEI","ȘCOALA GENERALĂ NR. 9",101,"Alegeri Prezidentiale",1,1235,530,495,35,0,516,14,1300,770,358,158
26,MARAMUREŞ,"MUNICIPIUL SIGHETU MARMAŢIEI",106559,"SIGHETU MARMAŢIEI","ȘCOALA GENERALĂ NR. 9",102,"Alegeri Prezidentiale",2,1113,448,406,42,0,440,8,1200,752,311,129
26,MARAMUREŞ,"MUNICIPIUL SIGHETU MARMAŢIEI",106559,"SIGHETU MARMAŢIEI","LICEUL TEHNOLOGIC FORESTIER",103,"Alegeri Prezidentiale",1,887,331,284,47,0,328,3,1000,669,228,100
26,MARAMUREŞ,"MUNICIPIUL SIGHETU MARMAŢIEI",106559,"SIGHETU MARMAŢIEI","LICEUL TEHNOLOGIC FORESTIER",104,"Alegeri Prezidentiale",1,1104,441,416,25,0,431,10,1200,759,283,148
26,MARAMUREŞ,"MUNICIPIUL SIGHETU MARMAŢIEI",106559,"SIGHETU MARMAŢIEI","ȘCOALA GENERALĂ NR. 6",105,"Alegeri Prezidentiale",1,1780,677,661,16,0,657,20,1900,1223,441,216
26,MARAMUREŞ,"MUNICIPIUL SIGHETU MARMAŢIEI",106559,"SIGHETU MARMAŢIEI","ȘCOALA GENERALĂ NR. 10",106,"Alegeri Prezidentiale",1,1384,526,503,22,1,514,12,1500,974,353,161
26,MARAMUREŞ,"MUNICIPIUL SIGHETU MARMAŢIEI",106559,"SIGHETU MARMAŢIEI","ȘCOALA GENERALĂ NR. 10",107,"Alegeri Prezidentiale",1,801,330,292,38,0,330,0,900,570,223,107
26,MARAMUREŞ,"MUNICIPIUL SIGHETU MARMAŢIEI",106559,"SIGHETU MARMAŢIEI","ȘCOALA GENERALĂ NR. 10",108,"Alegeri Prezidentiale",1,949,346,326,20,0,340,6,1000,654,254,86
26,MARAMUREŞ,"MUNICIPIUL SIGHETU MARMAŢIEI",106559,"SIGHETU MARMAŢIEI","GRĂDINIȚA NR. 1",109,"Alegeri Prezidentiale",1,1041,428,390,38,0,421,7,1100,672,266,155
26,MARAMUREŞ,"MUNICIPIUL SIGHETU MARMAŢIEI",106559,"SIGHETU MARMAŢIEI","GRĂDINIȚA NR. 1",110,"Alegeri Prezidentiale",1,837,316,297,19,0,305,11,900,584,217,88
26,MARAMUREŞ,"MUNICIPIUL SIGHETU MARMAŢIEI",106559,"SIGHETU MARMAŢIEI","SALA POLIVALENTĂ",111,"Alegeri Prezidentiale",1,1048,467,407,60,0,463,4,1100,633,312,151
26,MARAMUREŞ,"MUNICIPIUL SIGHETU MARMAŢIEI",106559,"SIGHETU MARMAŢIEI","SALA POLIVALENTĂ",112,"Alegeri Prezidentiale",1,828,332,320,12,0,322,10,900,568,225,97
26,MARAMUREŞ,"MUNICIPIUL SIGHETU MARMAŢIEI",106559,"SIGHETU MARMAŢIEI","SALA POLIVALENTĂ",113,"Alegeri Prezidentiale",1,1882,750,725,25,0,734,16,2100,1350,486,248
26,MARAMUREŞ,"MUNICIPIUL SIGHETU MARMAŢIEI",106559,"SIGHETU MARMAŢIEI","ȘCOALA GENERALĂ NR. 5",114,"Alegeri Prezidentiale",1,1232,537,513,23,1,529,8,1300,763,362,167
26,MARAMUREŞ,"MUNICIPIUL SIGHETU MARMAŢIEI",106559,"SIGHETU MARMAŢIEI","ȘCOALA GENERALĂ NR. 5",115,"Alegeri Prezidentiale",1,1340,516,482,34,0,508,8,1500,984,376,132
26,MARAMUREŞ,"MUNICIPIUL SIGHETU MARMAŢIEI",106559,"SIGHETU MARMAŢIEI","ȘCOALA GENERALĂ NR. 7",116,"Alegeri Prezidentiale",2,825,322,310,12,0,322,0,900,578,251,71
26,MARAMUREŞ,"ORAŞ BAIA SPRIE",106684,"BAIA SPRIE","COLEGIUL TEHNIC DE TRANSPORTURI AUTO",117,"Alegeri Prezidentiale",1,1173,494,469,25,0,484,10,1300,806,379,105
26,MARAMUREŞ,"ORAŞ BAIA SPRIE",106684,"BAIA SPRIE","COLEGIUL TEHNIC DE TRANSPORTURI AUTO",118,"Alegeri Prezidentiale",1,1241,540,523,17,0,531,9,1300,760,434,97
26,MARAMUREŞ,"ORAŞ BAIA SPRIE",106684,"BAIA SPRIE","COLEGIUL TEHNIC DE TRANSPORTURI AUTO",119,"Alegeri Prezidentiale",1,1127,400,370,30,0,396,4,1200,800,324,72
26,MARAMUREŞ,"ORAŞ BAIA SPRIE",106684,"BAIA SPRIE","COLEGIUL TEHNIC DE TRANSPORTURI AUTO",120,"Alegeri Prezidentiale",1,1228,525,488,22,15,518,7,1300,775,379,139
26,MARAMUREŞ,"ORAŞ BAIA SPRIE",106684,"BAIA SPRIE","ȘCOALA GIMNAZIALĂ",121,"Alegeri Prezidentiale",1,1629,640,603,37,0,630,10,1700,1060,470,160
26,MARAMUREŞ,"ORAŞ BAIA SPRIE",106684,"BAIA SPRIE","ȘCOALA GIMNAZIALĂ",122,"Alegeri Prezidentiale",1,1540,664,642,22,0,653,11,1700,1036,496,157
26,MARAMUREŞ,"ORAŞ BAIA SPRIE",106684,CHIUZBAIA,"ȘCOALA GIMNAZIALĂ",123,"Alegeri Prezidentiale",1,530,279,246,33,0,276,3,600,321,208,68
26,MARAMUREŞ,"ORAŞ BAIA SPRIE",106684,"SATU NOU DE SUS","ȘCOALA GIMNAZIALĂ „IOAN SLAVICI”",124,"Alegeri Prezidentiale",2,906,503,444,58,1,501,2,1000,497,413,88
26,MARAMUREŞ,"ORAŞ BAIA SPRIE",106684,"BAIA SPRIE","SALA DE SPORT",125,"Alegeri Prezidentiale",1,821,438,403,35,0,436,2,900,462,355,81
26,MARAMUREŞ,"ORAŞ BAIA SPRIE",106684,"BAIA SPRIE","SALA DE SPORT",126,"Alegeri Prezidentiale",1,1265,569,539,30,0,558,11,1400,831,400,158
26,MARAMUREŞ,"ORAŞ BAIA SPRIE",106684,"TĂUŢII DE SUS","ȘCOALA GIMNAZIALĂ „IOAN SLAVICI”",127,"Alegeri Prezidentiale",1,1228,765,471,47,247,758,7,1500,735,410,348
26,MARAMUREŞ,"ORAŞ BAIA SPRIE",106684,"TĂUŢII DE SUS","ȘCOALA GIMNAZIALĂ „IOAN SLAVICI”",128,"Alegeri Prezidentiale",1,1174,543,512,31,0,533,10,1300,757,402,131
26,MARAMUREŞ,"ORAŞ BORŞA",106746,BORŞA,"ŞCOALA NR. 1",129,"Alegeri Prezidentiale",1,1484,392,358,34,0,388,4,1600,1208,251,137
26,MARAMUREŞ,"ORAŞ BORŞA",106746,BORŞA,"ŞCOALA NR. 1",130,"Alegeri Prezidentiale",1,1350,441,419,22,0,435,6,1400,959,299,136
26,MARAMUREŞ,"ORAŞ BORŞA",106746,BORŞA,"ŞCOALA NR. 8",131,"Alegeri Prezidentiale",1,1310,458,431,27,0,448,10,1400,942,262,186
26,MARAMUREŞ,"ORAŞ BORŞA",106746,BORŞA,"ŞCOALA NR. 8",132,"Alegeri Prezidentiale",1,1319,460,446,14,0,459,1,1400,940,316,143
26,MARAMUREŞ,"ORAŞ BORŞA",106746,BORŞA,"ŞCOALA NR. 9",133,"Alegeri Prezidentiale",1,1593,508,475,33,0,504,4,1700,1192,325,179
26,MARAMUREŞ,"ORAŞ BORŞA",106746,BORŞA,"ŞCOALA NR. 9",134,"Alegeri Prezidentiale",1,1058,368,313,22,33,359,9,1200,832,229,130
26,MARAMUREŞ,"ORAŞ BORŞA",106746,BORŞA,"ŞCOALA NR. 9 CORP B",135,"Alegeri Prezidentiale",1,1116,416,364,16,36,409,7,1200,784,270,139
26,MARAMUREŞ,"ORAŞ BORŞA",106746,BORŞA,"ŞCOALA NR. 9 CORP B",136,"Alegeri Prezidentiale",1,818,309,250,18,41,301,8,900,591,195,106
26,MARAMUREŞ,"ORAŞ BORŞA",106746,BORŞA,"ŞCOALA NR. 9 CORP B",137,"Alegeri Prezidentiale",1,1071,368,314,20,34,356,12,1200,832,219,137
26,MARAMUREŞ,"ORAŞ BORŞA",106746,BORŞA,"ŞCOALA GÎRLEA",138,"Alegeri Prezidentiale",1,1054,354,344,10,0,351,3,1200,846,228,123
26,MARAMUREŞ,"ORAŞ BORŞA",106746,BORŞA,"ŞCOALA REPEDEA",139,"Alegeri Prezidentiale",1,850,258,250,8,0,256,2,900,642,158,98
26,MARAMUREŞ,"ORAŞ BORŞA",106746,BORŞA,"ŞCOALA REPEDEA",140,"Alegeri Prezidentiale",1,993,320,299,21,0,317,3,1100,780,201,116
26,MARAMUREŞ,"ORAŞ BORŞA",106746,BORŞA,"ŞCOALA POIANA",141,"Alegeri Prezidentiale",2,947,294,280,14,0,291,3,1000,706,186,105
26,MARAMUREŞ,"ORAŞ BORŞA",106746,BORŞA,"ŞCOALA POIANA",142,"Alegeri Prezidentiale",1,983,270,254,16,0,265,5,1097,827,181,84
26,MARAMUREŞ,"ORAŞ BORŞA",106746,BORŞA,"ŞCOALA BIRŢ",143,"Alegeri Prezidentiale",1,1311,428,409,19,0,423,5,1400,972,293,130
26,MARAMUREŞ,"ORAŞ BORŞA",106746,BORŞA,"ŞCOALA FÎNTÎNA",144,"Alegeri Prezidentiale",1,1144,343,297,46,0,336,7,1300,957,267,69
26,MARAMUREŞ,"ORAŞ BORŞA",106746,BORŞA,"ŞCOALA ROTUNDU",145,"Alegeri Prezidentiale",1,1106,337,323,14,0,334,3,1200,863,176,158
26,MARAMUREŞ,"ORAŞ BORŞA",106746,BORŞA,"ŞCOALA ROTUNDU",146,"Alegeri Prezidentiale",1,1200,417,405,12,0,415,2,1300,883,246,169
26,MARAMUREŞ,"ORAŞ BORŞA",106746,"BĂILE BORŞA","ŞCOALA NR. 7",147,"Alegeri Prezidentiale",1,1214,417,390,27,0,411,6,1300,883,244,167
26,MARAMUREŞ,"ORAŞ BORŞA",106746,BORŞA,"ŞCOALA NR. 7",148,"Alegeri Prezidentiale",1,1342,410,403,6,1,402,8,1490,1080,201,201
26,MARAMUREŞ,"ORAŞ CAVNIC",106782,CAVNIC,"COLEGIUL ECONOMIC „PINTEA VITEAZUL”",149,"Alegeri Prezidentiale",1,1767,716,679,37,0,697,19,1900,1184,448,249
26,MARAMUREŞ,"ORAŞ CAVNIC",106782,CAVNIC,"ŞCOALA GENERALĂ NR. 2",150,"Alegeri Prezidentiale",1,1693,709,673,34,2,697,12,1908,1199,388,309
26,MARAMUREŞ,"ORAŞ CAVNIC",106782,CAVNIC,"ŞCOALA GENERALĂ NR. 1",151,"Alegeri Prezidentiale",1,776,258,221,37,0,255,3,800,542,196,59
26,MARAMUREŞ,"ORAŞ DRAGOMIREŞTI",108017,DRAGOMIREŞTI,"SALA DE SPORT",152,"Alegeri Prezidentiale",1,1224,499,479,19,1,495,4,1300,801,319,176
26,MARAMUREŞ,"ORAŞ DRAGOMIREŞTI",108017,DRAGOMIREŞTI,"CĂMINUL CULTURAL",153,"Alegeri Prezidentiale",1,1351,521,492,29,0,515,6,1500,979,308,207
26,MARAMUREŞ,"ORAŞ SĂLIŞTEA DE SUS",108892,"SĂLIŞTEA DE SUS","CASA DE CULTURĂ",154,"Alegeri Prezidentiale",1,1642,669,646,23,0,664,5,1800,1131,406,258
26,MARAMUREŞ,"ORAŞ SĂLIŞTEA DE SUS",108892,"SĂLIŞTEA DE SUS","ŞCOALA GIMNAZIALĂ „MIHAI EMINESCU”",155,"Alegeri Prezidentiale",1,1557,607,578,29,0,605,2,1700,1093,365,240
26,MARAMUREŞ,"ORAŞ SĂLIŞTEA DE SUS",108892,"SĂLIŞTEA DE SUS","ŞCOALA GIMNAZIALĂ „MIHAI EMINESCU” LOCAL CENTRU 2",156,"Alegeri Prezidentiale",1,1026,397,378,19,0,394,3,1100,703,234,160
26,MARAMUREŞ,"ORAŞ SEINI",108963,SEINI,"CASA DE CULTURĂ",157,"Alegeri Prezidentiale",1,1751,789,727,62,0,779,10,1900,1111,549,230
26,MARAMUREŞ,"ORAŞ SEINI",108963,SEINI,"ŞCOALA GENERALĂ NR. 1",158,"Alegeri Prezidentiale",1,1717,804,761,43,0,784,20,1900,1096,550,234
26,MARAMUREŞ,"ORAŞ SEINI",108963,SEINI,"LICEUL TEHNOLOGIC AGRICOL „ALEXIU BERINDE”, ŞCOALA GENERALĂ SEINI",159,"Alegeri Prezidentiale",1,1892,791,739,52,0,781,10,2100,1309,635,146
26,MARAMUREŞ,"ORAŞ SEINI",108963,SEINI,"ŞCOALA MAGHIARĂ",160,"Alegeri Prezidentiale",1,1291,575,532,43,0,566,9,1400,825,418,148
26,MARAMUREŞ,"ORAŞ SEINI",108963,SĂBIŞA,ŞCOALA,161,"Alegeri Prezidentiale",1,681,374,342,32,0,371,3,700,326,264,107
26,MARAMUREŞ,"ORAŞ SEINI",108963,"VIILE APEI","SALA MULTIFUNCŢIONALĂ VIILE APEI",162,"Alegeri Prezidentiale",1,549,293,262,31,0,286,7,600,307,206,80
26,MARAMUREŞ,"ORAŞ ŞOMCUTA MARE",109176,"ŞOMCUTA MARE","CASA DE CULTURĂ",163,"Alegeri Prezidentiale",1,848,389,347,40,2,384,5,900,511,239,145
26,MARAMUREŞ,"ORAŞ ŞOMCUTA MARE",109176,"ŞOMCUTA MARE","ȘCOALA GENERALĂ CU CLASELE I-IV",164,"Alegeri Prezidentiale",1,733,366,312,54,0,366,0,800,434,221,145
26,MARAMUREŞ,"ORAŞ ŞOMCUTA MARE",109176,"ŞOMCUTA MARE","GRĂDINIȚA CU PROGRAM PRELUNGIT",165,"Alegeri Prezidentiale",1,980,489,430,56,3,487,2,1000,511,286,201
26,MARAMUREŞ,"ORAŞ ŞOMCUTA MARE",109176,"ŞOMCUTA MARE","ȘCOALA GENERALĂ NR. 2",166,"Alegeri Prezidentiale",1,761,292,272,20,0,290,2,800,508,64,226
26,MARAMUREŞ,"ORAŞ ŞOMCUTA MARE",109176,BUCIUMI,"CĂMINUL CULTURAL",167,"Alegeri Prezidentiale",1,644,357,318,38,1,356,1,700,343,143,213
26,MARAMUREŞ,"ORAŞ ŞOMCUTA MARE",109176,BUTEASA,"ȘCOALA GENERALĂ",168,"Alegeri Prezidentiale",1,316,175,166,9,0,172,3,370,195,83,89
26,MARAMUREŞ,"ORAŞ ŞOMCUTA MARE",109176,"CODRU BUTESII","ȘCOALA GENERALĂ",169,"Alegeri Prezidentiale",1,203,151,126,25,0,150,1,300,149,51,99
26,MARAMUREŞ,"ORAŞ ŞOMCUTA MARE",109176,"FINTEUŞU MARE","ȘCOALA GENERALĂ",170,"Alegeri Prezidentiale",1,529,328,272,55,1,325,3,599,271,167,158
26,MARAMUREŞ,"ORAŞ ŞOMCUTA MARE",109176,HOVRILA,"CĂMINUL CULTURAL",171,"Alegeri Prezidentiale",1,215,147,130,17,0,145,2,300,153,67,78
26,MARAMUREŞ,"ORAŞ ŞOMCUTA MARE",109176,CIOLT,"CĂMINUL CULTURAL",172,"Alegeri Prezidentiale",1,516,262,244,18,0,262,0,600,338,133,129
26,MARAMUREŞ,"ORAŞ ŞOMCUTA MARE",109176,"VĂLENII ŞOMCUTEI","CĂMINUL CULTURAL",173,"Alegeri Prezidentiale",1,627,359,327,32,0,356,3,700,341,167,189
26,MARAMUREŞ,"ORAŞ TĂUŢII-MĂGHERĂUŞ",106461,BĂIŢA,"ȘCOALA GENERALĂ",174,"Alegeri Prezidentiale",1,864,485,428,57,0,472,13,892,407,375,97
26,MARAMUREŞ,"ORAŞ TĂUŢII-MĂGHERĂUŞ",106461,"BOZÂNTA MARE","ȘCOALA GENERALĂ",175,"Alegeri Prezidentiale",1,567,307,273,34,0,305,2,600,293,188,117
26,MARAMUREŞ,"ORAŞ TĂUŢII-MĂGHERĂUŞ",106461,NISTRU,"ȘCOALA GENERALĂ",176,"Alegeri Prezidentiale",1,584,349,309,40,0,344,5,600,251,261,83
26,MARAMUREŞ,"ORAŞ TĂUŢII-MĂGHERĂUŞ",106461,TĂUŢII-MĂGHERĂUŞ,"SALA MULTIFUNCȚIONALĂ MĂGHERĂUȘ",177,"Alegeri Prezidentiale",1,1179,733,652,81,0,719,14,1208,475,571,148
26,MARAMUREŞ,"ORAŞ TĂUŢII-MĂGHERĂUŞ",106461,TĂUŢII-MĂGHERĂUŞ,"LICEUL TEHNOLOGIC „TRAIAN VUIA”",178,"Alegeri Prezidentiale",1,1088,736,566,170,0,725,11,1200,464,545,180
26,MARAMUREŞ,"ORAŞ TĂUŢII-MĂGHERĂUŞ",106461,TĂUŢII-MĂGHERĂUŞ,"GRĂDINIȚA HOȘTEZE",179,"Alegeri Prezidentiale",1,803,567,437,130,0,553,14,900,333,396,157
26,MARAMUREŞ,"ORAŞ TĂUŢII-MĂGHERĂUŞ",106461,BĂIŢA,"CANTONUL SILVIC",180,"Alegeri Prezidentiale",1,221,137,112,25,0,136,1,290,153,100,36
26,MARAMUREŞ,"ORAŞ TĂUŢII-MĂGHERĂUŞ",106461,BĂIŢA,"GRĂDINIȚA ROȘTI",181,"Alegeri Prezidentiale",1,476,291,267,24,0,286,5,500,209,204,82
26,MARAMUREŞ,"ORAŞ TĂUŢII-MĂGHERĂUŞ",106461,BUŞAG,"CĂMINUL CULTURAL",182,"Alegeri Prezidentiale",1,551,322,278,44,0,320,2,600,278,209,111
26,MARAMUREŞ,"ORAŞ TĂUŢII-MĂGHERĂUŞ",106461,MERIŞOR,"CĂMINUL CULTURAL",183,"Alegeri Prezidentiale",1,258,195,155,36,4,194,1,300,105,131,63
26,MARAMUREŞ,"ORAŞ TĂUŢII-MĂGHERĂUŞ",106461,ULMOASA,"CĂMINUL CULTURAL",184,"Alegeri Prezidentiale",1,149,103,89,14,0,102,1,200,97,61,41
26,MARAMUREŞ,"ORAŞ TĂUŢII-MĂGHERĂUŞ",106461,NISTRU,"GRĂDINIȚA 9 MAI",185,"Alegeri Prezidentiale",1,331,217,193,24,0,215,2,400,183,128,87
26,MARAMUREŞ,"ORAŞ TÂRGU LĂPUŞ",106817,"TÂRGU LĂPUŞ","CASA ORĂŞENEASCĂ DE CULTURĂ",186,"Alegeri Prezidentiale",1,1679,754,696,57,1,745,9,1800,1046,504,241
26,MARAMUREŞ,"ORAŞ TÂRGU LĂPUŞ",106817,"TÂRGU LĂPUŞ","ŞCOALA GENERALĂ PENTRU COPII CU DEFICIENŢE",187,"Alegeri Prezidentiale",1,1870,871,785,55,31,864,7,1992,1121,568,296
26,MARAMUREŞ,"ORAŞ TÂRGU LĂPUŞ",106817,"TÂRGU LĂPUŞ","PRIMĂRIA ORAŞULUI TÎRGU LĂPUŞ",188,"Alegeri Prezidentiale",1,1345,645,578,67,0,636,9,1400,755,431,205
26,MARAMUREŞ,"ORAŞ TÂRGU LĂPUŞ",106817,BOIERENI,"ŞCOALA GENERALĂ",189,"Alegeri Prezidentiale",1,286,118,97,21,0,116,2,300,182,85,31
26,MARAMUREŞ,"ORAŞ TÂRGU LĂPUŞ",106817,BORCUT,"ŞCOALA GENERALĂ",190,"Alegeri Prezidentiale",1,412,214,199,15,0,212,2,500,286,161,51
26,MARAMUREŞ,"ORAŞ TÂRGU LĂPUŞ",106817,CUFOAIA,"ŞCOALA GENERALĂ",191,"Alegeri Prezidentiale",1,172,104,86,18,0,103,1,200,96,88,15
26,MARAMUREŞ,"ORAŞ TÂRGU LĂPUŞ",106817,DĂMĂCUŞENI,"ŞCOALA GENERALĂ",192,"Alegeri Prezidentiale",1,776,227,217,10,0,227,0,800,573,204,23
26,MARAMUREŞ,"ORAŞ TÂRGU LĂPUŞ",106817,"DOBRICU LĂPUŞULUI","ŞCOALA GENERALĂ",193,"Alegeri Prezidentiale",1,327,155,131,24,0,152,3,400,245,125,27
26,MARAMUREŞ,"ORAŞ TÂRGU LĂPUŞ",106817,DUMBRAVA,"ŞCOALA GENERALĂ",194,"Alegeri Prezidentiale",1,180,86,72,14,0,86,0,200,114,66,20
26,MARAMUREŞ,"ORAŞ TÂRGU LĂPUŞ",106817,FÂNTÂNELE,"ŞCOALA GENERALĂ",195,"Alegeri Prezidentiale",1,197,86,67,19,0,85,1,200,114,49,36
26,MARAMUREŞ,"ORAŞ TÂRGU LĂPUŞ",106817,GROAPE,"ŞCOALA GENERALĂ",196,"Alegeri Prezidentiale",1,62,32,22,10,0,32,0,100,68,20,12
26,MARAMUREŞ,"ORAŞ TÂRGU LĂPUŞ",106817,INĂU,"ŞCOALA GENERALĂ",197,"Alegeri Prezidentiale",1,210,112,93,19,0,110,2,300,188,100,10
26,MARAMUREŞ,"ORAŞ TÂRGU LĂPUŞ",106817,RĂZOARE,"ȘCOALA GENERALA",198,"Alegeri Prezidentiale",1,651,222,197,25,0,222,0,701,479,146,76
26,MARAMUREŞ,"ORAŞ TÂRGU LĂPUŞ",106817,RĂZOARE,"ŞCOALA GENERALĂ",199,"Alegeri Prezidentiale",1,483,197,180,17,0,191,6,508,311,103,88
26,MARAMUREŞ,"ORAŞ TÂRGU LĂPUŞ",106817,ROGOZ,"CĂMINUL CULTURAL",200,"Alegeri Prezidentiale",1,1260,447,434,13,0,445,2,1400,953,298,147
26,MARAMUREŞ,"ORAŞ TÂRGU LĂPUŞ",106817,ROHIA,GRĂDINIŢĂ,201,"Alegeri Prezidentiale",1,596,258,224,34,0,256,2,600,342,152,104
26,MARAMUREŞ,"ORAŞ TÂRGU LĂPUŞ",106817,STOICENI,"ŞCOALA GENERALĂ",202,"Alegeri Prezidentiale",1,215,107,97,10,0,106,1,300,193,85,21
26,MARAMUREŞ,"ORAŞ ULMENI",109265,CHELINŢA,"ȘCOALA GIMNAZIALĂ",203,"Alegeri Prezidentiale",1,1184,559,529,30,0,549,10,1300,741,268,281
26,MARAMUREŞ,"ORAŞ ULMENI",109265,ULMENI,"CENTRUL DE CULTURĂ ȘI ARTĂ",204,"Alegeri Prezidentiale",1,1202,590,560,30,0,575,15,1300,710,352,223
26,MARAMUREŞ,"ORAŞ ULMENI",109265,ARDUZEL,"ȘCOALA GIMNAZIALĂ „KOS KAROLY”",205,"Alegeri Prezidentiale",1,712,331,310,8,13,325,6,800,469,272,53
26,MARAMUREŞ,"ORAŞ ULMENI",109265,MÂNĂU,"CĂMINUL CULTURAL",206,"Alegeri Prezidentiale",1,882,405,373,32,0,402,3,1000,595,293,109
26,MARAMUREŞ,"ORAŞ ULMENI",109265,SOMEŞ-UILEAC,"CĂMINUL CULTURAL",207,"Alegeri Prezidentiale",1,624,274,234,40,0,271,3,700,426,184,87
26,MARAMUREŞ,"ORAŞ ULMENI",109265,TOHAT,"CĂMINUL CULTURAL",208,"Alegeri Prezidentiale",1,195,122,106,14,2,121,1,300,178,77,44
26,MARAMUREŞ,"ORAŞ ULMENI",109265,ŢICĂU,"ȘCOALA PRIMARĂ",209,"Alegeri Prezidentiale",1,657,310,292,18,0,309,1,700,390,106,203
26,MARAMUREŞ,"ORAŞ ULMENI",109265,VICEA,"ȘCOALA PRIMARĂ",210,"Alegeri Prezidentiale",1,275,112,100,12,0,112,0,300,188,58,54
26,MARAMUREŞ,"ORAŞ VIŞEU DE SUS",106979,"VIŞEU DE SUS","ŞCOALA GENERALĂ NR. 2",211,"Alegeri Prezidentiale",1,1076,379,355,24,0,374,5,1192,813,249,125
26,MARAMUREŞ,"ORAŞ VIŞEU DE SUS",106979,"VIŞEU DE SUS","ŞCOALA GENERALĂ NR. 2",212,"Alegeri Prezidentiale",1,1067,377,365,12,0,373,4,1200,823,279,94
26,MARAMUREŞ,"ORAŞ VIŞEU DE SUS",106979,"VIŞEU DE SUS","LICEUL TEORETIC BOGDAN VODĂ",213,"Alegeri Prezidentiale",1,886,367,318,49,0,362,5,1000,633,261,101
26,MARAMUREŞ,"ORAŞ VIŞEU DE SUS",106979,"VIŞEU DE SUS","LICEUL TEORETIC BOGDAN VODĂ",214,"Alegeri Prezidentiale",1,919,381,365,16,0,376,5,1100,719,280,96
26,MARAMUREŞ,"ORAŞ VIŞEU DE SUS",106979,"VIŞEU DE SUS","LICEUL TEHNOLOGIC",215,"Alegeri Prezidentiale",1,1639,559,522,37,0,555,4,1800,1241,410,145
26,MARAMUREŞ,"ORAŞ VIŞEU DE SUS",106979,"VIŞEU DE SUS","LICEUL TEHNOLOGIC",216,"Alegeri Prezidentiale",1,1644,528,503,25,0,519,9,1800,1272,393,126
26,MARAMUREŞ,"ORAŞ VIŞEU DE SUS",106979,"VIŞEU DE SUS","LICEUL TEHNOLOGIC NR. 4",217,"Alegeri Prezidentiale",1,1063,369,359,10,0,365,4,1200,831,253,112
26,MARAMUREŞ,"ORAŞ VIŞEU DE SUS",106979,"VIŞEU DE SUS","LICEUL TEHNOLOGIC NR. 4",218,"Alegeri Prezidentiale",3,946,367,353,14,0,360,7,1000,633,229,131
26,MARAMUREŞ,"ORAŞ VIŞEU DE SUS",106979,"VIŞEU DE SUS","CANTINA DE AJUTOR SOCIAL",219,"Alegeri Prezidentiale",1,1514,662,631,31,0,647,15,1600,938,396,251
26,MARAMUREŞ,"ORAŞ VIŞEU DE SUS",106979,"VIŞEU DE SUS","ŞCOALA GIMNAZIALĂ NR. 7",220,"Alegeri Prezidentiale",1,1647,613,583,30,0,610,3,1800,1187,438,172
26,MARAMUREŞ,"ORAŞ VIŞEU DE SUS",106979,"VIŞEU DE SUS","ŞCOALA GIMNAZIALĂ NR. 7",221,"Alegeri Prezidentiale",1,1535,568,524,44,0,560,8,1600,1032,412,148
26,MARAMUREŞ,"ORAŞ VIŞEU DE SUS",106979,"VIŞEU DE SUS","ŞCOALA GIMNAZIALĂ NR. 3",222,"Alegeri Prezidentiale",1,755,307,291,16,0,304,3,800,493,255,49
26,MARAMUREŞ,ARDUSAT,107001,ARDUSAT,"ŞCOALA CU CLASELE I-VIII",223,"Alegeri Prezidentiale",1,1561,670,566,99,5,665,5,1600,930,425,240
26,MARAMUREŞ,ARDUSAT,107001,"ARIEŞU DE CÂMP","ŞCOALA CU CLASELE I-IV",224,"Alegeri Prezidentiale",1,225,130,102,28,0,130,0,300,170,104,26
26,MARAMUREŞ,ARDUSAT,107001,COLŢIREA,"ŞCOALA CU CLASELE I-IV",225,"Alegeri Prezidentiale",1,351,192,154,38,0,191,1,401,209,117,74
26,MARAMUREŞ,ARINIŞ,107047,ARINIŞ,"CĂMINUL CULTURAL",226,"Alegeri Prezidentiale",1,693,437,374,52,11,428,9,800,363,223,205
26,MARAMUREŞ,ARINIŞ,107047,TĂMĂŞEŞTI,"CĂMIN CULTURAL TĂMĂŞEŞTI",227,"Alegeri Prezidentiale",1,167,154,94,60,0,152,2,200,46,83,69
26,MARAMUREŞ,"ASUAJU DE SUS",107083,"ASUAJU DE SUS",PRIMĂRIA,228,"Alegeri Prezidentiale",1,759,408,351,54,3,403,5,800,392,195,208
26,MARAMUREŞ,"ASUAJU DE SUS",107083,"ASUAJU DE JOS","CĂMINUL CULTURAL",229,"Alegeri Prezidentiale",1,251,160,115,43,2,160,0,300,140,101,59
26,MARAMUREŞ,"BĂIŢA DE SUB CODRU",107118,"BĂIŢA DE SUB CODRU","ŞCOALA GIMNAZIALĂ",230,"Alegeri Prezidentiale",1,1190,635,553,73,9,632,3,1299,664,370,262
26,MARAMUREŞ,"BĂIŢA DE SUB CODRU",107118,URMENIŞ,"ŞCOALA CU CLASELE I-IV",231,"Alegeri Prezidentiale",1,255,152,133,19,0,146,6,300,148,94,52
26,MARAMUREŞ,BĂIUŢ,107154,STRÂMBU-BĂIUŢ,"CĂMINUL CULTURAL",232,"Alegeri Prezidentiale",1,494,206,178,28,0,205,1,607,401,126,79
26,MARAMUREŞ,BĂIUŢ,107154,BĂIUŢ,"ŞCOALA DE ARTE ŞI MESERII",233,"Alegeri Prezidentiale",1,1269,454,420,34,0,450,4,1400,946,299,151
26,MARAMUREŞ,BĂIUŢ,107154,"POIANA BOTIZII",GRĂDINIŢA,234,"Alegeri Prezidentiale",1,180,107,92,15,0,107,0,200,93,66,41
26,MARAMUREŞ,BĂSEŞTI,107190,BĂSEŞTI,"CĂMINUL CULTURAL",235,"Alegeri Prezidentiale",1,452,224,186,38,0,224,0,500,276,123,101
26,MARAMUREŞ,BĂSEŞTI,107190,ODEŞTI,"ŞCOALA CU CLASELE I-IV",236,"Alegeri Prezidentiale",1,315,148,117,31,0,147,1,402,254,87,60
26,MARAMUREŞ,BĂSEŞTI,107190,SĂLIŞTE,"CĂMINUL CULTURAL",237,"Alegeri Prezidentiale",1,73,60,35,25,0,60,0,100,40,35,25
26,MARAMUREŞ,BĂSEŞTI,107190,STREMŢ,"ŞCOALA CU CLASELE I-IV",238,"Alegeri Prezidentiale",1,232,86,67,19,0,86,0,300,214,52,34
26,MARAMUREŞ,BÂRSANA,107314,BÂRSANA,"ŞCOALA GIMNAZIALĂ „MIRCEA VULCANESCU”",239,"Alegeri Prezidentiale",1,1481,576,553,23,0,572,4,1600,1024,383,189
26,MARAMUREŞ,BÂRSANA,107314,BÂRSANA,"ŞCOALA GIMNAZIALĂ „MIRCEA VULCĂNESCU”",240,"Alegeri Prezidentiale",1,1153,461,435,26,0,459,2,1300,839,241,218
26,MARAMUREŞ,BÂRSANA,107314,BÂRSANA,"ȘCOALA „VALEA MUNTELUI”",241,"Alegeri Prezidentiale",1,620,251,235,16,0,249,2,700,449,156,93
26,MARAMUREŞ,BÂRSANA,107314,NĂNEŞTI,"ȘCOALA „NĂNEȘTI”",242,"Alegeri Prezidentiale",1,533,258,229,29,0,257,1,600,342,125,132
26,MARAMUREŞ,BICAZ,107234,BICAZ,"CĂMINUL CULTURAL",243,"Alegeri Prezidentiale",1,430,227,191,19,17,224,3,500,273,109,115
26,MARAMUREŞ,BICAZ,107234,CIUTA,"ŞCOALA CU CLASELE I-IV",244,"Alegeri Prezidentiale",1,139,119,73,35,11,119,0,200,81,59,60
26,MARAMUREŞ,BICAZ,107234,CORNI,"CĂMINUL CULTURAL",245,"Alegeri Prezidentiale",1,237,162,119,34,9,158,4,300,138,74,84
26,MARAMUREŞ,BISTRA,107270,BISTRA,"PRIMĂRIA BISTRA",246,"Alegeri Prezidentiale",1,812,336,316,20,0,335,1,900,564,252,83
26,MARAMUREŞ,BISTRA,107270,"CRASNA VIŞEULUI","ŞCOALA GIMNAZIALĂ",247,"Alegeri Prezidentiale",1,1268,483,464,19,0,477,6,1400,917,349,128
26,MARAMUREŞ,BISTRA,107270,"VALEA VIŞEULUI","ŞCOALA GIMNAZIALĂ",248,"Alegeri Prezidentiale",1,1193,388,368,20,0,379,9,1300,912,244,135
26,MARAMUREŞ,"BOCICOIU MARE",107350,"LUNCA LA TISA","ŞCOALA CU CLASELE I-VIII",249,"Alegeri Prezidentiale",1,692,258,237,19,2,256,2,800,542,161,95
26,MARAMUREŞ,"BOCICOIU MARE",107350,TISA,"ŞCOALA CU CLASELE I-VIII",250,"Alegeri Prezidentiale",1,1178,451,419,30,2,447,4,1300,849,296,151
26,MARAMUREŞ,"BOCICOIU MARE",107350,"BOCICOIU MARE","GRĂDINIŢA DE COPII",251,"Alegeri Prezidentiale",1,484,189,178,11,0,189,0,500,311,123,66
26,MARAMUREŞ,"BOCICOIU MARE",107350,CRĂCIUNEŞTI,"GRĂDINIŢA DE COPII",252,"Alegeri Prezidentiale",1,1291,558,519,39,0,552,6,1400,842,317,235
26,MARAMUREŞ,"BOGDAN VODĂ",107403,BOCICOEL,"ŞCOALA GENERALĂ",253,"Alegeri Prezidentiale",1,531,220,196,24,0,215,5,600,380,108,107
26,MARAMUREŞ,"BOGDAN VODĂ",107403,"BOGDAN VODĂ","CLUBUL DIN INCINTA PRIMĂRIEI",254,"Alegeri Prezidentiale",1,1987,783,733,50,0,778,5,2200,1417,513,265
26,MARAMUREŞ,"BOIU MARE",107430,"BOIU MARE",PRIMĂRIA,255,"Alegeri Prezidentiale",2,473,239,207,32,0,237,2,500,261,111,126
26,MARAMUREŞ,"BOIU MARE",107430,PRISLOP,"ŞCOALA GENERALĂ",256,"Alegeri Prezidentiale",1,387,191,166,25,0,188,3,400,209,113,75
26,MARAMUREŞ,"BOIU MARE",107430,"FRÂNCENII BOIULUI","ŞCOALA GENERALĂ",257,"Alegeri Prezidentiale",1,50,57,35,22,0,57,0,100,43,30,27
26,MARAMUREŞ,"BOIU MARE",107430,ROMÂNEŞTI,"ŞCOALA GENERALĂ",258,"Alegeri Prezidentiale",1,56,42,33,9,0,42,0,100,58,13,29
26,MARAMUREŞ,BOTIZA,107485,BOTIZA,"SEDIUL PRIMĂRIEI BOTIZA",259,"Alegeri Prezidentiale",1,1822,891,859,31,1,890,1,2000,1109,379,511
26,MARAMUREŞ,BOTIZA,107485,BOTIZA,"ŞCOALA PRIMARĂ VALEA SASULUI",260,"Alegeri Prezidentiale",1,268,152,138,14,0,150,2,300,148,85,65
26,MARAMUREŞ,BUDEŞTI,107519,SÂRBI,"ȘCOALA CU CLASELE I-VIII",261,"Alegeri Prezidentiale",1,667,354,342,12,0,353,1,700,346,197,156
26,MARAMUREŞ,BUDEŞTI,107519,BUDEŞTI,"SEDIUL PRIMĂRIEI",262,"Alegeri Prezidentiale",1,1153,603,573,24,6,601,2,1300,697,380,221
26,MARAMUREŞ,BUDEŞTI,107519,BUDEŞTI,"SEDIUL GRĂDINIȚEI",263,"Alegeri Prezidentiale",1,652,331,315,16,0,329,2,700,369,203,126
26,MARAMUREŞ,CĂLINEŞTI,107546,CORNEŞTI,"ŞCOALA GENERALĂ",264,"Alegeri Prezidentiale",1,347,141,124,17,0,140,1,400,259,114,26
26,MARAMUREŞ,CĂLINEŞTI,107546,CĂLINEŞTI,"CĂMINUL CULTURAL",265,"Alegeri Prezidentiale",1,1173,494,465,29,0,488,6,1300,806,378,110
26,MARAMUREŞ,CĂLINEŞTI,107546,VĂLENI,"CĂMINUL CULTURAL",266,"Alegeri Prezidentiale",1,1091,441,413,28,0,437,4,1200,759,262,175
26,MARAMUREŞ,"CÂMPULUNG LA TISA",107715,"CÂMPULUNG LA TISA",PRIMĂRIA,267,"Alegeri Prezidentiale",1,1251,305,305,0,0,304,1,1400,1095,256,48
26,MARAMUREŞ,"CÂMPULUNG LA TISA",107715,"CÂMPULUNG LA TISA",PRIMĂRIA,268,"Alegeri Prezidentiale",1,827,256,235,21,0,252,4,900,644,207,45
26,MARAMUREŞ,CERNEŞTI,107582,CERNEŞTI,"CENTRUL CULTURAL CERNEȘTI",269,"Alegeri Prezidentiale",1,675,342,311,29,2,342,0,709,367,219,123
26,MARAMUREŞ,CERNEŞTI,107582,TRESTIA,"CĂMINUL CULTURAL TRESTIA",270,"Alegeri Prezidentiale",1,593,365,337,17,11,364,1,722,357,158,206
26,MARAMUREŞ,CERNEŞTI,107582,BREBENI,"ȘCOALA PRIMARĂ BREBENI",271,"Alegeri Prezidentiale",1,173,113,91,22,0,113,0,200,87,83,30
26,MARAMUREŞ,CERNEŞTI,107582,MĂGURENI,"ȘCOALA PRIMARĂ MĂGURENI",272,"Alegeri Prezidentiale",1,176,109,85,24,0,108,1,200,91,79,29
26,MARAMUREŞ,CERNEŞTI,107582,FÂNAŢE,"ȘCOALA PRIMARĂ FÎNAȚE",273,"Alegeri Prezidentiale",1,547,231,204,24,3,231,0,600,369,131,100
26,MARAMUREŞ,CERNEŞTI,107582,CIOCOTIŞ,"GRĂDINIȚA CIOCOTIȘ",274,"Alegeri Prezidentiale",1,806,416,364,44,8,414,2,900,484,255,159
26,MARAMUREŞ,CICÂRLĂU,107662,CICÂRLĂU,"CĂMIN CULTURAL",275,"Alegeri Prezidentiale",1,1988,980,867,112,1,971,9,2200,1220,758,213
26,MARAMUREŞ,CICÂRLĂU,107662,ILBA,"CĂMIN CULTURAL",276,"Alegeri Prezidentiale",1,1121,457,404,53,0,454,3,1200,743,339,115
26,MARAMUREŞ,CICÂRLĂU,107662,"HANDALU ILBEI","CĂMIN CULTURAL",277,"Alegeri Prezidentiale",1,378,136,123,13,0,136,0,500,364,97,39
26,MARAMUREŞ,COAŞ,179837,COAŞ,"ŞCOALA GIMNAZIALA ”ION POPESCU DE COAȘ”",278,"Alegeri Prezidentiale",1,1108,627,561,63,3,625,2,1200,573,485,140
26,MARAMUREŞ,COAŞ,179837,ÎNTRERÂURI,"ŞCOALA PRIMARĂ ÎNTRERÂURI",279,"Alegeri Prezidentiale",1,68,53,36,17,0,50,3,100,47,37,13
26,MARAMUREŞ,COLTĂU,179846,COLTĂU,"CĂMINUL CULTURAL COLTĂU",280,"Alegeri Prezidentiale",1,1752,532,494,38,0,525,7,1900,1368,417,108
26,MARAMUREŞ,COLTĂU,179846,CĂTĂLINA,"CĂMIN CULTURAL CĂTĂLINA",281,"Alegeri Prezidentiale",1,379,227,190,36,1,225,2,400,173,189,36
26,MARAMUREŞ,COPALNIC-MĂNĂŞTUR,107733,BERINŢA,"SCOALA GENERALA(CORP NOU)",282,"Alegeri Prezidentiale",1,604,294,268,26,0,292,2,700,406,186,106
26,MARAMUREŞ,COPALNIC-MĂNĂŞTUR,107733,COPALNIC-DEAL,"CĂMINUL CULTURAL",283,"Alegeri Prezidentiale",1,74,35,22,13,0,35,0,100,65,28,7
26,MARAMUREŞ,COPALNIC-MĂNĂŞTUR,107733,FĂUREŞTI,"CĂMINUL CULTURAL",284,"Alegeri Prezidentiale",1,693,312,295,17,0,309,3,800,488,202,107
26,MARAMUREŞ,COPALNIC-MĂNĂŞTUR,107733,LĂSCHIA,"CĂMINUL CULTURAL",285,"Alegeri Prezidentiale",1,409,252,219,33,0,252,0,497,245,160,92
26,MARAMUREŞ,COPALNIC-MĂNĂŞTUR,107733,"PRELUCA NOUĂ","CĂMINUL CULTURAL",286,"Alegeri Prezidentiale",1,271,140,116,24,0,138,2,300,160,110,28
26,MARAMUREŞ,COPALNIC-MĂNĂŞTUR,107733,VAD,"ȘCOALA VAD",287,"Alegeri Prezidentiale",1,290,174,151,23,0,174,0,300,126,97,77
26,MARAMUREŞ,COPALNIC-MĂNĂŞTUR,107733,CĂRPINIŞ,ŞCOALA,288,"Alegeri Prezidentiale",1,283,173,145,28,0,167,6,293,120,108,59
26,MARAMUREŞ,COPALNIC-MĂNĂŞTUR,107733,"CURTUIUŞU MIC",ŞCOALA,289,"Alegeri Prezidentiale",1,209,105,81,24,0,103,2,300,195,72,31
26,MARAMUREŞ,COPALNIC-MĂNĂŞTUR,107733,"PRELUCA VECHE",ŞCOALA,290,"Alegeri Prezidentiale",1,290,132,122,10,0,132,0,300,168,114,18
26,MARAMUREŞ,COPALNIC-MĂNĂŞTUR,107733,COPALNIC,"CĂMINUL CULTURAL",291,"Alegeri Prezidentiale",1,544,215,176,39,0,209,6,600,385,156,53
26,MARAMUREŞ,COPALNIC-MĂNĂŞTUR,107733,RUŞOR,"FOSTA ȘCOALA I-IV RUȘOR",292,"Alegeri Prezidentiale",1,218,129,110,19,0,129,0,300,171,107,22
26,MARAMUREŞ,COPALNIC-MĂNĂŞTUR,107733,COPALNIC-MĂNĂŞTUR,"CĂMINUL CULTURAL",293,"Alegeri Prezidentiale",1,740,372,326,46,0,370,2,800,428,298,72
26,MARAMUREŞ,COROIENI,107868,COROIENI,PRIMÃRIE,294,"Alegeri Prezidentiale",1,332,175,141,30,4,175,0,379,204,122,53
26,MARAMUREŞ,COROIENI,107868,BABA,"ŞCOALA CU CLASELE I-IV",295,"Alegeri Prezidentiale",1,375,231,195,36,0,229,2,391,160,202,27
26,MARAMUREŞ,COROIENI,107868,DRĂGHIA,"ŞCOALA CU CLASELE I-IV",296,"Alegeri Prezidentiale",1,166,96,78,18,0,95,1,200,104,65,30
26,MARAMUREŞ,COROIENI,107868,"DEALU MARE","ŞCOALA CU CLASELE I-IV",297,"Alegeri Prezidentiale",1,173,114,90,24,0,113,1,200,86,58,55
26,MARAMUREŞ,COROIENI,107868,"VĂLENII LĂPUŞULUI","ŞCOALA GENERALÃ",298,"Alegeri Prezidentiale",1,733,436,413,23,0,429,7,800,364,368,61
26,MARAMUREŞ,CUPŞENI,107920,CUPŞENI,"ŞCOALA CU CLASELE I-VIII",299,"Alegeri Prezidentiale",1,646,281,268,13,0,277,4,700,419,190,87
26,MARAMUREŞ,CUPŞENI,107920,COSTENI,"ŞCOALA CU CLASELE I-VIII",300,"Alegeri Prezidentiale",1,341,155,140,15,0,155,0,400,245,128,27
26,MARAMUREŞ,CUPŞENI,107920,LIBOTIN,"ŞCOALA CU CLASELE V-VIII",301,"Alegeri Prezidentiale",1,858,410,391,19,0,407,3,900,490,265,142
26,MARAMUREŞ,CUPŞENI,107920,UNGURENI,"ŞCOALA PRIMARĂ",302,"Alegeri Prezidentiale",1,984,326,309,17,0,312,14,1100,774,111,201
26,MARAMUREŞ,DESEŞTI,107975,HĂRNICEŞTI,"CĂMINUL CULTURAL",303,"Alegeri Prezidentiale",1,458,228,209,16,3,228,0,500,272,186,42
26,MARAMUREŞ,DESEŞTI,107975,MARA,ȘCOALA,304,"Alegeri Prezidentiale",1,755,469,419,39,11,464,5,800,331,371,93
26,MARAMUREŞ,DESEŞTI,107975,DESEŞTI,"CĂMINUL CULTURAL",305,"Alegeri Prezidentiale",1,759,467,442,24,1,458,9,900,433,272,186
26,MARAMUREŞ,DUMBRĂVIŢA,108035,CĂRBUNARI,"ŞCOALA GENERALĂ",306,"Alegeri Prezidentiale",1,524,336,284,52,0,332,4,589,253,249,83
26,MARAMUREŞ,DUMBRĂVIŢA,108035,CHECHIŞ,"ŞCOALA GENERALĂ",307,"Alegeri Prezidentiale",1,794,396,346,50,0,386,10,900,504,294,92
26,MARAMUREŞ,DUMBRĂVIŢA,108035,RUS,"ŞCOALA GENERALĂ",308,"Alegeri Prezidentiale",1,535,286,253,33,0,285,1,609,323,241,44
26,MARAMUREŞ,DUMBRĂVIŢA,108035,SINDREŞTI,"ŞCOALA GENERALĂ",309,"Alegeri Prezidentiale",1,492,280,252,28,0,280,0,600,320,208,72
26,MARAMUREŞ,DUMBRĂVIŢA,108035,UNGURAŞ,"ŞCOALA GENERALĂ",310,"Alegeri Prezidentiale",1,400,249,222,27,0,244,5,400,151,173,71
26,MARAMUREŞ,DUMBRĂVIŢA,108035,DUMBRĂVIŢA,"ŞCOALA NOUĂ",311,"Alegeri Prezidentiale",1,938,514,465,49,0,508,6,1000,486,416,92
26,MARAMUREŞ,FĂRCAŞA,108106,FĂRCAŞA,"ȘCOALA GIMNAZIALĂ ”LUCIAN BLAGA” CORP C",312,"Alegeri Prezidentiale",1,1468,760,694,60,6,751,9,1600,840,527,224
26,MARAMUREŞ,FĂRCAŞA,108106,BUZEŞTI,"CĂMIN CULTURAL",313,"Alegeri Prezidentiale",1,539,196,159,31,6,192,4,600,404,151,41
26,MARAMUREŞ,FĂRCAŞA,108106,SÂRBI,"CĂMIN CULTURAL",314,"Alegeri Prezidentiale",1,425,255,216,32,7,250,5,500,245,143,107
26,MARAMUREŞ,FĂRCAŞA,108106,TĂMAIA,"CĂMIN CULTURAL",315,"Alegeri Prezidentiale",1,842,373,301,63,9,371,2,900,527,282,89
26,MARAMUREŞ,GÂRDANI,179855,GÂRDANI,"CĂMINUL CULTURAL",316,"Alegeri Prezidentiale",1,1119,597,526,71,0,593,4,1300,703,429,164
26,MARAMUREŞ,GIULEŞTI,108151,GIULEŞTI,"CĂMINUL CULTURAL",317,"Alegeri Prezidentiale",1,1048,407,383,24,0,407,0,1200,793,263,144
26,MARAMUREŞ,GIULEŞTI,108151,BERBEŞTI,"ȘCOALA CU CLASELE I-VIII",318,"Alegeri Prezidentiale",1,1217,505,477,28,0,501,4,1300,795,344,157
26,MARAMUREŞ,GIULEŞTI,108151,FEREŞTI,"ŞCOALA GENERALĂ",319,"Alegeri Prezidentiale",1,393,203,186,17,0,199,4,500,297,84,115
26,MARAMUREŞ,GROŞI,106363,GROŞI,"ȘCOALA GIMNAZIALĂ „GHEORGHE LUPAN”",320,"Alegeri Prezidentiale",1,1201,724,639,85,0,722,2,1300,576,539,183
26,MARAMUREŞ,GROŞI,106363,OCOLIŞ,"ȘCOALA GENERALĂ",321,"Alegeri Prezidentiale",1,387,173,121,52,0,171,2,399,226,133,38
26,MARAMUREŞ,GROŞI,106363,"SATU NOU DE JOS","ȘCOALA GENERALĂ",322,"Alegeri Prezidentiale",1,972,530,466,64,0,526,4,1100,570,430,96
26,MARAMUREŞ,"GROŞII ŢIBLEŞULUI",179622,"GROŞII ŢIBLEŞULUI","GRĂDINIŢA CU PROGRAM NORMAL GROŞII ŢIBLEŞULUI",323,"Alegeri Prezidentiale",1,929,515,475,40,0,512,3,1000,485,329,183
26,MARAMUREŞ,"GROŞII ŢIBLEŞULUI",179622,"GROŞII ŢIBLEŞULUI","ŞCOALA CU CLASELE I-IV GREBLE",324,"Alegeri Prezidentiale",2,781,425,393,32,0,424,1,900,475,297,127
26,MARAMUREŞ,IEUD,108204,IEUD,"ȘCOALA GIMNAZIALĂ",325,"Alegeri Prezidentiale",1,1524,515,484,30,1,513,2,1700,1185,309,204
26,MARAMUREŞ,IEUD,108204,IEUD,"ȘCOALA GIMNAZIALĂ",326,"Alegeri Prezidentiale",1,1600,550,521,26,3,547,3,1700,1150,361,186
26,MARAMUREŞ,IEUD,108204,IEUD,"ȘCOALA PLOPȘOR",327,"Alegeri Prezidentiale",1,346,114,102,12,0,112,2,400,286,70,42
26,MARAMUREŞ,LĂPUŞ,108222,LĂPUŞ,PRIMĂRIA,328,"Alegeri Prezidentiale",1,1419,647,604,43,0,644,3,1600,953,401,243
26,MARAMUREŞ,LĂPUŞ,108222,LĂPUŞ,"GRĂDINIȚA CU PROGRAM NORMAL ,3 GRUPE",329,"Alegeri Prezidentiale",1,1555,675,658,17,0,671,4,1700,1025,464,207
26,MARAMUREŞ,LEORDINA,108240,LEORDINA,PRIMĂRIA,330,"Alegeri Prezidentiale",1,1436,576,544,32,0,569,7,1600,1024,326,243
26,MARAMUREŞ,LEORDINA,108240,LEORDINA,ŞCOALA,331,"Alegeri Prezidentiale",1,540,198,181,17,0,196,2,600,402,131,65
26,MARAMUREŞ,"MIREŞU MARE",108268,IADĂRA,"ŞCOALA GENERALĂ",332,"Alegeri Prezidentiale",1,788,384,344,32,8,381,3,900,516,290,91
26,MARAMUREŞ,"MIREŞU MARE",108268,LUCĂCEŞTI,"CENTRUL MULTIFUNCŢIONAL",333,"Alegeri Prezidentiale",1,512,244,222,22,0,242,2,600,356,152,90
26,MARAMUREŞ,"MIREŞU MARE",108268,"DĂNEŞTII CHIOARULUI","CENTRUL SOCIAL DE ASIGURARE A SERVICIILOR SOCIALE",334,"Alegeri Prezidentiale",1,401,230,198,32,0,228,2,510,280,91,137
26,MARAMUREŞ,"MIREŞU MARE",108268,"MIREŞU MARE",PRIMĂRIA,335,"Alegeri Prezidentiale",1,1139,560,480,80,0,553,7,1200,640,360,193
26,MARAMUREŞ,"MIREŞU MARE",108268,"REMEŢI PE SOMEŞ","ŞCOALA CU CLASELE I-IV",336,"Alegeri Prezidentiale",1,473,201,166,35,0,200,1,500,299,117,83
26,MARAMUREŞ,"MIREŞU MARE",108268,TULGHIEŞ,"ŞCOALA CU CLASELE I-IV",337,"Alegeri Prezidentiale",1,529,281,236,45,0,278,3,600,319,185,93
26,MARAMUREŞ,MOISEI,108348,MOISEI,PRIMĂRIA,338,"Alegeri Prezidentiale",1,1711,795,762,33,0,785,10,1900,1105,511,274
26,MARAMUREŞ,MOISEI,108348,MOISEI,"ȘCOALA NR. 4",339,"Alegeri Prezidentiale",1,1059,462,440,22,0,454,8,1200,738,268,186
26,MARAMUREŞ,MOISEI,108348,MOISEI,"ȘCOALA NR. 3",340,"Alegeri Prezidentiale",1,1616,711,665,46,0,708,3,1800,1089,462,246
26,MARAMUREŞ,MOISEI,108348,MOISEI,"GOSPODĂRIE INDIVIDUALĂ",341,"Alegeri Prezidentiale",1,1223,560,543,17,0,559,1,1300,740,327,232
26,MARAMUREŞ,MOISEI,108348,MOISEI,"ȘCOALA NR. 2",342,"Alegeri Prezidentiale",1,2015,907,820,87,0,899,8,2200,1293,574,325
26,MARAMUREŞ,"OARŢA DE JOS",108366,"OARŢA DE JOS",PRIMĂRIA,343,"Alegeri Prezidentiale",1,354,203,163,40,0,200,3,400,197,133,67
26,MARAMUREŞ,"OARŢA DE JOS",108366,"OARŢA DE SUS","ȘCOALA GENERALĂ",344,"Alegeri Prezidentiale",1,571,311,264,47,0,308,3,700,389,226,82
26,MARAMUREŞ,"OCNA ŞUGATAG",108400,BREB,"SCOALA CU CLASELE I-VIII",345,"Alegeri Prezidentiale",1,868,345,323,22,0,343,2,1000,655,292,51
26,MARAMUREŞ,"OCNA ŞUGATAG",108400,HOTENI,"SCOALA CU CLASELE I-IV",346,"Alegeri Prezidentiale",1,271,142,121,20,1,139,3,300,158,113,26
26,MARAMUREŞ,"OCNA ŞUGATAG",108400,SAT-ŞUGATAG,"ŞCOALA GENERALĂ",347,"Alegeri Prezidentiale",1,1008,454,432,22,0,448,6,1100,646,334,114
26,MARAMUREŞ,"OCNA ŞUGATAG",108400,"OCNA ŞUGATAG","SALA DE FESTIVITĂȚI",348,"Alegeri Prezidentiale",1,1349,771,558,211,2,763,8,1500,729,543,220
26,MARAMUREŞ,ONCEŞTI,179864,ONCEŞTI,"CĂMINUL CULTURAL",349,"Alegeri Prezidentiale",1,1247,670,590,80,0,661,9,1400,730,343,318
26,MARAMUREŞ,PETROVA,108455,PETROVA,"ŞCOALA GENERALĂ „MOCEARSCHI”",350,"Alegeri Prezidentiale",1,1028,440,421,19,0,437,3,1100,660,202,235
26,MARAMUREŞ,PETROVA,108455,PETROVA,"ŞCOALA GENERALĂ „SUSANI”",351,"Alegeri Prezidentiale",1,955,438,386,52,0,436,2,1100,662,240,196
26,MARAMUREŞ,"POIENILE DE SUB MUNTE",108473,"POIENILE DE SUB MUNTE","LICEUL TEHNOLOGIC POIENILE DE SUB MUNTE - SALA DE SPORT",352,"Alegeri Prezidentiale",1,1109,482,467,15,0,474,8,1200,718,166,308
26,MARAMUREŞ,"POIENILE DE SUB MUNTE",108473,"POIENILE DE SUB MUNTE","LICEUL TEHNOLOGIC POIENILE DE SUB MUNTE - SALA DE SPORT",353,"Alegeri Prezidentiale",1,1105,420,408,12,0,411,9,1200,780,190,221
26,MARAMUREŞ,"POIENILE DE SUB MUNTE",108473,"POIENILE DE SUB MUNTE","LICEUL TEHNOLOGIC POIENILE DE SUB MUNTE - SALA DE SPORT",354,"Alegeri Prezidentiale",1,1630,625,618,7,0,616,9,1800,1175,193,423
26,MARAMUREŞ,"POIENILE DE SUB MUNTE",108473,"POIENILE DE SUB MUNTE","LICEUL TEHNOLOGIC POIENILE DE SUB MUNTE ȘCOALA NEJNEI CRAI",355,"Alegeri Prezidentiale",1,1394,479,467,12,0,473,6,1500,1021,188,285
26,MARAMUREŞ,"POIENILE DE SUB MUNTE",108473,"POIENILE DE SUB MUNTE","ȘCOALA GIMNAZIALĂ NR. 4 HORB POIENILE DE SUB MUNTE",356,"Alegeri Prezidentiale",1,1319,548,538,10,0,544,4,1400,852,193,351
26,MARAMUREŞ,"POIENILE DE SUB MUNTE",108473,"POIENILE DE SUB MUNTE","ȘCOALA GIMNAZIALĂ NR. 4 STRUCTURA LUHEI POIENILE DE SUB MUNTE",357,"Alegeri Prezidentiale",1,885,379,371,8,0,373,6,1000,621,71,302
26,MARAMUREŞ,"POIENILE IZEI",179604,"POIENILE IZEI",PRIMĂRIA,358,"Alegeri Prezidentiale",1,726,420,378,39,3,419,1,900,480,279,140
26,MARAMUREŞ,RECEA,106407,LĂPUŞEL,"ȘCOALA GIMNAZIALĂ",359,"Alegeri Prezidentiale",1,1222,765,675,90,0,760,5,1300,535,523,237
26,MARAMUREŞ,RECEA,106407,SĂSAR,"ȘCOALA GIMNAZIALĂ",360,"Alegeri Prezidentiale",1,1257,759,706,53,0,745,14,1400,641,596,149
26,MARAMUREŞ,RECEA,106407,"BOZÂNTA MICĂ","ȘCOALA CU CLASELE I-IV",361,"Alegeri Prezidentiale",1,335,229,173,56,0,227,2,400,171,132,95
26,MARAMUREŞ,RECEA,106407,MOCIRA,"ȘCOALA CU CLASELE I-IV",362,"Alegeri Prezidentiale",1,986,714,625,85,4,703,11,1100,386,481,222
26,MARAMUREŞ,RECEA,106407,RECEA,"ȘCOALĂ GIMNAZIALĂ",363,"Alegeri Prezidentiale",1,1052,634,570,61,3,623,11,1100,466,433,190
26,MARAMUREŞ,RECEA,106407,SĂSAR,"CLĂDIREA ADMINISTRATIVĂ BISERICA ”DUMINICA MIRONOSIȚELOR”",364,"Alegeri Prezidentiale",1,543,377,327,50,0,374,3,599,222,290,84
26,MARAMUREŞ,"REMETEA CHIOARULUI",108491,BERCHEZ,"CĂMINUL CULTURAL",365,"Alegeri Prezidentiale",1,518,215,202,13,0,215,0,600,385,182,33
26,MARAMUREŞ,"REMETEA CHIOARULUI",108491,BERCHEZOAIA,"CĂMINUL CULTURAL",366,"Alegeri Prezidentiale",1,352,132,118,14,0,131,1,400,268,81,50
26,MARAMUREŞ,"REMETEA CHIOARULUI",108491,POSTA,"SCOALA PRIMARA",367,"Alegeri Prezidentiale",1,269,154,124,30,0,154,0,300,146,98,56
26,MARAMUREŞ,"REMETEA CHIOARULUI",108491,"REMETEA CHIOARULUI","SCOALA GIMNAZIALA",368,"Alegeri Prezidentiale",1,890,462,393,68,1,453,9,900,438,273,180
26,MARAMUREŞ,"REMETEA CHIOARULUI",108491,REMECIOARA,"ȘCOALA CU CLASELE I-IV",369,"Alegeri Prezidentiale",1,219,108,89,18,1,107,1,300,192,88,19
26,MARAMUREŞ,REMEŢI,108552,PIATRA,"CĂMIN CULTURAL",370,"Alegeri Prezidentiale",1,316,103,82,21,0,103,0,399,296,78,25
26,MARAMUREŞ,REMEŢI,108552,"TECEU MIC","CANTON DE EXPLOATARE ABA SOMEŞ-TISA",371,"Alegeri Prezidentiale",1,146,69,49,20,0,67,2,200,131,55,12
26,MARAMUREŞ,REMEŢI,108552,REMEŢI,"ŞCOALA CU CLASELE I-VIII",372,"Alegeri Prezidentiale",1,1328,493,470,23,0,486,7,1500,1007,275,211
26,MARAMUREŞ,REMEŢI,108552,REMEŢI,GRĂDINIŢA,373,"Alegeri Prezidentiale",1,792,264,250,14,0,261,3,800,536,133,128
26,MARAMUREŞ,REPEDEA,108598,REPEDEA,"CĂMINUL CULTURAL",374,"Alegeri Prezidentiale",1,1719,657,636,21,0,651,6,1900,1243,324,327
26,MARAMUREŞ,REPEDEA,108598,REPEDEA,"ŞCOALA GENERALĂ CU CLASELE I-IV LUJANA",375,"Alegeri Prezidentiale",1,717,285,273,12,0,284,1,800,515,138,146
26,MARAMUREŞ,REPEDEA,108598,REPEDEA,"ŞCOALA GENERALĂ CU CLASEL I-IV LESPEDEA DE JOS",376,"Alegeri Prezidentiale",1,1177,405,396,9,0,402,3,1300,895,150,252
26,MARAMUREŞ,"RONA DE JOS",108614,"RONA DE JOS","ŞCOALA GIMNAZIALĂ „LAURENŢIU ULICI”",377,"Alegeri Prezidentiale",1,1697,763,725,37,1,756,7,1900,1137,455,301
26,MARAMUREŞ,"RONA DE SUS",108632,"RONA DE SUS","CĂMINUL CULTURAL",378,"Alegeri Prezidentiale",1,1621,505,484,20,1,500,5,1800,1295,326,174
26,MARAMUREŞ,"RONA DE SUS",108632,"RONA DE SUS","CĂMINUL CULTURAL",379,"Alegeri Prezidentiale",1,1495,460,441,19,0,453,7,1600,1140,280,173
26,MARAMUREŞ,"RONA DE SUS",108632,COŞTIUI,"CLUBUL TINERETULUI",380,"Alegeri Prezidentiale",1,600,264,232,26,6,261,3,700,436,198,63
26,MARAMUREŞ,ROZAVLEA,108669,ROZAVLEA,PRIMĂRIA,381,"Alegeri Prezidentiale",1,1907,690,659,31,0,687,3,2100,1410,328,359
26,MARAMUREŞ,ROZAVLEA,108669,ROZAVLEA,"GRĂDINIȚA ȘESU MÂNĂSTIRII",382,"Alegeri Prezidentiale",1,770,286,260,26,0,286,0,900,614,151,135
26,MARAMUREŞ,RUSCOVA,108696,RUSCOVA,"CLUBUL TINERETULUI",383,"Alegeri Prezidentiale",1,1535,435,420,15,0,431,4,1700,1265,311,120
26,MARAMUREŞ,RUSCOVA,108696,RUSCOVA,"GRĂDINIŢA NR.1",384,"Alegeri Prezidentiale",1,1679,496,483,13,0,488,8,1800,1304,349,139
26,MARAMUREŞ,RUSCOVA,108696,RUSCOVA,"ŞCOALA GENERALĂ NR.2",385,"Alegeri Prezidentiale",1,1114,342,320,22,0,339,3,1200,858,242,97
26,MARAMUREŞ,SARASĂU,106620,SARASĂU,"CĂMINUL CULTURAL",386,"Alegeri Prezidentiale",1,1209,523,488,35,0,517,6,1300,777,357,160
26,MARAMUREŞ,SARASĂU,106620,SARASĂU,"CĂMINUL CULTURAL",387,"Alegeri Prezidentiale",1,1058,472,460,12,0,471,1,1200,728,282,189
26,MARAMUREŞ,SATULUNG,108712,SATULUNG,"ȘCOALA GIMNAZIALĂ",388,"Alegeri Prezidentiale",1,1264,720,617,89,14,706,14,1400,680,420,286
26,MARAMUREŞ,SATULUNG,108712,"ARIEŞU DE PĂDURE","CĂMINUL CULTURAL",389,"Alegeri Prezidentiale",1,175,160,107,49,4,160,0,220,60,48,112
26,MARAMUREŞ,SATULUNG,108712,FERSIG,"ŞCOALA PRIMARĂ",390,"Alegeri Prezidentiale",1,577,345,280,60,5,344,1,600,255,173,171
26,MARAMUREŞ,SATULUNG,108712,MOGOŞEŞTI,"ŞCOALA PRIMARĂ",391,"Alegeri Prezidentiale",1,673,365,324,41,0,362,3,700,335,200,162
26,MARAMUREŞ,SATULUNG,108712,"FINTEUŞU MIC","ȘCOALA GIMNAZIALĂ",392,"Alegeri Prezidentiale",1,854,489,450,39,0,485,4,900,411,182,303
26,MARAMUREŞ,SATULUNG,108712,HIDEAGA,"ȘCOALA GIMNAZIALĂ",393,"Alegeri Prezidentiale",1,554,355,299,56,0,350,5,600,245,162,188
26,MARAMUREŞ,SATULUNG,108712,PRIBILEŞTI,"ŞCOALA GIMNAZIALĂ",394,"Alegeri Prezidentiale",1,617,363,334,29,0,360,3,699,336,254,106
26,MARAMUREŞ,SĂCĂLĂŞENI,108794,SĂCĂLĂŞENI,"SALA DE SPORT",395,"Alegeri Prezidentiale",1,759,403,341,62,0,401,2,800,397,250,151
26,MARAMUREŞ,SĂCĂLĂŞENI,108794,CORUIA,"CĂMINUL CULTURAL",396,"Alegeri Prezidentiale",1,670,391,343,48,0,387,4,700,309,271,116
26,MARAMUREŞ,SĂCĂLĂŞENI,108794,CULCEA,"CĂMINUL CULTURAL",397,"Alegeri Prezidentiale",1,510,248,220,28,0,246,2,600,352,180,66
26,MARAMUREŞ,SĂCEL,108874,SĂCEL,PRIMĂRIA,398,"Alegeri Prezidentiale",1,1456,602,574,28,0,597,5,1600,998,306,291
26,MARAMUREŞ,SĂCEL,108874,SĂCEL,"ŞCOALA VALEA CARELOR",399,"Alegeri Prezidentiale",1,1332,474,461,13,0,470,4,1500,1026,256,214
26,MARAMUREŞ,SĂLSIG,108918,SĂLSIG,"CĂMINUL CULTURAL",400,"Alegeri Prezidentiale",2,1258,711,640,70,1,701,10,1400,689,483,218
26,MARAMUREŞ,SĂPÂNŢA,108945,SĂPÂNŢA,"ȘCOALA GIMNAZIALĂ",401,"Alegeri Prezidentiale",1,1353,531,34,496,1,524,7,1500,969,333,191
26,MARAMUREŞ,SĂPÂNŢA,108945,SĂPÂNŢA,"ȘCOALA GIMNAZIALĂ",402,"Alegeri Prezidentiale",1,1286,521,497,24,0,517,4,1400,879,321,196
26,MARAMUREŞ,STRÂMTURA,109005,STRÂMTURA,"ȘCOALA GENERALĂ",403,"Alegeri Prezidentiale",1,1672,750,717,33,0,746,4,1800,1050,570,176
26,MARAMUREŞ,STRÂMTURA,109005,STRÂMTURA,"ȘCOALA GENERALĂ",404,"Alegeri Prezidentiale",1,411,163,155,8,0,161,2,500,337,115,46
26,MARAMUREŞ,STRÂMTURA,109005,GLOD,"ȘCOALA GENERALĂ",405,"Alegeri Prezidentiale",1,505,233,216,17,0,231,2,600,367,123,108
26,MARAMUREŞ,STRÂMTURA,109005,SLĂTIOARA,"ȘCOALA GENERALĂ",406,"Alegeri Prezidentiale",1,413,144,138,6,0,144,0,500,356,106,38
26,MARAMUREŞ,"SUCIU DE SUS",109041,"SUCIU DE JOS","CĂMINUL CULTURAL",407,"Alegeri Prezidentiale",1,821,441,397,42,2,438,3,900,459,212,226
26,MARAMUREŞ,"SUCIU DE SUS",109041,"SUCIU DE SUS",PRIMĂRIA,408,"Alegeri Prezidentiale",1,1360,822,760,51,11,812,10,1500,678,321,491
26,MARAMUREŞ,"SUCIU DE SUS",109041,"SUCIU DE SUS","ŞCOALA GENERALĂ CANDELA",409,"Alegeri Prezidentiale",1,723,407,348,49,10,400,7,800,393,117,283
26,MARAMUREŞ,"SUCIU DE SUS",109041,LARGA,"ŞCOALA PRIMARĂ",410,"Alegeri Prezidentiale",1,272,194,168,24,2,193,1,300,106,47,146
26,MARAMUREŞ,ŞIEU,179613,ŞIEU,"CĂMINUL CULTURAL",411,"Alegeri Prezidentiale",1,1182,474,424,46,4,469,5,1300,826,249,220
26,MARAMUREŞ,ŞIEU,179613,ŞIEU,"ȘCOALA DE LA PODUL RÂTULUI",412,"Alegeri Prezidentiale",1,740,317,282,32,3,315,2,800,483,138,177
26,MARAMUREŞ,ŞIŞEŞTI,109096,ŞIŞEŞTI,"PRIMĂRIA COMUNEI ȘIȘEȘTI",413,"Alegeri Prezidentiale",1,1282,720,672,45,3,712,8,1400,680,565,147
26,MARAMUREŞ,ŞIŞEŞTI,109096,BONTĂIENI,"ȘCOALA CU CLASELE I-IV",414,"Alegeri Prezidentiale",1,190,93,77,16,0,91,2,200,107,69,22
26,MARAMUREŞ,ŞIŞEŞTI,109096,NEGREIA,"ŞCOALA CU CLASELE I-IV",415,"Alegeri Prezidentiale",1,374,192,172,20,0,190,2,412,220,164,26
26,MARAMUREŞ,ŞIŞEŞTI,109096,PLOPIS,"ŞCOALA CU CLS I-IV",416,"Alegeri Prezidentiale",1,430,226,211,15,0,225,1,500,274,161,64
26,MARAMUREŞ,ŞIŞEŞTI,109096,CETĂŢELE,"ŞCOALA GENERALĂ",417,"Alegeri Prezidentiale",1,512,274,254,20,0,271,3,607,333,208,63
26,MARAMUREŞ,ŞIŞEŞTI,109096,DĂNEŞTI,"ŞCOALA GENERALĂ",418,"Alegeri Prezidentiale",1,517,297,266,31,0,292,5,599,302,228,64
26,MARAMUREŞ,ŞIŞEŞTI,109096,ŞURDEŞTI,"SCOALA GENERALĂ",419,"Alegeri Prezidentiale",1,1194,619,570,47,2,606,13,1300,681,463,143
26,MARAMUREŞ,"VADU IZEI",106648,"VADU IZEI","ȘCOALA GIMNAZIALĂ VADU IZEI",420,"Alegeri Prezidentiale",1,1034,544,423,121,0,536,8,1100,556,331,205
26,MARAMUREŞ,"VADU IZEI",106648,"VADU IZEI","ȘCOALA GIMNAZIALĂ VADU IZEI",421,"Alegeri Prezidentiale",1,1004,529,447,82,0,524,5,1100,571,261,263
26,MARAMUREŞ,"VADU IZEI",106648,"VALEA STEJARULUI","SALA DE FESTIVITĂȚI",422,"Alegeri Prezidentiale",1,394,197,181,16,0,196,1,500,303,94,102
26,MARAMUREŞ,"VALEA CHIOARULUI",109354,"CURTUIUŞU MARE","CĂMINUL CULTURAL",423,"Alegeri Prezidentiale",1,234,161,114,47,0,158,3,300,139,93,65
26,MARAMUREŞ,"VALEA CHIOARULUI",109354,FERICEA,"ȘCOALA GENERALĂ",424,"Alegeri Prezidentiale",1,364,221,197,24,0,220,1,400,179,48,172
26,MARAMUREŞ,"VALEA CHIOARULUI",109354,MESTEACĂN,"ȘCOALA GENERALĂ",425,"Alegeri Prezidentiale",1,293,174,147,27,0,172,2,300,126,94,78
26,MARAMUREŞ,"VALEA CHIOARULUI",109354,VĂRAI,"ȘCOALA GENERALĂ",426,"Alegeri Prezidentiale",1,206,130,96,34,0,130,0,300,170,86,44
26,MARAMUREŞ,"VALEA CHIOARULUI",109354,"VALEA CHIOARULUI","CĂMINUL CULTURAL",427,"Alegeri Prezidentiale",1,519,271,230,41,0,269,2,600,329,153,116
26,MARAMUREŞ,"VALEA CHIOARULUI",109354,DURUŞA,"CĂMINUL CULTURAL",428,"Alegeri Prezidentiale",1,42,41,21,20,0,41,0,100,59,26,15
26,MARAMUREŞ,"VIMA MICĂ",109425,"VIMA MICĂ","CĂMINUL CULTURAL",429,"Alegeri Prezidentiale",1,293,144,117,26,1,143,1,300,156,67,76
26,MARAMUREŞ,"VIMA MICĂ",109425,"DEALU CORBULUI","CĂMINUL CULTURAL",430,"Alegeri Prezidentiale",1,81,45,33,12,0,45,0,100,55,33,12
26,MARAMUREŞ,"VIMA MICĂ",109425,PETERITEA,"CĂMINUL CULTURAL",431,"Alegeri Prezidentiale",1,190,74,63,11,0,73,1,190,116,28,45
26,MARAMUREŞ,"VIMA MICĂ",109425,SĂLNIŢA,"CĂMINUL CULTURAL",432,"Alegeri Prezidentiale",1,207,102,92,10,0,102,0,300,198,49,53
26,MARAMUREŞ,"VIMA MICĂ",109425,"VIMA MARE","CĂMINUL CULTURAL",433,"Alegeri Prezidentiale",1,327,156,131,25,0,156,0,400,244,102,54
26,MARAMUREŞ,"VIMA MICĂ",109425,ASPRA,"ȘCOALA PRIMARĂ",434,"Alegeri Prezidentiale",1,41,44,23,21,0,44,0,100,56,17,27
26,MARAMUREŞ,"VIMA MICĂ",109425,JUGĂSTRENI,"ȘCOALA PRIMARĂ",435,"Alegeri Prezidentiale",1,40,38,25,13,0,38,0,101,63,22,16
26,MARAMUREŞ,"VIŞEU DE JOS",109504,"VIŞEU DE JOS",PRIMĂRIE,436,"Alegeri Prezidentiale",1,1416,576,541,35,0,575,1,1600,1024,344,231
26,MARAMUREŞ,"VIŞEU DE JOS",109504,"VIŞEU DE JOS","ȘCOALA GIMNAZIALĂ CU CLASELE I - VIII, VISEU DE JOS",437,"Alegeri Prezidentiale",1,1507,612,589,23,0,608,4,1600,988,366,242
26,MARAMUREŞ,"VIŞEU DE JOS",109504,"VIŞEU DE JOS","ȘCOALA GIMNAZIALĂ NR. 2",438,"Alegeri Prezidentiale",1,1285,473,451,22,0,470,3,1400,927,296,174
27,MEHEDINŢI,"MUNICIPIUL DROBETA-TURNU SEVERIN",109773,"DROBETA-TURNU SEVERIN","CONSILIUL LOCAL DROBETA-TURNU SEVERIN - PALATUL CULTURII ”TEODOR COSTESCU”",1,"Alegeri Prezidentiale",1,1381,769,572,197,0,750,19,1500,731,407,343
27,MEHEDINŢI,"MUNICIPIUL DROBETA-TURNU SEVERIN",109773,"DROBETA-TURNU SEVERIN","COLEGIUL NAȚIONAL ”TRAIAN”",2,"Alegeri Prezidentiale",1,1383,654,588,54,12,638,16,1499,845,335,303
27,MEHEDINŢI,"MUNICIPIUL DROBETA-TURNU SEVERIN",109773,"DROBETA-TURNU SEVERIN","ȘCOALA GIMNAZIALĂ ”DUMITRU I.TOTIR” (ȘCOALA GENERALĂ NR.10)",3,"Alegeri Prezidentiale",1,1429,675,650,25,0,660,15,1500,825,352,308
27,MEHEDINŢI,"MUNICIPIUL DROBETA-TURNU SEVERIN",109773,"DROBETA-TURNU SEVERIN","ȘCOALA GIMNAZIALĂ ”DUMITRU I.TOTIR”(ȘCOALA GENERALĂ NR.10)",4,"Alegeri Prezidentiale",1,1337,563,527,36,0,543,20,1400,837,276,267
27,MEHEDINŢI,"MUNICIPIUL DROBETA-TURNU SEVERIN",109773,"DROBETA-TURNU SEVERIN","ASOCIAȚIA DE PROPRIETARI NR.90",5,"Alegeri Prezidentiale",1,977,480,437,43,0,460,20,977,497,240,220
27,MEHEDINŢI,"MUNICIPIUL DROBETA-TURNU SEVERIN",109773,"DROBETA-TURNU SEVERIN","LICEUL TEHNOLOGIC SPECIAL ”DROBETA” (ȘCOALA ENERGETICĂ)",6,"Alegeri Prezidentiale",1,1396,659,600,59,0,643,16,1500,841,336,307
27,MEHEDINŢI,"MUNICIPIUL DROBETA-TURNU SEVERIN",109773,"DROBETA-TURNU SEVERIN","LICEUL TEHNOLOGIC SPECIAL ”DROBETA” (ȘCOALA ENERGETICĂ)",7,"Alegeri Prezidentiale",1,1030,448,423,25,0,445,3,1100,652,188,257
27,MEHEDINŢI,"MUNICIPIUL DROBETA-TURNU SEVERIN",109773,"DROBETA-TURNU SEVERIN","S.C. TRANSPORT PUBLIC URBAN ”DROBETA” S.A. (AUTOGARĂ)",8,"Alegeri Prezidentiale",1,1399,594,518,76,0,579,15,1500,906,284,295
27,MEHEDINŢI,"MUNICIPIUL DROBETA-TURNU SEVERIN",109773,"DROBETA-TURNU SEVERIN","ȘCOALA GIMNAZIALĂ ”CONSTANTIN NEGREANU” (ȘCOALA GENERALĂ NR.9)",9,"Alegeri Prezidentiale",1,1446,630,573,57,0,621,9,1500,870,286,335
27,MEHEDINŢI,"MUNICIPIUL DROBETA-TURNU SEVERIN",109773,"DROBETA-TURNU SEVERIN","ȘCOALA GIMNAZIALĂ ”CONSTANTIN NEGREANU” (ȘCOALA GENERALĂ NR.9)",10,"Alegeri Prezidentiale",1,1343,569,540,29,0,556,13,1392,823,280,276
27,MEHEDINŢI,"MUNICIPIUL DROBETA-TURNU SEVERIN",109773,"DROBETA-TURNU SEVERIN","ȘCOALA GIMNAZIALĂ ”CONSTANTIN NEGREANU” (ȘCOALA GENERALĂ NR.9)",11,"Alegeri Prezidentiale",1,1679,629,538,91,0,624,5,1800,1171,329,295
27,MEHEDINŢI,"MUNICIPIUL DROBETA-TURNU SEVERIN",109773,"DROBETA-TURNU SEVERIN","PRIMARIA MUNICIPIULUI DROBETA-TURNU SEVERIN DIRECȚIA PATRIMONIU",12,"Alegeri Prezidentiale",1,1639,577,547,30,0,556,21,1800,1223,306,250
27,MEHEDINŢI,"MUNICIPIUL DROBETA-TURNU SEVERIN",109773,"DROBETA-TURNU SEVERIN","PRIMARIA MUNICIPIULUI DROBETA-TURNU SEVERIN DIRECȚIA PATRIMONIU",13,"Alegeri Prezidentiale",1,1530,568,542,26,0,555,13,1600,1032,325,230
27,MEHEDINŢI,"MUNICIPIUL DROBETA-TURNU SEVERIN",109773,"DROBETA-TURNU SEVERIN","COLEGIUL NAȚIONAL ”GHEORGHE ȚIȚEICA”",14,"Alegeri Prezidentiale",1,1234,527,464,62,1,517,10,1300,773,258,259
27,MEHEDINŢI,"MUNICIPIUL DROBETA-TURNU SEVERIN",109773,"DROBETA-TURNU SEVERIN","COLEGIUL NAȚIONAL ”GHEORGHE ȚIȚEICA”",15,"Alegeri Prezidentiale",1,1174,558,467,91,0,545,13,1200,642,274,271
27,MEHEDINŢI,"MUNICIPIUL DROBETA-TURNU SEVERIN",109773,"DROBETA-TURNU SEVERIN","COLEGIUL NAȚIONAL ECONOMIC ”THEODOR COSTESCU”",16,"Alegeri Prezidentiale",1,1059,476,443,32,1,464,12,1200,724,202,262
27,MEHEDINŢI,"MUNICIPIUL DROBETA-TURNU SEVERIN",109773,"DROBETA-TURNU SEVERIN","GRĂDINIȚA CU PROGRAM PRELUNGIT NR. 22",17,"Alegeri Prezidentiale",1,1121,407,368,39,0,399,8,1200,793,188,211
27,MEHEDINŢI,"MUNICIPIUL DROBETA-TURNU SEVERIN",109773,"DROBETA-TURNU SEVERIN","ȘCOALA GIMNAZIALĂ NR. 14",18,"Alegeri Prezidentiale",1,1035,437,386,51,0,423,14,1100,663,180,243
27,MEHEDINŢI,"MUNICIPIUL DROBETA-TURNU SEVERIN",109773,"DROBETA-TURNU SEVERIN","ȘCOALA GIMNAZIALĂ NR. 14",19,"Alegeri Prezidentiale",1,1387,458,432,26,0,444,14,1500,1042,207,237
27,MEHEDINŢI,"MUNICIPIUL DROBETA-TURNU SEVERIN",109773,"DROBETA-TURNU SEVERIN","ASOCIATIA LIGA ”SOLIDARITATEA” A PENSIONARILOR",20,"Alegeri Prezidentiale",1,1193,512,487,25,0,503,9,1300,788,275,228
27,MEHEDINŢI,"MUNICIPIUL DROBETA-TURNU SEVERIN",109773,"DROBETA-TURNU SEVERIN","ȘCOALA GIMNAZIALĂ NR. 11",21,"Alegeri Prezidentiale",1,1617,680,638,42,0,657,23,1700,1020,334,323
27,MEHEDINŢI,"MUNICIPIUL DROBETA-TURNU SEVERIN",109773,"DROBETA-TURNU SEVERIN","ȘCOALA GIMNAZIALĂ NR. 11",22,"Alegeri Prezidentiale",1,1315,555,532,23,0,545,10,1400,845,238,307
27,MEHEDINŢI,"MUNICIPIUL DROBETA-TURNU SEVERIN",109773,"DROBETA-TURNU SEVERIN","MINISTERUL SĂNĂTĂȚII - SERVICIUL JUDEȚEAN DE AMBULANȚĂ - SPAȚIU ADMINISTRATIV",23,"Alegeri Prezidentiale",1,1516,606,574,32,0,587,19,1600,994,291,296
27,MEHEDINŢI,"MUNICIPIUL DROBETA-TURNU SEVERIN",109773,"DROBETA-TURNU SEVERIN","DIRECȚIA DE SĂNĂTATE PUBLICĂ MEHEDINȚI - SPITALUL JUDEŢEAN DE URGENŢĂ - SPAȚIU ADMINISTRATIV",24,"Alegeri Prezidentiale",1,1700,788,663,54,71,773,15,2000,1212,365,408
27,MEHEDINŢI,"MUNICIPIUL DROBETA-TURNU SEVERIN",109773,"DROBETA-TURNU SEVERIN","DIRECȚIA DE SĂNĂTATE PUBLICĂ MEHEDINȚI - SPITALUL JUDEŢEAN DE URGENŢĂ - SPAȚIU ADMINISTRATIV",25,"Alegeri Prezidentiale",1,1450,589,476,41,72,575,14,1600,1011,262,313
27,MEHEDINŢI,"MUNICIPIUL DROBETA-TURNU SEVERIN",109773,"DROBETA-TURNU SEVERIN","GRĂDINIȚA CU PROGRAM PRELUNGIT NR.20",26,"Alegeri Prezidentiale",1,1637,679,621,57,1,653,26,1800,1121,339,314
27,MEHEDINŢI,"MUNICIPIUL DROBETA-TURNU SEVERIN",109773,"DROBETA-TURNU SEVERIN","COLEGIUL TEHNIC ”DOMNUL TUDOR”",27,"Alegeri Prezidentiale",1,888,365,328,37,0,358,7,1000,635,195,163
27,MEHEDINŢI,"MUNICIPIUL DROBETA-TURNU SEVERIN",109773,"DROBETA-TURNU SEVERIN","COLEGIUL TEHNIC ”DOMNUL TUDOR”",28,"Alegeri Prezidentiale",1,1145,535,489,46,0,518,17,1300,765,262,256
27,MEHEDINŢI,"MUNICIPIUL DROBETA-TURNU SEVERIN",109773,"DROBETA-TURNU SEVERIN","COLEGIUL TEHNIC ”DOMNUL TUDOR”",29,"Alegeri Prezidentiale",1,1270,551,524,27,0,539,12,1300,749,288,251
27,MEHEDINŢI,"MUNICIPIUL DROBETA-TURNU SEVERIN",109773,"DROBETA-TURNU SEVERIN","COLEGIUL TEHNIC ”DOMNUL TUDOR”",30,"Alegeri Prezidentiale",2,1299,487,473,14,0,481,6,1400,913,238,243
27,MEHEDINŢI,"MUNICIPIUL DROBETA-TURNU SEVERIN",109773,"DROBETA-TURNU SEVERIN","PRIMĂRIA MUNICIPIULUI DROBETA-TURNU SEVERIN (STADIONUL MUNICIPAL)",31,"Alegeri Prezidentiale",1,1459,630,596,34,0,610,20,1600,970,281,329
27,MEHEDINŢI,"MUNICIPIUL DROBETA-TURNU SEVERIN",109773,"DROBETA-TURNU SEVERIN","COLEGIUL TEHNIC ”LORIN SĂLĂGEAN” (LICEUL INDUSTRIAL NR.4)",32,"Alegeri Prezidentiale",1,1125,465,436,29,0,457,8,1200,735,213,244
27,MEHEDINŢI,"MUNICIPIUL DROBETA-TURNU SEVERIN",109773,"DROBETA-TURNU SEVERIN","GRĂDINIȚA CU PROGRAM PRELUNGIT NR. 3",33,"Alegeri Prezidentiale",1,1322,573,540,33,0,559,14,1400,827,293,266
27,MEHEDINŢI,"MUNICIPIUL DROBETA-TURNU SEVERIN",109773,"DROBETA-TURNU SEVERIN","ȘCOALA GIMNAZIALĂ NR. 6",34,"Alegeri Prezidentiale",1,1263,585,518,67,0,564,21,1300,715,292,272
27,MEHEDINŢI,"MUNICIPIUL DROBETA-TURNU SEVERIN",109773,"DROBETA-TURNU SEVERIN","ȘCOALA GIMNAZIALĂ NR. 6",35,"Alegeri Prezidentiale",1,1543,653,599,53,1,634,19,1600,947,347,287
27,MEHEDINŢI,"MUNICIPIUL DROBETA-TURNU SEVERIN",109773,"DROBETA-TURNU SEVERIN","ȘCOALA GIMNAZIALĂ NR. 6",36,"Alegeri Prezidentiale",1,1246,517,486,31,0,495,22,1400,883,258,237
27,MEHEDINŢI,"MUNICIPIUL DROBETA-TURNU SEVERIN",109773,"DROBETA-TURNU SEVERIN","ȘCOALA GIMNAZIALĂ NR. 6",37,"Alegeri Prezidentiale",1,1229,498,479,19,0,477,21,1300,802,251,226
27,MEHEDINŢI,"MUNICIPIUL DROBETA-TURNU SEVERIN",109773,"DROBETA-TURNU SEVERIN","DIRECȚIA REGIONALĂ DE DRUMURI ȘI PODURI CRAIOVA",38,"Alegeri Prezidentiale",1,1383,600,477,123,0,587,13,1500,900,288,299
27,MEHEDINŢI,"MUNICIPIUL DROBETA-TURNU SEVERIN",109773,"DROBETA-TURNU SEVERIN","ȘCOALA GIMNAZIALĂ ”PETRE SERGESCU”",39,"Alegeri Prezidentiale",1,1196,461,418,43,0,448,13,1300,839,229,219
27,MEHEDINŢI,"MUNICIPIUL DROBETA-TURNU SEVERIN",109773,"DROBETA-TURNU SEVERIN","GRĂDINIȚA CU PROGRAM PRELUNGIT NR. 21",40,"Alegeri Prezidentiale",1,1019,413,388,25,0,405,8,1100,687,202,203
27,MEHEDINŢI,"MUNICIPIUL DROBETA-TURNU SEVERIN",109773,"DROBETA-TURNU SEVERIN","GRĂDINIȚA CU PROGRAM PRELUNGIT NR. 21",41,"Alegeri Prezidentiale",2,1297,517,479,38,0,507,10,1400,883,314,193
27,MEHEDINŢI,"MUNICIPIUL DROBETA-TURNU SEVERIN",109773,"DROBETA-TURNU SEVERIN","ȘCOALA GIMNAZIALĂ ”PETRE SERGESCU” (ȘCOALA GENERALĂ NR.4)",42,"Alegeri Prezidentiale",1,1242,444,412,32,0,428,16,1300,856,178,250
27,MEHEDINŢI,"MUNICIPIUL DROBETA-TURNU SEVERIN",109773,"DROBETA-TURNU SEVERIN","ȘCOALA GIMNAZIALĂ ”PETRE SERGESCU” (ȘCOALA GENERALĂ NR.4)",43,"Alegeri Prezidentiale",1,1271,500,408,92,0,488,12,1400,900,217,271
27,MEHEDINŢI,"MUNICIPIUL DROBETA-TURNU SEVERIN",109773,"DROBETA-TURNU SEVERIN","ȘCOALA GIMNAZIALĂ ”PETRE SERGESCU” (ȘCOALA GENERALĂ NR.4)",44,"Alegeri Prezidentiale",1,1304,483,459,24,0,470,13,1400,917,217,253
27,MEHEDINŢI,"MUNICIPIUL DROBETA-TURNU SEVERIN",109773,"DROBETA-TURNU SEVERIN","PRIMĂRIA MUNICIPIULUI DROBETA-TURNU SEVERIN (SALA POLIVALENTĂ)",45,"Alegeri Prezidentiale",2,1792,781,710,70,1,750,31,1900,1119,386,364
27,MEHEDINŢI,"MUNICIPIUL DROBETA-TURNU SEVERIN",109773,"DROBETA-TURNU SEVERIN","PRIMĂRIA MUNICIPIULUI DROBETA-TURNU SEVERIN (SALA POLIVALENTĂ)",46,"Alegeri Prezidentiale",1,1831,714,672,40,2,694,20,2000,1286,361,333
27,MEHEDINŢI,"MUNICIPIUL DROBETA-TURNU SEVERIN",109773,"DROBETA-TURNU SEVERIN","ȘCOALA GIMNAZIALĂ ”DIMITRIE GRECESCU” (ȘCOALA GENERALĂ NR.1)",47,"Alegeri Prezidentiale",1,1501,997,707,288,2,974,23,1800,803,418,556
27,MEHEDINŢI,"MUNICIPIUL DROBETA-TURNU SEVERIN",109773,"DROBETA-TURNU SEVERIN","COLEGIUL TEHNIC ”DECEBAL”",48,"Alegeri Prezidentiale",1,1353,645,603,42,0,631,14,1400,755,309,322
27,MEHEDINŢI,"MUNICIPIUL DROBETA-TURNU SEVERIN",109773,"DROBETA-TURNU SEVERIN","ȘCOALA GIMNAZIALĂ NR.3",49,"Alegeri Prezidentiale",1,1370,667,612,54,1,649,18,1500,833,323,326
27,MEHEDINŢI,"MUNICIPIUL DROBETA-TURNU SEVERIN",109773,"DROBETA-TURNU SEVERIN","ȘCOALA GIMNAZIALĂ ”ALICE VOINESCU” (ȘCOALA GENERALĂ NR.2)",50,"Alegeri Prezidentiale",1,1343,685,631,53,1,666,19,1400,715,317,349
27,MEHEDINŢI,"MUNICIPIUL DROBETA-TURNU SEVERIN",109773,"DROBETA-TURNU SEVERIN","ȘCOALA GIMNAZIALĂ NR.15 (FOSTA ȘCOALĂ GENERALĂ NR.8)",51,"Alegeri Prezidentiale",1,1033,467,431,36,0,455,12,1100,633,219,236
27,MEHEDINŢI,"MUNICIPIUL DROBETA-TURNU SEVERIN",109773,"DROBETA-TURNU SEVERIN","ȘCOALA GIMNAZIALĂ NR.15 (FOSTA ȘCOALĂ GENERALĂ NR.8)",52,"Alegeri Prezidentiale",1,1789,790,763,27,0,770,20,1900,1110,339,431
27,MEHEDINŢI,"MUNICIPIUL DROBETA-TURNU SEVERIN",109773,"DROBETA-TURNU SEVERIN","ȘCOALA GIMNAZIALĂ ”TEODOR COSTESCU” ( ȘCOALA GENERALĂ NR.7)",53,"Alegeri Prezidentiale",1,1845,690,637,53,0,676,14,2000,1310,321,355
27,MEHEDINŢI,"MUNICIPIUL DROBETA-TURNU SEVERIN",109773,"DROBETA-TURNU SEVERIN","ȘCOALA GIMNAZIALĂ ”TEODOR COSTESCU” ( ȘCOALA GENERALĂ NR.7)",54,"Alegeri Prezidentiale",1,1546,624,571,53,0,605,19,1600,976,316,289
27,MEHEDINŢI,"MUNICIPIUL DROBETA-TURNU SEVERIN",109773,"DROBETA-TURNU SEVERIN","ȘCOALA GIMNAZIALĂ ”TEODOR COSTESCU” ( ȘCOALA GENERALĂ NR.7)",55,"Alegeri Prezidentiale",1,1812,680,663,17,0,655,25,1900,1220,358,297
27,MEHEDINŢI,"MUNICIPIUL DROBETA-TURNU SEVERIN",109773,"DROBETA-TURNU SEVERIN","ȘCOALA GIMNAZIALĂ ”TEODOR COSTESCU” (ȘCOALA GENERALĂ NR.7)",56,"Alegeri Prezidentiale",1,1659,720,639,81,0,696,24,1800,1080,368,328
27,MEHEDINŢI,"MUNICIPIUL DROBETA-TURNU SEVERIN",109773,"DROBETA-TURNU SEVERIN","ȘCOALA GIMNAZIALĂ NR.15",57,"Alegeri Prezidentiale",1,1356,529,461,68,0,519,10,1400,871,263,256
27,MEHEDINŢI,"MUNICIPIUL DROBETA-TURNU SEVERIN",109773,"DROBETA-TURNU SEVERIN","ȘCOALA GIMNAZIALĂ NR.15",58,"Alegeri Prezidentiale",1,999,425,390,35,0,408,17,1000,575,206,202
27,MEHEDINŢI,"MUNICIPIUL DROBETA-TURNU SEVERIN",109773,"DROBETA-TURNU SEVERIN","ȘCOALA GIMNAZIALĂ NR.15",59,"Alegeri Prezidentiale",1,1328,533,513,20,0,519,14,1400,867,260,259
27,MEHEDINŢI,"MUNICIPIUL DROBETA-TURNU SEVERIN",109773,"DROBETA-TURNU SEVERIN","ȘCOALA GIMNAZIALĂ NR.15",60,"Alegeri Prezidentiale",1,1785,721,696,25,0,706,15,1900,1179,360,346
27,MEHEDINŢI,"MUNICIPIUL DROBETA-TURNU SEVERIN",109773,"DROBETA-TURNU SEVERIN","GRĂDINIȚA CU PROGRAM PRELUNGIT NR.15",61,"Alegeri Prezidentiale",1,1039,493,457,36,0,481,12,1100,607,211,270
27,MEHEDINŢI,"MUNICIPIUL DROBETA-TURNU SEVERIN",109773,"DROBETA-TURNU SEVERIN","GRĂDINIȚA CU PROGRAM PRELUNGIT NR.15",62,"Alegeri Prezidentiale",1,1406,652,529,123,0,641,11,1500,848,277,364
27,MEHEDINŢI,"MUNICIPIUL DROBETA-TURNU SEVERIN",109773,"DROBETA-TURNU SEVERIN","GRĂDINIȚA CU PROGRAM PRELUNGIT NR.15",63,"Alegeri Prezidentiale",1,1736,559,502,57,0,548,11,1900,1341,294,254
27,MEHEDINŢI,"MUNICIPIUL DROBETA-TURNU SEVERIN",109773,"DROBETA-TURNU SEVERIN","ȘCOALA GIMNAZIALĂ NR.5",64,"Alegeri Prezidentiale",1,1667,679,652,25,2,660,19,1800,1121,287,373
27,MEHEDINŢI,"MUNICIPIUL DROBETA-TURNU SEVERIN",109773,"DROBETA-TURNU SEVERIN","ȘCOALA GIMNAZIALĂ ”DIMITRIE GRECESCU” (ȘCOALA GENERALĂ NR.15 GURA VĂII)",65,"Alegeri Prezidentiale",1,1531,850,648,196,6,831,19,1600,750,337,494
27,MEHEDINŢI,"MUNICIPIUL ORŞOVA",110063,ORŞOVA,"ȘCOALA CU CLASELE I-VIII PETRU DUMITRIU SUD",66,"Alegeri Prezidentiale",1,1540,656,594,61,1,648,8,1600,944,373,275
27,MEHEDINŢI,"MUNICIPIUL ORŞOVA",110063,ORŞOVA,"LICEUL TRAIAN LALESCU",67,"Alegeri Prezidentiale",1,1027,376,332,44,0,368,8,1100,724,189,179
27,MEHEDINŢI,"MUNICIPIUL ORŞOVA",110063,ORŞOVA,"LICEUL TRAIAN LALESCU",68,"Alegeri Prezidentiale",1,1274,414,368,38,8,403,11,1400,986,196,207
27,MEHEDINŢI,"MUNICIPIUL ORŞOVA",110063,ORŞOVA,"CLUBUL COPIILOR",69,"Alegeri Prezidentiale",1,954,394,351,43,0,387,7,1100,706,185,202
27,MEHEDINŢI,"MUNICIPIUL ORŞOVA",110063,ORŞOVA,"CLUBUL COPIILOR",70,"Alegeri Prezidentiale",1,1218,440,409,31,0,435,5,1300,860,220,215
27,MEHEDINŢI,"MUNICIPIUL ORŞOVA",110063,ORŞOVA,"COLEGIUL TEHNIC DIERNA",71,"Alegeri Prezidentiale",1,1405,554,483,71,0,541,13,1500,946,295,246
27,MEHEDINŢI,"MUNICIPIUL ORŞOVA",110063,ORŞOVA,"ȘCOALA GENERALĂ I-VIII NUMĂRUL 1 NORD",72,"Alegeri Prezidentiale",1,1290,535,450,85,0,526,9,1400,865,283,243
27,MEHEDINŢI,"MUNICIPIUL ORŞOVA",110063,ORŞOVA,"GRĂDINIŢA NUMĂRUL 3",73,"Alegeri Prezidentiale",1,1470,664,596,67,1,646,18,1600,936,375,271
27,MEHEDINŢI,"MUNICIPIUL ORŞOVA",110063,ORŞOVA,"GRĂDINIŢA CORAMNIC",74,"Alegeri Prezidentiale",1,323,168,127,40,1,167,1,400,232,75,92
27,MEHEDINŢI,"ORAŞ BAIA DE ARAMĂ",109924,"BAIA DE ARAMĂ","ȘCOALA GENERALĂ BAIA DE ARAMĂ",75,"Alegeri Prezidentiale",1,1205,559,443,116,0,547,12,1300,741,292,255
27,MEHEDINŢI,"ORAŞ BAIA DE ARAMĂ",109924,"BAIA DE ARAMĂ","GRUPUL ŞCOLAR CONSTANTIN BRÂNCOVEANU",76,"Alegeri Prezidentiale",1,1172,577,416,146,15,567,10,1300,723,302,265
27,MEHEDINŢI,"ORAŞ BAIA DE ARAMĂ",109924,MĂRĂŞEŞTI,"ŞCOALA GENERALĂ MĂRĂŞEŞTI",77,"Alegeri Prezidentiale",1,1094,472,443,29,0,469,3,1200,728,230,239
27,MEHEDINŢI,"ORAŞ BAIA DE ARAMĂ",109924,TITERLEŞTI,"ŞCOALA GENERALĂ TITERLEŞTI",78,"Alegeri Prezidentiale",1,400,188,162,26,0,185,3,500,312,82,103
27,MEHEDINŢI,"ORAŞ BAIA DE ARAMĂ",109924,NEGOEŞTI,"ŞCOALA GENERALĂ NEGOEŞTI",79,"Alegeri Prezidentiale",1,694,343,252,91,0,337,6,800,457,138,199
27,MEHEDINŢI,"ORAŞ STREHAIA",110116,STREHAIA,"LICEUL TEHNOLOGIC MATEI BASARAB",80,"Alegeri Prezidentiale",1,1687,809,721,88,0,802,7,1800,991,360,442
27,MEHEDINŢI,"ORAŞ STREHAIA",110116,STREHAIA,"GRĂDINIŢA 2",81,"Alegeri Prezidentiale",1,1504,642,585,53,4,630,12,1600,958,272,358
27,MEHEDINŢI,"ORAŞ STREHAIA",110116,STREHAIA,"ŞCOALA GENERALĂ STREHAIA",82,"Alegeri Prezidentiale",1,1387,573,506,67,0,560,13,1500,927,223,337
27,MEHEDINŢI,"ORAŞ STREHAIA",110116,STREHAIA,"GRĂDINIŢA VEST STREHAIA",83,"Alegeri Prezidentiale",1,1403,680,618,39,23,669,11,1500,820,311,358
27,MEHEDINŢI,"ORAŞ STREHAIA",110116,CIOCHIUŢA,"ŞCOALA GENERALĂ CIOCHIUŢA",84,"Alegeri Prezidentiale",1,757,359,318,41,0,356,3,800,441,120,236
27,MEHEDINŢI,"ORAŞ STREHAIA",110116,"SLĂTINICU MARE","ŞCOALA GENERALĂ SLĂTINICUL MARE",85,"Alegeri Prezidentiale",1,281,153,112,39,2,152,1,400,247,65,87
27,MEHEDINŢI,"ORAŞ STREHAIA",110116,COMANDA,"ŞCOALA GENERALĂ COMANDA",86,"Alegeri Prezidentiale",1,1282,539,505,34,0,524,15,1400,861,256,268
27,MEHEDINŢI,"ORAŞ STREHAIA",110116,"LUNCA BANULUI","ŞCOALA GENERALĂ LUNCA BANULUI",87,"Alegeri Prezidentiale",1,376,174,154,20,0,174,0,400,226,68,106
27,MEHEDINŢI,"ORAŞ STREHAIA",110116,HURDUCEŞTI,"ŞCOALA GENERALĂ HURDUCEŞTI",88,"Alegeri Prezidentiale",1,213,125,106,19,0,124,1,300,175,31,93
27,MEHEDINŢI,"ORAŞ STREHAIA",110116,STĂNCEŞTI,"ŞCOALA GENERALĂ STĂNCEŞTI",89,"Alegeri Prezidentiale",1,150,89,70,19,0,88,1,200,111,40,48
27,MEHEDINŢI,"ORAŞ VÂNJU MARE",110232,"VÂNJU MARE","LICEUL TEORETIC VÎNJU MARE",90,"Alegeri Prezidentiale",2,1206,941,494,445,2,923,18,1300,359,415,508
27,MEHEDINŢI,"ORAŞ VÂNJU MARE",110232,"VÂNJU MARE","ŞCOALA GENERALĂ I-VIII VÎNJU MARE",91,"Alegeri Prezidentiale",1,1651,919,718,195,6,899,20,1800,881,488,411
27,MEHEDINŢI,"ORAŞ VÂNJU MARE",110232,BUCURA,"GRADINIŢA BUCURA",92,"Alegeri Prezidentiale",1,283,209,173,34,2,202,7,300,91,92,110
27,MEHEDINŢI,"ORAŞ VÂNJU MARE",110232,"NICOLAE BĂLCESCU","ŞCOALA GENERALĂ I-IV NICOLAE BĂLCESCU",93,"Alegeri Prezidentiale",1,626,403,314,86,3,403,0,700,297,235,168
27,MEHEDINŢI,"ORAŞ VÂNJU MARE",110232,"OREVIŢA MARE","CĂMINUL CULTURAL OREVIŢA MARE",94,"Alegeri Prezidentiale",1,609,412,327,83,2,408,4,700,288,234,174
27,MEHEDINŢI,"ORAŞ VÂNJU MARE",110232,TRAIAN,"ŞCOALA GIMNAZIALĂ VÎNJU MARE, GRĂDINIŢA CU PROGRAM NORMAL TRAIAN",95,"Alegeri Prezidentiale",1,480,360,240,120,0,356,4,600,240,165,191
27,MEHEDINŢI,BALA,110296,COMĂNEŞTI,"ŞCOALA GENERALĂ I-IV COMĂNEŞTI",96,"Alegeri Prezidentiale",1,326,188,140,48,0,182,6,400,212,80,102
27,MEHEDINŢI,BALA,110296,CRAINICI,"ȘCOALA GENERALĂ I-VIII CRAINICI",97,"Alegeri Prezidentiale",1,279,161,123,38,0,159,2,300,139,87,72
27,MEHEDINŢI,BALA,110296,SĂRDĂNEŞTI,"ȘCOALA GENERALĂ I-IV SĂRDĂNEŞTI",98,"Alegeri Prezidentiale",1,204,103,72,31,0,103,0,300,197,39,64
27,MEHEDINŢI,BALA,110296,IUPCA,"ȘCOALA GENERALĂ I-IV IUPCA",99,"Alegeri Prezidentiale",1,162,106,77,29,0,105,1,200,94,68,37
27,MEHEDINŢI,BALA,110296,BALA,"CĂMINUL CULTURAL BALA",100,"Alegeri Prezidentiale",1,688,425,290,135,0,419,6,700,275,165,254
27,MEHEDINŢI,BALA,110296,BRATEŞUL,"ȘCOALA GENERALĂ I-IV BRATEŞUL",101,"Alegeri Prezidentiale",1,105,51,43,8,0,51,0,200,149,25,26
27,MEHEDINŢI,BALA,110296,"BALA DE SUS","ȘCOALA GENERALĂ I-IV BALA DE SUS",102,"Alegeri Prezidentiale",1,494,282,238,44,0,280,2,600,318,124,156
27,MEHEDINŢI,BALA,110296,RUDINA,"ȘCOALA GENERALĂ I-IV RUDINA",103,"Alegeri Prezidentiale",1,382,186,146,40,0,184,2,500,314,83,101
27,MEHEDINŢI,BALA,110296,VIDIMIREŞTI,"ȘCOALA GENERALĂ I-IV VIDIMIREŞTI",104,"Alegeri Prezidentiale",1,123,64,43,21,0,64,0,200,136,22,42
27,MEHEDINŢI,BALA,110296,DÂLMA,"ȘCOALA GENERALĂ I-VIII DÎLMA",105,"Alegeri Prezidentiale",1,324,131,105,26,0,130,1,400,269,54,76
27,MEHEDINŢI,BALTA,110456,BALTA,"CĂMINUL CULTURAL BALTA",106,"Alegeri Prezidentiale",1,331,366,198,167,1,361,5,400,34,252,109
27,MEHEDINŢI,BALTA,110456,PREJNA,"CĂMINUL CULTURAL PREJNA",107,"Alegeri Prezidentiale",1,226,182,108,71,3,180,2,300,118,62,118
27,MEHEDINŢI,BALTA,110456,COSTEŞTI,"CĂMINUL CULTURAL COSTEŞTI",108,"Alegeri Prezidentiale",1,134,114,77,36,1,112,2,200,86,53,59
27,MEHEDINŢI,BALTA,110456,GORNOVIŢA,"CĂMINUL CULTURAL GORNOVIŢA",109,"Alegeri Prezidentiale",1,158,130,85,42,3,129,1,200,70,56,73
27,MEHEDINŢI,BĂLĂCIŢA,110535,BĂLĂCIŢA,"ŞCOALA GIMNAZIALĂ BĂLĂCIŢA",110,"Alegeri Prezidentiale",1,978,418,327,76,15,416,2,1100,682,208,208
27,MEHEDINŢI,BĂLĂCIŢA,110535,GVARDINIŢA,"ŞCOALA GIMNAZIALĂ GVARDINIŢA",111,"Alegeri Prezidentiale",1,811,422,343,57,22,416,6,900,478,146,270
27,MEHEDINŢI,BĂLĂCIŢA,110535,DOBRA,"ŞCOALA PRIMARĂ DOBRA",112,"Alegeri Prezidentiale",1,359,281,183,88,10,278,3,400,119,50,228
27,MEHEDINŢI,BÂCLEŞ,110571,BÂCLEŞ,"ȘCOALA GENERALĂ I-VIII BÎCLEȘ",113,"Alegeri Prezidentiale",1,481,426,240,131,55,422,4,600,174,336,86
27,MEHEDINŢI,BÂCLEŞ,110571,"PODU GROSULUI","ȘCOALA GENERALĂ I-IV PODU GROSULUI",114,"Alegeri Prezidentiale",1,160,143,85,46,12,143,0,199,56,101,42
27,MEHEDINŢI,BÂCLEŞ,110571,PETRA,"ȘCOALA GENERALĂ I-IV PETRA",115,"Alegeri Prezidentiale",1,132,145,77,52,16,145,0,199,54,121,24
27,MEHEDINŢI,BÂCLEŞ,110571,CORZU,"ȘCOALA GENERALĂ I-IV CORZU",116,"Alegeri Prezidentiale",1,333,271,177,67,27,269,2,400,129,189,80
27,MEHEDINŢI,BÂCLEŞ,110571,SMADOVIŢA,"ȘCOALA GENERALĂ I-IV SMADOVIŢA",117,"Alegeri Prezidentiale",1,363,283,191,72,20,281,2,400,117,226,55
27,MEHEDINŢI,BÂLVĂNEŞTI,110688,BÂLVĂNEŞTI,"PRIMĂRIA BÎLVĂNEŞTI",118,"Alegeri Prezidentiale",1,727,453,345,108,0,453,0,900,447,132,321
27,MEHEDINŢI,BRANIŞTEA,114060,BRANIŞTEA,"ȘCOALA GIMNAZIALĂ BRANIȘTEA",119,"Alegeri Prezidentiale",1,1095,794,602,91,101,792,2,1200,406,169,623
27,MEHEDINŢI,BRANIŞTEA,114060,GOANŢA,"ȘCOALA GENERALĂ I-IV GOANŢA",120,"Alegeri Prezidentiale",1,396,253,194,35,24,252,1,500,247,73,179
27,MEHEDINŢI,BREZNIŢA-MOTRU,110740,BREZNIŢA-MOTRU,"ŞCOALA GENERALA I-VIII BREZNIŢA MOTRU",121,"Alegeri Prezidentiale",1,851,463,353,51,59,455,8,899,436,235,220
27,MEHEDINŢI,BREZNIŢA-MOTRU,110740,FĂUROAIA,"ŞCOALA GENERALĂ I-VIII FĂUROAIA",122,"Alegeri Prezidentiale",1,277,166,113,39,14,166,0,299,133,44,122
27,MEHEDINŢI,BREZNIŢA-OCOL,110820,BREZNIŢA-OCOL,"ŞCOALA GENERALĂ I-VIII BREZNIŢA OCOL",123,"Alegeri Prezidentiale",1,1501,600,562,38,0,591,9,1600,1000,263,328
27,MEHEDINŢI,BREZNIŢA-OCOL,110820,MAGHERU,"ŞCOALA GENERALĂ I-IV MAGHERU",124,"Alegeri Prezidentiale",1,902,369,328,41,0,362,7,1000,631,134,228
27,MEHEDINŢI,BREZNIŢA-OCOL,110820,JIDOŞTIŢA,"ŞCOALA GENERALĂ I-IV JIDOŞTIŢA",125,"Alegeri Prezidentiale",1,900,450,360,90,0,448,2,900,450,234,214
27,MEHEDINŢI,BROŞTENI,110875,BROŞTENI,"CĂMIN CULTURAL BROŞTENI",126,"Alegeri Prezidentiale",1,1216,793,592,167,34,787,6,1300,507,331,456
27,MEHEDINŢI,BROŞTENI,110875,"LUPŞA DE JOS","CĂMIN CULTURAL LUPŞA DE JOS",127,"Alegeri Prezidentiale",1,1077,648,577,65,6,638,10,1100,452,262,376
27,MEHEDINŢI,"BURILA MARE",110946,"BURILA MARE","ȘCOALA GENERALĂ BURILA MARE",128,"Alegeri Prezidentiale",1,591,359,262,86,11,352,7,700,341,166,186
27,MEHEDINŢI,"BURILA MARE",110946,CRIVINA,"ȘCOALA GENERALĂ CRIVINA",129,"Alegeri Prezidentiale",1,535,278,182,81,15,275,3,600,322,126,149
27,MEHEDINŢI,"BURILA MARE",110946,ŢIGĂNAŞI,"ȘCOALA GENERALĂ ŢIGĂNAŞI",130,"Alegeri Prezidentiale",1,246,221,115,93,13,221,0,300,79,90,131
27,MEHEDINŢI,"BURILA MARE",110946,VRANCEA,"ȘCOALA VECHE VRANCEA",131,"Alegeri Prezidentiale",1,173,168,70,98,0,166,2,200,32,99,67
27,MEHEDINŢI,"BURILA MARE",110946,"IZVORU FRUMOS","ȘCOALA GENERALĂ IZVORU FRUMOS",132,"Alegeri Prezidentiale",1,176,120,76,38,6,118,2,200,80,55,63
27,MEHEDINŢI,BUTOIEŞTI,111006,BUTOIEŞTI,"PRIMĂRIA BUTOIEŞTI",133,"Alegeri Prezidentiale",1,854,462,337,125,0,456,6,900,438,224,232
27,MEHEDINŢI,BUTOIEŞTI,111006,ARGINEŞTI,"ŞCOALA GENERALĂ I-IV ARGINEŞTI",134,"Alegeri Prezidentiale",1,481,301,260,41,0,296,5,500,199,211,85
27,MEHEDINŢI,BUTOIEŞTI,111006,"GURA MOTRULUI","ŞCOALA GENERALĂ I-IV GURA MOTRULUI",135,"Alegeri Prezidentiale",1,229,181,118,63,0,179,2,300,119,107,72
27,MEHEDINŢI,BUTOIEŞTI,111006,BUICEŞTI,"ŞCOALA GENERALĂ I-IV BUICEŞTI",136,"Alegeri Prezidentiale",1,390,254,200,54,0,252,2,400,146,147,105
27,MEHEDINŢI,BUTOIEŞTI,111006,PLUTA,"ŞCOALA GENERALĂ I-IV PLUTA",137,"Alegeri Prezidentiale",1,343,225,170,55,0,223,2,400,175,83,140
27,MEHEDINŢI,BUTOIEŞTI,111006,ŢÂNŢARU,"ŞCOALA GENERALĂ I-IV ŢÎNŢARU",138,"Alegeri Prezidentiale",1,290,189,159,30,0,186,3,400,211,85,101
27,MEHEDINŢI,CĂZĂNEŞTI,111097,CĂZĂNEŞTI,"SCOALA GENERALĂ I-IV CĂZĂNEŞTI",139,"Alegeri Prezidentiale",1,718,587,385,202,0,579,8,800,213,327,252
27,MEHEDINŢI,CĂZĂNEŞTI,111097,SEVERINEŞTI,"SCOALA GENERALĂ I-IV SEVERINEŞTI",140,"Alegeri Prezidentiale",1,984,666,499,167,0,660,6,1100,434,319,341
27,MEHEDINŢI,CIREŞU,111220,CIREŞU,"CĂMINUL CULTURAL CIREŞU",141,"Alegeri Prezidentiale",1,384,489,216,267,6,488,1,550,61,248,240
27,MEHEDINŢI,CORCOVA,111275,CORCOVA,"CĂMINUL CULTURAL CORCOVA",142,"Alegeri Prezidentiale",1,924,620,450,165,5,616,4,1000,380,341,275
27,MEHEDINŢI,CORCOVA,111275,IMOASA,"ŞCOALA GENERALĂ IMOASA",143,"Alegeri Prezidentiale",1,310,222,180,42,0,219,3,400,178,121,98
27,MEHEDINŢI,CORCOVA,111275,CORDUN,"ŞCOALA GENERALĂ CORDUN",144,"Alegeri Prezidentiale",1,595,209,194,13,2,204,5,700,491,102,102
27,MEHEDINŢI,CORCOVA,111275,STEJARU,"ŞCOALA GENERALĂ I-IV STEJARU",145,"Alegeri Prezidentiale",1,444,205,182,23,0,203,2,500,295,90,113
27,MEHEDINŢI,CORCOVA,111275,JIROV,"CĂMINUL CULTURAL JIROV",146,"Alegeri Prezidentiale",1,1194,575,530,42,3,569,6,1300,725,308,261
27,MEHEDINŢI,CORCOVA,111275,"MĂRU ROŞU","ŞCOALA GENERALĂ MĂRU ROŞU",147,"Alegeri Prezidentiale",1,493,273,241,32,0,273,0,600,327,116,157
27,MEHEDINŢI,CORCOVA,111275,CERNAIA,"ŞCOALA GENERALĂ CERNAIA",148,"Alegeri Prezidentiale",1,402,199,176,22,1,194,5,500,301,94,100
27,MEHEDINŢI,CORCOVA,111275,"GÂRBOVĂŢU DE JOS","ŞCOALA GENERALĂ GÂRBOVĂŢU DE JOS",149,"Alegeri Prezidentiale",1,402,283,213,69,1,278,5,500,217,177,101
27,MEHEDINŢI,CORLĂŢEL,111417,CORLĂŢEL,"ȘCOALA PROFESIONALĂ CORLĂŢEL",150,"Alegeri Prezidentiale",1,597,436,327,92,17,435,1,600,164,169,266
27,MEHEDINŢI,CORLĂŢEL,111417,"VALEA ANILOR","ȘCOALA PROFESIONALĂ VALEA ANILOR",151,"Alegeri Prezidentiale",1,432,209,176,31,2,209,0,500,291,64,145
27,MEHEDINŢI,CUJMIR,111444,CUJMIR,"CĂMINUL CULTURAL",152,"Alegeri Prezidentiale",1,896,592,491,72,29,587,5,1000,408,356,231
27,MEHEDINŢI,CUJMIR,111444,CUJMIR,"CĂMINUL CULTURAL",153,"Alegeri Prezidentiale",1,871,552,449,71,32,546,6,900,348,296,250
27,MEHEDINŢI,CUJMIR,111444,AURORA,"ŞCOALA GENERALĂ AURORA",154,"Alegeri Prezidentiale",1,549,314,267,43,4,305,9,600,286,158,147
27,MEHEDINŢI,CUJMIR,111444,"CUJMIRU MIC","GRĂDINIŢA CUJMIRU MIC",155,"Alegeri Prezidentiale",1,396,272,216,56,0,266,6,500,228,169,97
27,MEHEDINŢI,DÂRVARI,111550,DÂRVARI,"CĂMINUL CULTURAL NOU-DÎRVARI",156,"Alegeri Prezidentiale",1,1174,619,490,66,63,614,5,1200,581,334,280
27,MEHEDINŢI,DÂRVARI,111550,GEMENI,"CĂMINUL CULTURAL VECHI-GEMENI",157,"Alegeri Prezidentiale",1,895,559,462,71,26,555,4,900,341,358,197
27,MEHEDINŢI,DEVESEL,111480,DEVESEL,"CĂMINUL CULTURAL DEVESEL",158,"Alegeri Prezidentiale",1,998,916,534,358,24,907,9,1182,266,551,356
27,MEHEDINŢI,DEVESEL,111480,BATOŢI,"ŞCOALA GENERALA BATOŢI",159,"Alegeri Prezidentiale",1,336,318,144,157,17,315,3,400,82,161,154
27,MEHEDINŢI,DEVESEL,111480,BISTREŢU,"ŞCOALA GENERALĂ BISTREŢU",160,"Alegeri Prezidentiale",1,382,379,200,147,32,377,2,400,21,223,154
27,MEHEDINŢI,DEVESEL,111480,SCĂPĂU,"ŞCOALA GENERALĂ SCĂPĂU",161,"Alegeri Prezidentiale",1,644,433,287,117,29,430,3,700,267,237,193
27,MEHEDINŢI,DUBOVA,112904,DUBOVA,"PRIMĂRIA DUBOVA",162,"Alegeri Prezidentiale",1,425,358,226,126,6,354,4,500,142,243,111
27,MEHEDINŢI,DUBOVA,112904,EIBENTHAL,"FOSTA PRIMĂRIE EIBENTHAL",163,"Alegeri Prezidentiale",1,247,122,99,17,6,121,1,300,178,85,36
27,MEHEDINŢI,DUBOVA,112904,"BAIA NOUĂ","FOSTA ŞCOALĂ BAIA NOUĂ",164,"Alegeri Prezidentiale",1,139,67,48,19,0,66,1,201,134,34,32
27,MEHEDINŢI,DUMBRAVA,111587,"DUMBRAVA DE JOS","CĂMINUL CULTURAL DUMBRAVA DE JOS",165,"Alegeri Prezidentiale",1,381,306,220,66,20,302,4,400,94,96,206
27,MEHEDINŢI,DUMBRAVA,111587,ALBULEŞTI,"ŞCOALA GENERALĂ ALBULEŞTI",166,"Alegeri Prezidentiale",1,459,335,238,67,30,333,2,500,165,107,226
27,MEHEDINŢI,DUMBRAVA,111587,"VALEA MARCULUI","CLĂDIRE FOSTA ŞCOALĂ VALEA MARCULUI",167,"Alegeri Prezidentiale",1,101,106,59,41,6,104,2,200,94,40,64
27,MEHEDINŢI,DUMBRAVA,111587,ROCŞORENI,"CĂMINUL CULTURAL ROCŞORENI",168,"Alegeri Prezidentiale",1,89,70,46,24,0,67,3,100,30,17,50
27,MEHEDINŢI,DUMBRAVA,111587,VLĂDICA,"CLĂDIRE FOSTĂ ŞCOALĂ VLĂDICA",169,"Alegeri Prezidentiale",1,59,85,37,48,0,85,0,100,15,53,32
27,MEHEDINŢI,EŞELNIŢA,112245,EŞELNIŢA,"GRADINITA ESELNITA",170,"Alegeri Prezidentiale",1,1151,549,475,74,0,542,7,1200,651,313,229
27,MEHEDINŢI,EŞELNIŢA,112245,EŞELNIŢA,"GRADINITA ESELNITA",171,"Alegeri Prezidentiale",1,1230,595,528,67,0,582,13,1300,705,354,228
27,MEHEDINŢI,FLOREŞTI,111685,FLOREŞTI,"ŞCOALA GENERALĂ I-VIII FLOREŞTI",172,"Alegeri Prezidentiale",1,1349,742,634,82,26,731,11,1399,657,282,449
27,MEHEDINŢI,FLOREŞTI,111685,ZEGUJANI,"ŞCOALA GENERALĂ I-VIII ZEGUJANI",173,"Alegeri Prezidentiale",1,814,584,463,86,35,574,10,999,415,120,454
27,MEHEDINŢI,"GÂRLA MARE",111783,"GÂRLA MARE","CĂMINUL CULTURAL GÎRLA MARE",174,"Alegeri Prezidentiale",1,1516,512,428,47,37,506,6,1600,1088,153,353
27,MEHEDINŢI,"GÂRLA MARE",111783,"GÂRLA MARE","CĂMINUL CULTURAL GÎRLA MARE",175,"Alegeri Prezidentiale",1,1090,409,337,42,30,399,10,1100,691,133,266
27,MEHEDINŢI,GODEANU,111818,GODEANU,"PRIMĂRIA GODEANU",176,"Alegeri Prezidentiale",1,463,372,240,131,1,368,4,562,190,145,223
27,MEHEDINŢI,GOGOŞU,111863,GOGOŞU,"ŞCOALA GENERALĂ CLASELE I-VIII GOGOȘU",177,"Alegeri Prezidentiale",1,914,558,427,100,31,551,7,1000,442,94,457
27,MEHEDINŢI,GOGOŞU,111863,"BALTA VERDE","ŞCOALA GENERALĂ BALTA VERDE",178,"Alegeri Prezidentiale",1,993,475,362,90,23,470,5,1100,625,107,363
27,MEHEDINŢI,GOGOŞU,111863,"BURILA MICĂ","ŞCOALA GENERALĂ BURILA MICĂ",179,"Alegeri Prezidentiale",1,755,327,253,58,16,325,2,800,473,67,258
27,MEHEDINŢI,GOGOŞU,111863,"OSTROVU MARE","ŞCOALA GENERALĂ OSTROVU MARE",180,"Alegeri Prezidentiale",1,514,260,195,44,21,254,6,700,440,76,178
27,MEHEDINŢI,GOGOŞU,111863,"OSTROVU MARE","GRĂDINIȚA PORŢILE DE FIER II",181,"Alegeri Prezidentiale",1,56,190,32,158,0,182,8,299,109,125,57
27,MEHEDINŢI,GRECI,111916,GRECI,"CĂMINUL CULTURAL GRECI",182,"Alegeri Prezidentiale",1,498,352,235,69,48,346,6,600,248,109,237
27,MEHEDINŢI,GRECI,111916,BÂLTANELE,"ŞCOALA GENERALĂ BÎLTANELE",183,"Alegeri Prezidentiale",1,310,244,142,73,29,241,3,400,156,145,96
27,MEHEDINŢI,GRECI,111916,SĂLĂTRUC,"ŞCOALA GENERALĂ SĂLĂTRUC",184,"Alegeri Prezidentiale",1,160,175,86,60,29,175,0,200,25,41,134
27,MEHEDINŢI,GROZEŞTI,111989,GROZEŞTI,"ŞCOALA GENERALĂ I-VIII GROZEŞTI",185,"Alegeri Prezidentiale",1,372,174,163,11,0,171,3,500,326,71,100
27,MEHEDINŢI,GROZEŞTI,111989,CÂRCENI,"ŞCOALA GENERALĂ I-IV CÎRCENI",186,"Alegeri Prezidentiale",1,773,293,264,29,0,290,3,800,507,99,191
27,MEHEDINŢI,GROZEŞTI,111989,ŞUŞIŢA,"ŞCOALA GENERALĂ I-IV ŞUŞIŢA",187,"Alegeri Prezidentiale",1,391,197,141,55,1,193,4,400,203,70,123
27,MEHEDINŢI,GRUIA,112030,GRUIA,"CĂMINUL CULTURAL GRUIA",188,"Alegeri Prezidentiale",1,661,408,279,129,0,404,4,800,392,215,189
27,MEHEDINŢI,GRUIA,112030,GRUIA,"STADIONUL COMUNAL GRUIA",189,"Alegeri Prezidentiale",1,712,270,255,15,0,267,3,800,530,119,148
27,MEHEDINŢI,GRUIA,112030,IZVOARELE,"CĂMINUL CULTURAL",190,"Alegeri Prezidentiale",1,706,424,312,112,0,422,2,800,376,237,185
27,MEHEDINŢI,GRUIA,112030,"POIANA GRUII","ŞCOALA POIANA GRUII",191,"Alegeri Prezidentiale",1,122,111,65,46,0,111,0,200,89,54,57
27,MEHEDINŢI,HINOVA,112076,HINOVA,"ŞCOALA GENERALĂ I-VIII HINOVA",192,"Alegeri Prezidentiale",1,858,364,286,78,0,359,5,900,536,150,209
27,MEHEDINŢI,HINOVA,112076,BISTRIŢA,"ŞCOALA GENERALĂ I-VIII BISTRIŢA",193,"Alegeri Prezidentiale",1,1152,566,510,56,0,554,12,1200,634,310,244
27,MEHEDINŢI,HINOVA,112076,"OSTROVU CORBULUI","ŞCOALA GENERALĂ I-IV OSTROVU CORBULUI",194,"Alegeri Prezidentiale",1,307,199,131,68,0,196,3,400,201,90,106
27,MEHEDINŢI,HUSNICIOARA,112129,HUSNICIOARA,"ŞCOALA GIMNAZIALĂ HUSNICIOARA",195,"Alegeri Prezidentiale",1,529,423,207,216,0,415,8,599,176,283,132
27,MEHEDINŢI,HUSNICIOARA,112129,PERI,"CĂMINUL CULTURAL PERI",196,"Alegeri Prezidentiale",1,315,211,111,100,0,207,4,400,189,114,93
27,MEHEDINŢI,HUSNICIOARA,112129,BĂDIŢEŞTI,"ŞCOALA GENERALĂ BĂDIŢEŞTI",197,"Alegeri Prezidentiale",1,148,107,73,34,0,105,2,200,93,71,34
27,MEHEDINŢI,ILOVĂŢ,112263,ILOVĂŢ,"DISPENSAR UMAN ILOVĂŢ",198,"Alegeri Prezidentiale",1,977,758,497,234,27,745,13,1000,242,439,306
27,MEHEDINŢI,ILOVIŢA,112334,ILOVIŢA,"ȘCOALA GENERALĂ ILOVIŢA",199,"Alegeri Prezidentiale",1,650,395,325,70,0,392,3,700,305,238,154
27,MEHEDINŢI,ILOVIŢA,112334,BAHNA,"CĂMINUL CULTURAL BAHNA",200,"Alegeri Prezidentiale",2,412,221,187,34,0,220,1,500,279,105,115
27,MEHEDINŢI,ISVERNA,112370,ISVERNA,"CĂMIN CULTURAL ISVERNA",201,"Alegeri Prezidentiale",1,1277,1104,747,357,0,1094,10,1249,145,569,525
27,MEHEDINŢI,ISVERNA,112370,NADANOVA,"ȘCOALA GENERALĂ NADANOVA",202,"Alegeri Prezidentiale",1,314,463,170,293,0,455,8,596,133,285,170
27,MEHEDINŢI,ISVERNA,112370,BUSEŞTI,"CĂMIN CULTURAL BUSEȘTI",203,"Alegeri Prezidentiale",1,144,304,72,232,0,299,5,451,147,190,109
27,MEHEDINŢI,"IZVORU BÂRZII",112469,"IZVORU BÂRZII","CĂMINUL CULTURAL IZVORU BÎRZII",204,"Alegeri Prezidentiale",1,1077,573,479,94,0,568,5,1100,527,321,247
27,MEHEDINŢI,"IZVORU BÂRZII",112469,BALOTEŞTI,"ȘCOALA GENERALĂ I-IV BALOTEŞTI",205,"Alegeri Prezidentiale",1,490,333,216,117,0,323,10,500,167,177,146
27,MEHEDINŢI,"IZVORU BÂRZII",112469,HALÂNGA,"ȘCOALA GENERALĂ I-VIII HALÎNGA",206,"Alegeri Prezidentiale",1,735,402,299,103,0,397,5,799,397,211,186
27,MEHEDINŢI,JIANA,112548,JIANA,"ȘCOALA GENERALĂ I-VIII JIANA",207,"Alegeri Prezidentiale",1,571,370,288,60,22,368,2,600,230,25,343
27,MEHEDINŢI,JIANA,112548,"JIANA MARE","ȘCOALA GENERALĂ I-IV JIANA MARE",208,"Alegeri Prezidentiale",1,560,413,275,82,56,396,17,600,187,61,335
27,MEHEDINŢI,JIANA,112548,"JIANA VECHE","ȘCOALA GENERALĂ I-VIII JIANA VECHE",209,"Alegeri Prezidentiale",1,892,323,246,31,46,319,4,900,577,90,229
27,MEHEDINŢI,JIANA,112548,DĂNCEU,"CĂMINUL CULTURAL DĂNCEU",210,"Alegeri Prezidentiale",1,1003,547,407,107,33,546,1,1200,653,137,409
27,MEHEDINŢI,JIANA,112548,CIOROBORENI,"CĂMINUL CULTURAL CIOROBORENI",211,"Alegeri Prezidentiale",1,508,388,273,99,16,387,1,600,212,56,331
27,MEHEDINŢI,LIVEZILE,112600,LIVEZILE,"CĂMINUL CULTURAL LIVEZILE",212,"Alegeri Prezidentiale",1,675,598,362,209,27,594,4,700,102,222,372
27,MEHEDINŢI,LIVEZILE,112600,"IZVORU ANEŞTILOR","ŞCOALA PRIMARĂ IZVORU ANEŞTILOR",213,"Alegeri Prezidentiale",1,355,295,197,90,8,292,3,400,105,65,227
27,MEHEDINŢI,LIVEZILE,112600,"IZVORĂLU DE JOS","ŞCOALA PRIMARĂ IZVORĂLU DE JOS",214,"Alegeri Prezidentiale",1,142,122,64,55,3,121,1,200,78,34,87
27,MEHEDINŢI,MALOVĂŢ,112664,MALOVĂŢ,"CĂMINUL CULTURAL MALOVĂŢ",215,"Alegeri Prezidentiale",1,980,644,490,154,0,634,10,1105,461,236,398
27,MEHEDINŢI,MALOVĂŢ,112664,"23 AUGUST","SCOALA GENERALĂ I-IV 23 AUGUST",216,"Alegeri Prezidentiale",1,311,225,147,78,0,224,1,399,174,97,127
27,MEHEDINŢI,MALOVĂŢ,112664,BOBAIŢA,"CĂMINUL CULTURAL BOBAIŢA",217,"Alegeri Prezidentiale",1,487,329,234,95,0,326,3,500,171,108,218
27,MEHEDINŢI,MALOVĂŢ,112664,COLIBAŞI,"ŞCOALA GENERALĂ I-IV COLIBAŞI",218,"Alegeri Prezidentiale",1,361,247,197,50,0,242,5,400,153,101,141
27,MEHEDINŢI,"OBÂRŞIA DE CÂMP",112744,"OBÂRŞIA DE CÂMP","CĂMINUL CULTURAL OBÂRŞIA DE CÂMP",219,"Alegeri Prezidentiale",1,615,385,284,70,31,380,5,700,315,134,246
27,MEHEDINŢI,"OBÂRŞIA DE CÂMP",112744,IZIMŞA,"CĂMINUL CULTURAL IZIMŞA",220,"Alegeri Prezidentiale",1,838,592,392,125,75,585,7,900,308,185,400
27,MEHEDINŢI,OBÂRŞIA-CLOŞANI,110027,OBÂRŞIA-CLOŞANI,"ȘCOALA GENERALĂ I-VIII OBÎRȘIA CLOȘANI",221,"Alegeri Prezidentiale",1,857,412,371,41,0,408,4,900,488,289,119
27,MEHEDINŢI,OPRIŞOR,112771,OPRIŞOR,"CĂMINUL CULTURAL OPRIȘOR",222,"Alegeri Prezidentiale",2,736,437,340,78,19,426,11,800,363,163,263
27,MEHEDINŢI,OPRIŞOR,112771,OPRIŞOR,"ȘCOALA GENERALĂ I-VIII OPRIȘOR",223,"Alegeri Prezidentiale",1,737,390,322,47,21,386,4,800,410,162,224
27,MEHEDINŢI,OPRIŞOR,112771,PRISĂCEAUA,"ȘCOALA GENERALĂ PRISĂCEAUA",224,"Alegeri Prezidentiale",1,291,250,155,82,13,248,2,399,149,97,151
27,MEHEDINŢI,PĂDINA,112806,"PĂDINA MARE","CĂMINUL CULTURAL PĂDINA MARE",225,"Alegeri Prezidentiale",1,192,135,82,40,13,135,0,200,65,33,102
27,MEHEDINŢI,PĂDINA,112806,"PĂDINA MICĂ","ŞCOALA GENERALĂ PĂDINA MICĂ",226,"Alegeri Prezidentiale",1,194,107,71,30,6,106,1,300,193,36,70
27,MEHEDINŢI,PĂDINA,112806,IABLANIŢA,"ŞCOALA GENERALĂ IABLANIŢA",227,"Alegeri Prezidentiale",1,203,157,100,52,5,156,1,300,143,36,120
27,MEHEDINŢI,PĂDINA,112806,SLAŞOMA,"CĂMINUL CULTURAL SLAŞOMA",228,"Alegeri Prezidentiale",1,395,276,177,72,27,274,2,500,224,79,195
27,MEHEDINŢI,PĂTULELE,112879,PĂTULELE,"CĂMINUL CULTURAL PĂTULELE",229,"Alegeri Prezidentiale",1,1203,780,621,131,28,768,12,1300,520,340,428
27,MEHEDINŢI,PĂTULELE,112879,PĂTULELE,"ŞCOALA GENERALĂ I-IV PĂTULELE",230,"Alegeri Prezidentiale",1,1005,617,512,60,45,607,10,1100,483,304,303
27,MEHEDINŢI,PĂTULELE,112879,PĂTULELE,"GRĂDINIŢA NR. 3 RUDĂRIE",231,"Alegeri Prezidentiale",1,376,136,122,11,3,136,0,400,264,47,89
27,MEHEDINŢI,PĂTULELE,112879,VIAŞU,"CĂMINUL CULTURAL VIAŞU",232,"Alegeri Prezidentiale",1,407,242,198,40,4,241,1,499,257,90,151
27,MEHEDINŢI,PODENI,112959,PODENI,"CĂMINUL CULTURAL PODENI",233,"Alegeri Prezidentiale",1,544,400,310,84,6,399,1,500,100,142,257
27,MEHEDINŢI,PODENI,112959,GORNENŢI,"CĂMINUL CULTURAL GORNENŢI",234,"Alegeri Prezidentiale",1,138,111,78,33,0,108,3,200,89,39,69
27,MEHEDINŢI,PONOARELE,112995,PONOARELE,"CĂMINUL CULTURAL PONOARELE",235,"Alegeri Prezidentiale",1,824,409,349,59,1,404,5,600,191,163,241
27,MEHEDINŢI,PONOARELE,112995,PROITEŞTI,"ȘCOALA GIMNAZIALĂ CU CLASELE I-IV PROITEȘTI",236,"Alegeri Prezidentiale",1,545,269,242,27,0,262,7,600,331,124,138
27,MEHEDINŢI,PONOARELE,112995,GĂRDĂNEASA,"CĂMINUL CULTURAL GĂRDĂNEASA",237,"Alegeri Prezidentiale",1,390,232,183,49,0,227,5,500,268,83,144
27,MEHEDINŢI,PONOARELE,112995,BÂRÂIACU,"CĂMINUL CULTURAL BÎRÎIACU",238,"Alegeri Prezidentiale",1,222,147,115,32,0,146,1,300,153,65,81
27,MEHEDINŢI,"POROINA MARE",113153,"POROINA MARE","ŞCOALA GENERALĂ POROINA MARE",239,"Alegeri Prezidentiale",1,305,274,151,92,31,274,0,400,126,235,39
27,MEHEDINŢI,"POROINA MARE",113153,STIGNIŢA,"ŞCOALA GENERALĂ I-IV STIGNIŢA",240,"Alegeri Prezidentiale",1,343,284,181,74,29,283,1,400,116,234,49
27,MEHEDINŢI,"POROINA MARE",113153,"FÂNTÂNILE NEGRE","ŞCOALA GENERALĂ FÎNTÂNILE NEGRE",241,"Alegeri Prezidentiale",1,131,86,49,31,6,85,1,200,114,56,29
27,MEHEDINŢI,PRISTOL,113206,PRISTOL,"CĂMINUL CULTURAL PRISTOL",242,"Alegeri Prezidentiale",1,790,502,329,140,33,497,5,900,398,199,298
27,MEHEDINŢI,PRISTOL,113206,COZIA,"ŞCOALA GENERALĂ COZIA",243,"Alegeri Prezidentiale",1,428,302,226,54,22,300,2,500,198,88,212
27,MEHEDINŢI,PRUNIŞOR,113233,PRUNIŞOR,"ŞCOALA GENERALĂ PRUNIŞOR",244,"Alegeri Prezidentiale",1,433,359,229,114,16,353,6,500,141,107,246
27,MEHEDINŢI,PRUNIŞOR,113233,"FÂNTÂNA DOMNEASCĂ","CĂMINUL CULTURAL FÎNTÎNA DOMNEASCĂ",245,"Alegeri Prezidentiale",1,306,160,125,35,0,158,2,400,240,79,79
27,MEHEDINŢI,PRUNIŞOR,113233,CERVENIŢA,"CĂMINUL CULTURAL CERVENIŢA",246,"Alegeri Prezidentiale",1,291,192,126,62,4,188,4,400,208,76,112
27,MEHEDINŢI,PRUNIŞOR,113233,GHELMEGIOAIA,"IMOBIL PROPRIETATE PRIVATĂ - PERSOANĂ FIZICĂ",247,"Alegeri Prezidentiale",1,303,252,126,108,18,250,2,400,148,97,153
27,MEHEDINŢI,PRUNIŞOR,113233,ZEGAIA,"ŞCOALA GENERALĂ ZEGAIA",248,"Alegeri Prezidentiale",1,205,190,96,94,0,190,0,300,110,68,122
27,MEHEDINŢI,PUNGHINA,113395,PUNGHINA,"CĂMINUL CULTURAL PUNGHINA",249,"Alegeri Prezidentiale",1,971,345,285,59,1,343,2,1100,755,115,228
27,MEHEDINŢI,PUNGHINA,113395,RECEA,"ŞCOALA I-IV RECEA",250,"Alegeri Prezidentiale",1,803,342,301,41,0,337,5,900,558,118,219
27,MEHEDINŢI,PUNGHINA,113395,CEARÂNGU,"CĂMINUL CULTURAL CEARÎNG",251,"Alegeri Prezidentiale",1,120,85,66,19,0,85,0,200,115,37,48
27,MEHEDINŢI,PUNGHINA,113395,DRINCEA,"CĂMINUL CULTURAL DRINCEA",252,"Alegeri Prezidentiale",1,276,199,134,65,0,198,1,300,101,59,139
27,MEHEDINŢI,ROGOVA,113466,ROGOVA,"ŞCOALA GENERALĂ I-VIII ROGOVA",253,"Alegeri Prezidentiale",1,1161,926,558,299,69,911,15,1200,274,376,535
27,MEHEDINŢI,SALCIA,113493,SALCIA,"ŞCOALA GENERALĂ V-VIII SALCIA",254,"Alegeri Prezidentiale",1,1130,650,555,52,43,645,5,1200,550,312,333
27,MEHEDINŢI,SALCIA,113493,SALCIA,"ŞCOALA GENERALĂ V-VIII SALCIA",255,"Alegeri Prezidentiale",1,1210,657,543,68,46,651,6,1300,643,245,406
27,MEHEDINŢI,STÂNGĂCEAUA,113518,STÂNGĂCEAUA,"ŞCOALA GENERALĂ STÎNGĂCEAUA",256,"Alegeri Prezidentiale",1,526,284,230,54,0,283,1,600,316,137,146
27,MEHEDINŢI,STÂNGĂCEAUA,113518,"SATU MARE","ŞCOALA GENERALĂ SATU MARE",257,"Alegeri Prezidentiale",1,355,204,171,33,0,204,0,400,196,92,112
27,MEHEDINŢI,STÂNGĂCEAUA,113518,BÂRLOGENI,"ŞCOALA GENERALĂ I-IV BÎRLOGENI",258,"Alegeri Prezidentiale",1,180,135,100,35,0,133,2,200,65,26,107
27,MEHEDINŢI,SVINIŢA,113607,SVINIŢA,"PRIMĂRIA SVINIŢA",259,"Alegeri Prezidentiale",1,793,413,354,53,6,407,6,800,387,206,201
27,MEHEDINŢI,ŞIMIAN,109826,ŞIMIAN,"ŞCOALA GENERALĂ I-VIII ŞIMIAN",260,"Alegeri Prezidentiale",1,1663,1154,707,445,2,1141,13,1800,646,849,292
27,MEHEDINŢI,ŞIMIAN,109826,ŞIMIAN,"ŞCOALA GENERALĂ I-VIII ŞIMIAN",261,"Alegeri Prezidentiale",1,1829,1026,670,356,0,1020,6,2000,974,720,300
27,MEHEDINŢI,ŞIMIAN,109826,CERNEŢI,"ŞCOALA GENERALĂ I-VIII CERNEŢI",262,"Alegeri Prezidentiale",1,1438,779,596,182,1,770,9,1500,721,558,212
27,MEHEDINŢI,ŞIMIAN,109826,CERNEŢI,"ŞCOALA GENERALĂ I-VIII CERNEŢI",263,"Alegeri Prezidentiale",1,1437,750,663,84,3,731,19,1500,750,475,256
27,MEHEDINŢI,ŞIMIAN,109826,DUDAŞU,"ŞCOALA GENERALĂ I-IV DUDAŞU",264,"Alegeri Prezidentiale",1,1133,619,457,162,0,607,12,1200,581,489,118
27,MEHEDINŢI,ŞIMIAN,109826,"DEDOVIŢA NOUĂ","ŞCOALA GENERALĂ I-IV DEDOVIŢA NOUĂ",265,"Alegeri Prezidentiale",1,338,280,159,121,0,277,3,400,120,172,105
27,MEHEDINŢI,ŞIMIAN,109826,POROINA,"ŞCOALA GENERALĂ I-IV POROINA",266,"Alegeri Prezidentiale",1,240,188,132,56,0,186,2,300,112,112,74
27,MEHEDINŢI,ŞIMIAN,109826,POROINA,"ȘCOALA GENERALĂ I-IV POROINA",267,"Alegeri Prezidentiale",1,270,146,112,34,0,143,3,400,254,94,49
27,MEHEDINŢI,ŞIMIAN,109826,"VALEA COPCII","ŞCOALA GENERALĂ VALEA COPCII",268,"Alegeri Prezidentiale",1,109,127,63,64,0,126,1,200,73,85,41
27,MEHEDINŢI,ŞIŞEŞTI,113625,ŞIŞEŞTI,"CĂMINUL CULTURAL ŞIŞEŞTI",269,"Alegeri Prezidentiale",1,978,502,396,106,0,502,0,1000,498,286,216
27,MEHEDINŢI,ŞIŞEŞTI,113625,COCOROVA,"ŞCOALA GENERALĂ I-IV COCOROVA",270,"Alegeri Prezidentiale",1,276,174,135,39,0,172,2,300,126,87,85
27,MEHEDINŢI,ŞIŞEŞTI,113625,NOAPTEŞA,"CĂMINUL CULTURAL NOAPTEȘA",271,"Alegeri Prezidentiale",1,573,276,241,35,0,272,4,700,424,152,120
27,MEHEDINŢI,ŞIŞEŞTI,113625,CRĂGUEŞTI,"ȘCOALA GENERALĂ I - IV CRĂGUEȘTI",272,"Alegeri Prezidentiale",1,290,171,108,63,0,171,0,300,129,87,84
27,MEHEDINŢI,ŞOVARNA,113698,ŞOVARNA,"PRIMĂRIA ŞOVARNA",273,"Alegeri Prezidentiale",1,922,626,468,158,0,619,7,1000,374,162,457
27,MEHEDINŢI,TÂMNA,113732,TÂMNA,"PRIMĂRIA TÎMNA",274,"Alegeri Prezidentiale",1,976,460,257,203,0,455,5,1100,640,163,292
27,MEHEDINŢI,TÂMNA,113732,TÂMNA,"CENTRUL DE ZI TÂMNA",275,"Alegeri Prezidentiale",1,535,301,245,56,0,298,3,600,299,129,169
27,MEHEDINŢI,TÂMNA,113732,IZVORĂLU,"CĂMIN CULTURAL IZVORĂLU",276,"Alegeri Prezidentiale",1,275,219,153,66,0,219,0,300,81,126,93
27,MEHEDINŢI,TÂMNA,113732,PLOPI,"ŞCOALA GENERALĂ PLOPI",277,"Alegeri Prezidentiale",1,494,262,213,49,0,258,4,500,238,112,146
27,MEHEDINŢI,TÂMNA,113732,CREMENEA,"ŞCOALA CREMENEA",278,"Alegeri Prezidentiale",1,169,81,56,25,0,77,4,200,119,28,49
27,MEHEDINŢI,VÂNĂTORI,113849,VÂNĂTORI,"ŞCOALA GENERALĂ I-VIII VÎNĂTORI",279,"Alegeri Prezidentiale",1,894,502,390,90,22,495,7,1000,498,180,315
27,MEHEDINŢI,VÂNĂTORI,113849,ROŞIORI,"ŞCOALA GENERALĂ I-IV ROŞIORI",280,"Alegeri Prezidentiale",1,745,443,298,139,6,440,3,800,357,178,262
27,MEHEDINŢI,VÂNJULEŢ,113894,VÂNJULEŢ,"CĂMIN CULTURAL VÎNJULEŢ",281,"Alegeri Prezidentiale",1,1450,779,535,114,130,775,4,1700,921,481,294
27,MEHEDINŢI,VLĂDAIA,113929,VLĂDAIA,"ŞCOALA I-VIII PREDA BUZESCU, VLĂDAIA",282,"Alegeri Prezidentiale",1,398,259,168,91,0,254,5,400,141,73,181
27,MEHEDINŢI,VLĂDAIA,113929,ALMĂJEL,"ŞCOALA GENERALĂ I-IV ALMĂJEL",283,"Alegeri Prezidentiale",1,571,212,169,43,0,204,8,599,387,49,155
27,MEHEDINŢI,VLĂDAIA,113929,SCORILA,"ŞCOALA GENERALĂ I-IV SCORILA",284,"Alegeri Prezidentiale",1,159,93,61,32,0,91,2,200,107,24,67
27,MEHEDINŢI,VLĂDAIA,113929,ŞTIRCOVIŢA,"ŞCOALA GENERALĂ I-IV ŞTIRCOVIŢA",285,"Alegeri Prezidentiale",1,153,104,59,45,0,104,0,200,96,49,55
27,MEHEDINŢI,VOLOIAC,113974,VOLOIAC,"ŞCOALA GENERALĂ I-VIII VOLOIAC",286,"Alegeri Prezidentiale",1,493,270,235,35,0,265,5,498,228,145,120
27,MEHEDINŢI,VOLOIAC,113974,COTOROAIA,"ŞCOALA GENERALĂ I-IV COTOROAIA",287,"Alegeri Prezidentiale",1,443,184,157,27,0,180,4,500,316,95,85
27,MEHEDINŢI,VOLOIAC,113974,LAC,"FOSTA ŞCOALĂ GENERALĂ I-IV LAC",288,"Alegeri Prezidentiale",1,94,92,61,31,0,91,1,200,108,39,52
27,MEHEDINŢI,VOLOIAC,113974,"VALEA BUNĂ","ŞCOALA GENERALĂ I-IV VALEA BUNĂ",289,"Alegeri Prezidentiale",1,289,174,135,39,0,172,2,300,126,61,111
27,MEHEDINŢI,VRATA,114079,VRATA,"CĂMINUL CULTURAL VRATA",290,"Alegeri Prezidentiale",1,1540,706,581,76,49,700,6,1600,894,254,446
28,MUREŞ,"MUNICIPIUL TÂRGU MUREŞ",114319,"TÂRGU MUREŞ","CASA ”APOLLO” (ŞCOALA DE ARTE)",1,"Alegeri Prezidentiale",1,1311,674,460,214,0,644,30,1451,777,485,159
28,MUREŞ,"MUNICIPIUL TÂRGU MUREŞ",114319,"TÂRGU MUREŞ","UNIVERSITATEA ”PETRU MAIOR”",2,"Alegeri Prezidentiale",1,1593,742,566,176,0,702,40,1701,959,547,155
28,MUREŞ,"MUNICIPIUL TÂRGU MUREŞ",114319,"TÂRGU MUREŞ","LICEUL TEORETIC ”BOLYAI FARKAS”,",3,"Alegeri Prezidentiale",1,1376,769,517,181,71,714,55,1501,732,520,194
28,MUREŞ,"MUNICIPIUL TÂRGU MUREŞ",114319,"TÂRGU MUREŞ","INTERNAT LICEUL TEHNOLOGIC ”AVRAM IANCU”",4,"Alegeri Prezidentiale",1,1362,552,489,52,11,509,43,1501,949,361,148
28,MUREŞ,"MUNICIPIUL TÂRGU MUREŞ",114319,"TÂRGU MUREŞ","ŞCOALA GIMNAZIALĂ ”NICOLAE BĂLCESCU”",5,"Alegeri Prezidentiale",1,1635,679,642,37,0,645,34,1750,1071,472,173
28,MUREŞ,"MUNICIPIUL TÂRGU MUREŞ",114319,"TÂRGU MUREŞ","ŞCOALA GIMNAZIALĂ ”NICOLAE BĂLCESCU”",6,"Alegeri Prezidentiale",1,1188,453,403,50,0,437,16,1300,847,283,154
28,MUREŞ,"MUNICIPIUL TÂRGU MUREŞ",114319,"TÂRGU MUREŞ","ŞCOALA GIMNAZIALĂ ”NICOLAE BĂLCESCU”",7,"Alegeri Prezidentiale",1,1340,538,506,32,0,521,17,1451,913,371,150
28,MUREŞ,"MUNICIPIUL TÂRGU MUREŞ",114319,"TÂRGU MUREŞ","ŞCOALA GIMNAZIALĂ ”NICOLAE BĂLCESCU”",8,"Alegeri Prezidentiale",1,1268,580,549,31,0,549,31,1401,821,423,126
28,MUREŞ,"MUNICIPIUL TÂRGU MUREŞ",114319,"TÂRGU MUREŞ","ŞCOALA GIMNAZIALĂ ”NICOLAE BĂLCESCU”",9,"Alegeri Prezidentiale",1,1607,594,559,34,1,558,36,1751,1157,424,134
28,MUREŞ,"MUNICIPIUL TÂRGU MUREŞ",114319,"TÂRGU MUREŞ","LICEUL TEHNOLOGIC ”AUREL PERŞU”",10,"Alegeri Prezidentiale",1,1276,460,433,27,0,450,10,1401,941,377,73
28,MUREŞ,"MUNICIPIUL TÂRGU MUREŞ",114319,"TÂRGU MUREŞ","LICEUL TEHNOLOGIC ”AUREL PERŞU”",11,"Alegeri Prezidentiale",1,1252,584,554,28,2,560,24,1350,766,432,128
28,MUREŞ,"MUNICIPIUL TÂRGU MUREŞ",114319,"TÂRGU MUREŞ","PRIMĂRIA MUNICIPIULUI TG.MUREŞ",12,"Alegeri Prezidentiale",1,1325,710,456,254,0,669,41,1451,741,504,165
28,MUREŞ,"MUNICIPIUL TÂRGU MUREŞ",114319,"TÂRGU MUREŞ","COLEGIUL AGRICOL ”TRAIAN SAVULESCU”",13,"Alegeri Prezidentiale",1,1558,707,626,81,0,666,41,1701,994,500,166
28,MUREŞ,"MUNICIPIUL TÂRGU MUREŞ",114319,"TÂRGU MUREŞ","ŞCOALA GIMNAZIALĂ ”AL.I.CUZA”",14,"Alegeri Prezidentiale",1,1576,804,778,26,0,778,26,1702,898,613,165
28,MUREŞ,"MUNICIPIUL TÂRGU MUREŞ",114319,"TÂRGU MUREŞ","ŞCOALA GIMNAZIALĂ ”AL.I.CUZA”",15,"Alegeri Prezidentiale",1,1737,828,802,26,0,794,34,1901,1073,618,176
28,MUREŞ,"MUNICIPIUL TÂRGU MUREŞ",114319,"TÂRGU MUREŞ","ŞCOALA GIMNAZIALĂ ”AL.I.CUZA”",16,"Alegeri Prezidentiale",1,1657,960,803,157,0,931,29,1801,841,724,207
28,MUREŞ,"MUNICIPIUL TÂRGU MUREŞ",114319,"TÂRGU MUREŞ","ŞCOALA GIMNAZIALĂ”AL.I.CUZA”",17,"Alegeri Prezidentiale",1,1805,998,931,67,0,977,21,1947,949,759,218
28,MUREŞ,"MUNICIPIUL TÂRGU MUREŞ",114319,"TÂRGU MUREŞ","ŞCOALA GIMNAZIALĂ”AL.I.CUZA”",18,"Alegeri Prezidentiale",1,1624,678,643,35,0,665,13,1751,1073,510,155
28,MUREŞ,"MUNICIPIUL TÂRGU MUREŞ",114319,"TÂRGU MUREŞ","ŞCOALA GIMNAZIALĂ”AL.I.CUZA”",19,"Alegeri Prezidentiale",1,1939,992,944,48,0,957,35,2101,1109,738,219
28,MUREŞ,"MUNICIPIUL TÂRGU MUREŞ",114319,"TÂRGU MUREŞ","ŞCOALA GEN. NR. 19 BEŞA",20,"Alegeri Prezidentiale",1,797,326,313,13,0,312,14,901,575,227,85
28,MUREŞ,"MUNICIPIUL TÂRGU MUREŞ",114319,"TÂRGU MUREŞ","ŞCOALA GIMNAZIALĂ ”FRIEDERICH SCHILLER”",21,"Alegeri Prezidentiale",1,1244,535,456,79,0,497,38,1351,816,359,138
28,MUREŞ,"MUNICIPIUL TÂRGU MUREŞ",114319,"TÂRGU MUREŞ","ŞCOALA GIMNAZIALĂ ”FRIEDERICH SCHILLER”",22,"Alegeri Prezidentiale",1,1261,637,567,69,1,603,34,1351,714,463,140
28,MUREŞ,"MUNICIPIUL TÂRGU MUREŞ",114319,"TÂRGU MUREŞ","LICEUL CU PROGRAM SPORTIV ”SZASZ ADALBERT”",23,"Alegeri Prezidentiale",1,1532,575,508,67,0,551,24,1651,1076,428,123
28,MUREŞ,"MUNICIPIUL TÂRGU MUREŞ",114319,"TÂRGU MUREŞ","ŞCOALA GIMNAZIALĂ ”EUROPA”",24,"Alegeri Prezidentiale",1,1434,1110,625,391,94,1063,47,1551,441,813,250
28,MUREŞ,"MUNICIPIUL TÂRGU MUREŞ",114319,"TÂRGU MUREŞ","GRĂDINIŢA PROGR.PREL.NR.6",25,"Alegeri Prezidentiale",1,1275,622,548,74,0,593,29,1400,778,430,163
28,MUREŞ,"MUNICIPIUL TÂRGU MUREŞ",114319,"TÂRGU MUREŞ","LICEUL TEHNOLOGIC ”C-TIN BRÂNCUŞI”",26,"Alegeri Prezidentiale",1,1357,813,574,239,0,754,59,1501,688,518,236
28,MUREŞ,"MUNICIPIUL TÂRGU MUREŞ",114319,"TÂRGU MUREŞ","ŞCOALA GIMNAZIALĂ NR. 7 CORP A",27,"Alegeri Prezidentiale",1,1383,860,622,238,0,827,33,1501,641,613,214
28,MUREŞ,"MUNICIPIUL TÂRGU MUREŞ",114319,"TÂRGU MUREŞ","ŞCOALA GIMNAZIALĂ NR. 7, CORPUL B",28,"Alegeri Prezidentiale",1,1094,647,401,198,48,627,20,1201,554,478,149
28,MUREŞ,"MUNICIPIUL TÂRGU MUREŞ",114319,"TÂRGU MUREŞ","ŞCOALA GIMNAZIALĂ NR. 7, CORPUL B",29,"Alegeri Prezidentiale",2,1292,631,528,103,0,602,29,1401,770,475,127
28,MUREŞ,"MUNICIPIUL TÂRGU MUREŞ",114319,"TÂRGU MUREŞ","LICEUL TEHNOLOGIC ”ION VLASIU”",30,"Alegeri Prezidentiale",1,1508,898,594,202,102,860,38,1651,753,652,208
28,MUREŞ,"MUNICIPIUL TÂRGU MUREŞ",114319,"TÂRGU MUREŞ","CENTRUL CULTURAL ”MIHAI EMINESCU”",31,"Alegeri Prezidentiale",1,815,1232,301,686,245,1184,48,1504,272,939,245
28,MUREŞ,"MUNICIPIUL TÂRGU MUREŞ",114319,"TÂRGU MUREŞ","COLEGIUL NAŢIONAL ”UNIREA”",32,"Alegeri Prezidentiale",1,1596,865,724,109,32,828,37,1751,886,615,213
28,MUREŞ,"MUNICIPIUL TÂRGU MUREŞ",114319,"TÂRGU MUREŞ","LICEUL VOCAŢIONAL ”M. EMINESCU”",33,"Alegeri Prezidentiale",1,1624,671,616,55,0,648,23,1750,1079,477,171
28,MUREŞ,"MUNICIPIUL TÂRGU MUREŞ",114319,"TÂRGU MUREŞ","ŞCOALA GIMNAZIALĂ ”T.VLADIMIRESCU”",34,"Alegeri Prezidentiale",1,1495,742,656,86,0,726,16,1651,909,533,193
28,MUREŞ,"MUNICIPIUL TÂRGU MUREŞ",114319,"TÂRGU MUREŞ","ŞCOALA GIMNAZIALĂ ”T.VLADIMIRESCU”",35,"Alegeri Prezidentiale",1,1499,805,717,87,1,779,26,1601,796,548,231
28,MUREŞ,"MUNICIPIUL TÂRGU MUREŞ",114319,"TÂRGU MUREŞ","ŞCOALA GIMNAZIALĂ ”T.VLADIMIRESCU”",36,"Alegeri Prezidentiale",1,1505,771,716,55,0,739,32,1651,880,539,200
28,MUREŞ,"MUNICIPIUL TÂRGU MUREŞ",114319,"TÂRGU MUREŞ","ŞCOALA GIMNAZIALĂ ”T.VLADIMIRESCU”",37,"Alegeri Prezidentiale",1,1553,776,726,49,1,757,19,1701,925,558,199
28,MUREŞ,"MUNICIPIUL TÂRGU MUREŞ",114319,"TÂRGU MUREŞ","ŞCOALA GIMNAZIALĂ ”T.VLADIMIRESCU”",38,"Alegeri Prezidentiale",1,1396,663,618,45,0,643,20,1501,838,465,178
28,MUREŞ,"MUNICIPIUL TÂRGU MUREŞ",114319,"TÂRGU MUREŞ","LICEUL TEHNOLOGIC ELECTROMUREŞ",39,"Alegeri Prezidentiale",1,1728,939,860,79,0,904,35,1851,912,654,250
28,MUREŞ,"MUNICIPIUL TÂRGU MUREŞ",114319,"TÂRGU MUREŞ","LICEUL TEHNOLOGIC ELECTROMUREŞ",40,"Alegeri Prezidentiale",1,1597,783,709,74,0,751,32,1750,967,561,190
28,MUREŞ,"MUNICIPIUL TÂRGU MUREŞ",114319,"TÂRGU MUREŞ","LICEUL TEHNOLOGIC ELECTROMUREŞ",41,"Alegeri Prezidentiale",1,1505,836,692,87,57,811,25,1652,816,612,199
28,MUREŞ,"MUNICIPIUL TÂRGU MUREŞ",114319,"TÂRGU MUREŞ","LICEUL TEHNOLOGIC ELECTROMUREŞ",42,"Alegeri Prezidentiale",1,1487,781,681,100,0,757,24,1601,820,499,258
28,MUREŞ,"MUNICIPIUL TÂRGU MUREŞ",114319,"TÂRGU MUREŞ","PUNCT COLECTARE TAXE ŞI IMPOZITE",43,"Alegeri Prezidentiale",1,1078,667,549,117,1,648,19,1153,486,498,150
28,MUREŞ,"MUNICIPIUL TÂRGU MUREŞ",114319,"TÂRGU MUREŞ","ŞCOALA GIMNAZIALĂ ”MIHAI VITEAZUL”",44,"Alegeri Prezidentiale",1,1612,842,718,124,0,802,40,1748,906,551,251
28,MUREŞ,"MUNICIPIUL TÂRGU MUREŞ",114319,"TÂRGU MUREŞ","ŞCOALA GIMNAZIALĂ ”MIHAI VITEAZUL”",45,"Alegeri Prezidentiale",1,1554,843,767,76,0,811,32,1701,858,557,254
28,MUREŞ,"MUNICIPIUL TÂRGU MUREŞ",114319,"TÂRGU MUREŞ","ŞCOALA GIMNAZIALĂ ”MIHAI VITEAZUL”",46,"Alegeri Prezidentiale",1,1583,817,741,76,0,774,43,1701,884,574,200
28,MUREŞ,"MUNICIPIUL TÂRGU MUREŞ",114319,"TÂRGU MUREŞ","ŞCOALA GIMNAZIALĂ ”MIHAI VITEAZUL”",47,"Alegeri Prezidentiale",1,1532,743,681,62,0,717,26,1651,908,520,197
28,MUREŞ,"MUNICIPIUL TÂRGU MUREŞ",114319,"TÂRGU MUREŞ","ŞCOALA GIMNAZIALĂ ”ROMULUS GUGA”",48,"Alegeri Prezidentiale",1,1488,838,682,156,0,815,23,1601,763,588,227
28,MUREŞ,"MUNICIPIUL TÂRGU MUREŞ",114319,"TÂRGU MUREŞ","ŞCOALA GIMNAZIALĂ ”ROMULUS GUGA”",49,"Alegeri Prezidentiale",1,1736,1035,902,133,0,1012,23,1851,816,788,224
28,MUREŞ,"MUNICIPIUL TÂRGU MUREŞ",114319,"TÂRGU MUREŞ","ŞCOALA GIMNAZIALĂ ”ROMULUS GUGA”",50,"Alegeri Prezidentiale",1,1494,766,728,38,0,736,30,1600,834,544,192
28,MUREŞ,"MUNICIPIUL TÂRGU MUREŞ",114319,"TÂRGU MUREŞ","ŞCOALA GIMNAZIALĂ ”ROMULUS GUGA”",51,"Alegeri Prezidentiale",1,1412,685,657,28,0,661,24,1550,865,469,192
28,MUREŞ,"MUNICIPIUL TÂRGU MUREŞ",114319,"TÂRGU MUREŞ","GRĂDINIŢA CU PROGR.PREL.”CODRIŞOR”",52,"Alegeri Prezidentiale",1,1607,825,782,43,0,803,22,1751,926,565,238
28,MUREŞ,"MUNICIPIUL TÂRGU MUREŞ",114319,"TÂRGU MUREŞ","ŞCOALA GIMNAZIALĂ ”G.COŞBUC”",53,"Alegeri Prezidentiale",2,1424,632,542,90,0,590,42,1551,919,454,136
28,MUREŞ,"MUNICIPIUL TÂRGU MUREŞ",114319,"TÂRGU MUREŞ","ŞCOALA GIMNAZIALĂ ”G.COŞBUC”",54,"Alegeri Prezidentiale",1,1541,658,593,64,1,635,23,1651,993,486,149
28,MUREŞ,"MUNICIPIUL TÂRGU MUREŞ",114319,"TÂRGU MUREŞ","ŞCOALA GIMNAZIALĂ ”DACIA”/B",55,"Alegeri Prezidentiale",1,1499,681,618,61,2,654,27,1602,921,478,176
28,MUREŞ,"MUNICIPIUL TÂRGU MUREŞ",114319,"TÂRGU MUREŞ","ŞCOALA GIMNAZIALĂ ”DACIA”/B",56,"Alegeri Prezidentiale",1,1503,671,629,41,1,647,24,1651,980,471,176
28,MUREŞ,"MUNICIPIUL TÂRGU MUREŞ",114319,"TÂRGU MUREŞ","CENTRUL ŞCOLAR PENTRU EDUCAŢIE INCLUZIVĂ NR.1",57,"Alegeri Prezidentiale",1,1536,745,613,55,77,713,32,1651,906,438,275
28,MUREŞ,"MUNICIPIUL TÂRGU MUREŞ",114319,"TÂRGU MUREŞ","CENTRUL ŞCOLAR PENTRU EDUCAŢIE INCLUZIVĂ NR.1",58,"Alegeri Prezidentiale",1,1415,403,288,39,76,392,11,983,580,235,157
28,MUREŞ,"MUNICIPIUL TÂRGU MUREŞ",114319,"TÂRGU MUREŞ","ŞCOALA GIMNAZIALĂ ”DACIA”/A",59,"Alegeri Prezidentiale",1,1523,765,733,32,0,737,28,1651,886,553,184
28,MUREŞ,"MUNICIPIUL TÂRGU MUREŞ",114319,"TÂRGU MUREŞ","ŞCOALA GIMNAZIALĂ ”DACIA”/A",60,"Alegeri Prezidentiale",1,1420,774,676,76,22,738,36,1551,777,531,207
28,MUREŞ,"MUNICIPIUL TÂRGU MUREŞ",114319,"TÂRGU MUREŞ","ŞCOALA GIMNAZIALĂ ”DACIA”/A",61,"Alegeri Prezidentiale",1,964,403,352,51,0,369,34,1051,648,282,87
28,MUREŞ,"MUNICIPIUL TÂRGU MUREŞ",114319,"TÂRGU MUREŞ","LICEUL TEHNOLOGIC ”AVRAM IANCU”",62,"Alegeri Prezidentiale",1,1306,607,527,80,0,561,46,1401,794,416,145
28,MUREŞ,"MUNICIPIUL TÂRGU MUREŞ",114319,"TÂRGU MUREŞ","LICEUL TEHNOLOGIC ”AVRAM IANCU”",63,"Alegeri Prezidentiale",1,1527,677,600,77,0,639,38,1651,974,489,150
28,MUREŞ,"MUNICIPIUL TÂRGU MUREŞ",114319,"TÂRGU MUREŞ","LICEUL TEHNOLOGIC ”AVRAM IANCU”",64,"Alegeri Prezidentiale",1,1409,597,514,61,22,580,17,1551,954,425,155
28,MUREŞ,"MUNICIPIUL TÂRGU MUREŞ",114319,"TÂRGU MUREŞ","GRĂDINIŢA PROG.PREL.”ALBINUŢA”",65,"Alegeri Prezidentiale",1,1323,647,562,85,0,628,19,1451,804,468,160
28,MUREŞ,"MUNICIPIUL TÂRGU MUREŞ",114319,"TÂRGU MUREŞ","ŞCOALA GIMNAZIALĂ ”LIVIU REBREANU”",66,"Alegeri Prezidentiale",1,1398,573,528,45,0,554,19,1550,977,403,151
28,MUREŞ,"MUNICIPIUL TÂRGU MUREŞ",114319,"TÂRGU MUREŞ","ŞCOALA GIMNAZIALĂ ”LIVIU REBREANU”",67,"Alegeri Prezidentiale",1,1405,717,687,29,1,682,35,1552,835,489,193
28,MUREŞ,"MUNICIPIUL TÂRGU MUREŞ",114319,"TÂRGU MUREŞ","ŞCOALA GIMNAZIALĂ ”LIVIU REBREANU”",68,"Alegeri Prezidentiale",1,1451,596,570,26,0,560,36,1600,1004,409,151
28,MUREŞ,"MUNICIPIUL TÂRGU MUREŞ",114319,"TÂRGU MUREŞ","ŞCOALA GIMNAZIALĂ ”LIVIU REBREANU”",69,"Alegeri Prezidentiale",2,1455,667,627,40,0,636,31,1552,885,460,176
28,MUREŞ,"MUNICIPIUL TÂRGU MUREŞ",114319,"TÂRGU MUREŞ","GRĂDINIŢA PROG.PREL.”LICURICI”",70,"Alegeri Prezidentiale",1,1487,657,610,47,0,621,36,1601,944,514,107
28,MUREŞ,"MUNICIPIUL TÂRGU MUREŞ",114319,"TÂRGU MUREŞ","GRĂDINIŢA PROG.PREL.”LICURICI”",71,"Alegeri Prezidentiale",1,1263,613,588,25,0,586,27,1401,788,427,159
28,MUREŞ,"MUNICIPIUL TÂRGU MUREŞ",114319,"TÂRGU MUREŞ","LICEUL TEHNOLOGIC ”GH. ŞINCAI”",72,"Alegeri Prezidentiale",1,1527,681,606,74,1,644,37,1651,970,458,186
28,MUREŞ,"MUNICIPIUL TÂRGU MUREŞ",114319,"TÂRGU MUREŞ","LICEUL TEHNOLOGIC ”GH. ŞINCAI”",73,"Alegeri Prezidentiale",1,1451,655,619,36,0,629,26,1551,896,410,219
28,MUREŞ,"MUNICIPIUL TÂRGU MUREŞ",114319,"TÂRGU MUREŞ","ŞCOALA GIMNAZIALĂ LIVIU REBREANU",74,"Alegeri Prezidentiale",1,1349,589,544,45,0,543,46,1501,912,365,178
28,MUREŞ,"MUNICIPIUL TÂRGU MUREŞ",114319,"TÂRGU MUREŞ","ŞCOALA GIMNAZIALĂ LIVIU REBREANU",75,"Alegeri Prezidentiale",1,1437,614,583,31,0,590,24,1551,937,440,150
28,MUREŞ,"MUNICIPIUL TÂRGU MUREŞ",114319,"TÂRGU MUREŞ","GRĂDINIŢA CU PROG.PREL.”RÂNDUNICA”",76,"Alegeri Prezidentiale",1,1649,709,648,61,0,677,32,1801,1092,486,191
28,MUREŞ,"MUNICIPIUL TÂRGU MUREŞ",114319,"TÂRGU MUREŞ","LICEUL TEHNOLOGIC ”GH.ŞINCAI”",77,"Alegeri Prezidentiale",1,1553,648,620,24,4,613,35,1701,1053,405,208
28,MUREŞ,"MUNICIPIUL TÂRGU MUREŞ",114319,"TÂRGU MUREŞ","ŞCOALA GIMNAZIALĂ ”SERAFIM DUICU”",78,"Alegeri Prezidentiale",1,1643,697,653,44,0,657,40,1801,1104,465,192
28,MUREŞ,"MUNICIPIUL TÂRGU MUREŞ",114319,"TÂRGU MUREŞ","ŞCOALA GIMNAZIALĂ ”SERAFIM DUICU”",79,"Alegeri Prezidentiale",1,1406,599,544,55,0,582,17,1551,952,475,107
28,MUREŞ,"MUNICIPIUL TÂRGU MUREŞ",114319,"TÂRGU MUREŞ","ŞCOALA GIMNAZIALĂ ”SERAFIM DUICU”",80,"Alegeri Prezidentiale",1,1597,713,661,52,0,703,10,1701,988,531,172
28,MUREŞ,"MUNICIPIUL TÂRGU MUREŞ",114319,"TÂRGU MUREŞ","LICEUL TEHNOLOGIC ”TRAIAN VUIA”",81,"Alegeri Prezidentiale",1,1629,770,709,61,0,752,18,1751,981,573,179
28,MUREŞ,"MUNICIPIUL TÂRGU MUREŞ",114319,"TÂRGU MUREŞ","LICEUL TEHNOLOGIC ”TRAIAN VUIA”",82,"Alegeri Prezidentiale",1,1601,649,575,38,36,628,21,1452,803,509,119
28,MUREŞ,"MUNICIPIUL TÂRGU MUREŞ",114319,"TÂRGU MUREŞ","LICEUL TEHNOLOGIC ”TRAIAN VUIA”",83,"Alegeri Prezidentiale",1,1482,706,657,49,0,686,20,1601,895,524,162
28,MUREŞ,"MUNICIPIUL TÂRGU MUREŞ",114319,"TÂRGU MUREŞ","LICEUL TEHNOLOGIC ”EMIL DANDEA”",84,"Alegeri Prezidentiale",1,1232,462,414,48,0,454,8,1351,889,311,143
28,MUREŞ,"MUNICIPIUL TÂRGU MUREŞ",114319,"TÂRGU MUREŞ","CĂMINUL CULTURAL",85,"Alegeri Prezidentiale",1,1010,430,404,25,1,420,10,1101,671,328,92
28,MUREŞ,"MUNICIPIUL REGHIN",114809,REGHIN,"ŞCOALA GIMNAZIALĂ ”ALEXANDRU CEUŞIANU”",86,"Alegeri Prezidentiale",1,1441,758,698,60,0,749,9,1551,793,572,177
28,MUREŞ,"MUNICIPIUL REGHIN",114809,REGHIN,"CLUBUL COPIILOR",87,"Alegeri Prezidentiale",1,1389,787,752,34,1,781,6,1501,714,620,161
28,MUREŞ,"MUNICIPIUL REGHIN",114809,REGHIN,"LICEUL TEHNOLOGIC ”LUCIAN BLAGA”",88,"Alegeri Prezidentiale",1,1527,870,825,45,0,853,17,1651,781,677,176
28,MUREŞ,"MUNICIPIUL REGHIN",114809,REGHIN,"LICEUL TEHNOLOGIC ”LUCIAN BLAGA”",89,"Alegeri Prezidentiale",1,1322,668,40,628,0,658,10,1451,783,528,130
28,MUREŞ,"MUNICIPIUL REGHIN",114809,REGHIN,"LICEUL TEHNOLOGIC ”PETRU MAIOR”",90,"Alegeri Prezidentiale",1,1591,856,788,56,12,843,13,1751,895,662,181
28,MUREŞ,"MUNICIPIUL REGHIN",114809,REGHIN,"LICEUL TEHNOLOGIC ”PETRU MAIOR”",91,"Alegeri Prezidentiale",1,1542,784,733,51,0,776,8,1651,867,606,170
28,MUREŞ,"MUNICIPIUL REGHIN",114809,REGHIN,"LICEUL TEHNOLOGIC ”PETRU MAIOR”",92,"Alegeri Prezidentiale",1,1474,738,697,41,0,733,5,1601,863,587,146
28,MUREŞ,"MUNICIPIUL REGHIN",114809,REGHIN,"LICEUL TEHNOLOGIC ”IOAN BOJOR”",93,"Alegeri Prezidentiale",1,1651,859,814,45,0,847,12,1801,942,691,156
28,MUREŞ,"MUNICIPIUL REGHIN",114809,REGHIN,"LICEUL TEHNOLOGIC ”IOAN BOJOR”",94,"Alegeri Prezidentiale",1,1664,843,817,26,0,833,10,1801,958,627,206
28,MUREŞ,"MUNICIPIUL REGHIN",114809,REGHIN,"GRĂDINIŢA CU PROGRAM PRELUNGIT NR.4",95,"Alegeri Prezidentiale",1,988,481,453,28,0,472,9,1101,620,392,80
28,MUREŞ,"MUNICIPIUL REGHIN",114809,REGHIN,"GRĂDINIŢA CU PROGRAM PRELUNGIT NR.4",96,"Alegeri Prezidentiale",1,980,466,448,18,0,462,4,1101,635,350,112
28,MUREŞ,"MUNICIPIUL REGHIN",114809,REGHIN,"CĂMINUL CULTURAL ”IERNUŢENI”",97,"Alegeri Prezidentiale",1,1590,860,794,65,1,843,17,1701,841,649,194
28,MUREŞ,"MUNICIPIUL REGHIN",114809,REGHIN,"ŞCOALA GIMNAZIALĂ NR.4",98,"Alegeri Prezidentiale",1,1045,558,534,24,0,545,13,1151,593,215,330
28,MUREŞ,"MUNICIPIUL REGHIN",114809,REGHIN,"ŞCOALA GIMNAZIALĂ NR.4",99,"Alegeri Prezidentiale",1,1136,568,546,21,1,559,9,1251,683,445,114
28,MUREŞ,"MUNICIPIUL REGHIN",114809,REGHIN,"GRĂDINIŢA CU PROGRAM PRELUNGIT NR.3",100,"Alegeri Prezidentiale",1,1389,751,707,44,0,740,11,1500,749,525,215
28,MUREŞ,"MUNICIPIUL REGHIN",114809,REGHIN,"ŞCOALA GIMNAZIALĂ ”FLOREA BOGDAN”",101,"Alegeri Prezidentiale",1,1367,673,628,45,0,662,11,1501,828,537,125
28,MUREŞ,"MUNICIPIUL REGHIN",114809,REGHIN,"ŞCOALA GIMNAZIALĂ ”FLOREA BOGDAN”",102,"Alegeri Prezidentiale",1,1423,720,681,38,1,707,13,1551,831,542,165
28,MUREŞ,"MUNICIPIUL REGHIN",114809,REGHIN,"ŞCOALA GIMNAZIALĂ ”FLOREA BOGDAN”",103,"Alegeri Prezidentiale",1,1355,628,605,23,0,621,7,1451,823,497,124
28,MUREŞ,"MUNICIPIUL REGHIN",114809,REGHIN,"GRĂDINIŢA CU PROGRAM NORMAL NR.3",104,"Alegeri Prezidentiale",1,1229,695,655,40,0,687,8,1351,656,549,138
28,MUREŞ,"MUNICIPIUL REGHIN",114809,REGHIN,"GRĂDINIŢA CU PROGRAM NORMAL NR.3",105,"Alegeri Prezidentiale",2,1058,570,537,32,1,561,9,1151,581,448,113
28,MUREŞ,"MUNICIPIUL REGHIN",114809,REGHIN,"GRĂDINITA CU PROGRAM NORMAL NR.1 REGHIN",106,"Alegeri Prezidentiale",1,1150,551,498,52,1,530,21,1251,700,409,121
28,MUREŞ,"MUNICIPIUL REGHIN",114809,REGHIN,"ŞCOALA GIMNAZIALĂ ”AUGUSTIN MAIOR”",107,"Alegeri Prezidentiale",1,1200,563,524,39,0,553,10,1300,737,436,117
28,MUREŞ,"MUNICIPIUL REGHIN",114809,REGHIN,"CASA DE CULTURĂ DR. ”EUGEN NICOARA”",108,"Alegeri Prezidentiale",1,1236,699,565,58,76,692,7,1351,652,520,172
28,MUREŞ,"MUNICIPIUL SIGHIŞOARA",114514,SIGHIŞOARA,"ŞCOALA GIMNAZIALĂ ” OCTAVIAN GOGA ”",109,"Alegeri Prezidentiale",1,1364,762,708,54,0,746,16,1501,739,581,165
28,MUREŞ,"MUNICIPIUL SIGHIŞOARA",114514,SIGHIŞOARA,"LICEUL TEHNOLOGIC NR. 2",110,"Alegeri Prezidentiale",1,1098,499,465,34,0,495,4,1201,702,406,89
28,MUREŞ,"MUNICIPIUL SIGHIŞOARA",114514,SIGHIŞOARA,"LICEUL TEHNOLOGIC NR. 2",111,"Alegeri Prezidentiale",1,971,431,380,34,17,422,9,1051,620,332,90
28,MUREŞ,"MUNICIPIUL SIGHIŞOARA",114514,SIGHIŞOARA,"ŞCOALA GIMNAZIALĂ ”MIRON NEAGU”",112,"Alegeri Prezidentiale",1,1339,556,523,33,0,549,7,1451,895,413,136
28,MUREŞ,"MUNICIPIUL SIGHIŞOARA",114514,SIGHIŞOARA,"ŞCOALA GIMNAZIALĂ ”MIRON NEAGU”",113,"Alegeri Prezidentiale",1,1314,645,505,140,0,638,7,1451,806,502,136
28,MUREŞ,"MUNICIPIUL SIGHIŞOARA",114514,SIGHIŞOARA,"LICEUL TEORETIC ”JOSEPH HALTRICH”",114,"Alegeri Prezidentiale",1,1091,554,370,184,0,545,9,1201,647,468,77
28,MUREŞ,"MUNICIPIUL SIGHIŞOARA",114514,SIGHIŞOARA,"GRĂDINIŢA CU PROGRAM PRELUNGIT NR.2",115,"Alegeri Prezidentiale",1,1239,599,554,45,0,587,12,1350,751,486,101
28,MUREŞ,"MUNICIPIUL SIGHIŞOARA",114514,SIGHIŞOARA,"ŞCOALA GIMNAZIALĂ ” NICOLAE IORGA ”",116,"Alegeri Prezidentiale",1,996,394,376,18,0,384,10,1101,707,297,87
28,MUREŞ,"MUNICIPIUL SIGHIŞOARA",114514,SIGHIŞOARA,"ŞCOALA GIMNAZIALĂ ” NICOLAE IORGA ”",117,"Alegeri Prezidentiale",1,973,478,434,43,1,473,5,1051,573,359,114
28,MUREŞ,"MUNICIPIUL SIGHIŞOARA",114514,SIGHIŞOARA,"ŞCOALA GIMNAZIALĂ ” NICOLAE IORGA ”",118,"Alegeri Prezidentiale",1,1389,602,572,30,0,590,12,1501,899,472,118
28,MUREŞ,"MUNICIPIUL SIGHIŞOARA",114514,SIGHIŞOARA,"ŞCOALA GIMNAZIALĂ ” NICOLAE IORGA ”",119,"Alegeri Prezidentiale",1,1175,486,471,15,0,475,11,1301,815,383,92
28,MUREŞ,"MUNICIPIUL SIGHIŞOARA",114514,SIGHIŞOARA,"ŞCOALA GIMNAZIALĂ ” ZAHARIA BOIU ”",120,"Alegeri Prezidentiale",1,1255,517,504,13,0,509,8,1351,834,420,89
28,MUREŞ,"MUNICIPIUL SIGHIŞOARA",114514,SIGHIŞOARA,"ŞCOALA GIMNAZIALĂ ” ZAHARIA BOIU ”",121,"Alegeri Prezidentiale",1,1297,590,576,14,0,582,8,1401,811,493,89
28,MUREŞ,"MUNICIPIUL SIGHIŞOARA",114514,SIGHIŞOARA,"ŞCOALA GIMNAZIALĂ ” ZAHARIA BOIU ”",122,"Alegeri Prezidentiale",1,1157,531,486,45,0,520,11,1251,720,395,125
28,MUREŞ,"MUNICIPIUL SIGHIŞOARA",114514,SIGHIŞOARA,"ŞCOALA GIMNAZIALĂ ” ZAHARIA BOIU ”",123,"Alegeri Prezidentiale",1,1608,765,733,32,0,758,7,1751,986,649,109
28,MUREŞ,"MUNICIPIUL SIGHIŞOARA",114514,SIGHIŞOARA,"ŞCOALA GIMNAZIALĂ ” ZAHARIA BOIU ”",124,"Alegeri Prezidentiale",1,1414,691,632,59,0,684,7,1551,860,570,114
28,MUREŞ,"MUNICIPIUL SIGHIŞOARA",114514,SIGHIŞOARA,"ŞCOALA PRIMARĂ ”DEALUL VIILOR”",125,"Alegeri Prezidentiale",1,1625,610,570,40,0,595,15,1751,1141,492,103
28,MUREŞ,"MUNICIPIUL SIGHIŞOARA",114514,SIGHIŞOARA,"ŞCOALA GIMNAZIALĂ ”AUREL MOSORA”",126,"Alegeri Prezidentiale",1,1413,723,645,69,9,708,15,1551,828,557,151
28,MUREŞ,"MUNICIPIUL SIGHIŞOARA",114514,SIGHIŞOARA,"ŞCOALA GIMNAZIALĂ ”AUREL MOSORA”",127,"Alegeri Prezidentiale",1,1343,615,560,55,0,603,12,1451,836,478,125
28,MUREŞ,"MUNICIPIUL SIGHIŞOARA",114514,SIGHIŞOARA,"ŞCOALA GIMNAZIALĂ ”RADU POPA”",128,"Alegeri Prezidentiale",1,1124,644,496,81,67,631,13,1251,607,469,162
28,MUREŞ,"MUNICIPIUL SIGHIŞOARA",114514,SIGHIŞOARA,"ŞCOALA GIMNAZIALĂ ” VICTOR JINGA”",129,"Alegeri Prezidentiale",1,1186,625,558,67,0,613,12,1301,676,459,154
28,MUREŞ,"MUNICIPIUL SIGHIŞOARA",114514,SIGHIŞOARA,"ŞCOALA GIMNAZIALĂ ” VICTOR JINGA”",130,"Alegeri Prezidentiale",1,981,401,366,35,0,389,12,1051,650,302,87
28,MUREŞ,"MUNICIPIUL SIGHIŞOARA",114514,HETIUR,"ȘCOALA PRIMARĂ HETIUR",131,"Alegeri Prezidentiale",1,850,351,319,32,0,347,4,951,600,300,47
28,MUREŞ,"MUNICIPIUL TÂRNĂVENI",114925,TÂRNĂVENI,"GRĂDINIȚA CU PROGRAM PRELUNGIT NR. 4",132,"Alegeri Prezidentiale",1,962,398,373,25,0,391,7,1051,653,248,143
28,MUREŞ,"MUNICIPIUL TÂRNĂVENI",114925,TÂRNĂVENI,"ȘCOALA GIMNAZIALĂ NR.3",133,"Alegeri Prezidentiale",1,1109,398,378,20,0,390,8,1201,803,274,116
28,MUREŞ,"MUNICIPIUL TÂRNĂVENI",114925,TÂRNĂVENI,"ȘCOALA GIMNAZIALĂ NR.3",134,"Alegeri Prezidentiale",1,963,367,349,18,0,364,3,1051,684,253,111
28,MUREŞ,"MUNICIPIUL TÂRNĂVENI",114925,TÂRNĂVENI,"GRĂDINIȚA CU PROGRAM PRELUNGIT NR.1",135,"Alegeri Prezidentiale",1,932,457,433,24,0,437,20,1000,543,291,146
28,MUREŞ,"MUNICIPIUL TÂRNĂVENI",114925,TÂRNĂVENI,"ȘCOALA GIMNAZIALĂ TRAIAN",136,"Alegeri Prezidentiale",1,1080,480,444,36,0,468,12,1201,721,329,139
28,MUREŞ,"MUNICIPIUL TÂRNĂVENI",114925,TÂRNĂVENI,"LICEUL CONSTANTIN BRÂNCUŞI",137,"Alegeri Prezidentiale",1,1186,450,431,19,0,435,15,1301,851,267,168
28,MUREŞ,"MUNICIPIUL TÂRNĂVENI",114925,TÂRNĂVENI,"CASA DE CULTURĂ MIHAI EMINESCU",138,"Alegeri Prezidentiale",1,1182,536,508,28,0,528,8,1301,765,355,173
28,MUREŞ,"MUNICIPIUL TÂRNĂVENI",114925,TÂRNĂVENI,"COLEGIUL TEHNIC",139,"Alegeri Prezidentiale",1,948,401,379,20,2,392,9,1051,650,269,123
28,MUREŞ,"MUNICIPIUL TÂRNĂVENI",114925,TÂRNĂVENI,"ŞCOALA GIMNAZIALĂ AVRAM IANCU",140,"Alegeri Prezidentiale",1,927,344,312,32,0,342,2,1001,657,236,106
28,MUREŞ,"MUNICIPIUL TÂRNĂVENI",114925,TÂRNĂVENI,"ȘCOALA GIMNAZIALĂ AVRAM IANCU",141,"Alegeri Prezidentiale",2,886,329,313,16,0,320,9,951,622,210,110
28,MUREŞ,"MUNICIPIUL TÂRNĂVENI",114925,TÂRNĂVENI,"LICEUL TEORETIC ANDREI BÂRSEANU",142,"Alegeri Prezidentiale",1,1280,576,514,15,47,562,14,1402,826,360,202
28,MUREŞ,"MUNICIPIUL TÂRNĂVENI",114925,TÂRNĂVENI,"LICEUL TEORETIC ANDREI BÂRSEANU",143,"Alegeri Prezidentiale",1,1343,550,530,19,1,540,10,1451,901,408,132
28,MUREŞ,"MUNICIPIUL TÂRNĂVENI",114925,TÂRNĂVENI,"GRĂDINIȚA CU PROGRAM NORMAL NR. 6",144,"Alegeri Prezidentiale",1,1150,527,491,36,0,517,10,1251,724,391,126
28,MUREŞ,"MUNICIPIUL TÂRNĂVENI",114925,TÂRNĂVENI,"CLUBUL PENSIONARILOR NR. 2",145,"Alegeri Prezidentiale",1,1150,473,452,21,0,467,6,1251,778,345,122
28,MUREŞ,"MUNICIPIUL TÂRNĂVENI",114925,TÂRNĂVENI,"CENTRUL SOCIAL VICTORIA",146,"Alegeri Prezidentiale",1,1077,515,457,58,0,508,7,1151,636,350,158
28,MUREŞ,"MUNICIPIUL TÂRNĂVENI",114925,TÂRNĂVENI,"ŞCOALA GIMNAZIALĂ VASILE MOLDOVAN",147,"Alegeri Prezidentiale",1,1086,468,435,33,0,459,9,1201,733,367,92
28,MUREŞ,"MUNICIPIUL TÂRNĂVENI",114925,TÂRNĂVENI,"ŞCOALA GIMNAZIALĂ VASILE MOLDOVAN",148,"Alegeri Prezidentiale",1,1132,499,471,28,0,481,18,1251,752,293,188
28,MUREŞ,"MUNICIPIUL TÂRNĂVENI",114925,TÂRNĂVENI,"ŞCOALA GIMNAZIALĂ VASILE MOLDOVAN",149,"Alegeri Prezidentiale",1,1173,482,464,18,0,474,8,1301,819,354,120
28,MUREŞ,"MUNICIPIUL TÂRNĂVENI",114925,TÂRNĂVENI,"ŞCOALA PRIMARĂ BOTORCA",150,"Alegeri Prezidentiale",1,293,149,136,13,0,149,0,352,203,118,31
28,MUREŞ,"MUNICIPIUL TÂRNĂVENI",114925,BOBOHALMA,"CĂMINUL CULTURAL BOBOHALMA",151,"Alegeri Prezidentiale",1,824,364,341,23,0,360,4,901,537,308,52
28,MUREŞ,"MUNICIPIUL TÂRNĂVENI",114925,CUŞTELNIC,"GRĂDINIŢA CU PROGRAM NORMAL NR. 6",152,"Alegeri Prezidentiale",1,443,192,176,15,1,190,2,501,309,129,61
28,MUREŞ,"ORAŞ IERNUT",117827,IERNUT,"CASA DE CULTURĂ IERNUT",153,"Alegeri Prezidentiale",1,1318,670,592,76,2,651,19,1451,781,475,176
28,MUREŞ,"ORAŞ IERNUT",117827,IERNUT,"GRĂDINIŢA CU PROGRAM NORMAL IERNUT",154,"Alegeri Prezidentiale",1,1082,519,486,33,0,509,10,1201,682,366,143
28,MUREŞ,"ORAŞ IERNUT",117827,IERNUT,"ŞCOALA GIMNAZIALĂ IERNUT",155,"Alegeri Prezidentiale",1,1236,581,542,39,0,572,9,1351,770,455,117
28,MUREŞ,"ORAŞ IERNUT",117827,IERNUT,"ŞCOALA GIMNAZIALĂ IERNUT",156,"Alegeri Prezidentiale",1,1366,593,543,50,0,577,16,1501,908,442,135
28,MUREŞ,"ORAŞ IERNUT",117827,CIPĂU,"ŞCOALA GIMNAZIALĂ CIPĂU",157,"Alegeri Prezidentiale",1,884,447,384,63,0,438,9,1001,554,320,118
28,MUREŞ,"ORAŞ IERNUT",117827,DEAG,"CĂMIN CULTURAL",158,"Alegeri Prezidentiale",1,277,112,98,14,0,109,3,301,189,86,23
28,MUREŞ,"ORAŞ IERNUT",117827,LECHINŢA,"ŞCOALA GIMNAZIALĂ LECHINŢA",159,"Alegeri Prezidentiale",1,721,287,262,25,0,284,3,801,514,197,87
28,MUREŞ,"ORAŞ IERNUT",117827,"OARBA DE MUREŞ","CĂMIN CULTURAL OARBA DE MUREŞ",160,"Alegeri Prezidentiale",1,92,61,40,21,0,61,0,101,40,43,18
28,MUREŞ,"ORAŞ IERNUT",117827,SĂLCUD,"ŞCOALA PRIMARĂ SĂLCUD",161,"Alegeri Prezidentiale",1,529,213,186,27,0,209,4,601,388,177,32
28,MUREŞ,"ORAŞ IERNUT",117827,"SFÂNTU GHEORGHE","ŞCOALA PRIMARĂ SFÎNTU GHEORGHE",162,"Alegeri Prezidentiale",1,325,189,166,23,0,187,2,351,162,160,27
28,MUREŞ,"ORAŞ LUDUŞ",114710,LUDUŞ,"CĂMINUL CULTURAL GHEJA-LUDUȘ",163,"Alegeri Prezidentiale",1,1269,703,673,30,0,692,11,1401,698,434,258
28,MUREŞ,"ORAŞ LUDUŞ",114710,LUDUŞ,"CĂMINUL CULTURAL ROȘIORI-LUDUȘ",164,"Alegeri Prezidentiale",1,1060,457,432,25,0,451,6,1151,694,388,63
28,MUREŞ,"ORAŞ LUDUŞ",114710,LUDUŞ,"CASA DE CULTURĂ ”POMPEIU HĂRĂŞTEANU” - LUDUȘ",165,"Alegeri Prezidentiale",1,1577,972,762,168,42,957,15,1701,729,701,256
28,MUREŞ,"ORAŞ LUDUŞ",114710,LUDUŞ,"ŞCOALA GIMNAZIALĂ ”IOAN VLĂDUŢIU” - LUDUȘ",166,"Alegeri Prezidentiale",1,1384,739,700,39,0,730,9,1501,762,529,201
28,MUREŞ,"ORAŞ LUDUŞ",114710,LUDUŞ,"ŞCOALA GIMNAZIALĂ ”IOAN VLĂDUŢIU” - LUDUȘ",167,"Alegeri Prezidentiale",1,1595,789,739,50,0,778,11,1751,962,531,247
28,MUREŞ,"ORAŞ LUDUŞ",114710,LUDUŞ,"LICEUL TEHNOLOGIC NR. 1 - LUDUȘ",168,"Alegeri Prezidentiale",1,1326,675,640,35,0,667,8,1451,776,438,229
28,MUREŞ,"ORAŞ LUDUŞ",114710,LUDUŞ,"GRĂDINIŢA ”CĂSUŢA FERMECATĂ” - LUDUȘ",169,"Alegeri Prezidentiale",1,1376,677,631,46,0,666,11,1501,824,413,253
28,MUREŞ,"ORAŞ LUDUŞ",114710,LUDUŞ,"GRĂDINIȚA CU PROGRAM NORMAL NR. 02 - LUDUȘ",170,"Alegeri Prezidentiale",1,1498,791,729,61,1,772,19,1601,810,521,251
28,MUREŞ,"ORAŞ LUDUŞ",114710,LUDUŞ,"GRĂDINIŢA CU PROGRAM PRELUNGIT NR. 01 - LUDUȘ",171,"Alegeri Prezidentiale",1,1102,460,395,65,0,453,7,1201,741,283,170
28,MUREŞ,"ORAŞ LUDUŞ",114710,LUDUŞ,"ŞCOALA GIMNAZIALĂ NR.1 - LUDUȘ",172,"Alegeri Prezidentiale",1,1106,443,400,43,0,436,7,1201,758,307,129
28,MUREŞ,"ORAŞ LUDUŞ",114710,LUDUŞ,"ŞCOALA GIMNAZIALĂ NR.1 - LUDUȘ",173,"Alegeri Prezidentiale",1,1114,554,475,79,0,546,8,1201,647,383,163
28,MUREŞ,"ORAŞ MIERCUREA NIRAJULUI",118281,"MIERCUREA NIRAJULUI","CĂMINUL CULTURAL",174,"Alegeri Prezidentiale",1,964,208,187,21,0,165,43,1051,843,113,52
28,MUREŞ,"ORAŞ MIERCUREA NIRAJULUI",118281,"MIERCUREA NIRAJULUI","ŞCOALA GIMNAZIALĂ DEÁK FARKAS",175,"Alegeri Prezidentiale",1,1081,245,217,28,0,198,47,1201,956,130,68
28,MUREŞ,"ORAŞ MIERCUREA NIRAJULUI",118281,"MIERCUREA NIRAJULUI","INTERNATUL ŞCOLAR",176,"Alegeri Prezidentiale",1,1059,226,206,20,0,197,29,1151,925,122,75
28,MUREŞ,"ORAŞ MIERCUREA NIRAJULUI",118281,DUMITREŞTII,"CAMINUL CULTURAL",177,"Alegeri Prezidentiale",1,258,70,60,10,0,66,4,301,231,42,24
28,MUREŞ,"ORAŞ MIERCUREA NIRAJULUI",118281,TÂMPA,"CAMINUL CULTURAL",178,"Alegeri Prezidentiale",1,438,83,72,11,0,78,5,501,418,44,34
28,MUREŞ,"ORAŞ MIERCUREA NIRAJULUI",118281,"ŞARDU NIRAJULUI","ŞCOALA GIMNAZIALĂ",179,"Alegeri Prezidentiale",1,573,148,115,33,0,144,4,651,503,103,41
28,MUREŞ,"ORAŞ MIERCUREA NIRAJULUI",118281,MOŞUNI,"ŞCOALA PRIMARĂ",180,"Alegeri Prezidentiale",1,320,108,75,33,0,105,3,351,243,79,26
28,MUREŞ,"ORAŞ SĂRMAŞU",119242,BALDA,"CĂMINUL CULTURAL BALDA",181,"Alegeri Prezidentiale",1,887,369,331,38,0,364,5,951,582,264,100
28,MUREŞ,"ORAŞ SĂRMAŞU",119242,SARMĂŞEL-GARĂ,"CĂMINUL CULTURAL SĂRMĂŞEL GARĂ",182,"Alegeri Prezidentiale",1,567,246,217,29,0,245,1,651,405,166,79
28,MUREŞ,"ORAŞ SĂRMAŞU",119242,VIŞINELU,"CĂMINUL CULTURAL VIŞINELU",183,"Alegeri Prezidentiale",1,369,243,212,31,0,242,1,401,158,138,104
28,MUREŞ,"ORAŞ SĂRMAŞU",119242,SĂRMAŞU,"SALĂ SPORT SĂRMAŞU",184,"Alegeri Prezidentiale",1,1131,496,456,40,0,487,9,1251,755,329,158
28,MUREŞ,"ORAŞ SĂRMAŞU",119242,SĂRMAŞU,"LICEUL TEORETIC ”SAMUIL MICU” SĂRMAŞU",185,"Alegeri Prezidentiale",1,826,303,270,33,0,299,4,901,598,239,60
28,MUREŞ,"ORAŞ SĂRMAŞU",119242,SĂRMAŞU,"LICEUL TEORETIC ”SAMUIL MICU” - ŞCOALA GIMNAZIALĂ SĂRMAŞU",186,"Alegeri Prezidentiale",1,985,428,399,29,0,424,4,1100,672,271,153
28,MUREŞ,"ORAŞ SĂRMAŞU",119242,LARGA,"ŞCOALA PRIMARĂ LARGA",187,"Alegeri Prezidentiale",1,153,51,43,8,0,51,0,201,150,49,2
28,MUREŞ,"ORAŞ SĂRMAŞU",119242,SĂRMĂŞEL,"CĂMINUL CULTURAL SĂRMĂŞEL",188,"Alegeri Prezidentiale",1,611,311,271,40,0,309,2,701,390,237,72
28,MUREŞ,"ORAŞ SÂNGEORGIU DE PĂDURE",119331,"SÂNGEORGIU DE PĂDURE","CAMINUL CULTURAL SÂNGEORGIU DE PĂDURE",189,"Alegeri Prezidentiale",1,1259,283,268,15,0,263,20,1351,1068,171,92
28,MUREŞ,"ORAŞ SÂNGEORGIU DE PĂDURE",119331,"SÂNGEORGIU DE PĂDURE","CAMINUL CULTURAL SÂNGEORGIU DE PĂDURE",190,"Alegeri Prezidentiale",1,1287,242,225,17,0,231,11,1401,1159,138,93
28,MUREŞ,"ORAŞ SÂNGEORGIU DE PĂDURE",119331,"SÂNGEORGIU DE PĂDURE","LICEUL TEHNOLOGIC” SFÂNTUL GHEORGHE” SÂNGEORGIU DE PĂDURE",191,"Alegeri Prezidentiale",1,1323,301,276,22,3,284,17,1451,1150,203,81
28,MUREŞ,"ORAŞ SÂNGEORGIU DE PĂDURE",119331,BEZID,"SCOALA GIMNAZIALĂ BEZID",192,"Alegeri Prezidentiale",1,515,100,85,15,0,93,7,547,447,55,38
28,MUREŞ,"ORAŞ SOVATA",114854,ILIEŞI,"CĂMINUL CULTURAL SATUL ILIEŞI",193,"Alegeri Prezidentiale",1,414,100,90,10,0,95,5,451,351,56,39
28,MUREŞ,"ORAŞ SOVATA",114854,SĂCĂDAT,"ŞCOALA PRIMARĂ SĂCĂDATU DE JOS",194,"Alegeri Prezidentiale",1,1181,211,183,27,1,192,19,1301,1090,155,37
28,MUREŞ,"ORAŞ SOVATA",114854,SOVATA,"ŞCOALA GIMNAZIALĂ ”S.ILLYES LAJOS” SOVATA",195,"Alegeri Prezidentiale",1,1026,268,224,44,0,231,37,1101,833,182,49
28,MUREŞ,"ORAŞ SOVATA",114854,SOVATA,"ŞCOALA GIMNAZIALĂ ”S.ILLYES LAJOS” SOVATA",196,"Alegeri Prezidentiale",1,1389,327,299,28,0,286,41,1501,1174,231,55
28,MUREŞ,"ORAŞ SOVATA",114854,SOVATA,"PRIMĂRIA ORAŞ SOVATA",197,"Alegeri Prezidentiale",1,1439,411,322,74,15,388,23,1551,1140,304,84
28,MUREŞ,"ORAŞ SOVATA",114854,SOVATA,"CENTRUL NAȚIONAL DE INFORMARE ȘI PROMOVARE TURISTICĂ SOVATA",198,"Alegeri Prezidentiale",1,455,504,93,411,0,483,21,521,17,352,131
28,MUREŞ,"ORAŞ SOVATA",114854,SOVATA,"CENTRUL CULTURAL ”DOMOKOS KÁZMÉR” SOVATA",199,"Alegeri Prezidentiale",1,1555,346,322,24,0,313,33,1681,1335,238,75
28,MUREŞ,"ORAŞ SOVATA",114854,SOVATA,"ŞCOALA PRRIMARĂ SOVATA NR.3",200,"Alegeri Prezidentiale",1,1090,182,167,15,0,171,11,1201,1019,138,33
28,MUREŞ,"ORAŞ UNGHENI",119894,UNGHENI,"ŞCOALA GIMNAZIALĂ ”EMIL DRĂGAN” UNGHENI",201,"Alegeri Prezidentiale",1,920,496,411,84,1,490,6,1001,505,349,141
28,MUREŞ,"ORAŞ UNGHENI",119894,UNGHENI,"ŞCOALA GIMNAZIALĂ ”EMIL DRĂGAN”UNGHENI",202,"Alegeri Prezidentiale",1,854,399,359,40,0,396,3,951,552,315,81
28,MUREŞ,"ORAŞ UNGHENI",119894,UNGHENI,"CĂMIN CULTURAL UNGHENI",203,"Alegeri Prezidentiale",1,812,461,362,99,0,448,13,901,440,297,151
28,MUREŞ,"ORAŞ UNGHENI",119894,UNGHENI,"CĂMIN CULTURAL UNGHENI",204,"Alegeri Prezidentiale",1,822,347,327,20,0,340,7,901,554,274,66
28,MUREŞ,"ORAŞ UNGHENI",119894,CERGHID,"CĂMIN CULTURAL CERGHID",205,"Alegeri Prezidentiale",1,418,248,193,55,0,242,6,451,203,156,86
28,MUREŞ,"ORAŞ UNGHENI",119894,MOREŞTI,"CĂMIN CULTURAL MOREŞTI",206,"Alegeri Prezidentiale",1,642,385,348,37,0,378,7,702,317,249,129
28,MUREŞ,"ORAŞ UNGHENI",119894,CERGHIZEL,"ȘCOALA PRIMARĂ CERGHIZEL",207,"Alegeri Prezidentiale",1,383,230,203,27,0,229,1,451,221,135,94
28,MUREŞ,"ORAŞ UNGHENI",119894,ŞĂUŞA,"ȘCOALA PRIMARĂ ŞĂUŞA",208,"Alegeri Prezidentiale",1,206,123,107,16,0,120,3,251,128,79,41
28,MUREŞ,"ORAŞ UNGHENI",119894,VIDRASĂU,"ȘCOALA PRIMARĂ VIDRASĂU",209,"Alegeri Prezidentiale",1,917,479,425,54,0,469,10,1001,522,342,127
28,MUREŞ,ACĂŢARI,114970,ACĂŢARI,"SALĂ DE SPORT ACĂȚARI",210,"Alegeri Prezidentiale",1,997,267,224,23,20,247,20,1101,834,151,96
28,MUREŞ,ACĂŢARI,114970,GRUIŞOR,"CĂMINUL CULTURAL GRUIȘOR",211,"Alegeri Prezidentiale",1,342,93,72,14,7,91,2,401,308,64,27
28,MUREŞ,ACĂŢARI,114970,GĂIEŞTI,"CĂMIN CULTURAL GĂIEȘTI",212,"Alegeri Prezidentiale",1,289,107,90,15,2,104,3,351,244,85,19
28,MUREŞ,ACĂŢARI,114970,MURGEŞTI,"CĂMIN CULTURAL MURGEȘTI",213,"Alegeri Prezidentiale",1,414,148,121,17,10,144,4,451,303,96,48
28,MUREŞ,ACĂŢARI,114970,ROTENI,"CĂMINUL CULTURAL ROTENI",214,"Alegeri Prezidentiale",1,640,185,162,12,11,174,11,701,516,102,72
28,MUREŞ,ACĂŢARI,114970,STEJERIŞ,"CĂMIN CULTURAL STEJERIȘ",215,"Alegeri Prezidentiale",1,278,77,66,11,0,65,12,301,224,43,22
28,MUREŞ,ACĂŢARI,114970,SUVEICA,"CĂMIN CULTURAL SUVEICA",216,"Alegeri Prezidentiale",1,173,44,28,15,1,37,7,201,157,27,10
28,MUREŞ,ACĂŢARI,114970,VĂLENII,"CASA DE TINERET VĂLENII",217,"Alegeri Prezidentiale",1,653,195,149,35,11,185,10,701,506,130,55
28,MUREŞ,ADĂMUŞ,115076,ADĂMUŞ,"ȘCOALA GIMNAZIALĂ ADĂMUȘ",218,"Alegeri Prezidentiale",1,651,189,174,15,0,185,4,701,512,156,29
28,MUREŞ,ADĂMUŞ,115076,ADĂMUŞ,"CĂMINUL CULTURAL ADĂMUȘ",219,"Alegeri Prezidentiale",1,1094,423,398,24,1,421,2,1201,778,291,130
28,MUREŞ,ADĂMUŞ,115076,CORNEŞTI,"ȘCOALA PRIMARĂ CORNEȘTI",220,"Alegeri Prezidentiale",1,992,391,357,34,0,387,4,1101,710,264,123
28,MUREŞ,ADĂMUŞ,115076,CRĂIEŞTI,"SCOALA PRIMARĂ CRĂIEȘTI",221,"Alegeri Prezidentiale",1,857,280,263,17,0,275,5,951,671,239,36
28,MUREŞ,ADĂMUŞ,115076,DÂMBĂU,"GRĂDINIȚA DE COPII CU PROGRAM NORMAL DÎMBĂU",222,"Alegeri Prezidentiale",1,866,341,323,18,0,331,10,952,611,266,65
28,MUREŞ,ALBEŞTI,114603,ŢOPA,"ȘCOALA GIMNAZIALĂ ȚOPA",223,"Alegeri Prezidentiale",1,295,148,131,17,0,148,0,350,202,92,56
28,MUREŞ,ALBEŞTI,114603,ALBEŞTI,"ȘCOALA GIMNAZIALĂ ALBEȘTI",224,"Alegeri Prezidentiale",1,1671,778,716,62,0,764,14,1801,1023,576,188
28,MUREŞ,ALBEŞTI,114603,ALBEŞTI,"ȘCOALA GIMNAZIALĂ ALBEȘTI",225,"Alegeri Prezidentiale",1,1776,787,753,34,0,775,12,1901,1114,575,200
28,MUREŞ,ALBEŞTI,114603,BOIU,"ȘCOALA GIMNAZIALĂ BOIU",226,"Alegeri Prezidentiale",1,1207,507,466,41,0,502,5,1301,794,412,90
28,MUREŞ,ALUNIŞ,115147,ALUNIŞ,"CĂMINUL CULTURAL ALUNIŞ-SALA MARE",227,"Alegeri Prezidentiale",1,788,246,231,14,1,240,6,851,605,188,52
28,MUREŞ,ALUNIŞ,115147,ALUNIŞ,"CĂMINUL CULTURAL ALUNIŞ-SALA MICĂ",228,"Alegeri Prezidentiale",1,804,254,231,23,0,247,7,901,647,189,58
28,MUREŞ,ALUNIŞ,115147,FIŢCĂU,"ŞCOALA PRIMARĂ FIŢCĂU",229,"Alegeri Prezidentiale",1,398,155,136,18,1,154,1,451,296,132,22
28,MUREŞ,ALUNIŞ,115147,"LUNCA MUREŞULUI","CĂMINUL CULTURAL LUNCA- MUREŞ - SALA MICĂ",230,"Alegeri Prezidentiale",1,553,209,188,21,0,203,6,601,392,174,29
28,MUREŞ,APOLD,115183,APOLD,"GRĂDINIŢA CU PROGRAM NORMAL APOLD",231,"Alegeri Prezidentiale",1,823,233,207,25,1,230,3,901,668,177,53
28,MUREŞ,APOLD,115183,DAIA,"ŞCOALA PRIMARĂ DAIA",232,"Alegeri Prezidentiale",1,549,179,162,16,1,179,0,601,422,129,50
28,MUREŞ,APOLD,115183,ŞAEŞ,"ŞCOALA GIMNAZIALĂ ŞAEŞ",233,"Alegeri Prezidentiale",1,1094,377,350,27,0,374,3,1200,823,273,101
28,MUREŞ,AŢINTIŞ,115236,AŢINTIŞ,"SEDIUL PRIMARIEI ATINTIS",234,"Alegeri Prezidentiale",1,598,287,239,42,6,284,3,651,364,212,72
28,MUREŞ,AŢINTIŞ,115236,BOTEZ,"SCOALA PRIMARA BOTEZ",235,"Alegeri Prezidentiale",1,138,83,65,18,0,81,2,151,68,54,27
28,MUREŞ,AŢINTIŞ,115236,CECĂLACA,"SCOALA PRIMARA CECALACA",236,"Alegeri Prezidentiale",1,319,158,142,16,0,155,3,351,193,121,34
28,MUREŞ,AŢINTIŞ,115236,IŞTIHAZA,"SCOALA PRIMARA ISTIHAZA",237,"Alegeri Prezidentiale",1,165,74,55,19,0,73,1,201,127,70,3
28,MUREŞ,BAHNEA,115307,BAHNEA,"ŞCOALA GIMNAZIALĂ BAHNEA",238,"Alegeri Prezidentiale",1,965,411,386,25,0,405,6,1051,640,331,74
28,MUREŞ,BAHNEA,115307,BAHNEA,"ŞCOALA GIMNAZIALĂ BAHNEA",239,"Alegeri Prezidentiale",1,586,215,199,16,0,211,4,651,436,179,32
28,MUREŞ,BAHNEA,115307,BERNADEA,"ŞCOALA PRIMARĂ BERNADEA",240,"Alegeri Prezidentiale",1,140,92,66,26,0,89,3,151,59,64,25
28,MUREŞ,BAHNEA,115307,LEPINDEA,"ŞCOALA PRIMARĂ LEPINDEA",241,"Alegeri Prezidentiale",1,131,63,44,19,0,62,1,150,87,45,17
28,MUREŞ,BAHNEA,115307,DAIA,"ŞCOALA PRIMARĂ DAIA",242,"Alegeri Prezidentiale",1,135,67,54,13,0,65,2,151,84,52,13
28,MUREŞ,BAHNEA,115307,IDICIU,"ŞCOALA GIMNAZIALĂ IDICIU",243,"Alegeri Prezidentiale",1,238,139,118,21,0,137,2,301,162,91,46
28,MUREŞ,BAHNEA,115307,GOGAN,"ŞCOALA GIMNAZIALĂ GOGAN",244,"Alegeri Prezidentiale",1,415,165,142,23,0,165,0,451,286,152,13
28,MUREŞ,BAHNEA,115307,CUND,"ŞCOALA PRIMARĂ CUND",245,"Alegeri Prezidentiale",1,175,74,57,17,0,74,0,201,127,63,11
28,MUREŞ,BAND,115389,BAND,"SCOALA PROFESIONALA BAND",246,"Alegeri Prezidentiale",1,658,224,195,29,0,216,8,750,526,158,58
28,MUREŞ,BAND,115389,BAND,"SCOALA PROFESIONALA BAND",247,"Alegeri Prezidentiale",1,794,162,151,11,0,157,5,851,689,124,33
28,MUREŞ,BAND,115389,BAND,"SCOALA PROFESIONALA BAND",248,"Alegeri Prezidentiale",1,907,405,387,18,0,390,15,1001,596,203,187
28,MUREŞ,BAND,115389,BAND,"GRĂDINIŢA CU PROGRAM NORMAL BAND",249,"Alegeri Prezidentiale",1,763,268,254,14,0,259,9,851,583,160,99
28,MUREŞ,BAND,115389,ŢIPTELNIC,"CONSUMCOOP SOCIETATE COOPERATIVĂ",250,"Alegeri Prezidentiale",1,90,60,46,14,0,59,1,101,41,27,32
28,MUREŞ,BAND,115389,"VALEA RECE","ŞCOALA PRIMARA VALEA RECE",251,"Alegeri Prezidentiale",1,216,92,72,20,0,91,1,251,159,63,28
28,MUREŞ,BAND,115389,MĂRĂŞEŞTI,"ŞCOALA PRIMARA MĂRĂŞEŞTI",252,"Alegeri Prezidentiale",1,261,157,133,24,0,151,6,302,145,106,45
28,MUREŞ,BAND,115389,FÂNAŢE,"ŞCOALA GIMNAZIALA FÎNAŢE",253,"Alegeri Prezidentiale",1,349,135,115,20,0,135,0,399,264,49,86
28,MUREŞ,BAND,115389,OROIU,"ŞCOALA PRIMARA OROIU",254,"Alegeri Prezidentiale",1,236,122,103,18,1,121,1,303,181,79,42
28,MUREŞ,BAND,115389,PETEA,"ŞCOALA PRIMARA PETEA",255,"Alegeri Prezidentiale",1,162,87,69,18,0,83,4,201,114,49,34
28,MUREŞ,BAND,115389,"DRĂCULEA BANDULUI","ŞCOALA PRIMARA DRĂCULEA BANDULUI",256,"Alegeri Prezidentiale",1,102,68,47,21,0,68,0,151,83,46,22
28,MUREŞ,BAND,115389,"NEGRENII DE CÂMPIE","SALA SEDINTA- PAROHIA REFORMATA NEGRENII DE CAMPIE",257,"Alegeri Prezidentiale",1,99,43,33,10,0,42,1,151,108,34,8
28,MUREŞ,BAND,115389,"VALEA MARE","ŞCOALA PRIMARA VALEA MARE",258,"Alegeri Prezidentiale",1,169,74,61,13,0,72,2,201,127,38,34
28,MUREŞ,BATOŞ,115520,BATOŞ,"ŞCOALA GIMNAZIALĂ BATOŞ",259,"Alegeri Prezidentiale",1,1111,527,490,37,0,525,2,1201,674,432,93
28,MUREŞ,BATOŞ,115520,DEDRAD,"ŞCOALA GIMNAZIALĂ DEDRAD",260,"Alegeri Prezidentiale",1,1302,593,559,34,0,590,3,1401,808,477,113
28,MUREŞ,BATOŞ,115520,GORENI,"GRĂDINIŢA CU PROGRAM NORMAL GORENI",261,"Alegeri Prezidentiale",1,497,214,196,18,0,207,7,551,337,155,52
28,MUREŞ,BATOŞ,115520,UILA,"ŞCOALA PRIMARĂ UILA",262,"Alegeri Prezidentiale",1,485,181,160,21,0,179,2,551,370,127,52
28,MUREŞ,BĂGACIU,115575,BĂGACIU,"CĂMINUL CULTURAL BĂGACIU",263,"Alegeri Prezidentiale",1,1129,401,373,28,0,393,8,1251,850,291,102
28,MUREŞ,BĂGACIU,115575,DELENII,"CĂMIN CULTURAL DELENII",264,"Alegeri Prezidentiale",1,897,451,415,36,0,446,5,1001,550,414,32
28,MUREŞ,BĂLA,115600,BĂLA,"CĂMIN CULTURAL",265,"Alegeri Prezidentiale",1,446,231,198,33,0,231,0,501,270,160,71
28,MUREŞ,BĂLA,115600,ERCEA,"ȘCOALA PRIMARĂ",266,"Alegeri Prezidentiale",1,135,83,69,14,0,82,1,151,68,57,25
28,MUREŞ,BĂLĂUŞERI,115637,BĂLĂUŞERI,"CĂMINUL CULTURAL BĂLĂUŞERI",267,"Alegeri Prezidentiale",1,949,144,129,15,0,142,2,1051,907,127,15
28,MUREŞ,BĂLĂUŞERI,115637,AGRIŞTEU,"CĂMIN CULTURAL AGRIŞTEU",268,"Alegeri Prezidentiale",1,634,172,148,24,0,166,6,701,529,136,30
28,MUREŞ,BĂLĂUŞERI,115637,DUMITRENI,"CĂMIN CULTURAL DUMITRENI",269,"Alegeri Prezidentiale",1,372,71,57,14,0,67,4,401,330,49,18
28,MUREŞ,BĂLĂUŞERI,115637,FILITELNIC,"CĂMIN CULTURAL FILITELNIC",270,"Alegeri Prezidentiale",1,181,92,73,19,0,90,2,201,109,79,11
28,MUREŞ,BĂLĂUŞERI,115637,CHENDU,"SCOALĂ GIMNAZIALĂ SAMUEL JOZSEF CHENDU",271,"Alegeri Prezidentiale",1,1164,195,163,32,0,183,12,1251,1056,157,26
28,MUREŞ,BĂLĂUŞERI,115637,SENEREUŞ,"SCOALĂ GIMNAZIALĂ SENEREUŞ",272,"Alegeri Prezidentiale",1,528,197,184,13,0,195,2,601,404,160,35
28,MUREŞ,"BEICA DE JOS",115708,"BEICA DE JOS","CĂMINUL CULTURAL BEICA DE JOS",273,"Alegeri Prezidentiale",1,701,329,283,46,0,320,9,801,472,201,119
28,MUREŞ,"BEICA DE JOS",115708,"BEICA DE SUS","GRĂDINIȚA CU PROGRAM NORMAL BEICA DE SUS",274,"Alegeri Prezidentiale",1,217,112,87,23,2,109,3,251,139,56,53
28,MUREŞ,"BEICA DE JOS",115708,NADĂŞA,"ȘCOALA PRIMARĂ NADĂȘA",275,"Alegeri Prezidentiale",1,185,121,91,29,1,118,3,201,80,60,58
28,MUREŞ,"BEICA DE JOS",115708,CĂCUCIU,"ȘCOALA PRIMARĂ CĂCUCIU",276,"Alegeri Prezidentiale",1,112,105,71,34,0,104,1,151,46,63,41
28,MUREŞ,"BEICA DE JOS",115708,ŞERBENI,"ȘCOALA PRIMARĂ ȘERBENI",277,"Alegeri Prezidentiale",1,280,170,151,18,1,169,1,301,131,88,81
28,MUREŞ,"BEICA DE JOS",115708,"SÂNMIHAI DE PĂDURE","CĂMINUL CULTURAL SÎNMIHAI DE PĂDURE",278,"Alegeri Prezidentiale",1,191,134,108,26,0,132,2,250,116,81,51
28,MUREŞ,BERENI,120511,BERENI,"CĂMINUL CULTURAL BERENI",279,"Alegeri Prezidentiale",1,443,115,76,39,0,109,6,501,386,68,41
28,MUREŞ,BERENI,120511,EREMIENI,"CĂMINUL CULTURAL EREMIENI",280,"Alegeri Prezidentiale",1,197,71,58,13,0,66,5,251,180,40,26
28,MUREŞ,BERENI,120511,MĂRCULENI,"CĂMINUL CULTURAL MĂRCULENI",281,"Alegeri Prezidentiale",1,361,61,54,7,0,59,2,401,340,43,16
28,MUREŞ,BICHIŞ,115771,BICHIŞ,"CĂMIN CULTURAL BICHIŞ",282,"Alegeri Prezidentiale",1,159,69,44,25,0,69,0,201,132,52,17
28,MUREŞ,BICHIŞ,115771,GÂMBUŢ,"CÃMIN CULTURAL GÎMBUŢ",283,"Alegeri Prezidentiale",1,127,69,55,14,0,69,0,151,82,48,21
28,MUREŞ,BICHIŞ,115771,NANDRA,"ŞCOALA PRIMARĂ NANDRA",284,"Alegeri Prezidentiale",1,118,44,34,10,0,43,1,151,107,25,18
28,MUREŞ,BICHIŞ,115771,OZD,"CĂMINUL CULTURAL OZD",285,"Alegeri Prezidentiale",1,254,119,85,34,0,115,4,301,182,93,22
28,MUREŞ,BOGATA,115824,RANTA,"ŞCOALA PRIMARĂ",286,"Alegeri Prezidentiale",1,233,112,90,22,0,112,0,301,189,105,7
28,MUREŞ,BOGATA,115824,BOGATA,"PRIMARIA BOGATA",287,"Alegeri Prezidentiale",1,1269,482,419,63,0,478,4,1401,919,368,110
28,MUREŞ,BRÂNCOVENEŞTI,115897,IDICEL-PĂDURE,"CĂMIN CULTURAL",288,"Alegeri Prezidentiale",1,379,195,167,28,0,192,3,451,256,166,26
28,MUREŞ,BRÂNCOVENEŞTI,115897,BRÂNCOVENEŞTI,"ȘCOALA PRIMARĂ",289,"Alegeri Prezidentiale",1,1327,454,405,49,0,442,12,1451,997,347,95
28,MUREŞ,BRÂNCOVENEŞTI,115897,IDICEL,"ȘCOALA PRIMARĂ",290,"Alegeri Prezidentiale",1,331,176,148,28,0,176,0,401,225,144,32
28,MUREŞ,BRÂNCOVENEŞTI,115897,"SĂCALU DE PĂDURE","ȘCOALA PRIMARĂ",291,"Alegeri Prezidentiale",1,271,149,116,33,0,148,1,301,152,89,59
28,MUREŞ,BRÂNCOVENEŞTI,115897,"VĂLENII DE MUREŞ","CLUB-CĂMIN CULTURAL",292,"Alegeri Prezidentiale",1,1018,289,272,17,0,280,9,1101,812,242,38
28,MUREŞ,BREAZA,115851,"FILPIŞU MARE","CĂMIN CULTURAL FILPIŞU MARE",293,"Alegeri Prezidentiale",1,643,291,243,48,0,287,4,700,409,231,56
28,MUREŞ,BREAZA,115851,"FILPIŞU MIC","ȘCOALA PRIMARĂ FILPIȘU MIC",294,"Alegeri Prezidentiale",1,346,186,175,11,0,182,4,401,215,153,29
28,MUREŞ,BREAZA,115851,BREAZA,"CAMIN CULTURAL BREAZA",295,"Alegeri Prezidentiale",1,1059,537,488,49,0,524,13,1151,614,453,71
28,MUREŞ,"CEUAŞU DE CÂMPIE",115959,"CEUAŞU DE CÂMPIE","CĂMINUL CULTURAL CEUAŞU DE CÎMPIE",296,"Alegeri Prezidentiale",1,1347,546,487,59,0,528,18,1451,905,385,143
28,MUREŞ,"CEUAŞU DE CÂMPIE",115959,BOZED,"CĂMINUL CULTURAL BOZED",297,"Alegeri Prezidentiale",1,114,77,51,26,0,76,1,151,74,52,24
28,MUREŞ,"CEUAŞU DE CÂMPIE",115959,CÂMPENIŢA,"CĂMINUL CULTURAL CÎMPENIŢA",298,"Alegeri Prezidentiale",1,736,231,202,29,0,219,12,800,569,182,37
28,MUREŞ,"CEUAŞU DE CÂMPIE",115959,CULPIU,"CĂMINUL CULTURAL CULPIU",299,"Alegeri Prezidentiale",1,306,117,103,14,0,113,4,352,235,85,28
28,MUREŞ,"CEUAŞU DE CÂMPIE",115959,HERGHELIA,"CĂMINUL CULTURAL HERGHELIA",300,"Alegeri Prezidentiale",1,321,171,123,48,0,165,6,352,181,128,37
28,MUREŞ,"CEUAŞU DE CÂMPIE",115959,PORUMBENI,"ŞCOALA PRIMARĂ PORUMBENI",301,"Alegeri Prezidentiale",1,468,213,185,28,0,204,9,501,288,137,67
28,MUREŞ,"CEUAŞU DE CÂMPIE",115959,SĂBED,"CĂMINUL CULTURAL SĂBED",302,"Alegeri Prezidentiale",1,626,214,191,23,0,205,9,701,487,173,32
28,MUREŞ,"CEUAŞU DE CÂMPIE",115959,VOINICENI,"CĂMINUL CULTURAL VOINICENI",303,"Alegeri Prezidentiale",1,921,494,436,58,0,488,6,1001,507,355,133
28,MUREŞ,CHEŢANI,116046,GRINDENI,"CAMIN CULTURAL",304,"Alegeri Prezidentiale",1,467,206,173,33,0,205,1,500,294,171,34
28,MUREŞ,CHEŢANI,116046,CHEŢANI,"SEDIUL PRIMARIEI CHETANI",305,"Alegeri Prezidentiale",1,926,505,440,65,0,500,5,1001,496,364,136
28,MUREŞ,CHEŢANI,116046,HĂDĂRENI,"CAMIN CULTURAL HADARENI",306,"Alegeri Prezidentiale",1,663,323,251,72,0,315,8,751,428,249,66
28,MUREŞ,CHIBED,120478,CHIBED,"PRIMĂRIA COMUNEI CHIBED",307,"Alegeri Prezidentiale",1,1355,234,215,19,0,214,20,1451,1217,160,54
28,MUREŞ,"CHIHERU DE JOS",116126,"CHIHERU DE JOS","SEDIUL PRIMĂRIEI COMUNEI CHIHERU DE JOS",308,"Alegeri Prezidentiale",1,349,210,164,46,0,209,1,402,192,120,89
28,MUREŞ,"CHIHERU DE JOS",116126,"CHIHERU DE SUS","ŞCOALA PRIMARĂ CHIHERU DE SUS",309,"Alegeri Prezidentiale",1,313,130,109,21,0,129,1,352,222,79,50
28,MUREŞ,"CHIHERU DE JOS",116126,"URISIU DE JOS","ŞCOALA PRIMARĂ URISIU DE JOS",310,"Alegeri Prezidentiale",1,254,167,138,29,0,167,0,301,134,126,41
28,MUREŞ,"CHIHERU DE JOS",116126,"URISIU DE SUS","CAMINUL CULTURAL URISIU DE SUS",311,"Alegeri Prezidentiale",1,342,201,179,22,0,198,3,400,199,122,76
28,MUREŞ,COROISÂNMĂRTIN,116171,COROISÂNMĂRTIN,"ȘCOALA GIMNAZIALĂ COROISÎNMĂRTIN",312,"Alegeri Prezidentiale",1,331,111,93,18,0,103,8,401,290,82,21
28,MUREŞ,COROISÂNMĂRTIN,116171,ŞOIMUŞ,"ȘCOALA PRIMARĂ ȘOIMUȘ",313,"Alegeri Prezidentiale",1,316,155,131,24,0,152,3,351,196,114,38
28,MUREŞ,COROISÂNMĂRTIN,116171,ODRIHEI,"CĂMINUL CULTURAL ODRIHEI",314,"Alegeri Prezidentiale",1,391,199,167,32,0,195,4,451,252,146,49
28,MUREŞ,COROISÂNMĂRTIN,116171,COROI,"ȘCOALA PRIMARĂ COROI",315,"Alegeri Prezidentiale",1,98,71,45,26,0,70,1,151,80,50,20
28,MUREŞ,CORUNCA,120487,CORUNCA,"CĂMINUL CULTURAL CORUNCA",316,"Alegeri Prezidentiale",1,1430,505,401,104,0,487,18,1551,1046,406,81
28,MUREŞ,CORUNCA,120487,CORUNCA,"CĂMINUL CULTURAL CORUNCA",317,"Alegeri Prezidentiale",1,1322,789,691,98,0,754,35,1451,662,582,172
28,MUREŞ,CORUNCA,120487,BOZENI,"CĂMINUL CULTURAL BOZENI",318,"Alegeri Prezidentiale",1,113,61,25,36,0,55,6,151,90,45,10
28,MUREŞ,COZMA,116224,"SOCOLU DE CÂMPIE","CAMIN CULTURAL",319,"Alegeri Prezidentiale",1,107,47,38,9,0,47,0,151,104,39,8
28,MUREŞ,COZMA,116224,COZMA,"PRIMARIA COZMA",320,"Alegeri Prezidentiale",1,320,179,154,25,0,178,1,342,163,145,33
28,MUREŞ,CRĂCIUNEŞTI,116288,CRĂCIUNEŞTI,"CĂMIN CULTURAL CRĂCIUNEŞTI SALA MICĂ",321,"Alegeri Prezidentiale",1,808,84,70,14,0,78,6,901,817,55,23
28,MUREŞ,CRĂCIUNEŞTI,116288,CRĂCIUNEŞTI,"CĂMINUL CULTURAL CRĂCIUNEŞTI SALA MARE",322,"Alegeri Prezidentiale",1,993,220,190,30,0,212,8,1101,881,171,41
28,MUREŞ,CRĂCIUNEŞTI,116288,CORNEŞTI,"CĂMINUL CULTURAL CORNEŞTI",323,"Alegeri Prezidentiale",1,706,256,238,18,0,238,18,801,545,173,65
28,MUREŞ,CRĂCIUNEŞTI,116288,CINTA,"ŞCOALA PRIMARĂ CINTA",324,"Alegeri Prezidentiale",1,428,117,105,12,0,111,6,504,387,95,16
28,MUREŞ,CRĂCIUNEŞTI,116288,"BUDIU MIC","ŞCOALA PRIMARĂ BUDIU MIC",325,"Alegeri Prezidentiale",1,340,96,71,25,0,93,3,401,305,76,17
28,MUREŞ,CRĂIEŞTI,116340,CRĂIEŞTI,"PRIMARIA COMUNEI CRAIESTI",326,"Alegeri Prezidentiale",1,508,264,224,40,0,262,2,551,287,211,51
28,MUREŞ,CRĂIEŞTI,116340,MILĂŞEL,"CĂMIN CULTURAL MILAȘEL",327,"Alegeri Prezidentiale",1,153,75,57,18,0,74,1,201,126,57,17
28,MUREŞ,CRĂIEŞTI,116340,LEFAIA,"CĂMIN CULTURAL LEFAIA",328,"Alegeri Prezidentiale",1,49,48,31,17,0,47,1,101,53,35,12
28,MUREŞ,CRISTEŞTI,114355,CRISTEŞTI,PRIMARIA,329,"Alegeri Prezidentiale",1,1444,641,590,50,1,627,14,1551,910,470,157
28,MUREŞ,CRISTEŞTI,114355,CRISTEŞTI,PRIMĂRIE,330,"Alegeri Prezidentiale",1,1301,657,602,55,0,639,18,1401,744,512,127
28,MUREŞ,CRISTEŞTI,114355,CRISTEŞTI,"ŞCOALA GIMNAZIALA CRISTEŞTI",331,"Alegeri Prezidentiale",1,1466,611,552,59,0,596,15,1601,990,450,146
28,MUREŞ,CRISTEŞTI,114355,VĂLURENI,"CĂMINUL CULTURAL",332,"Alegeri Prezidentiale",1,806,197,172,25,0,184,13,901,704,152,32
28,MUREŞ,CUCERDEA,116395,CUCERDEA,"PRIMARIA CUCERDEA",333,"Alegeri Prezidentiale",1,566,296,233,63,0,294,2,651,355,198,96
28,MUREŞ,CUCERDEA,116395,"ŞEULIA DE MUREŞ","ȘCOALA GIMNAZIALĂ ȘEULIA DE MUREȘ",334,"Alegeri Prezidentiale",1,469,221,192,29,0,217,4,550,329,149,68
28,MUREŞ,CUCERDEA,116395,BORD,"CĂMIN CULTURAL BORD",335,"Alegeri Prezidentiale",1,98,68,49,19,0,67,1,151,83,47,20
28,MUREŞ,CUCI,116439,OROSIA,"CAMIN CULTURAL",336,"Alegeri Prezidentiale",1,133,90,67,23,0,90,0,151,61,49,41
28,MUREŞ,CUCI,116439,PETRILACA,"CĂMIN CULTURAL",337,"Alegeri Prezidentiale",1,438,182,156,26,0,177,5,501,319,115,62
28,MUREŞ,CUCI,116439,DĂTĂŞENI,"SCOALA PRIMARĂ",338,"Alegeri Prezidentiale",1,276,150,117,29,4,147,3,301,151,105,42
28,MUREŞ,CUCI,116439,CUCI,"PRIMĂRIA CUCI",339,"Alegeri Prezidentiale",1,663,382,326,56,0,377,5,751,369,254,123
28,MUREŞ,DANEŞ,116493,DANEŞ,"CĂMINUL CULTURAL DANES",340,"Alegeri Prezidentiale",1,996,495,454,41,0,491,4,1101,606,417,74
28,MUREŞ,DANEŞ,116493,DANEŞ,"CLUBUL TINERETULUI",341,"Alegeri Prezidentiale",1,990,449,412,37,0,443,6,1101,652,354,89
28,MUREŞ,DANEŞ,116493,SELEUŞ,"SCOALA GIMNAZIALA SELEUS-DANES",342,"Alegeri Prezidentiale",1,872,362,334,28,0,360,2,951,589,308,52
28,MUREŞ,DANEŞ,116493,SELEUŞ,"SCOALA GIMNAZIALA SELEUS-DANES",343,"Alegeri Prezidentiale",1,891,370,355,15,0,367,3,1001,631,300,67
28,MUREŞ,DANEŞ,116493,CRIŞ,"ŞCOALA GIMNAZIALA INV.”STROIESCU IOAN ”CRIŞ",344,"Alegeri Prezidentiale",1,570,194,176,18,0,191,3,651,457,155,36
28,MUREŞ,DANEŞ,116493,STEJĂRENII,"CĂMINUL CULTURAL STEJĂRENII",345,"Alegeri Prezidentiale",1,271,75,53,22,0,73,2,301,226,53,20
28,MUREŞ,DEDA,116545,"BISTRA MUREŞULUI","ŞCOALA GIMNAZIALĂ BISTRA-MUREŞULUI",346,"Alegeri Prezidentiale",1,816,514,413,101,0,505,9,901,387,289,216
28,MUREŞ,DEDA,116545,FILEA,"ŞCOALA PRIMARĂ FILEA",347,"Alegeri Prezidentiale",1,567,400,359,38,3,397,3,651,251,166,231
28,MUREŞ,DEDA,116545,PIETRIŞ,"ŞCOALA PRIMARĂ PIETRŞ",348,"Alegeri Prezidentiale",1,374,248,211,36,1,244,4,401,153,128,116
28,MUREŞ,DEDA,116545,DEDA,"CĂMIN CULTURAL DEDA",349,"Alegeri Prezidentiale",1,1514,963,858,75,30,947,16,1651,688,451,496
28,MUREŞ,EREMITU,116590,EREMITU,"ȘCOALA GIMNAZIALĂ ”DR. NYULAS FERENC ” EREMITU",350,"Alegeri Prezidentiale",1,1459,295,270,25,0,259,36,1601,1306,175,84
28,MUREŞ,EREMITU,116590,CĂLUGĂRENI,"ȘCOALA PRIMARĂ CĂLUGĂRENI",351,"Alegeri Prezidentiale",1,464,74,59,15,0,64,10,501,427,38,26
28,MUREŞ,EREMITU,116590,"CÂMPU CETĂŢII","ȘCOALA PRIMARĂ CÎMPU CETĂŢII",352,"Alegeri Prezidentiale",1,307,87,62,25,0,81,6,351,264,62,19
28,MUREŞ,EREMITU,116590,DĂMIENI,"ȘCOALA PRIMARĂ DĂMIENI",353,"Alegeri Prezidentiale",1,179,70,54,16,0,70,0,200,130,56,14
28,MUREŞ,EREMITU,116590,MĂTRICI,"ȘCOALA GIMNAZIALĂ MĂTRICI",354,"Alegeri Prezidentiale",1,722,194,172,22,0,187,7,801,607,124,63
28,MUREŞ,ERNEI,116652,ERNEI,"CĂMINUL CULTURAL ERNEI",355,"Alegeri Prezidentiale",1,868,225,184,41,0,211,14,951,726,160,51
28,MUREŞ,ERNEI,116652,ERNEI,"SALA DE ŞEDINŢE - PRIMĂRIA COMUNEI ERNEI",356,"Alegeri Prezidentiale",1,1064,289,251,36,2,276,13,1151,862,221,55
28,MUREŞ,ERNEI,116652,CĂLUŞERI,"CĂMINUL CULTURAL CĂLUŞERI",357,"Alegeri Prezidentiale",1,468,127,113,14,0,117,10,501,374,73,44
28,MUREŞ,ERNEI,116652,DUMBRĂVIOARA,"CĂMINUL CULTURAL DUMBRĂVIOARA",358,"Alegeri Prezidentiale",1,1484,331,298,33,0,314,17,1601,1270,247,67
28,MUREŞ,ERNEI,116652,ICLAND,"CĂMINUL CULTURAL ICLAND",359,"Alegeri Prezidentiale",1,311,101,74,27,0,99,2,351,250,70,29
28,MUREŞ,ERNEI,116652,SĂCĂRENI,"SCOALA PRIMARĂ SĂCĂRENI",360,"Alegeri Prezidentiale",1,211,59,35,24,0,54,5,251,192,47,7
28,MUREŞ,ERNEI,116652,"SÂNGERU DE PĂDURE","CĂMINUL CULTURAL SÎNGERU DE PĂDURE",361,"Alegeri Prezidentiale",1,326,100,78,22,0,98,2,401,301,77,21
28,MUREŞ,FĂRĂGĂU,116723,FĂRĂGĂU,"SEDIU PRIMARIE",362,"Alegeri Prezidentiale",1,365,318,223,92,3,315,3,402,84,158,157
28,MUREŞ,FĂRĂGĂU,116723,POARTA,"CLADIRE FOSTUL CAP",363,"Alegeri Prezidentiale",1,179,135,101,34,0,132,3,201,66,68,64
28,MUREŞ,FĂRĂGĂU,116723,TONCIU,"SCOALA GIMNAZIALA TONCIU",364,"Alegeri Prezidentiale",1,719,359,336,23,0,349,10,801,442,103,246
28,MUREŞ,FÂNTÂNELE,116796,FÂNTÂNELE,"ŞCOALA GIMNAZIALĂ FÎNTÎNELE",365,"Alegeri Prezidentiale",1,983,175,164,11,0,166,9,1051,876,76,90
28,MUREŞ,FÂNTÂNELE,116796,FÂNTÂNELE,"ŞCOALA GIMNAZIALĂ FÎNTÎNELE",366,"Alegeri Prezidentiale",1,980,154,131,23,0,148,6,1046,892,87,61
28,MUREŞ,FÂNTÂNELE,116796,CĂLIMĂNEŞTI,"ŞCOALA GIMNAZIALĂ CĂLIMĂNEŞTI",367,"Alegeri Prezidentiale",1,711,122,110,12,0,116,6,801,679,78,38
28,MUREŞ,FÂNTÂNELE,116796,VIFOROASA,"ŞCOALA PRIMARĂ VIFOROASA",368,"Alegeri Prezidentiale",1,664,123,106,17,0,111,12,751,628,82,29
28,MUREŞ,FÂNTÂNELE,116796,BORDOŞIU,"ŞCOALA PRIMARĂ BORDOŞIU",369,"Alegeri Prezidentiale",1,252,49,40,9,0,44,5,301,252,21,23
28,MUREŞ,FÂNTÂNELE,116796,CIBU,"GRĂDINIŢA CU PROGRAM NORMAL CIBU",370,"Alegeri Prezidentiale",1,88,38,22,16,0,36,2,101,63,23,13
28,MUREŞ,FÂNTÂNELE,116796,ROUA,"ŞCOALA PRIMARĂ ROUA",371,"Alegeri Prezidentiale",1,288,62,50,12,0,56,6,352,290,26,30
28,MUREŞ,GĂLEŞTI,116867,GĂLEŞTI,"ŞCOALA GIMNAZIALĂ „SZENTIVÁNI MIHÁLY” GĂLEŞTI",372,"Alegeri Prezidentiale",1,755,122,88,33,1,111,11,850,728,85,26
28,MUREŞ,GĂLEŞTI,116867,TROIŢA,"ŞCOALA GIMNAZIALĂ TROIŢA",373,"Alegeri Prezidentiale",1,577,84,71,13,0,78,6,651,567,48,30
28,MUREŞ,GĂLEŞTI,116867,MAIAD,"ŞCOALA PRIMARĂ MAIAD",374,"Alegeri Prezidentiale",1,230,72,56,16,0,71,1,251,179,53,18
28,MUREŞ,GĂLEŞTI,116867,SÂNVĂSII,"CĂMINUL CULTURAL SÂNVĂSII",375,"Alegeri Prezidentiale",1,258,70,54,16,0,60,10,301,231,48,12
28,MUREŞ,GĂLEŞTI,116867,"ADRIANU MARE","ŞCOALA PRIMARĂ ADRIANU MARE",376,"Alegeri Prezidentiale",1,108,23,16,7,0,20,3,151,128,10,10
28,MUREŞ,GĂLEŞTI,116867,BEDENI,"CLĂDIREA SPAŢIU COMERCIAL BEDENI",377,"Alegeri Prezidentiale",1,115,55,37,18,0,54,1,151,96,35,19
28,MUREŞ,GĂNEŞTI,116938,GĂNEŞTI,"GRĂDINIŢA CU PROGRAM NORMAL GĂNEŞTI",378,"Alegeri Prezidentiale",1,977,420,394,25,1,402,18,1051,631,334,68
28,MUREŞ,GĂNEŞTI,116938,GĂNEŞTI,"ŞCOALA GIMNAZIALĂ FOGARASI SAMUEL GĂNEŞTI",379,"Alegeri Prezidentiale",1,773,337,323,14,0,324,13,851,514,277,47
28,MUREŞ,GĂNEŞTI,116938,PĂUCIŞOARA,"ŞCOALA PRIMARĂ PĂUCIŞOARA",380,"Alegeri Prezidentiale",1,219,86,69,17,0,85,1,251,165,64,21
28,MUREŞ,GĂNEŞTI,116938,SEUCA,"ŞCOALA PRIMARĂ SEUCA",381,"Alegeri Prezidentiale",1,943,410,380,30,0,400,10,1051,641,348,52
28,MUREŞ,"GHEORGHE DOJA",116983,"GHEORGHE DOJA","CĂMINUL CULTURAL GHEORGHE DOJA",382,"Alegeri Prezidentiale",1,393,102,75,27,0,99,3,450,348,85,14
28,MUREŞ,"GHEORGHE DOJA",116983,ILIENI,"CĂMINUL CULTURAL ILIENI",383,"Alegeri Prezidentiale",1,332,118,94,24,0,112,6,401,283,90,22
28,MUREŞ,"GHEORGHE DOJA",116983,LEORDENI,"CĂMINUL CULTURAL LEORDENI",384,"Alegeri Prezidentiale",1,316,141,99,42,0,133,8,350,209,100,33
28,MUREŞ,"GHEORGHE DOJA",116983,"SATU NOU","ȘCOALA PRIMARĂ SATU NOU",385,"Alegeri Prezidentiale",1,627,107,101,6,0,101,6,701,594,67,34
28,MUREŞ,"GHEORGHE DOJA",116983,TIRIMIA,"ȘCOALĂ GIMNAZIALĂ TIRIMIA",386,"Alegeri Prezidentiale",1,717,279,233,46,0,273,6,801,522,223,50
28,MUREŞ,GHINDARI,117042,GHINDARI,"ȘCOALA GIMNAZIALĂ WESSELÉNYI MIKLÓS",387,"Alegeri Prezidentiale",1,1247,172,130,42,0,148,24,1351,1179,89,59
28,MUREŞ,GHINDARI,117042,"TREI SATE","CĂMIN CULTURAL TREI SATE",388,"Alegeri Prezidentiale",1,963,113,92,21,0,99,14,1051,938,70,29
28,MUREŞ,GHINDARI,117042,SOLOCMA,"ȘCOALĂ PRIMARĂ SOLOCMA",389,"Alegeri Prezidentiale",1,251,49,26,23,0,47,2,301,252,26,21
28,MUREŞ,GHINDARI,117042,ABUD,"ȘCOALĂ PRIMARĂ ABUD",390,"Alegeri Prezidentiale",1,100,27,10,17,0,27,0,150,123,16,11
28,MUREŞ,GLODENI,117113,GLODENI,"ȘCOALA GIMNAZIALĂ „ADORJANI KAROLY” GLODENI",391,"Alegeri Prezidentiale",1,947,169,148,21,0,163,6,1051,882,100,63
28,MUREŞ,GLODENI,117113,GLODENI,"ȘCOALA GIMNAZIALĂ „ADORJANI KAROLY” GLODENI",392,"Alegeri Prezidentiale",1,1054,363,291,20,52,351,12,1151,788,249,102
28,MUREŞ,GLODENI,117113,MERIŞOR,"ȘCOALA PRIMARĂ MERIȘOR",393,"Alegeri Prezidentiale",1,136,75,60,15,0,73,2,151,76,39,34
28,MUREŞ,GLODENI,117113,MOIŞA,"ŞCOALA PRIMARĂ MOIȘA",394,"Alegeri Prezidentiale",1,194,98,85,13,0,96,2,251,153,52,44
28,MUREŞ,GLODENI,117113,PĂCURENI,"ŞCOALA PRIMARĂ PĂCURENI",395,"Alegeri Prezidentiale",1,180,60,43,17,0,58,2,201,141,43,15
28,MUREŞ,GLODENI,117113,PĂINGENI,"ȘCOALA PRIMARĂ PĂINGENI",396,"Alegeri Prezidentiale",1,297,119,99,20,0,115,4,351,232,93,22
28,MUREŞ,GORNEŞTI,117177,ILIOARA,"CAMIN CULTURAL",397,"Alegeri Prezidentiale",1,89,50,29,21,0,47,3,101,51,38,9
28,MUREŞ,GORNEŞTI,117177,PĂDURENI,"CAMIN CULTURAL",398,"Alegeri Prezidentiale",1,352,124,104,20,0,117,7,401,277,99,18
28,MUREŞ,GORNEŞTI,117177,"PETRILACA DE MUREŞ","CAMIN CULTURAL",399,"Alegeri Prezidentiale",1,337,113,89,24,0,111,2,400,287,93,18
28,MUREŞ,GORNEŞTI,117177,TELEAC,"SCOALA PRIMARĂ TELEAC",400,"Alegeri Prezidentiale",1,329,148,126,22,0,145,3,401,253,86,59
28,MUREŞ,GORNEŞTI,117177,GORNEŞTI,"SCOALA GIMNAZIALA TELEKI DOMOKOS",401,"Alegeri Prezidentiale",1,800,237,206,31,0,227,10,901,664,183,44
28,MUREŞ,GORNEŞTI,117177,GORNEŞTI,"GRADINITA CU PROGRAM NORMAL",402,"Alegeri Prezidentiale",1,812,260,233,27,0,254,6,901,641,196,58
28,MUREŞ,GORNEŞTI,117177,PERIŞ,"CAMIN CULTURAL PERIS",403,"Alegeri Prezidentiale",1,1492,508,454,54,0,487,21,1601,1093,408,79
28,MUREŞ,GORNEŞTI,117177,"IARA DE MUREŞ","SCOALA PRIMARĂ IARA DE MUREŞ",404,"Alegeri Prezidentiale",1,243,38,24,14,0,37,1,301,263,23,14
28,MUREŞ,"GREBENIŞU DE CÂMPIE",117275,"GREBENIŞU DE CÂMPIE","CĂMIN CULTURAL GREBENISU DE CIMPIE",405,"Alegeri Prezidentiale",1,1337,639,590,32,17,632,7,1451,812,386,246
28,MUREŞ,GURGHIU,117319,GURGHIU,"CĂMINUL CULTURAL GURGHIU",406,"Alegeri Prezidentiale",1,848,376,350,26,0,372,4,951,575,292,80
28,MUREŞ,GURGHIU,117319,GURGHIU,"CAMINUL CULTURAL GURGHIU",407,"Alegeri Prezidentiale",1,761,346,318,28,0,342,4,851,505,253,89
28,MUREŞ,GURGHIU,117319,ADRIAN,"CĂMINUL CULTURAL ADRIAN",408,"Alegeri Prezidentiale",1,229,133,107,26,0,131,2,251,118,113,18
28,MUREŞ,GURGHIU,117319,CAŞVA,"SCOALA PRIMARA CASVA",409,"Alegeri Prezidentiale",1,673,351,319,31,1,351,0,751,400,278,73
28,MUREŞ,GURGHIU,117319,COMORI,"FOSTA SCOALA PRIMARA COMORI",410,"Alegeri Prezidentiale",1,150,116,89,27,0,115,1,201,85,85,30
28,MUREŞ,GURGHIU,117319,GLĂJĂRIE,"CAMINUL CULTURAL GLAJARIE",411,"Alegeri Prezidentiale",1,1421,532,486,33,13,519,13,1551,1019,445,74
28,MUREŞ,GURGHIU,117319,LARGA,"SCOALA PRIMARA LARGA",412,"Alegeri Prezidentiale",1,191,92,73,19,0,92,0,251,159,75,17
28,MUREŞ,GURGHIU,117319,ORŞOVA,"CAMINUL CULTURAL ORSOVA",413,"Alegeri Prezidentiale",1,657,345,311,34,0,342,3,751,406,271,71
28,MUREŞ,HODAC,117426,HODAC,"CAMINUL CULTURAL HODAC",414,"Alegeri Prezidentiale",1,997,371,350,21,0,371,0,1101,730,233,138
28,MUREŞ,HODAC,117426,HODAC,"SCOALA GIMNAZIALA HODAC",415,"Alegeri Prezidentiale",1,1053,543,496,46,1,542,1,1152,609,389,153
28,MUREŞ,HODAC,117426,TOACA,"GRADINITA CU PROGRAM NORMAL TOACA",416,"Alegeri Prezidentiale",1,657,357,334,23,0,355,2,751,394,271,84
28,MUREŞ,HODAC,117426,"DUBIŞTEA DE PĂDURE","SCOALA GIMNAZIALA DUBISTEA DE PADURE",417,"Alegeri Prezidentiale",1,377,236,212,24,0,235,1,451,215,165,70
28,MUREŞ,HODAC,117426,TOACA,"ȘCOALA GIMNAZIALĂ TOACA",418,"Alegeri Prezidentiale",1,866,488,455,33,0,486,2,951,463,362,124
28,MUREŞ,HODOŞA,117505,HODOŞA,"ȘCOALA PRIMARĂ HODOȘA",419,"Alegeri Prezidentiale",1,172,79,62,17,0,72,7,201,122,47,25
28,MUREŞ,HODOŞA,117505,IHOD,"ȘCOALA PRIMARĂ IHOD",420,"Alegeri Prezidentiale",1,98,40,27,13,0,37,3,151,111,25,12
28,MUREŞ,HODOŞA,117505,ISLA,"CLĂDIREA BAZEI SPORTIVE ISLA",421,"Alegeri Prezidentiale",1,225,74,54,20,0,71,3,251,177,51,20
28,MUREŞ,HODOŞA,117505,SÂMBRIAŞ,"ȘCOALA GIMNAZIALĂ ”PETREȘ KÁLMÁN „ SÎMBRIAȘ",422,"Alegeri Prezidentiale",1,508,87,71,16,0,78,9,552,465,44,34
28,MUREŞ,IBĂNEŞTI,117550,IBĂNEŞTI,"GRĂDINIŢA CU PROGRAM NORMAL IBĂNEŞTI",423,"Alegeri Prezidentiale",1,1318,720,675,44,1,716,4,1451,731,460,256
28,MUREŞ,IBĂNEŞTI,117550,IBĂNEŞTI,"SALĂ MANIFESTĂRI ISTICEU",424,"Alegeri Prezidentiale",1,485,306,265,40,1,304,2,551,245,212,92
28,MUREŞ,IBĂNEŞTI,117550,IBĂNEŞTI-PĂDURE,"GRĂDINIŢA CU PROGRAM PRELUNGIT IBĂNEŞTI-PĂDURE",425,"Alegeri Prezidentiale",2,769,450,405,45,0,447,3,851,401,311,136
28,MUREŞ,IBĂNEŞTI,117550,DULCEA,"CĂMIN CULTURAL DULCEA",426,"Alegeri Prezidentiale",1,890,546,486,60,0,544,2,1001,455,364,180
28,MUREŞ,ICLĂNZEL,117667,ICLĂNZEL,"CAMINUL CULTURAL",427,"Alegeri Prezidentiale",1,1021,480,433,47,0,476,4,1101,621,232,244
28,MUREŞ,ICLĂNZEL,117667,"CĂPUŞU DE CÂMPIE","ȘCOALA GIMNAZIALĂ ”PETRU MAIOR”",428,"Alegeri Prezidentiale",1,623,258,206,47,5,257,1,701,443,158,99
28,MUREŞ,"IDECIU DE JOS",117783,"IDECIU DE JOS","CAMINUL CULTURAL IDECIU DE JOS",429,"Alegeri Prezidentiale",1,841,488,387,60,41,484,4,901,413,366,118
28,MUREŞ,"IDECIU DE JOS",117783,"IDECIU DE JOS","GRADINITA CU PROGRAM NORMAL IDECIU DE SUS",430,"Alegeri Prezidentiale",1,690,314,282,30,2,312,2,751,437,246,66
28,MUREŞ,"IDECIU DE JOS",117783,"IDECIU DE JOS","FOSTA SCOALA PRIMARA DELENI",431,"Alegeri Prezidentiale",1,204,130,110,20,0,130,0,251,121,87,43
28,MUREŞ,LIVEZENI,117925,IVĂNEŞTI,"ȘCOALA PRIMARĂ IVĂNEȘTI",432,"Alegeri Prezidentiale",1,368,181,145,35,1,180,1,401,220,132,48
28,MUREŞ,LIVEZENI,117925,POIENIŢA,"ȘCOALA PRIMARĂ POIENIȚA",433,"Alegeri Prezidentiale",1,245,134,93,41,0,132,2,301,167,102,30
28,MUREŞ,LIVEZENI,117925,LIVEZENI,"CENTRUL COMUNITAR DE SERVICII INTEGRATE LIVEZENI",434,"Alegeri Prezidentiale",1,1930,873,753,120,0,835,38,2050,1177,694,141
28,MUREŞ,LIVEZENI,117925,SÂNIŞOR,"ȘCOALA PRIMARĂ SÂNIȘOR",435,"Alegeri Prezidentiale",1,205,107,83,24,0,105,2,251,144,96,9
28,MUREŞ,LUNCA,117998,LUNCA,"SEDIUL ADMINISTRATIV AL PRIMĂRIEI",436,"Alegeri Prezidentiale",1,410,269,242,27,0,267,2,451,182,183,84
28,MUREŞ,LUNCA,117998,BĂIŢA,"ŞCOALA GIMNAZIALĂ BĂIŢA",437,"Alegeri Prezidentiale",1,613,301,273,28,0,300,1,701,400,228,72
28,MUREŞ,LUNCA,117998,FRUNZENI,"ŞCOALA PRIMARĂ FRUNZENI",438,"Alegeri Prezidentiale",1,327,194,167,27,0,193,1,401,207,122,71
28,MUREŞ,LUNCA,117998,LOGIG,"ŞCOALA PRIMARĂ LOGIG",439,"Alegeri Prezidentiale",1,320,186,164,22,0,183,3,351,165,96,87
28,MUREŞ,LUNCA,117998,SÂNTU,"ŞCOALA PRIMARĂ SÎNTU",440,"Alegeri Prezidentiale",1,267,188,161,27,0,183,5,301,113,141,42
28,MUREŞ,"LUNCA BRADULUI",118058,"LUNCA BRADULUI","CASA DE CULTURA LUNCA BRADULUI",441,"Alegeri Prezidentiale",1,1191,446,391,55,0,443,3,1301,855,264,179
28,MUREŞ,"LUNCA BRADULUI",118058,NEAGRA,"SCOALA PRIMARA SAT NEAGRA",442,"Alegeri Prezidentiale",1,360,153,135,18,0,153,0,401,248,119,34
28,MUREŞ,MĂDĂRAŞ,120502,MĂDĂRAŞ,"SEDIUL PRIMĂRIEI COMUNEI MĂDĂRAȘ",443,"Alegeri Prezidentiale",1,1041,254,239,15,0,242,12,1151,897,187,55
28,MUREŞ,MĂDĂRAŞ,120502,MĂDĂRAŞ,"ȘCOALA PRIMARĂ CU CLASELE I-IV FÂNAȚTELE MĂDĂRAȘULUI",444,"Alegeri Prezidentiale",1,236,92,75,17,0,90,2,301,209,72,18
28,MUREŞ,MĂGHERANI,118094,MĂGHERANI,"ŞCOALA GIMNAZIALĂ MĂGHERANI",445,"Alegeri Prezidentiale",1,614,146,123,23,0,130,16,701,555,84,46
28,MUREŞ,MĂGHERANI,118094,"ŞILEA NIRAJULUI","ŞCOALA PRIMARĂ ŞILEA NIRAJULUI",446,"Alegeri Prezidentiale",1,326,85,70,15,0,71,14,351,266,41,30
28,MUREŞ,MĂGHERANI,118094,TORBA,"CĂMIN CULTURAL TORBA",447,"Alegeri Prezidentiale",1,124,39,26,13,0,29,10,151,112,19,10
28,MUREŞ,MICA,118209,MICA,"ȘCOALA PRIMARĂ MICA",448,"Alegeri Prezidentiale",1,571,193,166,27,0,193,0,650,457,143,50
28,MUREŞ,MICA,118209,CEUAŞ,"ȘCOALA GIMNAZIALĂ ”BELLE JOZSEF”",449,"Alegeri Prezidentiale",1,713,254,235,19,0,233,21,809,555,181,52
28,MUREŞ,MICA,118209,DEAJ,"ȘCOALA GIMNAZIALĂ DEAJ",450,"Alegeri Prezidentiale",1,1200,385,357,28,0,375,10,1301,916,238,137
28,MUREŞ,MICA,118209,HĂRĂNGLAB,"ȘCOALA GIMNAZIALĂ HĂRĂNGLAB",451,"Alegeri Prezidentiale",1,624,258,240,18,0,250,8,701,443,225,25
28,MUREŞ,MICA,118209,ŞOMOŞTELNIC,"ȘCOALA PRIMARĂ ȘOMOȘTELNIC",452,"Alegeri Prezidentiale",1,211,106,81,25,0,101,5,251,145,45,56
28,MUREŞ,MICA,118209,ABUŞ,"ȘCOALA PRIMARĂ",453,"Alegeri Prezidentiale",1,234,102,77,25,0,96,6,301,199,69,27
28,MUREŞ,"MIHEŞU DE CÂMPIE",118370,"MIHEŞU DE CÂMPIE","CĂMINUL CULTURAL MIHEȘU DE CÎMPIE",454,"Alegeri Prezidentiale",1,1243,537,496,41,0,533,4,1351,814,402,131
28,MUREŞ,"MIHEŞU DE CÂMPIE",118370,RĂZOARE,"CĂMINUL CULTURAL RĂZOARE",455,"Alegeri Prezidentiale",1,666,210,174,36,0,209,1,760,550,106,103
28,MUREŞ,NADEŞ,118469,NADEŞ,"ŞCOALA GIMNAZIALĂ CORPUL A NADEŞ",456,"Alegeri Prezidentiale",1,1174,310,295,15,0,306,4,1307,997,249,57
28,MUREŞ,NADEŞ,118469,MĂGHERUŞ,"ŞCOALA PRIMARĂ MĂGHERUŞ",457,"Alegeri Prezidentiale",1,97,53,39,14,0,52,1,151,98,42,10
28,MUREŞ,NADEŞ,118469,PIPEA,"CĂMINUL CULTURAL PIPEA",458,"Alegeri Prezidentiale",1,46,19,7,12,0,19,0,101,82,17,2
28,MUREŞ,NADEŞ,118469,ŢIGMANDRU,"ŞCOALA GIMNAZIALĂ ŢIGMANDRU",459,"Alegeri Prezidentiale",1,877,285,265,20,0,283,2,951,666,234,49
28,MUREŞ,NEAUA,118511,NEAUA,"ŞCOALA GIMNAZIALĂ NEAUA",460,"Alegeri Prezidentiale",1,308,74,61,13,0,68,6,351,277,54,14
28,MUREŞ,NEAUA,118511,VĂDAŞ,"CĂMINUL CULTURAL VĂDAȘ",461,"Alegeri Prezidentiale",1,294,52,42,10,0,48,4,355,303,37,11
28,MUREŞ,NEAUA,118511,GHINEŞTI,"ŞCOALA PRIMARĂ GHINEȘTI",462,"Alegeri Prezidentiale",1,211,52,32,20,0,48,4,249,197,33,15
28,MUREŞ,NEAUA,118511,SÂNSIMION,"CĂMINUL CULTURAL SÎNSIMION",463,"Alegeri Prezidentiale",1,56,33,17,16,0,30,3,101,68,25,5
28,MUREŞ,NEAUA,118511,RIGMANI,"ŞCOALA PRIMARĂ RIGMANI",464,"Alegeri Prezidentiale",1,188,57,45,12,0,52,5,251,194,22,30
28,MUREŞ,OGRA,118575,OGRA,"CLUB CĂMIN CULTURAL OGRA",465,"Alegeri Prezidentiale",1,1317,562,495,66,1,549,13,1451,889,349,200
28,MUREŞ,OGRA,118575,OGRA,"ȘCOALA GIMNAZIALĂ OGRA",466,"Alegeri Prezidentiale",1,132,45,20,25,0,45,0,151,106,35,10
28,MUREŞ,OGRA,118575,GIULUŞ,"FOSTA ŞCOALĂ GENERALĂ GIULUŞ",467,"Alegeri Prezidentiale",1,102,56,47,9,0,52,4,151,95,38,14
28,MUREŞ,OGRA,118575,LĂSCUD,"ŞCOALA PRIMARĂ LĂSCUD",468,"Alegeri Prezidentiale",1,198,93,75,18,0,92,1,251,158,62,30
28,MUREŞ,OGRA,118575,VAIDEIU,"CAMIN CULTURAL VAIDEIU",469,"Alegeri Prezidentiale",1,97,53,36,17,0,51,2,151,98,36,15
28,MUREŞ,"PAPIU ILARIAN",118637,"PAPIU ILARIAN","CAMIN CULTURAL",470,"Alegeri Prezidentiale",1,693,306,281,24,1,303,3,751,445,250,53
28,MUREŞ,PĂNET,118691,PĂNET,"GRĂDINIŢA CU PROGRAM NORMAL PĂNET",471,"Alegeri Prezidentiale",1,1060,201,188,13,0,177,24,1151,950,145,32
28,MUREŞ,PĂNET,118691,PĂNET,"SEDIUL PRIMĂRIEI COMUNEI PĂNET",472,"Alegeri Prezidentiale",1,855,170,157,13,0,149,21,951,781,117,32
28,MUREŞ,PĂNET,118691,BERGHIA,"GRĂDINIȚA BERGHIA",473,"Alegeri Prezidentiale",1,998,359,324,35,0,358,1,1110,751,324,34
28,MUREŞ,PĂNET,118691,CUIEŞD,"ŞCOALA PRIMARĂ CUIEŞD",474,"Alegeri Prezidentiale",1,659,172,158,14,0,164,8,750,578,93,71
28,MUREŞ,PĂNET,118691,HĂRŢĂU,"GRĂDINIȚA HĂRŢĂU",475,"Alegeri Prezidentiale",1,281,117,97,20,0,115,2,301,184,80,35
28,MUREŞ,PĂNET,118691,"SÂNTIOANA DE MUREŞ","GRĂDINIȚA SÎNTIOANA DE MUREŞ",476,"Alegeri Prezidentiale",1,1166,380,351,29,0,367,13,1251,871,301,66
28,MUREŞ,PĂSĂRENI,118753,PĂSĂRENI,"ŞCOALA GIMNANZIALĂ ”KISS GERGELY” PĂSĂRENI",477,"Alegeri Prezidentiale",1,691,225,191,34,0,199,26,751,526,154,45
28,MUREŞ,PĂSĂRENI,118753,GĂLĂŢENI,"ŞCOALA PRIMARĂ GĂLĂŢENI, SAT GĂLĂȚENI",478,"Alegeri Prezidentiale",1,557,123,101,22,0,115,8,601,478,86,29
28,MUREŞ,PĂSĂRENI,118753,BOLINTINENI,"CĂMIN CULTURAL BOLINTINENI, SAT BOLINTINENI",479,"Alegeri Prezidentiale",1,174,78,52,26,0,75,3,201,123,56,19
28,MUREŞ,PETELEA,118799,PETELEA,"FOSTUL SEDIU AL POSTEI ROMANE",480,"Alegeri Prezidentiale",1,1099,480,456,24,0,470,10,1201,721,391,79
28,MUREŞ,PETELEA,118799,PETELEA,"SEDIUL PRIMARIEI",481,"Alegeri Prezidentiale",1,914,456,390,66,0,452,4,1001,545,333,119
28,MUREŞ,PETELEA,118799,HABIC,"SCOALA PRIMARA HABIC",482,"Alegeri Prezidentiale",1,197,106,68,38,0,105,1,251,145,87,18
28,MUREŞ,POGĂCEAUA,118824,POGĂCEAUA,"CĂMINUL CULTURAL POGĂCEAUA",483,"Alegeri Prezidentiale",1,1058,448,415,33,0,445,3,1151,703,320,125
28,MUREŞ,POGĂCEAUA,118824,VĂLENI,"CĂMINUL CULTURAL VĂLENI",484,"Alegeri Prezidentiale",1,416,184,152,32,0,181,3,451,267,92,89
28,MUREŞ,RĂSTOLIŢA,118931,RĂSTOLIŢA,"ȘCOALA GIMNAZIALĂ RĂSTOLIȚA",485,"Alegeri Prezidentiale",1,1464,671,604,67,0,663,8,1601,930,494,169
28,MUREŞ,RÂCIU,118995,"SÂNMĂRTINU DE CÂMPIE","CĂMINUL CULTURAL SÎNMARTINU DE CÎMPIE",486,"Alegeri Prezidentiale",1,738,352,311,41,0,349,3,801,449,263,86
28,MUREŞ,RÂCIU,118995,"NIMA RÂCIULUI","CĂMINUL CULTURAL NIMA RÎCIULUI",487,"Alegeri Prezidentiale",1,134,87,58,29,0,87,0,151,64,51,36
28,MUREŞ,RÂCIU,118995,ULIEŞ,"ŞCOALA GIMNAZIALĂ ULIEŞ",488,"Alegeri Prezidentiale",1,601,225,200,25,0,224,1,659,434,162,62
28,MUREŞ,RÂCIU,118995,RÂCIU,"CASA DE CULTURĂ ”VASILE CONȚIU” RÂCIU",489,"Alegeri Prezidentiale",1,1333,663,592,71,0,658,5,1451,788,469,189
28,MUREŞ,RUŞII-MUNŢI,119153,RUŞII-MUNŢI,"CĂMINUL CULTURAL",490,"Alegeri Prezidentiale",1,1242,716,637,66,13,705,11,1351,635,404,301
28,MUREŞ,RUŞII-MUNŢI,119153,MAIOREŞTI,"CĂMINUL CULTURAL",491,"Alegeri Prezidentiale",1,195,135,112,23,0,134,1,251,116,84,50
28,MUREŞ,RUŞII-MUNŢI,119153,MORĂRENI,"FOSTA SCOALA PRIMARA",492,"Alegeri Prezidentiale",1,314,204,179,24,1,202,2,351,147,100,102
28,MUREŞ,SASCHIZ,119206,SASCHIZ,"ȘCOALA GIMNAZIALĂ ”ION DACIAN”",493,"Alegeri Prezidentiale",1,1389,456,411,45,0,449,7,1501,1045,315,134
28,MUREŞ,SASCHIZ,119206,"MIHAI VITEAZU","CĂMIN CULTURAL MIHAI VITEAZU",494,"Alegeri Prezidentiale",1,248,122,93,29,0,119,3,298,176,86,33
28,MUREŞ,SASCHIZ,119206,CLOAŞTERF,"CĂMIN CULTURAL CLOAȘTERF",495,"Alegeri Prezidentiale",1,150,85,59,26,0,84,1,202,117,66,18
28,MUREŞ,SĂRĂŢENI,120496,SĂRĂŢENI,"PRIMĂRIA COMUNEI SĂRĂȚENI",496,"Alegeri Prezidentiale",1,1243,295,267,28,0,275,20,1351,1056,160,115
28,MUREŞ,"SÂNCRAIU DE MUREŞ",114382,"SÂNCRAIU DE MUREŞ","CĂMINUL CULTURAL SÎNCRAIU DE MUREŞ",497,"Alegeri Prezidentiale",1,1580,831,742,89,0,809,22,1701,870,669,140
28,MUREŞ,"SÂNCRAIU DE MUREŞ",114382,"SÂNCRAIU DE MUREŞ","PRIMĂRIA SÎNCRAIU DE MUREŞ",498,"Alegeri Prezidentiale",1,1874,1056,920,135,1,1037,19,2001,945,812,225
28,MUREŞ,"SÂNCRAIU DE MUREŞ",114382,"SÂNCRAIU DE MUREŞ","FOSTUL CĂMIN CULTURAL SÎNCRAIU DE MUREŞ",499,"Alegeri Prezidentiale",1,1850,777,704,73,0,757,20,2001,1224,553,204
28,MUREŞ,"SÂNCRAIU DE MUREŞ",114382,NAZNA,"CĂMINUL CULTURAL NAZNA",500,"Alegeri Prezidentiale",1,1145,709,639,70,0,693,16,1251,542,504,189
28,MUREŞ,"SÂNCRAIU DE MUREŞ",114382,NAZNA,"ŞCOALA GIMNAZIALĂ NAZNA",501,"Alegeri Prezidentiale",1,1001,666,558,108,0,655,11,1101,435,500,155
28,MUREŞ,"SÂNGEORGIU DE MUREŞ",114417,"SÂNGEORGIU DE MUREŞ","ȘCOALA GIMNAZIALĂ ”SFÂNTU GHEORGHE” SÂNGEORGIU DE MUREȘ",502,"Alegeri Prezidentiale",1,1180,527,484,43,0,503,24,1301,774,394,109
28,MUREŞ,"SÂNGEORGIU DE MUREŞ",114417,"SÂNGEORGIU DE MUREŞ","ȘCOALA GIMNAZIALĂ ”SFÂNTU GHEORGHE” SÂNGEORGIU DE MUREȘ",503,"Alegeri Prezidentiale",1,1635,782,727,54,1,757,25,1750,968,594,163
28,MUREŞ,"SÂNGEORGIU DE MUREŞ",114417,COTUŞ,"ȘCOALA GIMNAZIALĂ ”SFÂNTUL GHEORGHE” - ȘCOALA PRIMARĂ COTUȘ",504,"Alegeri Prezidentiale",1,417,147,125,22,0,143,4,452,305,111,32
28,MUREŞ,"SÂNGEORGIU DE MUREŞ",114417,"SÂNGEORGIU DE MUREŞ","GRĂDINIȚA CU PROGRAM PRELUNGIT ”BAMBI” SÎNGEORGIU DE MUREȘ",505,"Alegeri Prezidentiale",1,1502,609,565,44,0,577,32,1600,991,475,102
28,MUREŞ,"SÂNGEORGIU DE MUREŞ",114417,"SÂNGEORGIU DE MUREŞ","ȘCOALA GIMNAZIALĂ ”SFÂNTUL GHEORGHE” SÎNGEORGIU DE MUREȘ",506,"Alegeri Prezidentiale",1,1218,514,471,43,0,504,10,1301,787,366,138
28,MUREŞ,"SÂNGEORGIU DE MUREŞ",114417,"SÂNGEORGIU DE MUREŞ","ȘCOALA GIMNAZIALĂ ”SFÂNTUL GHEORGHE” SÎNGEORGIU DE MUREȘ",507,"Alegeri Prezidentiale",2,1265,534,459,75,0,519,15,1350,816,391,128
28,MUREŞ,"SÂNGEORGIU DE MUREŞ",114417,"SÂNGEORGIU DE MUREŞ","ȘCOALA GIMNAZIALĂ ”SFÂNTUL GHEORGHE” SÎNGEORGIU DE MUREȘ",508,"Alegeri Prezidentiale",1,1166,577,486,91,0,548,29,1253,676,452,96
28,MUREŞ,SÂNGER,119386,SÂNGER,"GRADINITA CU PROGRAM NORMAL SANGER",509,"Alegeri Prezidentiale",1,1275,489,448,41,0,484,5,1401,912,360,124
28,MUREŞ,SÂNGER,119386,CIPĂIENI,"CAMINUL CULTURAL CIPAIENI",510,"Alegeri Prezidentiale",1,583,241,220,21,0,241,0,651,410,177,64
28,MUREŞ,SÂNPAUL,119466,SÂNPAUL,"CĂMINUL CULTURAL",511,"Alegeri Prezidentiale",1,1409,522,450,64,8,508,14,1551,1029,368,140
28,MUREŞ,SÂNPAUL,119466,CHIRILEU,"ŞCOALA GENERALĂ CHIRILEU",512,"Alegeri Prezidentiale",1,686,345,300,45,0,339,6,751,406,178,161
28,MUREŞ,SÂNPAUL,119466,"DILEU NOU","CĂMINUL CULTURAL",513,"Alegeri Prezidentiale",1,139,73,54,19,0,73,0,151,78,58,15
28,MUREŞ,SÂNPAUL,119466,SÂNMĂRGHITA,"CĂMINUL CULTURAL",514,"Alegeri Prezidentiale",1,199,113,88,25,0,110,3,251,138,67,43
28,MUREŞ,SÂNPAUL,119466,"VALEA IZVOARELOR","CĂMINUL CULTURAL",515,"Alegeri Prezidentiale",1,956,402,347,34,21,384,18,1051,649,297,87
28,MUREŞ,"SÂNPETRU DE CÂMPIE",119527,"SÂNPETRU DE CÂMPIE","CĂMINUL CULTURAL SÎNPETRU DE CÎMPIE",516,"Alegeri Prezidentiale",1,826,343,304,39,0,340,3,901,558,228,112
28,MUREŞ,"SÂNPETRU DE CÂMPIE",119527,BÂRLIBAŞ,"CĂMINUL CULTURAL BÎRLIBAȘ",517,"Alegeri Prezidentiale",1,110,54,43,11,0,54,0,151,97,42,12
28,MUREŞ,"SÂNPETRU DE CÂMPIE",119527,DÂMBU,"ȘCOALA GENERALĂ DÎMBU",518,"Alegeri Prezidentiale",1,459,212,185,27,0,209,3,501,289,122,87
28,MUREŞ,"SÂNPETRU DE CÂMPIE",119527,"SATU NOU","FOSTA ȘCOALA PRIMARA SATU -NOU",519,"Alegeri Prezidentiale",1,161,87,70,17,0,86,1,201,114,57,29
28,MUREŞ,"SÂNPETRU DE CÂMPIE",119527,"SÂNGEORGIU DE CÂMPIE","CĂMINUL CULTURAL SÎNGEORGIU DE CÎMPIE",520,"Alegeri Prezidentiale",1,271,118,102,16,0,118,0,301,183,73,45
28,MUREŞ,"SÂNPETRU DE CÂMPIE",119527,TUŞINU,"ȘCOALA GENERALĂ TUȘINU",521,"Alegeri Prezidentiale",1,395,154,123,31,0,151,3,451,297,94,57
28,MUREŞ,"SÂNTANA DE MUREŞ",114453,"SÂNTANA DE MUREŞ","CĂMIN CULTURAL SÂNTANA DE MUREȘ",522,"Alegeri Prezidentiale",1,1491,766,695,70,1,758,8,1593,827,563,195
28,MUREŞ,"SÂNTANA DE MUREŞ",114453,"SÂNTANA DE MUREŞ","CĂMIN CULTURAL SÂNTANA DE MUREȘ",523,"Alegeri Prezidentiale",1,1503,835,739,96,0,819,16,1651,816,645,174
28,MUREŞ,"SÂNTANA DE MUREŞ",114453,CURTENI,"CĂMIN CULTURAL CURTENI",524,"Alegeri Prezidentiale",1,842,373,337,36,0,358,15,901,528,311,47
28,MUREŞ,"SÂNTANA DE MUREŞ",114453,CHINARI,"GRĂDINIȚA CU PROGRAM NORMAL CHINARI",525,"Alegeri Prezidentiale",1,596,261,231,30,0,251,10,651,390,190,61
28,MUREŞ,"SÂNTANA DE MUREŞ",114453,BĂRDEŞTI,"CĂMINUL CULTURAL BĂRDEŞTI",526,"Alegeri Prezidentiale",1,404,294,213,81,0,290,4,451,157,180,110
28,MUREŞ,SOLOVĂSTRU,119590,SOLOVĂSTRU,"ŞCOALA GIMNAZIALĂ SOLOVĂSTRU",527,"Alegeri Prezidentiale",1,1404,716,668,47,1,706,10,1551,835,557,149
28,MUREŞ,SOLOVĂSTRU,119590,JABENIŢA,"ŞCOALA GIMNAZIALĂ JABENIŢA",528,"Alegeri Prezidentiale",1,964,488,444,44,0,482,6,1034,546,372,110
28,MUREŞ,STÂNCENI,119625,STÂNCENI,"CĂMIN CULTURAL STÎNCENI",529,"Alegeri Prezidentiale",1,1196,599,538,61,0,587,12,1301,702,410,177
28,MUREŞ,SUPLAC,119661,SUPLAC,"ȘCOALA PRIMARĂ SUPLAC",530,"Alegeri Prezidentiale",1,646,244,217,27,0,241,3,701,457,180,61
28,MUREŞ,SUPLAC,119661,IDRIFAIA,"ȘCOALA GIMNAZIALĂ ” BORDI ANDRÁS ”IDRIFAIA",531,"Alegeri Prezidentiale",1,513,204,187,17,0,195,9,551,347,135,60
28,MUREŞ,SUPLAC,119661,"LASLĂU MARE","ȘCOALA GIMNAZIALĂ ” SF.NICOLAE” LASLĂU MARE",532,"Alegeri Prezidentiale",1,301,178,144,34,0,175,3,351,173,106,69
28,MUREŞ,SUPLAC,119661,"LASLĂU MIC","ŞCOALA PRIMARĂ LASLĂU MIC",533,"Alegeri Prezidentiale",1,407,122,105,17,0,121,1,451,329,98,23
28,MUREŞ,SUSENI,119723,SUSENI,"ŞCOALA GIMNAZIALĂ SUSENI",534,"Alegeri Prezidentiale",1,1409,673,618,54,1,659,14,1551,878,543,116
28,MUREŞ,SUSENI,119723,LUIERIU,"FOSTA ŞCOALĂ GENERALĂ LUIERIU",535,"Alegeri Prezidentiale",1,525,300,256,44,0,300,0,601,301,196,104
28,MUREŞ,ŞĂULIA,119750,ŞĂULIA,"CĂMINUL CULTURAL ȘĂULIA",536,"Alegeri Prezidentiale",1,1313,708,617,71,20,700,8,1401,693,335,365
28,MUREŞ,ŞĂULIA,119750,ŞĂULIA,"CLUBUL TINERETULUI ȘĂULIA",537,"Alegeri Prezidentiale",1,257,174,121,53,0,169,5,301,127,97,72
28,MUREŞ,ŞINCAI,119803,ŞINCAI,"CONSILIUL LOCAL ŞINCAI",538,"Alegeri Prezidentiale",1,845,297,259,38,0,289,8,951,654,212,77
28,MUREŞ,ŞINCAI,119803,LECHINCIOARA,"ŞCOALA PRIMARĂ LECHINCIOARA",539,"Alegeri Prezidentiale",1,82,59,39,20,0,58,1,101,42,44,14
28,MUREŞ,ŞINCAI,119803,PUSTA,"ŞCOALA PRIMARĂ PUSTA",540,"Alegeri Prezidentiale",1,96,72,54,18,0,70,2,151,79,30,40
28,MUREŞ,ŞINCAI,119803,ŞINCAI-FÂNAŢE,"ŞCOALA PRIMARĂ ŞINCAI-FÎNAŢE",541,"Alegeri Prezidentiale",1,174,104,78,26,0,103,1,201,97,74,29
28,MUREŞ,TĂURENI,119858,TĂURENI,"PRIMĂRIA TĂURENI",542,"Alegeri Prezidentiale",1,771,462,404,44,14,457,5,852,390,184,273
28,MUREŞ,"VALEA LARGĂ",119974,"VALEA LARGĂ","PRIMARIA COMUNEI VALEA LARGA",543,"Alegeri Prezidentiale",1,1099,389,354,35,0,385,4,1200,811,305,80
28,MUREŞ,"VALEA LARGĂ",119974,"VALEA LARGĂ","CĂMINUL CULTURAL VALEA LARGA",544,"Alegeri Prezidentiale",1,897,282,248,34,0,281,1,1000,718,205,76
28,MUREŞ,"VALEA LARGĂ",119974,"VALEA FRĂŢIEI","ŞCOALA PRIMARĂ VALEA FRĂŢIEI",545,"Alegeri Prezidentiale",1,491,134,118,16,0,134,0,551,417,115,19
28,MUREŞ,VĂRGATA,120076,VĂRGATA,"ŞCOALA GIMNAZIALĂ VĂRGATA",546,"Alegeri Prezidentiale",1,670,126,109,17,0,108,18,751,625,70,38
28,MUREŞ,VĂRGATA,120076,GRÂUŞORUL,"CASĂ PARTCULARĂ PROPRIETATEA LUI MÁJAI PETER",547,"Alegeri Prezidentiale",1,142,48,30,18,0,43,5,201,153,26,17
28,MUREŞ,VĂRGATA,120076,VADU,"PAROHIA UNITARIANĂ VADU",548,"Alegeri Prezidentiale",1,195,53,34,19,0,45,8,251,198,26,19
28,MUREŞ,VĂRGATA,120076,VALEA,"ŞCOALA PRIMARĂ VALEA",549,"Alegeri Prezidentiale",1,556,109,92,17,0,103,6,601,492,78,25
28,MUREŞ,VĂTAVA,120138,VĂTAVA,"CĂMINUL CULTURAL VĂTAVA",550,"Alegeri Prezidentiale",1,638,362,319,43,0,361,1,700,338,272,89
28,MUREŞ,VĂTAVA,120138,DUMBRAVA,"ȘCOALA PRIMARĂ DUMBRAVA",551,"Alegeri Prezidentiale",1,542,297,268,29,0,292,5,601,304,179,113
28,MUREŞ,VĂTAVA,120138,"RÂPA DE JOS","ȘCOALA ”MIHAI TOMSA” RÎPA DE JOS",552,"Alegeri Prezidentiale",1,371,246,211,35,0,242,4,401,155,161,81
28,MUREŞ,VÂNĂTORI,120254,VÂNĂTORI,"ŞCOALA GIMNAZIALĂ ” PETRE N. POPESCU ” VÎNĂTORI",553,"Alegeri Prezidentiale",1,1407,585,536,49,0,579,6,1551,966,463,116
28,MUREŞ,VÂNĂTORI,120254,ARCHITA,"GRĂDINIŢA CU PROGRAM NORMAL ARCHITA",554,"Alegeri Prezidentiale",2,707,245,217,28,0,245,0,801,556,191,54
28,MUREŞ,VÂNĂTORI,120254,FELEAG,"ŞCOALA PRIMARĂ FELEAG",555,"Alegeri Prezidentiale",1,167,90,57,33,0,90,0,200,110,56,34
28,MUREŞ,VÂNĂTORI,120254,MURENI,"ŞCOALA PRIMARĂ MURENI",556,"Alegeri Prezidentiale",1,275,95,81,14,0,94,1,300,205,83,11
28,MUREŞ,VÂNĂTORI,120254,ŞOARD,"ŞCOALA PRIMARĂ ŞOARD",557,"Alegeri Prezidentiale",1,598,206,189,17,0,202,4,651,445,170,32
28,MUREŞ,VEŢCA,120174,VEŢCA,"ȘCOALA GIMNAZIALĂ VEȚCA",558,"Alegeri Prezidentiale",1,377,77,67,10,0,76,1,451,374,62,14
28,MUREŞ,VEŢCA,120174,JACODU,"CĂMINUL CULTURAL JACODU",559,"Alegeri Prezidentiale",1,196,93,66,27,0,87,6,251,158,48,39
28,MUREŞ,VIIŞOARA,120218,VIIŞOARA,"PRIMĂRIA VIIŞOARA",560,"Alegeri Prezidentiale",1,634,202,184,18,0,200,2,701,499,143,57
28,MUREŞ,VIIŞOARA,120218,SÂNTIOANA,"CĂMINUL CULTURAL SÎNTIOANA",561,"Alegeri Prezidentiale",1,430,173,151,22,0,172,1,501,328,146,26
28,MUREŞ,VIIŞOARA,120218,ORMENIŞ,"CĂMINUL CULTURAL ORMENIŞ",562,"Alegeri Prezidentiale",1,347,141,132,9,0,141,0,400,259,133,8
28,MUREŞ,VOIVODENI,120316,VOIVODENI,"ȘCOALA GIMNAZIALĂ VOIVODENI",563,"Alegeri Prezidentiale",1,1294,498,437,42,19,487,11,1401,903,318,169
28,MUREŞ,VOIVODENI,120316,TOLDAL,"CĂMINUL CULTURAL TOLDAL",564,"Alegeri Prezidentiale",1,182,91,68,21,2,90,1,201,110,48,42
28,MUREŞ,ZAGĂR,120343,ZAGĂR,"PRIMARIA ZAGAR",565,"Alegeri Prezidentiale",1,1009,285,252,33,0,285,0,1096,811,205,80
28,MUREŞ,"ZAU DE CÂMPIE",120370,"ZAU DE CÂMPIE","ȘCOALA PRIMARĂ CLASELE 0-IV ZAU DE CÎMPIE",566,"Alegeri Prezidentiale",1,962,421,373,48,0,417,4,1051,630,290,127
28,MUREŞ,"ZAU DE CÂMPIE",120370,"ZAU DE CÂMPIE","ŞCOALA GIMNAZIALĂ ZAU DE CÎMPIE",567,"Alegeri Prezidentiale",1,1262,445,412,33,0,442,3,1351,906,351,91
28,MUREŞ,"ZAU DE CÂMPIE",120370,BĂRBOŞI,"ȘCOALA GIMNAZIALĂ BĂRBOȘI",568,"Alegeri Prezidentiale",1,375,165,143,22,0,162,3,452,287,120,42
29,NEAMŢ,"MUNICIPIUL PIATRA-NEAMŢ",120726,PIATRA-NEAMŢ,"ŞCOALA GIMNAZIALĂ NR.3",1,"Alegeri Prezidentiale",1,937,488,405,82,1,474,14,1000,512,268,206
29,NEAMŢ,"MUNICIPIUL PIATRA-NEAMŢ",120726,PIATRA-NEAMŢ,"ŞCOALA GIMNAZIALĂ NR.3",2,"Alegeri Prezidentiale",1,927,500,431,69,0,485,15,1000,500,286,199
29,NEAMŢ,"MUNICIPIUL PIATRA-NEAMŢ",120726,PIATRA-NEAMŢ,"ȘCOALA GIMNAZIALĂ NR.3",3,"Alegeri Prezidentiale",1,1109,551,506,45,0,541,10,1200,649,343,198
29,NEAMŢ,"MUNICIPIUL PIATRA-NEAMŢ",120726,PIATRA-NEAMŢ,"GRĂDINIȚA CU PROGRAM PRELUNGIT NR.6",4,"Alegeri Prezidentiale",1,963,494,443,51,0,482,12,1101,607,269,213
29,NEAMŢ,"MUNICIPIUL PIATRA-NEAMŢ",120726,PIATRA-NEAMŢ,"COLEGIUL NAȚIONAL ”PETRU RAREȘ”",5,"Alegeri Prezidentiale",1,1661,590,533,56,1,576,14,1800,1210,352,224
29,NEAMŢ,"MUNICIPIUL PIATRA-NEAMŢ",120726,PIATRA-NEAMŢ,"LICEUL DE ARTE ”VICTOR BRAUNER” - CORPUL B",6,"Alegeri Prezidentiale",1,1249,577,525,52,0,567,10,1400,823,354,213
29,NEAMŢ,"MUNICIPIUL PIATRA-NEAMŢ",120726,PIATRA-NEAMŢ,"COLEGIUL NAȚIONAL ”CALISTRAT HOGAȘ”",7,"Alegeri Prezidentiale",1,918,515,481,34,0,502,13,1000,485,356,146
29,NEAMŢ,"MUNICIPIUL PIATRA-NEAMŢ",120726,PIATRA-NEAMŢ,"LICEUL TEHNOLOGIC ”SPIRU HARET”",8,"Alegeri Prezidentiale",1,1267,654,594,60,0,640,14,1400,746,383,257
29,NEAMŢ,"MUNICIPIUL PIATRA-NEAMŢ",120726,PIATRA-NEAMŢ,"LICEUL TEHOLOGIC ”SPIRU HARET”",9,"Alegeri Prezidentiale",1,1099,558,516,42,0,542,16,1200,642,318,224
29,NEAMŢ,"MUNICIPIUL PIATRA-NEAMŢ",120726,PIATRA-NEAMŢ,"GRĂDINIȚA CU PROGRAM PRELUNGIT NR.3 CORP B",10,"Alegeri Prezidentiale",1,1044,497,462,34,1,481,16,1100,603,299,182
29,NEAMŢ,"MUNICIPIUL PIATRA-NEAMŢ",120726,PIATRA-NEAMŢ,"LICEUL CU PROGRAM SPORTIV",11,"Alegeri Prezidentiale",1,1308,588,550,38,0,567,21,1400,812,357,210
29,NEAMŢ,"MUNICIPIUL PIATRA-NEAMŢ",120726,PIATRA-NEAMŢ,"LICEUL CU PROGRAM SPORTIV",12,"Alegeri Prezidentiale",1,1131,592,549,43,0,573,19,1200,608,348,225
29,NEAMŢ,"MUNICIPIUL PIATRA-NEAMŢ",120726,PIATRA-NEAMŢ,"ŞCOALA GIMNAZIALĂ NR.8",13,"Alegeri Prezidentiale",1,1292,621,580,41,0,606,15,1400,779,358,248
29,NEAMŢ,"MUNICIPIUL PIATRA-NEAMŢ",120726,PIATRA-NEAMŢ,"ȘCOALA GIMNAZIALĂ NR.8",14,"Alegeri Prezidentiale",1,1437,704,676,28,0,688,16,1600,896,393,295
29,NEAMŢ,"MUNICIPIUL PIATRA-NEAMŢ",120726,PIATRA-NEAMŢ,"GRĂDINIȚA CUPLATĂ CU CREŞĂ NR.5",15,"Alegeri Prezidentiale",1,1405,651,633,18,0,635,16,1500,849,378,257
29,NEAMŢ,"MUNICIPIUL PIATRA-NEAMŢ",120726,PIATRA-NEAMŢ,"GRĂDINIȚA CUPLATĂ CU CREŞĂ NR.5",16,"Alegeri Prezidentiale",1,1046,428,408,20,0,419,9,1100,672,252,167
29,NEAMŢ,"MUNICIPIUL PIATRA-NEAMŢ",120726,PIATRA-NEAMŢ,"GRĂDINIȚA CU PROGRAM PRELUNGIT NR.8",17,"Alegeri Prezidentiale",1,920,396,371,25,0,386,10,1000,604,228,158
29,NEAMŢ,"MUNICIPIUL PIATRA-NEAMŢ",120726,PIATRA-NEAMŢ,"GRĂDINIȚA CU PROGRAM NORMAL OCOL",18,"Alegeri Prezidentiale",1,1853,976,884,75,17,950,26,2000,1024,638,312
29,NEAMŢ,"MUNICIPIUL PIATRA-NEAMŢ",120726,PIATRA-NEAMŢ,"ASE BUCUREȘTI",19,"Alegeri Prezidentiale",1,1456,608,554,54,0,591,17,1600,992,376,215
29,NEAMŢ,"MUNICIPIUL PIATRA-NEAMŢ",120726,PIATRA-NEAMŢ,"ȘCOALA GIMNAZIALĂ NR.11",20,"Alegeri Prezidentiale",2,1448,621,580,40,1,610,11,1600,979,384,226
29,NEAMŢ,"MUNICIPIUL PIATRA-NEAMŢ",120726,PIATRA-NEAMŢ,"COLEGIUL NAȚIONAL ”GH. ASACHI”",21,"Alegeri Prezidentiale",1,945,346,314,32,0,342,4,1000,654,215,127
29,NEAMŢ,"MUNICIPIUL PIATRA-NEAMŢ",120726,PIATRA-NEAMŢ,"COLEGIUL NAȚIONAL ”GH. ASACHI”",22,"Alegeri Prezidentiale",1,1051,375,356,19,0,365,10,1101,726,263,102
29,NEAMŢ,"MUNICIPIUL PIATRA-NEAMŢ",120726,PIATRA-NEAMŢ,"ŞCOALA GIMNAZIALĂ NR.5",23,"Alegeri Prezidentiale",1,1508,609,560,49,0,597,12,1600,991,371,226
29,NEAMŢ,"MUNICIPIUL PIATRA-NEAMŢ",120726,PIATRA-NEAMŢ,"ŞCOALA GIMNAZIALĂ NR.5",24,"Alegeri Prezidentiale",1,1395,690,662,27,1,667,23,1500,810,385,282
29,NEAMŢ,"MUNICIPIUL PIATRA-NEAMŢ",120726,PIATRA-NEAMŢ,"GRĂDINIŢA CU PROGRAM PRELUNGIT NR.12",25,"Alegeri Prezidentiale",1,1340,601,573,27,1,581,20,1501,900,354,227
29,NEAMŢ,"MUNICIPIUL PIATRA-NEAMŢ",120726,PIATRA-NEAMŢ,"GRĂDINIŢA CU PROGRAM PRELUNGIT NR.12",26,"Alegeri Prezidentiale",1,1242,559,535,24,0,550,9,1400,841,349,201
29,NEAMŢ,"MUNICIPIUL PIATRA-NEAMŢ",120726,PIATRA-NEAMŢ,"GRĂDINIŢA CU PROGRAM PRELUNGIT NR.12",27,"Alegeri Prezidentiale",1,1343,574,557,17,0,557,17,1500,926,354,203
29,NEAMŢ,"MUNICIPIUL PIATRA-NEAMŢ",120726,PIATRA-NEAMŢ,"CENTRUL SOCIAL PIETRICICA",28,"Alegeri Prezidentiale",1,1578,726,681,43,2,707,19,1700,974,424,283
29,NEAMŢ,"MUNICIPIUL PIATRA-NEAMŢ",120726,PIATRA-NEAMŢ,"COLEGIUL NAȚIONAL DE INFORMATICĂ",29,"Alegeri Prezidentiale",1,1503,640,613,27,0,621,19,1600,960,441,180
29,NEAMŢ,"MUNICIPIUL PIATRA-NEAMŢ",120726,PIATRA-NEAMŢ,"COLEGIUL NAȚIONAL DE INFORMATICĂ",30,"Alegeri Prezidentiale",1,1521,760,723,37,0,722,38,1700,940,533,189
29,NEAMŢ,"MUNICIPIUL PIATRA-NEAMŢ",120726,PIATRA-NEAMŢ,"COLEGIUL NAȚIONAL DE INFORMATICĂ",31,"Alegeri Prezidentiale",1,1652,720,690,30,0,698,22,1800,1080,428,270
29,NEAMŢ,"MUNICIPIUL PIATRA-NEAMŢ",120726,PIATRA-NEAMŢ,"COLEGIUL NAȚIONAL DE INFORMATICĂ",32,"Alegeri Prezidentiale",1,1374,689,646,43,0,664,25,1500,811,426,238
29,NEAMŢ,"MUNICIPIUL PIATRA-NEAMŢ",120726,PIATRA-NEAMŢ,"COLEGIUL NAȚIONAL DE INFORMATICĂ",33,"Alegeri Prezidentiale",1,1024,340,321,19,0,329,11,1100,760,228,101
29,NEAMŢ,"MUNICIPIUL PIATRA-NEAMŢ",120726,PIATRA-NEAMŢ,"COLEGIUL NAȚIONAL DE INFORMATICĂ",34,"Alegeri Prezidentiale",1,907,400,385,15,0,380,20,1000,600,244,136
29,NEAMŢ,"MUNICIPIUL PIATRA-NEAMŢ",120726,PIATRA-NEAMŢ,"ŞCOALA GIMNAZIALĂ NR.7",35,"Alegeri Prezidentiale",1,1640,627,604,23,0,616,11,1800,1173,402,214
29,NEAMŢ,"MUNICIPIUL PIATRA-NEAMŢ",120726,PIATRA-NEAMŢ,"CENTRUL SOCIAL - CARTIER SPERANŢA",36,"Alegeri Prezidentiale",1,931,418,384,34,0,409,9,1000,582,307,102
29,NEAMŢ,"MUNICIPIUL PIATRA-NEAMŢ",120726,PIATRA-NEAMŢ,"CLĂDIRE ADMINISTRATIVĂ S.C. CMI URBAN S.A. (ŞTRAND MUNICIPAL)",37,"Alegeri Prezidentiale",1,730,316,295,21,0,309,7,800,484,227,82
29,NEAMŢ,"MUNICIPIUL PIATRA-NEAMŢ",120726,PIATRA-NEAMŢ,"ȘCOALA GIMNAZIALĂ NR.2",38,"Alegeri Prezidentiale",1,1032,563,474,51,38,546,17,1200,637,319,227
29,NEAMŢ,"MUNICIPIUL PIATRA-NEAMŢ",120726,PIATRA-NEAMŢ,"ȘCOALA GIMNAZIALĂ NR.2",39,"Alegeri Prezidentiale",1,927,520,444,35,41,506,14,1100,580,334,172
29,NEAMŢ,"MUNICIPIUL PIATRA-NEAMŢ",120726,PIATRA-NEAMŢ,"ȘCOALA GIMNAZIALĂ NR.2",40,"Alegeri Prezidentiale",1,876,522,460,28,34,502,20,1100,578,243,259
29,NEAMŢ,"MUNICIPIUL PIATRA-NEAMŢ",120726,PIATRA-NEAMŢ,"ŞCOALA GIMNAZIALĂ NR.2",41,"Alegeri Prezidentiale",1,1136,625,546,40,39,605,20,1300,675,347,258
29,NEAMŢ,"MUNICIPIUL PIATRA-NEAMŢ",120726,PIATRA-NEAMŢ,"ŞCOALA GIMNAZIALĂ NR.2",42,"Alegeri Prezidentiale",1,1349,641,579,25,37,617,24,1600,959,352,265
29,NEAMŢ,"MUNICIPIUL PIATRA-NEAMŢ",120726,PIATRA-NEAMŢ,"DIRECȚIA AGRICOLĂ",43,"Alegeri Prezidentiale",1,1332,702,656,46,0,684,18,1500,798,402,282
29,NEAMŢ,"MUNICIPIUL PIATRA-NEAMŢ",120726,PIATRA-NEAMŢ,"S.C. APA SERV S.A.",44,"Alegeri Prezidentiale",1,1139,572,536,36,0,555,17,1200,628,349,206
29,NEAMŢ,"MUNICIPIUL PIATRA-NEAMŢ",120726,PIATRA-NEAMŢ,"COMPLEXUL EXPOZIȚIONAL MUNICIPAL",45,"Alegeri Prezidentiale",1,1367,806,672,133,1,785,21,1500,694,494,291
29,NEAMŢ,"MUNICIPIUL PIATRA-NEAMŢ",120726,PIATRA-NEAMŢ,"ȘCOALA GIMNAZIALĂ ”ELENA CUZA”",46,"Alegeri Prezidentiale",1,1419,744,673,71,0,727,17,1600,856,461,266
29,NEAMŢ,"MUNICIPIUL PIATRA-NEAMŢ",120726,PIATRA-NEAMŢ,"ȘCOALA GIMNAZIALĂ ”ELENA CUZA”",47,"Alegeri Prezidentiale",1,1355,691,641,50,0,675,16,1500,809,421,254
29,NEAMŢ,"MUNICIPIUL PIATRA-NEAMŢ",120726,PIATRA-NEAMŢ,"ŞCOALA GIMNAZIALĂ ”NICU ALBU”",48,"Alegeri Prezidentiale",1,1205,606,504,102,0,589,17,1300,694,413,176
29,NEAMŢ,"MUNICIPIUL PIATRA-NEAMŢ",120726,PIATRA-NEAMŢ,"ŞCOALA GIMNAZIALĂ ”NICU ALBU”",49,"Alegeri Prezidentiale",1,1347,633,586,47,0,610,23,1500,867,419,191
29,NEAMŢ,"MUNICIPIUL PIATRA-NEAMŢ",120726,PIATRA-NEAMŢ,"ŞCOALA GIMNAZIALĂ ”NICU ALBU”",50,"Alegeri Prezidentiale",1,1206,525,501,24,0,514,11,1300,775,341,173
29,NEAMŢ,"MUNICIPIUL PIATRA-NEAMŢ",120726,PIATRA-NEAMŢ,"ŞCOALA GIMNAZIALĂ ”NICU ALBU”",51,"Alegeri Prezidentiale",1,1345,605,586,19,0,591,14,1500,895,390,201
29,NEAMŢ,"MUNICIPIUL PIATRA-NEAMŢ",120726,PIATRA-NEAMŢ,"ŞCOALA GIMNAZIALĂ ”NICU ALBU”",52,"Alegeri Prezidentiale",1,1375,578,560,18,0,558,20,1500,922,386,172
29,NEAMŢ,"MUNICIPIUL PIATRA-NEAMŢ",120726,PIATRA-NEAMŢ,"ŞCOALA GIMNAZIALĂ ”NICU ALBU”",53,"Alegeri Prezidentiale",1,1371,625,594,31,0,618,7,1500,875,372,246
29,NEAMŢ,"MUNICIPIUL PIATRA-NEAMŢ",120726,PIATRA-NEAMŢ,"CASA CORPULUI DIDACTIC",54,"Alegeri Prezidentiale",1,1277,624,586,37,1,611,13,1400,776,401,210
29,NEAMŢ,"MUNICIPIUL PIATRA-NEAMŢ",120726,PIATRA-NEAMŢ,"COLEGIUL TEHNIC DE TRANSPORTURI",55,"Alegeri Prezidentiale",1,1181,525,476,28,21,512,13,1300,775,330,182
29,NEAMŢ,"MUNICIPIUL PIATRA-NEAMŢ",120726,PIATRA-NEAMŢ,"COLEGIUL TEHNIC FORESTIER",56,"Alegeri Prezidentiale",1,1247,544,510,34,0,532,12,1399,855,346,186
29,NEAMŢ,"MUNICIPIUL PIATRA-NEAMŢ",120726,PIATRA-NEAMŢ,"COLEGIUL TEHNIC FORESTIER",57,"Alegeri Prezidentiale",1,1321,690,656,34,0,674,16,1400,710,442,232
29,NEAMŢ,"MUNICIPIUL PIATRA-NEAMŢ",120726,PIATRA-NEAMŢ,"LICEUL TEHNOLOGIC ECONOMIC ADMINISTRATIV",58,"Alegeri Prezidentiale",1,1397,722,683,38,1,697,25,1500,778,461,236
29,NEAMŢ,"MUNICIPIUL PIATRA-NEAMŢ",120726,PIATRA-NEAMŢ,"COLEGIUL TEHNIC ”GHEORGHE CARTIANU”",59,"Alegeri Prezidentiale",1,1375,704,673,31,0,677,27,1500,796,409,268
29,NEAMŢ,"MUNICIPIUL PIATRA-NEAMŢ",120726,PIATRA-NEAMŢ,"COLEGIUL TEHNIC ”GHEORGHE CARTIANU”",60,"Alegeri Prezidentiale",1,901,454,398,56,0,440,14,1000,546,312,128
29,NEAMŢ,"MUNICIPIUL PIATRA-NEAMŢ",120726,PIATRA-NEAMŢ,"COLEGIUL TEHNIC ”GHEORGHE CARTIANU”",61,"Alegeri Prezidentiale",1,1286,622,598,24,0,608,14,1400,778,387,221
29,NEAMŢ,"MUNICIPIUL PIATRA-NEAMŢ",120726,PIATRA-NEAMŢ,"COLEGIUL TEHNIC ”GHEORGHE CARTIANU”",62,"Alegeri Prezidentiale",1,1313,452,438,14,0,439,13,1400,948,286,153
29,NEAMŢ,"MUNICIPIUL PIATRA-NEAMŢ",120726,PIATRA-NEAMŢ,"ŞCOALA GIMNAZIALĂ NR.1",63,"Alegeri Prezidentiale",1,1798,905,827,78,0,879,26,2000,1095,601,278
29,NEAMŢ,"MUNICIPIUL PIATRA-NEAMŢ",120726,PIATRA-NEAMŢ,"GRĂDINIȚA CU PROGRAM NORMAL NR.19",64,"Alegeri Prezidentiale",1,796,423,394,29,0,409,14,900,477,275,134
29,NEAMŢ,"MUNICIPIUL PIATRA-NEAMŢ",120726,PIATRA-NEAMŢ,"LICEUL TEHNOLOGIC ”DIMITRIE LEONIDA”",65,"Alegeri Prezidentiale",1,1393,641,606,35,0,622,19,1500,859,406,216
29,NEAMŢ,"MUNICIPIUL PIATRA-NEAMŢ",120726,PIATRA-NEAMŢ,"LICEUL TEHNOLOGIC ”DIMITRIE LEONIDA”",66,"Alegeri Prezidentiale",1,1265,561,536,25,0,540,21,1400,839,288,252
29,NEAMŢ,"MUNICIPIUL PIATRA-NEAMŢ",120726,PIATRA-NEAMŢ,"LICEUL TEHNOLOGIC ”DIMITRIE LEONIDA” CORP B",67,"Alegeri Prezidentiale",2,1062,518,485,33,0,504,14,1192,674,382,122
29,NEAMŢ,"MUNICIPIUL PIATRA-NEAMŢ",120726,PIATRA-NEAMŢ,"ȘCOALA GIMNAZIALĂ ”DANIELA CUCIUC”",68,"Alegeri Prezidentiale",1,1765,693,654,39,0,672,21,1900,1207,461,211
29,NEAMŢ,"MUNICIPIUL PIATRA-NEAMŢ",120726,PIATRA-NEAMŢ,"ȘCOALA GIMNAZIALĂ ”DANIELA CUCIUC”",69,"Alegeri Prezidentiale",1,993,458,423,35,0,446,12,1101,643,272,174
29,NEAMŢ,"MUNICIPIUL PIATRA-NEAMŢ",120726,PIATRA-NEAMŢ,"ȘCOALA GIMNAZIALĂ ”DANIELA CUCIUC”",70,"Alegeri Prezidentiale",1,1229,558,538,20,0,547,11,1301,743,362,185
29,NEAMŢ,"MUNICIPIUL PIATRA-NEAMŢ",120726,PIATRA-NEAMŢ,"ȘCOALA GIMNAZIALĂ ”DANIELA CUCIUC”",71,"Alegeri Prezidentiale",1,905,460,443,17,0,443,17,1000,540,284,159
29,NEAMŢ,"MUNICIPIUL PIATRA-NEAMŢ",120726,PIATRA-NEAMŢ,"ȘCOALA GIMNAZIALĂ ”DANIELA CUCIUC”",72,"Alegeri Prezidentiale",3,1718,643,589,54,0,625,18,1900,1257,441,184
29,NEAMŢ,"MUNICIPIUL PIATRA-NEAMŢ",120726,PIATRA-NEAMŢ,"GRĂDINIŢA CU PROGRAM PRELUNGIT ”FLOARE DE COLŢ”",73,"Alegeri Prezidentiale",1,1516,655,619,36,0,637,18,1700,1045,437,200
29,NEAMŢ,"MUNICIPIUL PIATRA-NEAMŢ",120726,PIATRA-NEAMŢ,"GRĂDINIŢA CU PROGRAM PRELUNGIT ”FLOARE DE COLŢ”",74,"Alegeri Prezidentiale",1,1264,558,517,41,0,547,11,1400,842,341,206
29,NEAMŢ,"MUNICIPIUL PIATRA-NEAMŢ",120726,PIATRA-NEAMŢ,"GRĂDINIŢA CU PROGRAM NORMAL NR.1",75,"Alegeri Prezidentiale",1,1528,770,734,36,0,753,17,1700,930,460,293
29,NEAMŢ,"MUNICIPIUL ROMAN",120860,ROMAN,"COLEGIUL NAŢIONAL ”ROMAN VODĂ” - CORP A",76,"Alegeri Prezidentiale",1,1256,588,512,76,0,578,10,1400,812,345,233
29,NEAMŢ,"MUNICIPIUL ROMAN",120860,ROMAN,"GRĂDINIŢA DE COPII NR. 2 CU PROGRAM PRELUNGIT",77,"Alegeri Prezidentiale",1,1190,734,596,42,96,719,15,1300,566,363,356
29,NEAMŢ,"MUNICIPIUL ROMAN",120860,ROMAN,"GRĂDINIŢA DE COPII NR. 6 CU PROGRAM PRELUNGIT",78,"Alegeri Prezidentiale",1,1249,617,591,26,0,602,15,1400,783,329,273
29,NEAMŢ,"MUNICIPIUL ROMAN",120860,ROMAN,"ŞCOALA GIMNAZIALĂ ”CALISTRAT HOGAŞ”",79,"Alegeri Prezidentiale",1,1704,621,561,60,0,603,18,1900,1279,362,241
29,NEAMŢ,"MUNICIPIUL ROMAN",120860,ROMAN,"ŞCOALA GIMNAZIALĂ ”CALISTRAT HOGAŞ”",80,"Alegeri Prezidentiale",1,1157,436,392,43,1,426,10,1300,864,270,156
29,NEAMŢ,"MUNICIPIUL ROMAN",120860,ROMAN,"ŞCOALA GIMNAZIALĂ ”CALISTRAT HOGAŞ”",81,"Alegeri Prezidentiale",1,1915,503,459,44,0,492,11,2099,1596,325,167
29,NEAMŢ,"MUNICIPIUL ROMAN",120860,ROMAN,"CENTRUL DE PERMANENŢĂ DE LA DISPENSARUL MEDICAL NR. 6",82,"Alegeri Prezidentiale",1,1267,489,464,25,0,479,10,1401,912,298,181
29,NEAMŢ,"MUNICIPIUL ROMAN",120860,ROMAN,"AGENŢIA PENTRU PROTECŢIA MEDIULUI",83,"Alegeri Prezidentiale",1,1287,507,483,24,0,490,17,1400,893,288,202
29,NEAMŢ,"MUNICIPIUL ROMAN",120860,ROMAN,"GRĂDINIŢA DE COPII NR. 6 CU PROGRAM NORMAL",84,"Alegeri Prezidentiale",1,1382,612,584,28,0,601,11,1500,888,396,205
29,NEAMŢ,"MUNICIPIUL ROMAN",120860,ROMAN,"LICEUL TEHNOLOGIC „VASILE SAV”",85,"Alegeri Prezidentiale",1,1104,490,437,53,0,476,14,1200,710,252,224
29,NEAMŢ,"MUNICIPIUL ROMAN",120860,ROMAN,"LICEUL TEHNOLOGIC „VASILE SAV”",86,"Alegeri Prezidentiale",1,1042,402,390,12,0,395,7,1101,699,253,142
29,NEAMŢ,"MUNICIPIUL ROMAN",120860,ROMAN,"CIRCUMSCRIPTIA SANITAR VETERINARA",87,"Alegeri Prezidentiale",1,1238,375,352,23,0,366,9,1400,1025,179,187
29,NEAMŢ,"MUNICIPIUL ROMAN",120860,ROMAN,"ŞCOALA GIMNAZIALĂ ”CAROL I”",88,"Alegeri Prezidentiale",1,1441,637,586,51,0,619,18,1600,963,347,272
29,NEAMŢ,"MUNICIPIUL ROMAN",120860,ROMAN,"ŞCOALA GIMNAZIALĂ ”CAROL I”",89,"Alegeri Prezidentiale",1,1387,659,604,55,0,642,17,1500,841,404,238
29,NEAMŢ,"MUNICIPIUL ROMAN",120860,ROMAN,"ŞCOALA DE ARTĂ ”SERGIU CELIBIDACHE” - CORP A",90,"Alegeri Prezidentiale",1,1314,534,499,35,0,516,18,1400,866,298,218
29,NEAMŢ,"MUNICIPIUL ROMAN",120860,ROMAN,"ŞCOALA DE ARTĂ ”SERGIU CELIBIDACHE” - CORP A",91,"Alegeri Prezidentiale",1,1386,644,607,36,1,628,16,1500,856,356,272
29,NEAMŢ,"MUNICIPIUL ROMAN",120860,ROMAN,"ŞCOALA DE ARTĂ ”SERGIU CELIBIDACHE” - CORP B",92,"Alegeri Prezidentiale",1,1414,605,580,25,0,582,23,1500,895,324,258
29,NEAMŢ,"MUNICIPIUL ROMAN",120860,ROMAN,"GRĂDINIŢA DE COPII NR. 4 CU PROGRAM NORMAL",93,"Alegeri Prezidentiale",1,1393,618,594,24,0,606,12,1500,882,340,266
29,NEAMŢ,"MUNICIPIUL ROMAN",120860,ROMAN,"GRĂDINIŢA DE COPII NR. 5 CU PROGRAM PRELUNGIT",94,"Alegeri Prezidentiale",1,1540,759,728,31,0,747,12,1700,941,436,311
29,NEAMŢ,"MUNICIPIUL ROMAN",120860,ROMAN,"CREŞA SMIRODAVA",95,"Alegeri Prezidentiale",1,1378,598,556,41,1,575,23,1500,902,317,258
29,NEAMŢ,"MUNICIPIUL ROMAN",120860,ROMAN,"GRĂDINIŢA DE COPII NR. 1 CU PROGRAM PRELUNGIT",96,"Alegeri Prezidentiale",1,1393,574,552,22,0,562,12,1501,927,335,227
29,NEAMŢ,"MUNICIPIUL ROMAN",120860,ROMAN,"GRĂDINIŢA DE COPII NR. 1 CU PROGRAM PRELUNGIT",97,"Alegeri Prezidentiale",1,1421,581,560,21,0,562,19,1600,1019,336,226
29,NEAMŢ,"MUNICIPIUL ROMAN",120860,ROMAN,"ŞCOALA GIMNAZIALĂ ”MIHAI EMINESCU”",98,"Alegeri Prezidentiale",1,1382,662,617,45,0,639,23,1501,839,367,272
29,NEAMŢ,"MUNICIPIUL ROMAN",120860,ROMAN,"COLEGIUL TEHNIC „MIRON COSTIN”",99,"Alegeri Prezidentiale",1,1283,380,345,35,0,369,11,1400,1020,248,121
29,NEAMŢ,"MUNICIPIUL ROMAN",120860,ROMAN,"LICEUL CU PROGRAM SPORTIV",100,"Alegeri Prezidentiale",1,1110,479,455,24,0,463,16,1200,721,252,211
29,NEAMŢ,"MUNICIPIUL ROMAN",120860,ROMAN,"ŞCOALA GIMNAZIALĂ ”VASILE ALECSANDRI” - LOCAL VECHI",101,"Alegeri Prezidentiale",1,1232,567,539,28,0,553,14,1300,733,312,241
29,NEAMŢ,"MUNICIPIUL ROMAN",120860,ROMAN,"ŞCOALA GIMNAZIALĂ ”VASILE ALECSANDRI” - LOCAL NOU",102,"Alegeri Prezidentiale",1,1427,590,539,50,1,575,15,1600,1010,350,225
29,NEAMŢ,"MUNICIPIUL ROMAN",120860,ROMAN,"CENTRUL DE ÎNGRIJIRE ŞI ASISTENŢĂ BĂTRÂNI (DISPENSAR 7)",103,"Alegeri Prezidentiale",1,1753,919,873,46,0,900,19,1900,981,585,315
29,NEAMŢ,"MUNICIPIUL ROMAN",120860,ROMAN,"DIRECŢIA DE ASISTENŢĂ SOCIALĂ ROMAN",104,"Alegeri Prezidentiale",1,1061,476,447,29,0,464,12,1200,724,264,200
29,NEAMŢ,"MUNICIPIUL ROMAN",120860,ROMAN,"LICEUL TEOLOGIC „EPISCOP MELCHISEDEC”",105,"Alegeri Prezidentiale",1,1323,597,543,54,0,584,13,1400,803,354,230
29,NEAMŢ,"MUNICIPIUL ROMAN",120860,ROMAN,"ŞCOALA GIMNAZIALĂ ”ROMAN MUŞAT”",106,"Alegeri Prezidentiale",1,1328,519,497,22,0,512,7,1501,982,328,184
29,NEAMŢ,"MUNICIPIUL ROMAN",120860,ROMAN,"ŞCOALA GIMNAZIALĂ ”ROMAN MUŞAT”",107,"Alegeri Prezidentiale",1,1239,471,447,24,0,460,11,1300,829,283,177
29,NEAMŢ,"MUNICIPIUL ROMAN",120860,ROMAN,"ŞCOALA GIMNAZIALĂ ”ROMAN MUŞAT”",108,"Alegeri Prezidentiale",1,1404,582,531,51,0,564,18,1500,918,384,180
29,NEAMŢ,"MUNICIPIUL ROMAN",120860,ROMAN,"GRĂDINIŢA DE COPII NR. 5 CU PROGRAM NORMAL",109,"Alegeri Prezidentiale",1,1514,715,671,44,0,701,14,1600,885,416,285
29,NEAMŢ,"MUNICIPIUL ROMAN",120860,ROMAN,"ŞCOALA GIMNAZIALĂ ”COSTACHE NEGRI” - LOCAL NOU",110,"Alegeri Prezidentiale",1,967,403,375,28,0,393,10,1100,697,243,150
29,NEAMŢ,"MUNICIPIUL ROMAN",120860,ROMAN,"ŞCOALA GIMNAZIALĂ ”COSTACHE NEGRI” - LOCAL NOU",111,"Alegeri Prezidentiale",1,1457,618,598,20,0,594,24,1600,982,324,270
29,NEAMŢ,"MUNICIPIUL ROMAN",120860,ROMAN,"COLEGIUL TEHNIC „PETRU PONI” - CORP A",112,"Alegeri Prezidentiale",1,1233,567,461,106,0,553,14,1300,733,381,172
29,NEAMŢ,"MUNICIPIUL ROMAN",120860,ROMAN,"COLEGIUL TEHNIC „PETRU PONI” - CORP B",113,"Alegeri Prezidentiale",1,1461,734,692,42,0,717,17,1600,866,420,297
29,NEAMŢ,"MUNICIPIUL ROMAN",120860,ROMAN,"ŞCOALA GIMNAZIALĂ „ALEXANDRU IOAN CUZA”(ŞCOALA NR. 5)",114,"Alegeri Prezidentiale",1,1551,726,671,55,0,709,17,1700,974,442,267
29,NEAMŢ,"MUNICIPIUL ROMAN",120860,ROMAN,"ŞCOALA GIMNAZIALĂ „ALEXANDRU IOAN CUZA”(ŞCOALA NR. 5)",115,"Alegeri Prezidentiale",1,1299,587,554,33,0,578,9,1400,813,372,206
29,NEAMŢ,"MUNICIPIUL ROMAN",120860,ROMAN,"ŞCOALA GIMNAZIALĂ „ALEXANDRU IOAN CUZA” CORP C(GRĂDINIŢA DE COPII NR. 3 CU PROGRAM PRELUNGIT)",116,"Alegeri Prezidentiale",1,1302,646,581,65,0,626,20,1401,755,381,245
29,NEAMŢ,"MUNICIPIUL ROMAN",120860,ROMAN,"ŞCOALA GIMNAZIALĂ „ALEXANDRU IOAN CUZA” CORP B(GRĂDINIŢA DE COPII NR. 12 CU PROGRAM NORMAL)",117,"Alegeri Prezidentiale",1,1243,551,507,44,0,529,22,1400,849,353,176
29,NEAMŢ,"MUNICIPIUL ROMAN",120860,ROMAN,"COLEGIUL TEHNIC „DANUBIANA”",118,"Alegeri Prezidentiale",1,1351,532,476,56,0,511,21,1500,968,309,202
29,NEAMŢ,"ORAŞ BICAZ",120968,BICAZ,"PRIMARIA ORASULUI BICAZ",119,"Alegeri Prezidentiale",1,1176,598,502,96,0,587,11,1300,702,315,272
29,NEAMŢ,"ORAŞ BICAZ",120968,BICAZ,"SCOALA GENERALA NR. 1 MARCENI",120,"Alegeri Prezidentiale",1,762,382,345,35,2,372,10,800,418,204,168
29,NEAMŢ,"ORAŞ BICAZ",120968,BICAZ,"SCOALA GENERALA NR. 1 MARCENI",121,"Alegeri Prezidentiale",1,1196,468,440,28,0,454,14,1300,832,260,194
29,NEAMŢ,"ORAŞ BICAZ",120968,CAPŞA,"LICEUL CAROL I",122,"Alegeri Prezidentiale",1,1077,505,456,49,0,490,15,1200,695,273,217
29,NEAMŢ,"ORAŞ BICAZ",120968,DODENI,"SCOALA GENERALA NR.2 DODENI",123,"Alegeri Prezidentiale",1,964,353,337,16,0,344,9,1100,747,209,135
29,NEAMŢ,"ORAŞ BICAZ",120968,DODENI,"SCOALA GENERALA NR.2 DODENI",124,"Alegeri Prezidentiale",1,1038,360,335,10,15,355,5,1100,740,217,138
29,NEAMŢ,"ORAŞ BICAZ",120968,"IZVORU MUNTELUI","CENTRUL CULTURAL IZVORU MUNTELUI",125,"Alegeri Prezidentiale",1,402,262,206,56,0,255,7,500,238,158,97
29,NEAMŢ,"ORAŞ BICAZ",120968,"IZVORU ALB","SCOALA GENERALA NR.1 MARCENI",126,"Alegeri Prezidentiale",1,124,76,53,23,0,74,2,200,124,32,42
29,NEAMŢ,"ORAŞ BICAZ",120968,POTOCI,"SCOALA GENERALA NR.1 MARCENI",127,"Alegeri Prezidentiale",1,210,100,83,17,0,96,4,300,200,45,51
29,NEAMŢ,"ORAŞ BICAZ",120968,SECU,"SCOALA GENERALA NR.1 MARCENI",128,"Alegeri Prezidentiale",1,67,39,28,11,0,39,0,100,61,26,13
29,NEAMŢ,"ORAŞ ROZNOV",124117,ROZNOV,"ȘCOALA GENERALĂ ROZNOV",129,"Alegeri Prezidentiale",1,1721,775,663,112,0,753,22,1900,1125,418,335
29,NEAMŢ,"ORAŞ ROZNOV",124117,ROZNOV,"GARA ROZNOV",130,"Alegeri Prezidentiale",1,1529,701,645,56,0,682,19,1700,999,409,273
29,NEAMŢ,"ORAŞ ROZNOV",124117,ROZNOV,"CĂMINUL PENTRU PERSOANE VÂRSTNICE ROZNOV",131,"Alegeri Prezidentiale",1,1345,642,532,103,7,632,10,1501,859,403,229
29,NEAMŢ,"ORAŞ ROZNOV",124117,CHINTINICI,"ȘCOALA GENERALĂ CHINTINICI",132,"Alegeri Prezidentiale",1,965,399,366,33,0,394,5,1100,701,248,146
29,NEAMŢ,"ORAŞ ROZNOV",124117,SLOBOZIA,"DISPENSAR MEDICAL SLOBOZIA",133,"Alegeri Prezidentiale",1,1430,631,589,42,0,619,12,1600,969,414,205
29,NEAMŢ,"ORAŞ ROZNOV",124117,SLOBOZIA,"ȘCOALA GENERALĂ SLOBOZIA",134,"Alegeri Prezidentiale",1,1339,645,559,86,0,629,16,1500,855,356,273
29,NEAMŢ,"ORAŞ TÂRGU-NEAMŢ",121055,TÂRGU-NEAMŢ,"SALA DE SPORT PARC CETATE",135,"Alegeri Prezidentiale",1,783,463,388,75,0,448,15,900,437,237,211
29,NEAMŢ,"ORAŞ TÂRGU-NEAMŢ",121055,TÂRGU-NEAMŢ,"GRĂDINIŢA CU PROGRAM PRELUNGIT NR.2",136,"Alegeri Prezidentiale",1,517,353,226,21,106,339,14,600,247,173,166
29,NEAMŢ,"ORAŞ TÂRGU-NEAMŢ",121055,TÂRGU-NEAMŢ,"SCOALA GIMNAZIALĂ DOMNEASCĂ ”GRIGORE GHICA VODĂ”",137,"Alegeri Prezidentiale",1,1701,843,775,66,2,819,24,1901,1058,438,381
29,NEAMŢ,"ORAŞ TÂRGU-NEAMŢ",121055,TÂRGU-NEAMŢ,"LICEUL ”VASILE CONTA”",138,"Alegeri Prezidentiale",1,1679,771,694,77,0,754,17,1800,1029,391,363
29,NEAMŢ,"ORAŞ TÂRGU-NEAMŢ",121055,TÂRGU-NEAMŢ,"COLEGIUL NAŢIONAL ”ŞTEFAN CEL MARE”, CORP B, SALA 1",139,"Alegeri Prezidentiale",1,1640,728,663,65,0,708,20,1801,1073,360,348
29,NEAMŢ,"ORAŞ TÂRGU-NEAMŢ",121055,TÂRGU-NEAMŢ,"COLEGIUL NAŢIONAL ”ŞTEFAN CEL MARE”, CORP B, SALA 2 (FOSTA SECŢIE DE LA CASA CULTURII)",140,"Alegeri Prezidentiale",1,1649,773,743,30,0,748,25,1801,1028,362,386
29,NEAMŢ,"ORAŞ TÂRGU-NEAMŢ",121055,TÂRGU-NEAMŢ,"COLEGIUL NAŢIONAL ”ŞTEFAN CEL MARE”, CORP A, SALA 1",141,"Alegeri Prezidentiale",1,1900,935,875,60,0,908,27,2100,1165,482,426
29,NEAMŢ,"ORAŞ TÂRGU-NEAMŢ",121055,TÂRGU-NEAMŢ,"CLUBUL COPIILOR",142,"Alegeri Prezidentiale",1,1810,845,797,48,0,824,21,2000,1155,431,393
29,NEAMŢ,"ORAŞ TÂRGU-NEAMŢ",121055,TÂRGU-NEAMŢ,"COLEGIUL TEHNIC ”ION CREANGĂ”, CORP B",143,"Alegeri Prezidentiale",1,604,301,279,22,0,291,10,701,400,165,126
29,NEAMŢ,"ORAŞ TÂRGU-NEAMŢ",121055,TÂRGU-NEAMŢ,"COLEGIUL TEHNIC ”ION CREANGĂ”, CORP B",144,"Alegeri Prezidentiale",1,1616,596,564,32,0,569,27,1701,1105,291,278
29,NEAMŢ,"ORAŞ TÂRGU-NEAMŢ",121055,TÂRGU-NEAMŢ,"CĂMINUL CULTURAL LOC.BLEBEA",145,"Alegeri Prezidentiale",1,672,306,286,20,0,296,10,701,395,148,148
29,NEAMŢ,"ORAŞ TÂRGU-NEAMŢ",121055,TÂRGU-NEAMŢ,"ŞCOALA GIMNAZIALĂ ”ION CREANGĂ”, CORP B, LOC. HUMULEŞTI",146,"Alegeri Prezidentiale",1,1573,721,693,28,0,705,16,1700,979,322,383
29,NEAMŢ,"ORAŞ TÂRGU-NEAMŢ",121055,TÂRGU-NEAMŢ,"ŞCOALA GIMNAZIALĂ ”ION CREANGĂ”, CORP A, LOC. HUMULEŞTI",147,"Alegeri Prezidentiale",1,1697,779,739,40,0,757,22,1900,1121,445,312
29,NEAMŢ,"ORAŞ TÂRGU-NEAMŢ",121055,TÂRGU-NEAMŢ,"ŞCOALA GIMNAZIALĂ ”ION CREANGĂ”, CORP A1, LOC. HUMULEŞTI",148,"Alegeri Prezidentiale",1,488,212,166,46,0,206,6,500,288,102,104
29,NEAMŢ,AGAPIA,121108,AGAPIA,"ŞCOALA GIMNAZIALĂ NICOLAE GRIGORESCU AGAPIA",149,"Alegeri Prezidentiale",1,1452,664,592,72,0,642,22,1600,936,268,374
29,NEAMŢ,AGAPIA,121108,FILIOARA,"ŞCOALA GIMNAZIALĂ MIHAI EMINESCU FILIOARA",150,"Alegeri Prezidentiale",1,849,405,383,21,1,399,6,900,495,204,195
29,NEAMŢ,AGAPIA,121108,SĂCĂLUŞEŞTI,"ŞCOALA PRIMARĂ SĂCĂLUŞEŞTI",151,"Alegeri Prezidentiale",1,534,270,236,34,0,264,6,601,331,150,114
29,NEAMŢ,AGAPIA,121108,VARATEC,"ŞCOALA NOUĂ VĂRATEC",152,"Alegeri Prezidentiale",1,726,478,373,55,50,457,21,800,322,188,269
29,NEAMŢ,"ALEXANDRU CEL BUN",124938,VIIŞOARA,"SEDIUL S.V.S.U.",153,"Alegeri Prezidentiale",1,931,510,409,101,0,498,12,1000,490,323,175
29,NEAMŢ,"ALEXANDRU CEL BUN",124938,VADURI,"SCOALA GIMNAZIALĂ VADURI",154,"Alegeri Prezidentiale",1,871,449,370,79,0,436,13,900,451,303,133
29,NEAMŢ,"ALEXANDRU CEL BUN",124938,BISTRIŢA,"SCOALA GIMNAZIALĂ VADURI",155,"Alegeri Prezidentiale",1,1837,877,762,115,0,861,16,2000,1123,613,248
29,NEAMŢ,"ALEXANDRU CEL BUN",124938,VĂDURELE,"SCOALA GIMNAZIALĂ VADURI",156,"Alegeri Prezidentiale",1,1119,584,526,58,0,574,10,1200,616,378,196
29,NEAMŢ,"ALEXANDRU CEL BUN",124938,AGÂRCIA,"ȘCOALA GIMNAZIALĂ VADURI (CLĂDIREA FOSTEI ȘCOLI DIN SATUL AGÂRCIA)",157,"Alegeri Prezidentiale",1,282,165,137,28,0,159,6,300,135,111,48
29,NEAMŢ,BAHNA,121153,BAHNA,"CĂMINUL CULTURAL,LOCALITATEA BAHNA",158,"Alegeri Prezidentiale",1,540,228,193,33,2,224,4,600,372,128,96
29,NEAMŢ,BAHNA,121153,BROŞTENI,"GRĂDINIŢĂ CU PROGRAM NORMAL,LOCALITATEA BROŞTENI",159,"Alegeri Prezidentiale",1,379,244,180,52,12,242,2,400,156,140,102
29,NEAMŢ,BAHNA,121153,"ŢUŢCANII DIN VALE","FOSTA ŞCOALA CU CLASELE I-IV,LOCALITATEA ŢUŢCANII DIN VALE",160,"Alegeri Prezidentiale",1,249,163,119,36,8,163,0,300,137,95,68
29,NEAMŢ,BAHNA,121153,BĂHNIŞOARA,"GRĂDINIŢA CU PROGRAM NORMAL,LOCALITATEA BĂHNIŞOARA",161,"Alegeri Prezidentiale",2,366,167,149,18,0,165,2,400,233,99,66
29,NEAMŢ,BAHNA,121153,IZVOARE,"ŞCOALA GIMNAZIALĂ,LOCALITATEA IZVOARE",162,"Alegeri Prezidentiale",1,1067,426,384,40,2,418,8,1200,774,259,159
29,NEAMŢ,BĂLŢĂTEŞTI,121242,BĂLŢĂTEŞTI,"PRIMĂRIA COMUNEI BĂLŢĂTEŞTI",163,"Alegeri Prezidentiale",1,1726,926,769,155,2,905,21,1900,974,541,364
29,NEAMŢ,BĂLŢĂTEŞTI,121242,"VALEA SEACĂ","ŞCOALA GIMNAZIALĂ",164,"Alegeri Prezidentiale",1,1229,511,476,35,0,506,5,1300,789,290,216
29,NEAMŢ,BĂLŢĂTEŞTI,121242,"VALEA ARINI","CASA DE PRĂZNUIRE A PAROHIEI VALEA ARINI",165,"Alegeri Prezidentiale",1,496,189,173,16,0,187,2,600,411,116,71
29,NEAMŢ,BÂRGĂUANI,121466,BÂRGĂUANI,"PRIMĂRIA BÎRGĂUANI",166,"Alegeri Prezidentiale",1,448,192,163,29,0,190,2,500,308,102,88
29,NEAMŢ,BÂRGĂUANI,121466,BÂRGĂUANI,"FOSTA GRĂDINIȚĂ DE COPII BÎRGĂUANI DEAL",167,"Alegeri Prezidentiale",1,474,266,220,46,0,264,2,500,234,98,166
29,NEAMŢ,BÂRGĂUANI,121466,BREAZA,"FOSTA ȘCOALĂ PRIMARĂ BREAZA",168,"Alegeri Prezidentiale",1,171,103,95,8,0,101,2,200,97,38,63
29,NEAMŢ,BÂRGĂUANI,121466,CERTIENI,"FOSTA ȘCOALĂ PRIMARĂ CERTIENI",169,"Alegeri Prezidentiale",2,179,100,73,27,0,98,2,200,100,57,41
29,NEAMŢ,BÂRGĂUANI,121466,HÂRTOP,"CĂMINUL CULTURAL HÎRTOP",170,"Alegeri Prezidentiale",1,186,119,87,32,0,119,0,200,81,60,59
29,NEAMŢ,BÂRGĂUANI,121466,BĂLĂNEŞTI,"ȘCOALA PRIMARĂ BĂLĂNEȘTI",171,"Alegeri Prezidentiale",1,536,231,191,40,0,228,3,600,369,157,71
29,NEAMŢ,BÂRGĂUANI,121466,TALPA,"ȘCOALA PRIMARĂ TALPA",172,"Alegeri Prezidentiale",1,564,266,215,51,0,265,1,600,334,124,141
29,NEAMŢ,BÂRGĂUANI,121466,VLĂDICENI,"FOSTA ȘCOALĂ PRIMARĂ VLĂDICENI",173,"Alegeri Prezidentiale",1,478,221,181,40,0,220,1,500,279,102,118
29,NEAMŢ,BICAZ-CHEI,121297,BICAZ-CHEI,"CAMIN CULTURAL",174,"Alegeri Prezidentiale",1,1133,477,430,47,0,472,5,1200,723,261,211
29,NEAMŢ,BICAZ-CHEI,121297,BICAZ-CHEI,"SCOALA GIMNAZIALA NR. 2",175,"Alegeri Prezidentiale",1,802,359,345,14,0,358,1,900,541,213,145
29,NEAMŢ,BICAZ-CHEI,121297,BICAZ-CHEI,"SCOALA GIMNAZIALA NR.1",176,"Alegeri Prezidentiale",1,1037,468,447,21,0,463,5,1100,632,226,237
29,NEAMŢ,BICAZ-CHEI,121297,IVANEŞ,"SCOALA GIMNAZIALA NR.3",177,"Alegeri Prezidentiale",1,708,374,355,19,0,373,1,800,426,149,224
29,NEAMŢ,"BICAZU ARDELEAN",121340,"BICAZU ARDELEAN","ȘCOALA GIMNAZIALĂ NR. 1",178,"Alegeri Prezidentiale",1,1361,481,449,32,0,469,12,1500,1019,372,97
29,NEAMŢ,"BICAZU ARDELEAN",121340,TELEC,"ŞCOALA GIMNAZIALA NR.2",179,"Alegeri Prezidentiale",1,1090,412,380,32,0,411,1,1200,788,299,112
29,NEAMŢ,"BICAZU ARDELEAN",121340,TELEC,"GRĂDINIȚA CU PROGRAM NORMAL NR. 1",180,"Alegeri Prezidentiale",1,421,204,188,16,0,203,1,500,296,154,49
29,NEAMŢ,"BICAZU ARDELEAN",121340,TICOŞ,"ȘCOALA PRIMARĂ NOUĂ TICOȘ",181,"Alegeri Prezidentiale",1,254,148,118,30,0,147,1,300,152,113,34
29,NEAMŢ,BIRA,121386,BIRA,"CĂMINUL CULTURAL BÎRA",182,"Alegeri Prezidentiale",1,625,284,253,31,0,281,3,700,416,160,121
29,NEAMŢ,BIRA,121386,REDIU,"GRĂDINIȚA REDIU",183,"Alegeri Prezidentiale",1,551,288,262,26,0,286,2,600,312,149,137
29,NEAMŢ,BIRA,121386,REDIU,"SCOALA PRIMARA NR.2 REDIU",184,"Alegeri Prezidentiale",1,231,123,105,18,0,122,1,300,177,41,81
29,NEAMŢ,BIRA,121386,NEGREŞTI,"CLADIRE FOSTA SCOALA PRIMARA",185,"Alegeri Prezidentiale",1,157,99,70,29,0,98,1,200,101,52,46
29,NEAMŢ,BODEŞTI,121607,BODEŞTI,"ŞCOALA CU CLASELE I-IV",186,"Alegeri Prezidentiale",1,891,413,372,41,0,401,12,1000,587,224,177
29,NEAMŢ,BODEŞTI,121607,BODEŞTI,"ŞCOALA CU CLASELE I-IV",187,"Alegeri Prezidentiale",1,873,397,344,53,0,387,10,1000,603,223,164
29,NEAMŢ,BODEŞTI,121607,CORNI,ŞCOALA,188,"Alegeri Prezidentiale",1,112,91,60,31,0,89,2,200,109,33,56
29,NEAMŢ,BODEŞTI,121607,OŞLOBENI,ŞCOALA,189,"Alegeri Prezidentiale",1,770,388,347,41,0,384,4,800,412,207,177
29,NEAMŢ,BODEŞTI,121607,"BODEŞTII DE JOS","GRĂDINIŢĂ - (CĂTUNĂ)",190,"Alegeri Prezidentiale",1,516,269,198,71,0,254,15,600,331,140,114
29,NEAMŢ,BODEŞTI,121607,"BODEŞTII DE JOS","ŞCOALA CU CLASELE I-VIII",191,"Alegeri Prezidentiale",1,739,372,325,47,0,365,7,800,428,174,191
29,NEAMŢ,BOGHICEA,125178,BOGHICEA,"ȘCOALA GIMNAZIALĂ BOGHICEA",192,"Alegeri Prezidentiale",1,999,404,370,34,0,397,7,1100,696,254,143
29,NEAMŢ,BOGHICEA,125178,SLOBOZIA,"ȘCOALA GIMNAZIALĂ SLOBOZIA",193,"Alegeri Prezidentiale",1,594,303,270,33,0,300,3,700,397,212,88
29,NEAMŢ,BOGHICEA,125178,CĂUŞENI,"ȘCOALA PRIMARĂ CĂUȘENI",194,"Alegeri Prezidentiale",1,145,101,84,17,0,100,1,200,99,50,50
29,NEAMŢ,BOGHICEA,125178,NISTRIA,"ȘCOALA PRIMARĂ NISTRIA",195,"Alegeri Prezidentiale",1,208,105,95,10,0,104,1,300,195,57,47
29,NEAMŢ,BORCA,121652,BORCA,"LICEUL ”MIHAIL SADOVEANU”(CORPUL B)",196,"Alegeri Prezidentiale",1,877,399,359,40,0,387,12,1000,601,174,213
29,NEAMŢ,BORCA,121652,MĂDEI,"SALA DE FESTIVITĂŢI MADEI",197,"Alegeri Prezidentiale",1,896,456,417,39,0,446,10,1000,544,221,225
29,NEAMŢ,BORCA,121652,"PÂRÂUL CÂRJEI","ŞCOALA PRIMARĂ NR.3 LOCALITATEA PÎRÎUL CÎRJEI",198,"Alegeri Prezidentiale",1,597,254,236,18,0,252,2,700,446,122,130
29,NEAMŢ,BORCA,121652,SABASA,"GRĂDINIŢA CU PROGRAM NORMAL - BORCA CENTRU",199,"Alegeri Prezidentiale",1,776,457,377,80,0,447,10,800,343,256,191
29,NEAMŢ,BORCA,121652,SABASA,"CĂMIN CULTURAL SABASA",200,"Alegeri Prezidentiale",1,935,461,445,16,0,449,12,1000,539,198,251
29,NEAMŢ,BORCA,121652,"PÂRÂUL PÂNTEI","ŞCOALA PRIMARĂ NR.2 LOCALITATEA PÎRÎUL PÎNTEI",201,"Alegeri Prezidentiale",1,422,204,183,21,0,200,4,500,296,87,113
29,NEAMŢ,BORCA,121652,SOCI,"ŞCOALA PRIMARĂ NR.1 LOCALITATEA SOCI",202,"Alegeri Prezidentiale",1,730,347,335,12,0,342,5,800,453,156,186
29,NEAMŢ,BORLEŞTI,121732,BORLEŞTI,"SCOALA GIMNAZIALĂ BORLEŞTI",203,"Alegeri Prezidentiale",1,1504,659,562,97,0,651,8,1600,941,388,263
29,NEAMŢ,BORLEŞTI,121732,BORLEŞTI,"ȘCOALA PRIMARĂ NR. 2 BORLEȘTI",204,"Alegeri Prezidentiale",1,802,305,288,17,0,297,8,900,595,203,94
29,NEAMŢ,BORLEŞTI,121732,MASTACĂN,"ŞCOALA GIMNAZIALĂ ”ŞTEFAN CEL MARE”",205,"Alegeri Prezidentiale",1,1549,616,577,37,2,608,8,1600,984,399,209
29,NEAMŢ,BORLEŞTI,121732,RUSENI,"ŞCOALA GIMNAZIALA ” IOAN GRIGORE TEODORESCU”",206,"Alegeri Prezidentiale",1,895,387,321,66,0,377,10,1000,613,238,139
29,NEAMŢ,BORLEŞTI,121732,RUSENI,"CĂMIN CULTURAL",207,"Alegeri Prezidentiale",1,1389,480,450,30,0,474,6,1500,1020,267,207
29,NEAMŢ,BORLEŞTI,121732,ŞOVOAIA,"ȘCOALA PRIMARĂ ȘOVOAIA",208,"Alegeri Prezidentiale",1,420,164,134,30,0,163,1,500,336,96,67
29,NEAMŢ,BORLEŞTI,121732,NECHIT,"”CĂMIN CULTURAL”",209,"Alegeri Prezidentiale",1,231,267,97,170,0,258,9,400,133,88,170
29,NEAMŢ,BORLEŞTI,121732,RUSENI,"GRĂDINIȚA CU PROGRAM NORMAL NR.3",210,"Alegeri Prezidentiale",1,804,349,307,42,0,341,8,900,551,237,104
29,NEAMŢ,BOTEŞTI,121796,BOTEŞTI,"ŞCOALA CU CLASELE I-IV",211,"Alegeri Prezidentiale",1,348,200,174,26,0,195,5,400,200,87,108
29,NEAMŢ,BOTEŞTI,121796,NISIPOREŞTI,"LICEUL TEHNOLOGIC",212,"Alegeri Prezidentiale",1,967,336,301,35,0,331,5,1101,765,231,100
29,NEAMŢ,BOTEŞTI,121796,NISIPOREŞTI,"LICEUL TEHNOLOGIC",213,"Alegeri Prezidentiale",1,1047,375,350,25,0,371,4,1100,725,266,105
29,NEAMŢ,BOTEŞTI,121796,BARTICEŞTI,"SCOALA CU CLASELE I-VII",214,"Alegeri Prezidentiale",1,1751,608,574,34,0,603,5,1901,1293,397,206
29,NEAMŢ,BOZIENI,121876,BOZIENI,"ȘCOALA GIMNAZIALĂ BOZIENI (ȘCOALA GENERALĂ BOZIENI)",215,"Alegeri Prezidentiale",1,915,375,326,49,0,372,3,1000,625,200,172
29,NEAMŢ,BOZIENI,121876,CUCI,"ȘCOALA GIMNAZIALĂ BOZIENI - ȘCOALA PRIMARĂ CUCI (ŞCOALA GENERALĂ BOZIENI)",216,"Alegeri Prezidentiale",1,672,287,256,31,0,283,4,700,413,105,178
29,NEAMŢ,BOZIENI,121876,IUCŞA,"ȘCOALA GIMNAZIALĂ BOZIENI - ȘCOALA PRIMARĂ IUCȘA (ŞCOALA GENERALĂ BOZIENI)",217,"Alegeri Prezidentiale",1,626,243,210,33,0,242,1,700,457,110,132
29,NEAMŢ,BRUSTURI,121938,BRUSTURI,"ŞCOALA GIMNAZIALĂ „IEREMIA IRIMESCU” BRUSTURI",218,"Alegeri Prezidentiale",1,1542,658,586,72,0,640,18,1700,1042,357,283
29,NEAMŢ,BRUSTURI,121938,GROŞI,"GRADINITA CU PROGRAM NORMAL GROSI",219,"Alegeri Prezidentiale",1,388,151,128,23,0,147,4,500,349,38,109
29,NEAMŢ,BRUSTURI,121938,POIANA,"GRADINITA CU PROGRAM NORMAL POIANA",220,"Alegeri Prezidentiale",1,646,297,269,28,0,290,7,700,403,99,191
29,NEAMŢ,BRUSTURI,121938,TÂRZIA,"ŞCOALA GIMNAZIALĂ „GRIGORE STURZU” TIRZIA",221,"Alegeri Prezidentiale",1,615,277,254,23,0,265,12,700,423,99,166
29,NEAMŢ,CÂNDEŞTI,122061,CÂNDEŞTI,"ȘCOALA GIMNAZIALĂ",222,"Alegeri Prezidentiale",1,1305,494,453,40,1,491,3,1400,906,327,164
29,NEAMŢ,CÂNDEŞTI,122061,VĂDURELE,"GRĂDINIȚA CU PROGRAM NORMAL",223,"Alegeri Prezidentiale",1,1060,379,350,29,0,375,4,1200,821,241,134
29,NEAMŢ,CÂNDEŞTI,122061,BĂRCĂNEŞTI,"GRĂDINIȚA CU PROGRAM NORMAL",224,"Alegeri Prezidentiale",1,695,252,232,20,0,249,3,800,548,155,94
29,NEAMŢ,CÂNDEŞTI,122061,PĂDURENI,"ȘCOALA PRIMARĂ",225,"Alegeri Prezidentiale",1,311,127,107,20,0,126,1,400,273,65,61
29,NEAMŢ,CEAHLĂU,122025,BISTRICIOARA,"ȘCOALA PRIMARĂ NR.1",226,"Alegeri Prezidentiale",1,614,304,260,44,0,300,4,700,396,147,153
29,NEAMŢ,CEAHLĂU,122025,CEAHLĂU,"ŞCOALA GRIGORE UNGUREANU",227,"Alegeri Prezidentiale",1,1398,821,644,158,19,805,16,1500,679,520,285
29,NEAMŢ,CORDUN,120888,CORDUN,"ȘCOALA GIMNAZIALĂ NR. 1 - GRĂDINIŢA CU PROGRAM PRELUNGIT CORDUN",228,"Alegeri Prezidentiale",1,1347,566,534,32,0,558,8,1501,935,336,222
29,NEAMŢ,CORDUN,120888,CORDUN,"ȘCOALA GIMNAZIALĂ NR. 1 - GRĂDINIŢA CU PROGRAM PRELUNGIT CORDUN",229,"Alegeri Prezidentiale",1,1035,495,461,34,0,480,15,1101,606,268,212
29,NEAMŢ,CORDUN,120888,SIMIONEŞTI,"CĂMINUL CULTURAL",230,"Alegeri Prezidentiale",1,725,317,291,25,1,310,7,801,484,172,138
29,NEAMŢ,CORDUN,120888,PILDEŞTI,"ŞCOALA GIMNAZIALĂ NR.1 PILDEŞTI",231,"Alegeri Prezidentiale",1,1728,702,675,19,8,696,6,1901,1199,581,115
29,NEAMŢ,CORDUN,120888,PILDEŞTI,"ȘCOALA GIMNAZIALĂ NR. 1 PILDEŞTI",232,"Alegeri Prezidentiale",1,1719,656,609,33,14,642,14,1901,1245,550,92
29,NEAMŢ,COSTIŞA,122132,COSTIŞA,"ŞCOALA GIMNAZIALA SAT COSTISA",233,"Alegeri Prezidentiale",1,1400,595,534,61,0,590,5,1500,905,314,276
29,NEAMŢ,COSTIŞA,122132,MĂNOAIA,"ŞCOALA PRIMARA SAT MANOAIA",234,"Alegeri Prezidentiale",1,772,348,313,35,0,342,6,800,452,183,159
29,NEAMŢ,COSTIŞA,122132,FRUNZENI,"ŞCOALA PRIMARA SAT FRUNZENI",235,"Alegeri Prezidentiale",1,537,190,170,20,0,185,5,600,410,136,49
29,NEAMŢ,COSTIŞA,122132,DORNEŞTI,"CLADIRE ŞCOALĂ",236,"Alegeri Prezidentiale",1,215,108,89,19,0,105,3,300,192,57,48
29,NEAMŢ,CRĂCĂOANI,122187,CRĂCĂOANI,"ŞCOALA GIMNAZIALĂ ”GHEORGHE SĂVINESCU”",237,"Alegeri Prezidentiale",1,868,357,311,46,0,348,9,892,535,206,142
29,NEAMŢ,CRĂCĂOANI,122187,CRĂCĂOANI,"ŞCOALA GIMNAZIALĂ ”GHEORGHE SĂVINESCU”",238,"Alegeri Prezidentiale",1,920,338,282,56,0,335,3,1000,662,155,180
29,NEAMŢ,CRĂCĂOANI,122187,MAGAZIA,"ŞCOALA GENERALĂ",239,"Alegeri Prezidentiale",1,557,347,284,63,0,346,1,600,253,172,174
29,NEAMŢ,CRĂCĂOANI,122187,"CRACĂUL NEGRU","ŞCOALA GENERALĂ",240,"Alegeri Prezidentiale",1,867,380,352,28,0,373,7,900,520,235,138
29,NEAMŢ,CRĂCĂOANI,122187,"MITOCU BĂLAN","ŞCOALA GENERALĂ",241,"Alegeri Prezidentiale",1,258,148,127,21,0,146,2,300,152,73,73
29,NEAMŢ,DĂMUC,122249,HUISUREZ,"SCOALA GENERALA",242,"Alegeri Prezidentiale",1,623,292,259,28,5,282,10,700,408,100,182
29,NEAMŢ,DĂMUC,122249,DĂMUC,"CAMINUL CULTURAL DAMUC",243,"Alegeri Prezidentiale",1,1271,602,550,49,3,600,2,1400,798,344,256
29,NEAMŢ,DĂMUC,122249,DĂMUC,"ŞCOALA GENERALĂ",244,"Alegeri Prezidentiale",1,511,303,265,32,6,302,1,600,297,181,121
29,NEAMŢ,DOBRENI,122285,DOBRENI,"CĂMINUL CULTURAL DOBRENI",245,"Alegeri Prezidentiale",1,1486,752,641,111,0,734,18,1600,848,422,312
29,NEAMŢ,DOCHIA,125098,BĂLUŞEŞTI,"CĂMINUL CULTURAL",246,"Alegeri Prezidentiale",1,102,76,40,36,0,76,0,200,124,38,38
29,NEAMŢ,DOCHIA,125098,DOCHIA,"ŞCOALA GIMNAZIALĂ NR.1",247,"Alegeri Prezidentiale",1,796,376,336,40,0,366,10,900,524,177,189
29,NEAMŢ,DOCHIA,125098,DOCHIA,"ŞCOALA GIMNAZIALĂ NR.1",248,"Alegeri Prezidentiale",1,1100,572,517,55,0,566,6,1200,628,265,301
29,NEAMŢ,DOLJEŞTI,122347,DOLJEŞTI,"ŞCOALA GIMNAZIALĂ NR.1 DOLJEŞTI",249,"Alegeri Prezidentiale",1,1012,424,392,32,0,422,2,1100,676,221,201
29,NEAMŢ,DOLJEŞTI,122347,ROTUNDA,"GRĂDINIȚA CU PROGRAM NORMAL ROTUNDA",250,"Alegeri Prezidentiale",1,1303,445,405,40,0,442,3,1400,955,315,127
29,NEAMŢ,DOLJEŞTI,122347,BUHONCA,"ŞCOALA PRIMARĂ NR.1 BUHONCA",251,"Alegeri Prezidentiale",1,564,206,193,13,0,204,2,600,394,120,84
29,NEAMŢ,DOLJEŞTI,122347,BURUIENEŞTI,"ŞCOALA GIMNAZIALĂ ”GHEORGHE PATRAŞCU” BURUIENEŞTI, CORP B",252,"Alegeri Prezidentiale",1,1598,530,496,34,0,521,9,1700,1170,367,154
29,NEAMŢ,DOLJEŞTI,122347,BURUIENEŞTI,"ŞCOALA GIMNAZIALĂ ”GHEORGHE PATRAŞCU” BURUIENESTI, CORP C",253,"Alegeri Prezidentiale",1,1464,453,439,14,0,449,4,1600,1147,317,132
29,NEAMŢ,DRAGOMIREŞTI,122392,VAD,"GRĂDINIŢA CU PROGRAM NORMAL VAD",254,"Alegeri Prezidentiale",1,709,341,276,65,0,340,1,800,459,189,151
29,NEAMŢ,DRAGOMIREŞTI,122392,BORNIŞ,"SCOALA GENERALA",255,"Alegeri Prezidentiale",1,101,90,40,48,2,89,1,200,110,71,18
29,NEAMŢ,DRAGOMIREŞTI,122392,MASTACĂN,"SCOALA GENERALA",256,"Alegeri Prezidentiale",1,164,103,74,29,0,103,0,200,97,53,50
29,NEAMŢ,DRAGOMIREŞTI,122392,UNGHI,"SCOALA GENERALA",257,"Alegeri Prezidentiale",1,94,64,38,26,0,62,2,200,136,38,24
29,NEAMŢ,DRAGOMIREŞTI,122392,HLĂPEŞTI,"ŞCOALA PRIMARĂ HLĂPEŞTI",258,"Alegeri Prezidentiale",1,661,313,254,59,0,311,2,700,387,205,106
29,NEAMŢ,DRĂGĂNEŞTI,125132,DRĂGĂNEŞTI,"SCOALA GIMNAZIALA",259,"Alegeri Prezidentiale",1,578,322,280,42,0,314,8,600,278,205,109
29,NEAMŢ,DRĂGĂNEŞTI,125132,ORŢĂŞTI,"SCOALA PRIMARA",260,"Alegeri Prezidentiale",1,283,149,125,24,0,146,3,300,151,83,63
29,NEAMŢ,DRĂGĂNEŞTI,125132,ŞOIMĂREŞTI,"SCOALA PRIMARA",261,"Alegeri Prezidentiale",1,380,194,166,28,0,187,7,400,206,125,62
29,NEAMŢ,DULCEŞTI,122463,CORHANA,"ŞCOALA CORHANA",262,"Alegeri Prezidentiale",1,495,221,201,20,0,212,9,601,380,123,89
29,NEAMŢ,DULCEŞTI,122463,CÂRLIG,"ŞCOALA CÎRLIG",263,"Alegeri Prezidentiale",1,462,253,211,34,8,251,2,500,247,100,151
29,NEAMŢ,DULCEŞTI,122463,ROŞIORI,"ŞCOALA ROŞIORI",264,"Alegeri Prezidentiale",1,266,165,129,32,4,163,2,301,136,83,80
29,NEAMŢ,DULCEŞTI,122463,DULCEŞTI,"ŞCOALA GIMNAZIALA DULCESTI",265,"Alegeri Prezidentiale",1,914,476,402,56,18,472,4,1001,525,208,264
29,NEAMŢ,"DUMBRAVA ROŞIE",120771,BRĂŞĂUŢI,"SCOALA GIMNAZIALA NR 4 BRASAUTI",266,"Alegeri Prezidentiale",1,581,297,261,36,0,293,4,600,303,146,147
29,NEAMŢ,"DUMBRAVA ROŞIE",120771,"DUMBRAVA ROŞIE","SCOALA GIMNAZIALA NR. 1 DUMBRAVA ROSIE",267,"Alegeri Prezidentiale",1,1483,677,611,66,0,665,12,1600,923,460,205
29,NEAMŢ,"DUMBRAVA ROŞIE",120771,"DUMBRAVA ROŞIE","SCOALA GIMNAZIALA NR. 1 DUMBRAVA ROSIE",268,"Alegeri Prezidentiale",1,1746,756,711,44,1,737,19,1900,1144,514,223
29,NEAMŢ,"DUMBRAVA ROŞIE",120771,IZVOARE,"SCOALA GIMNAZIALA NR. 2 IZVOARE",269,"Alegeri Prezidentiale",1,1026,522,467,55,0,513,9,1100,578,370,143
29,NEAMŢ,"DUMBRAVA ROŞIE",120771,CUT,"SCOALA GIMNAZIALA NR. 3 CUT",270,"Alegeri Prezidentiale",1,1003,467,438,29,0,461,6,1100,633,347,114
29,NEAMŢ,"DUMBRAVA ROŞIE",120771,CUT,"SCOALA GIMNAZIALA NR 3 CUT",271,"Alegeri Prezidentiale",1,1143,523,493,30,0,514,9,1200,677,398,116
29,NEAMŢ,FARCAŞA,122551,FARCAŞA,"ŞCOALA GIMNAZIALA ” IOAN LUCA ” FARCASA",272,"Alegeri Prezidentiale",1,1136,569,519,49,1,564,5,1200,631,300,264
29,NEAMŢ,FARCAŞA,122551,FRUMOSU,"CĂMINUL CULTURAL",273,"Alegeri Prezidentiale",1,758,414,369,43,2,407,7,801,387,205,202
29,NEAMŢ,FARCAŞA,122551,STEJARU,"CĂMINUL CULTURAL",274,"Alegeri Prezidentiale",3,643,337,316,21,0,334,3,700,363,175,159
29,NEAMŢ,FĂUREI,122613,BUDEŞTI,"SCOALA PRIMARA BUDESTI",275,"Alegeri Prezidentiale",1,866,372,328,44,0,366,6,900,528,205,161
29,NEAMŢ,FĂUREI,122613,FĂUREI,"SCOALA GIMNAZIALA, COMUNA FAUREI",276,"Alegeri Prezidentiale",1,626,273,241,32,0,270,3,700,427,144,126
29,NEAMŢ,FĂUREI,122613,CLIMEŞTI,"BIBLIOTECA COMUNALA FAUREI",277,"Alegeri Prezidentiale",1,230,85,70,15,0,82,3,300,215,63,19
29,NEAMŢ,GÂDINŢI,125150,GÂDINŢI,"SCOALA GIMNAZIALA GADINTI (CORP 1)",278,"Alegeri Prezidentiale",1,1001,400,369,31,0,390,10,1100,700,175,215
29,NEAMŢ,GÂDINŢI,125150,GÂDINŢI,"SCOALA GIMNAZIALA GADINTI (CORP 2)",279,"Alegeri Prezidentiale",1,1041,383,351,32,0,377,6,1100,717,185,192
29,NEAMŢ,GÂRCINA,122828,GÂRCINA,"ŞCOALA GIMNAZIALĂ ”EPISCOP MELCHISEDEC ŞTEFĂNESCU”, CORP A",280,"Alegeri Prezidentiale",1,1209,505,474,31,0,494,11,1300,795,325,169
29,NEAMŢ,GÂRCINA,122828,ALMAŞ,"ŞCOALA ALMAŞ",281,"Alegeri Prezidentiale",1,556,316,262,54,0,309,7,600,284,221,88
29,NEAMŢ,GÂRCINA,122828,CUEJDIU,"ŞCOALA GIMNAZIALĂ ”EPISCOP MELCHISEDEC ŞTEFĂNESCU”",282,"Alegeri Prezidentiale",1,1043,358,336,22,0,348,10,1100,742,255,93
29,NEAMŢ,GÂRCINA,122828,GÂRCINA,"ŞCOALA GIMNAZIALĂ ”EPISCOP MELCHISEDEC ŞTEFĂNESCU”",283,"Alegeri Prezidentiale",1,1120,483,422,61,0,467,16,1200,717,324,143
29,NEAMŢ,GHERĂEŞTI,122668,GHERĂEŞTI,"SCOALA GIMNAZIALA, COMUNA GHERAESTI",284,"Alegeri Prezidentiale",1,1421,517,498,18,1,514,3,1500,983,378,136
29,NEAMŢ,GHERĂEŞTI,122668,GHERĂEŞTI,"SCOALA GIMNAZIALA, COMUNA GHERAESTI",285,"Alegeri Prezidentiale",1,1341,458,437,21,0,454,4,1500,1042,336,118
29,NEAMŢ,GHERĂEŞTI,122668,GHERĂEŞTI,"SCOALA GIMNAZIALA, COMUNA GHERAESTI",286,"Alegeri Prezidentiale",1,1433,469,439,30,0,460,9,1600,1131,336,124
29,NEAMŢ,GHERĂEŞTI,122668,"GHERĂEŞTII NOI","SCOALA PRIMARA, GHERAESTII NOI",287,"Alegeri Prezidentiale",1,475,183,162,21,0,180,3,500,317,149,31
29,NEAMŢ,GHERĂEŞTI,122668,TEŢCANI,"SCOALA PRIMARA, TETCANI",288,"Alegeri Prezidentiale",1,741,261,230,31,0,260,1,800,539,199,61
29,NEAMŢ,GHINDĂOANI,125114,GHINDĂOANI,"CLĂDIREA ”SALA DE NUNŢI”",289,"Alegeri Prezidentiale",1,1617,716,652,64,0,711,5,1800,1084,409,302
29,NEAMŢ,GIROV,122702,GIROV,"SCOALA GIMNAZIALA ”PROF. GHEORGHE DUMITREASA” GIROV",290,"Alegeri Prezidentiale",1,1373,578,518,60,0,574,4,1500,922,388,186
29,NEAMŢ,GIROV,122702,CĂCIULEŞTI,"SCOALA GIMNAZIALA NR. 1 CACIULESTI",291,"Alegeri Prezidentiale",1,580,255,210,45,0,255,0,600,345,140,115
29,NEAMŢ,GIROV,122702,"GURA VĂII","SCOALA PRIMARA GURA VAII",292,"Alegeri Prezidentiale",1,624,255,230,25,0,249,6,700,445,162,87
29,NEAMŢ,GIROV,122702,TURTUREŞTI,"PENSIUNEA ELENA",293,"Alegeri Prezidentiale",1,509,294,240,54,0,289,5,600,306,175,114
29,NEAMŢ,GIROV,122702,BOŢEŞTI,"SCOALA BOTESTI",294,"Alegeri Prezidentiale",1,428,220,173,47,0,219,1,499,279,137,82
29,NEAMŢ,GIROV,122702,DOINA,"SCOALA DOINA",295,"Alegeri Prezidentiale",1,235,146,117,29,0,141,5,301,155,104,37
29,NEAMŢ,GIROV,122702,DĂNEŞTI,"SCOALA DANESTI",296,"Alegeri Prezidentiale",1,249,121,99,22,0,121,0,300,179,79,42
29,NEAMŢ,GIROV,122702,VERŞEŞTI,"SCOALA VERSESTI",297,"Alegeri Prezidentiale",1,252,154,108,46,0,152,2,300,146,94,58
29,NEAMŢ,GRINŢIEŞ,122864,GRINŢIEŞ,"CĂMINUL CULTURAL",298,"Alegeri Prezidentiale",1,1371,611,550,61,0,603,8,1500,889,309,294
29,NEAMŢ,GRINŢIEŞ,122864,BRADU,"SALA DE FESTIVITĂŢI",299,"Alegeri Prezidentiale",1,660,297,268,29,0,296,1,700,403,151,145
29,NEAMŢ,GRUMĂZEŞTI,122908,TOPOLIŢA,SCOALA,300,"Alegeri Prezidentiale",1,1361,592,539,53,0,581,11,1500,908,228,353
29,NEAMŢ,GRUMĂZEŞTI,122908,CURECHIŞTEA,"SCOALA PRIMARA",301,"Alegeri Prezidentiale",1,596,264,238,26,0,255,9,700,436,74,181
29,NEAMŢ,GRUMĂZEŞTI,122908,GRUMĂZEŞTI,GRADINITA,302,"Alegeri Prezidentiale",1,1427,646,608,38,0,640,6,1500,854,247,393
29,NEAMŢ,GRUMĂZEŞTI,122908,GRUMĂZEŞTI,GRADINITA,303,"Alegeri Prezidentiale",1,965,383,352,31,0,379,4,1100,717,149,230
29,NEAMŢ,HANGU,122953,BUHALNIŢA,"ŞCOALA GIMNAZIALĂ BUHALNIŢA",304,"Alegeri Prezidentiale",1,681,276,232,42,2,268,8,700,424,130,138
29,NEAMŢ,HANGU,122953,HANGU,"ŞCOALA GIMNAZIALĂ,COMUNA HANGU",305,"Alegeri Prezidentiale",1,970,453,409,44,0,449,4,1100,647,194,255
29,NEAMŢ,HANGU,122953,HANGU,"ŞCOALA PRIMARĂ BOBOTENI",306,"Alegeri Prezidentiale",1,478,224,198,25,1,221,3,500,276,125,96
29,NEAMŢ,HANGU,122953,CHIRIŢENI,"ŞCOALA PRIMARĂ CHIRIŢENI",307,"Alegeri Prezidentiale",1,406,183,163,14,6,182,1,500,317,91,91
29,NEAMŢ,HANGU,122953,GROZĂVEŞTI,"ŞCOALA PRIMARĂ GROZĂVEŞTI",308,"Alegeri Prezidentiale",1,344,168,153,15,0,167,1,400,232,107,60
29,NEAMŢ,HANGU,122953,RUGINEŞTI,"ŞCOALA PRIMARĂ RUGINEŞTI",309,"Alegeri Prezidentiale",1,301,145,119,26,0,143,2,400,255,91,52
29,NEAMŢ,HORIA,120922,HORIA,"SCOALA GIMNAZIALA ”CARMEN SYLVA”",310,"Alegeri Prezidentiale",1,1695,685,651,34,0,674,11,1800,1115,361,313
29,NEAMŢ,HORIA,120922,HORIA,"CAMIN CULTURAL",311,"Alegeri Prezidentiale",1,1670,660,615,45,0,650,10,1800,1140,406,244
29,NEAMŢ,HORIA,120922,"COTU VAMEŞ","SCOALA GIMNAZIALA ” OTILIA CAZIMIR ” COTU VAMES",312,"Alegeri Prezidentiale",1,1392,550,516,34,0,541,9,1501,951,316,225
29,NEAMŢ,HORIA,120922,"COTU VAMEŞ","GRADINITA DE COPII",313,"Alegeri Prezidentiale",1,1307,553,514,39,0,546,7,1400,847,313,233
29,NEAMŢ,ICUŞEŞTI,123013,ICUŞEŞTI,"SCOALA GIMNAZIALA ICUSESTI",314,"Alegeri Prezidentiale",1,607,258,196,62,0,250,8,700,442,183,67
29,NEAMŢ,ICUŞEŞTI,123013,BĂLUŞEŞTI,"SCOALA GIMNAZIALA BALUSESTI",315,"Alegeri Prezidentiale",1,985,383,364,19,0,381,2,1100,717,277,104
29,NEAMŢ,ICUŞEŞTI,123013,BĂLUŞEŞTI,"SCOALA GIMNAZIALA BALUSESTI",316,"Alegeri Prezidentiale",1,994,363,345,18,0,357,6,1100,737,231,126
29,NEAMŢ,ICUŞEŞTI,123013,ROCNA,"SCOALA PRIMARA ROCNA",317,"Alegeri Prezidentiale",1,455,214,184,30,0,211,3,500,286,127,84
29,NEAMŢ,ICUŞEŞTI,123013,MESTEACĂN,"SCOALA PRIMARA MESTEACAN",318,"Alegeri Prezidentiale",1,433,201,185,16,0,198,3,497,296,161,37
29,NEAMŢ,ICUŞEŞTI,123013,SPIRIDONEŞTI,"SCOALA PRIMARA SPIRIDONESTI",319,"Alegeri Prezidentiale",1,180,90,79,11,0,89,1,200,110,46,43
29,NEAMŢ,"ION CREANGĂ",123102,IZVORU,ŞCOALA,320,"Alegeri Prezidentiale",1,372,198,176,22,0,197,1,400,202,103,94
29,NEAMŢ,"ION CREANGĂ",123102,RECEA,ŞCOALA,321,"Alegeri Prezidentiale",1,666,288,266,22,0,288,0,700,412,196,92
29,NEAMŢ,"ION CREANGĂ",123102,STEJARU,"CĂMIN CULTURAL",322,"Alegeri Prezidentiale",1,673,311,274,37,0,307,4,700,389,148,159
29,NEAMŢ,"ION CREANGĂ",123102,"ION CREANGĂ","CĂMIN CULTURAL NOU ȘI BIBLIOTECĂ",323,"Alegeri Prezidentiale",1,969,404,376,27,1,401,3,1000,596,212,189
29,NEAMŢ,"ION CREANGĂ",123102,"ION CREANGĂ","CĂMIN CULTURAL NOU ȘI BIBLIOTECĂ",324,"Alegeri Prezidentiale",1,1169,448,434,14,0,440,8,1300,852,228,212
29,NEAMŢ,"ION CREANGĂ",123102,AVEREŞTI,"CAMIN CULTURAL",325,"Alegeri Prezidentiale",1,772,422,362,60,0,415,7,800,378,174,241
29,NEAMŢ,MĂRGINENI,123175,MĂRGINENI,"ŞCOALA GENERALĂ",326,"Alegeri Prezidentiale",1,855,304,260,44,0,299,5,900,596,167,132
29,NEAMŢ,MĂRGINENI,123175,MĂRGINENI,GRĂDINIŢA,327,"Alegeri Prezidentiale",1,944,356,320,36,0,349,7,1000,644,175,174
29,NEAMŢ,MĂRGINENI,123175,HÂRŢEŞTI,"SCOALA GENERALA",328,"Alegeri Prezidentiale",1,179,101,84,17,0,100,1,200,99,55,45
29,NEAMŢ,MĂRGINENI,123175,HOISEŞTI,"ŞCOALA GENERALĂ",329,"Alegeri Prezidentiale",1,767,362,325,37,0,355,7,800,438,190,165
29,NEAMŢ,MĂRGINENI,123175,ITRINEŞTI,"ŞCOALA GENERALĂ",330,"Alegeri Prezidentiale",1,233,94,79,15,0,94,0,300,206,44,50
29,NEAMŢ,MOLDOVENI,123228,MOLDOVENI,"SCOALA GIMNAZIALA SATUL MOLDOVENI",331,"Alegeri Prezidentiale",1,1037,426,370,55,1,417,9,1100,674,234,183
29,NEAMŢ,MOLDOVENI,123228,HOCIUNGI,"FOSTA SCOALA CU CLASELE I-IV SATUL HOCIUNGI",332,"Alegeri Prezidentiale",1,699,358,287,69,2,347,11,800,442,232,115
29,NEAMŢ,NEGREŞTI,125169,NEGREŞTI,"SCOALA GIMNAZIALA ”DUMITRU ALMAS” NEGRESTI",333,"Alegeri Prezidentiale",1,1191,541,466,68,7,533,8,1301,760,287,246
29,NEAMŢ,NEGREŞTI,125169,POIANA,"GRADINITA CU PROGRAM NORMAL POIANA",334,"Alegeri Prezidentiale",1,321,169,126,43,0,168,1,400,231,57,111
29,NEAMŢ,ONICENI,123255,ONICENI,"ŞCOALA GENERALĂ",335,"Alegeri Prezidentiale",1,633,293,264,29,0,291,2,700,407,103,188
29,NEAMŢ,ONICENI,123255,GORUN,"ŞCOALA GENERALĂ",336,"Alegeri Prezidentiale",1,231,155,145,10,0,150,5,300,145,29,121
29,NEAMŢ,ONICENI,123255,MĂRMURENI,"ŞCOALA GENERALĂ",337,"Alegeri Prezidentiale",1,352,182,155,27,0,182,0,400,218,71,111
29,NEAMŢ,ONICENI,123255,SOLCA,"ŞCOALA GENERALĂ",338,"Alegeri Prezidentiale",1,1003,576,550,26,0,570,6,1100,524,129,441
29,NEAMŢ,ONICENI,123255,"VALEA ENEI","ŞCOALA GENERALĂ",339,"Alegeri Prezidentiale",1,291,161,151,10,0,157,4,400,239,66,91
29,NEAMŢ,PĂSTRĂVENI,123371,PĂSTRĂVENI,"ŞCOALA GIMNAZIALA, COMUNA PASTRAVENI",340,"Alegeri Prezidentiale",1,723,312,276,36,0,308,4,800,488,138,170
29,NEAMŢ,PĂSTRĂVENI,123371,PĂSTRĂVENI,"CENTRU DE RECUPERARE SI REABILITARE A PERSOANELOR CU HANDICAP",341,"Alegeri Prezidentiale",1,694,287,245,42,0,284,3,800,513,132,152
29,NEAMŢ,PĂSTRĂVENI,123371,RĂDENI,"SCOALA GIMNAZIALA NR. 1 RADENI",342,"Alegeri Prezidentiale",1,772,286,256,30,0,276,10,800,514,146,130
29,NEAMŢ,PĂSTRĂVENI,123371,RĂDENI,"SCOALA PRIMARA NR. 2 RADENI",343,"Alegeri Prezidentiale",1,576,242,229,13,0,235,7,600,358,115,120
29,NEAMŢ,PĂSTRĂVENI,123371,"LUNCA MOLDOVEI","CASA SOCIALĂ A PAROHIEI ZVORĂNEŞTI, FILIA LUNCA MOLDOVEI",344,"Alegeri Prezidentiale",1,252,148,122,26,0,145,3,300,152,52,93
29,NEAMŢ,PÂNCEŞTI,125141,PÂNCEŞTI,"ŞCOALA GIMNAZIALA ”VLAD DANULESCU ” PANCESTI",345,"Alegeri Prezidentiale",1,979,469,413,48,8,466,3,1100,631,197,269
29,NEAMŢ,PÂNCEŞTI,125141,CIUREA,"ŞCOALA PRIMARA CIUREA",346,"Alegeri Prezidentiale",1,191,130,103,27,0,129,1,301,171,56,73
29,NEAMŢ,PÂNGĂRAŢI,123601,PÂNGĂRĂCIOR,"ŞCOALA GIMNAZIALĂ ”NICOLAE IORGA” - SAT PÎNGĂRĂCIOR",347,"Alegeri Prezidentiale",1,1721,795,720,75,0,785,10,1900,1105,517,268
29,NEAMŢ,PÂNGĂRAŢI,123601,PÂNGĂRAŢI,"ŞCOALA GIMNAZIALĂ ”NICOLAE IORGA” -SAT PÎNGĂRAȚI - PUNCT CASTEL",348,"Alegeri Prezidentiale",1,620,315,273,40,2,305,10,700,385,197,108
29,NEAMŢ,PÂNGĂRAŢI,123601,STEJARU,"ŞCOALA GIMNAZIALĂ ”NICOLAE IORGA” - SAT STEJARU",349,"Alegeri Prezidentiale",1,881,423,365,58,0,413,10,1000,577,310,103
29,NEAMŢ,PÂNGĂRAŢI,123601,OANŢU,"ŞCOALA GIMNAZIALĂ ”NICOLAE IORGA” - SAT OANȚU",350,"Alegeri Prezidentiale",1,1273,583,558,25,0,578,5,1400,817,354,224
29,NEAMŢ,PETRICANI,123424,PETRICANI,"LICEUL TEHNOLOGIC",351,"Alegeri Prezidentiale",1,1433,583,556,27,0,575,8,1600,1017,282,293
29,NEAMŢ,PETRICANI,123424,BOIŞTEA,"SCOALA GENERALA",352,"Alegeri Prezidentiale",1,741,423,401,22,0,417,6,800,377,145,272
29,NEAMŢ,PETRICANI,123424,TÂRPEŞTI,"SCOALA GENERALA",353,"Alegeri Prezidentiale",1,1137,467,428,39,0,457,10,1200,733,205,252
29,NEAMŢ,PETRICANI,123424,ŢOLICI,"SCOALA GENERALA",354,"Alegeri Prezidentiale",1,1375,435,415,20,0,430,5,1501,1066,141,289
29,NEAMŢ,"PIATRA ŞOIMULUI",123479,LUMINIŞ,"SCOALA GIMNAZIALA LUMINIS,COMUNA PIATRA SOIMULUI",355,"Alegeri Prezidentiale",1,1134,417,406,11,0,413,4,1200,783,214,199
29,NEAMŢ,"PIATRA ŞOIMULUI",123479,POIENI,"SCOALA GIMNAZIALA POIENI,COMUNA PIATRA SOIMULUI",356,"Alegeri Prezidentiale",1,1106,525,504,19,2,518,7,1200,675,201,317
29,NEAMŢ,"PIATRA ŞOIMULUI",123479,LUMINIŞ,"ŞCOALA GIMNAZIALA LUMINIS,COMUNA PIATRA SOIMULUI",357,"Alegeri Prezidentiale",1,997,399,382,17,0,392,7,1100,701,219,173
29,NEAMŢ,"PIATRA ŞOIMULUI",123479,NEGULEŞTI,"GRADINITA CU PROGRAM NORMAL NEGULESTI,COMUNA PIATRA SOIMULUI",358,"Alegeri Prezidentiale",1,587,242,227,15,0,234,8,600,358,118,116
29,NEAMŢ,"PIATRA ŞOIMULUI",123479,"PIATRA ŞOIMULUI","SCOALA GIMNAZIALA,COMUNA PIATRA SOIMULUI",359,"Alegeri Prezidentiale",1,1583,587,544,42,1,578,9,1700,1113,342,236
29,NEAMŢ,"PIATRA ŞOIMULUI",123479,"PIATRA ŞOIMULUI","ŞCOALA PRIMARA,COMUNA PIATRA SOIMULUI",360,"Alegeri Prezidentiale",1,1466,574,529,45,0,556,18,1600,1026,311,245
29,NEAMŢ,PIPIRIG,123521,DOLHEŞTI,"LICEUL TEHNOLOGIC ”ION CREANGA” PIPIRIG",361,"Alegeri Prezidentiale",1,1463,611,573,38,0,603,8,1600,989,325,278
29,NEAMŢ,PIPIRIG,123521,PIPIRIG,"SCOALA PIPIRIG NR. 2",362,"Alegeri Prezidentiale",1,898,456,407,49,0,452,4,1000,544,246,206
29,NEAMŢ,PIPIRIG,123521,BOBOIEŞTI,"SCOALA GIMNAZIALA NR. 1",363,"Alegeri Prezidentiale",2,1303,531,516,15,0,522,9,1400,869,285,237
29,NEAMŢ,PIPIRIG,123521,LEGHIN,"GRADINITA CU PROGRAM NORMAL",364,"Alegeri Prezidentiale",1,539,259,236,23,0,256,3,600,341,145,111
29,NEAMŢ,PIPIRIG,123521,STÂNCA,"SCOALA GIMNAZIALA STINCA",365,"Alegeri Prezidentiale",1,1260,511,480,31,0,507,4,1400,889,258,249
29,NEAMŢ,PIPIRIG,123521,DOLHEŞTI,"SCOALA CU CLASELE I-IV DOLHESTI",366,"Alegeri Prezidentiale",1,892,316,306,10,0,315,1,1000,684,163,152
29,NEAMŢ,PIPIRIG,123521,PLUTON,"SCOALA GIMNAZIALA PLUTON",367,"Alegeri Prezidentiale",1,830,345,319,26,0,339,6,901,556,233,106
29,NEAMŢ,PODOLENI,123674,PODOLENI,"GRĂDINIŢA CU PROGRAM NORMAL NR. 2",368,"Alegeri Prezidentiale",1,1203,470,440,30,0,461,9,1300,830,309,152
29,NEAMŢ,PODOLENI,123674,PODOLENI,"ŞCOALA GIMNAZIALĂ ”ALEXANDRU PODOLEANU”",369,"Alegeri Prezidentiale",1,1053,404,373,31,0,401,3,1100,696,264,137
29,NEAMŢ,PODOLENI,123674,PODOLENI,"ŞCOALA GIMNAZIALĂ ”ALEXANDRU PODOLEANU”",370,"Alegeri Prezidentiale",1,1179,500,471,29,0,495,5,1300,800,323,172
29,NEAMŢ,PODOLENI,123674,PODOLENI,"GRĂDINIŢA CU PROGRAM NORMAL NR. 3",371,"Alegeri Prezidentiale",1,888,379,351,28,0,373,6,1000,621,241,132
29,NEAMŢ,PODOLENI,123674,NEGRITEŞTI,"ŞCOALA PRIMARĂ NEGRITEŞTI",372,"Alegeri Prezidentiale",1,297,163,143,20,0,161,2,400,237,76,85
29,NEAMŢ,"POIANA TEIULUI",123790,DREPTU,"ŞCOALA GIMNAZIALA ”CONSTANTIN ROMANESCU” DREPTU",373,"Alegeri Prezidentiale",1,953,448,415,33,0,440,8,1000,552,190,250
29,NEAMŢ,"POIANA TEIULUI",123790,"POIANA LARGULUI","SOCIETATEA COMERCIALǍ TCE PETROFOREST SRL",374,"Alegeri Prezidentiale",1,755,388,342,46,0,378,10,800,412,188,190
29,NEAMŢ,"POIANA TEIULUI",123790,"PETRU VODĂ","ŞCOALA GIMNAZIALA PETRU VODA",375,"Alegeri Prezidentiale",1,1082,423,384,39,0,420,3,1200,777,200,220
29,NEAMŢ,"POIANA TEIULUI",123790,"POIANA TEIULUI","ȘCOALA GIMNAZIALǍ ”IUSTIN PÎRVU”",376,"Alegeri Prezidentiale",1,1318,590,543,47,0,581,9,1400,810,342,239
29,NEAMŢ,POIENARI,123709,POIENARI,"SCOALA GIMNAZIALA NR. 1",377,"Alegeri Prezidentiale",1,960,431,380,51,0,427,4,1100,669,217,210
29,NEAMŢ,POIENARI,123709,SĂCĂLENI,"SCOALA GIMNAZIALA STRUCTURA SACALENI",378,"Alegeri Prezidentiale",1,271,127,103,24,0,126,1,300,173,65,61
29,NEAMŢ,RĂUCEŞTI,123914,OGLINZI,"LICEUL TEHNOLOGIC OGLINZI",379,"Alegeri Prezidentiale",1,1650,683,633,50,0,677,6,1800,1117,364,313
29,NEAMŢ,RĂUCEŞTI,123914,OGLINZI,"ŞCOALA PRIMARĂ NR. 2 OGLINZI",380,"Alegeri Prezidentiale",1,829,359,296,63,0,351,8,900,541,187,164
29,NEAMŢ,RĂUCEŞTI,123914,UNGHENI,"ŞCOALA UNGHENI",381,"Alegeri Prezidentiale",1,429,213,188,25,0,210,3,500,287,98,112
29,NEAMŢ,RĂUCEŞTI,123914,RĂUCEŞTI,"ŞCOALA GIMNAZIALĂ NR. 1 RĂUCEŞTI",382,"Alegeri Prezidentiale",1,1300,556,505,51,0,548,8,1400,844,274,274
29,NEAMŢ,RĂUCEŞTI,123914,RĂUCEŞTI,"ŞCOALA GIMNAZIALĂ NR. 2 ”MIHAIL KOGĂLNICEANU” RĂUCEŞTI",383,"Alegeri Prezidentiale",1,629,256,229,27,0,251,5,700,444,87,164
29,NEAMŢ,RĂUCEŞTI,123914,RĂUCEŞTI,"GRĂDINIŢA CU PROGRAM NORMAL NR. 2 RĂUCEŞTI",384,"Alegeri Prezidentiale",1,626,257,234,23,0,253,4,700,443,135,118
29,NEAMŢ,RĂUCEŞTI,123914,OGLINZI,"LICEUL TEHNOLOGIC OGLINZI (GRĂDINIŢA NR. 1- CORP C)",385,"Alegeri Prezidentiale",1,822,329,302,27,0,326,3,900,571,258,68
29,NEAMŢ,RĂUCEŞTI,123914,SĂVEŞTI,"ŞCOALA SĂVEŞTI",386,"Alegeri Prezidentiale",1,355,185,161,24,0,182,3,400,215,92,90
29,NEAMŢ,RĂZBOIENI,123969,BORŞENI,"SCOALA GENERALA",387,"Alegeri Prezidentiale",1,280,168,128,32,8,164,4,300,132,52,112
29,NEAMŢ,RĂZBOIENI,123969,"VALEA ALBĂ","SCOALA GENERALA",388,"Alegeri Prezidentiale",1,331,213,172,25,16,211,2,400,187,90,121
29,NEAMŢ,RĂZBOIENI,123969,"RĂZBOIENII DE JOS","SCOALA GENERALA CU CLASELE I-VIII",389,"Alegeri Prezidentiale",2,619,427,308,90,29,411,16,701,274,191,220
29,NEAMŢ,RĂZBOIENI,123969,RĂZBOIENI,"SCOALA GENERALA CU CLASELE I-IV NR. 3",390,"Alegeri Prezidentiale",1,480,305,222,69,14,295,10,500,195,105,190
29,NEAMŢ,REDIU,124028,BEŢEŞTI,"ŞCOALA CU CLASELE I-IV BETESTI",391,"Alegeri Prezidentiale",1,625,251,227,23,1,248,3,700,449,166,82
29,NEAMŢ,REDIU,124028,REDIU,"SCOALA CU CLASELE I-VIII REDIU",392,"Alegeri Prezidentiale",1,679,249,217,31,1,248,1,700,451,169,79
29,NEAMŢ,REDIU,124028,POLOBOC,"ŞCOALA CU CLASELE I-VIII POLOBOC",393,"Alegeri Prezidentiale",1,1205,503,455,46,2,500,3,1300,797,304,196
29,NEAMŢ,REDIU,124028,SOCEA,"GRADINITA SOCEA",394,"Alegeri Prezidentiale",1,618,265,248,17,0,263,2,700,435,153,110
29,NEAMŢ,REDIU,124028,REDIU,"ŞCOALA CU CLASELE I-VIII REDIU",395,"Alegeri Prezidentiale",2,1209,446,420,25,1,440,6,1300,854,295,145
29,NEAMŢ,ROMÂNI,124073,ROMÂNI,"ŞCOALA CU CLASELE I-VIII",396,"Alegeri Prezidentiale",1,769,352,321,31,0,349,3,800,448,207,142
29,NEAMŢ,ROMÂNI,124073,SILIŞTEA,"ŞCOALA CU CLASELE I-VIII",397,"Alegeri Prezidentiale",1,1036,526,469,57,0,519,7,1100,574,225,294
29,NEAMŢ,ROMÂNI,124073,GOŞMANI,"ŞCOALA CU CLASELE I-VIII",398,"Alegeri Prezidentiale",1,812,324,287,37,0,319,5,900,576,154,165
29,NEAMŢ,ROMÂNI,124073,SILIŞTEA,"SCOALA CU CLASELE I-VIII SILISTEAII",399,"Alegeri Prezidentiale",1,840,323,290,33,0,320,3,900,577,155,165
29,NEAMŢ,RUGINOASA,125105,"BOZIENII DE SUS","FOSTA SCOALĂ BOZIENII DE SUS",400,"Alegeri Prezidentiale",1,299,175,121,29,25,170,5,401,226,101,69
29,NEAMŢ,RUGINOASA,125105,RUGINOASA,"ȘCOALA GIMNAZIALĂ ” NICOLAE APOSTOL” RUGINOASA",401,"Alegeri Prezidentiale",1,606,393,336,32,25,391,2,701,308,220,171
29,NEAMŢ,RUGINOASA,125105,RUGINOASA,"ȘCOALA GIMNAZIALĂ ” NICOLAE APOSTOL ” RUGINOASA",402,"Alegeri Prezidentiale",1,659,405,328,47,30,401,4,700,295,273,128
29,NEAMŢ,SAGNA,124153,SAGNA,"ŞCOALA GIMNAZIALĂ, COMUNA SAGNA",403,"Alegeri Prezidentiale",1,1686,624,596,28,0,618,6,1800,1176,435,183
29,NEAMŢ,SAGNA,124153,SAGNA,"ŞCOALA GIMNAZIALĂ, COMUNA SAGNA",404,"Alegeri Prezidentiale",1,1516,558,532,26,0,546,12,1600,1042,348,198
29,NEAMŢ,SAGNA,124153,LUŢCA,"GRĂDINIŢA CU PROGRAM NORMAL LUŢCA",405,"Alegeri Prezidentiale",1,392,220,179,41,0,218,2,500,280,92,126
29,NEAMŢ,SAGNA,124153,VULPĂŞEŞTI,"ŞCOALA PRIMARĂ VULPĂŞEŞTI",406,"Alegeri Prezidentiale",1,669,282,244,38,0,281,1,700,418,165,116
29,NEAMŢ,SĂBĂOANI,124206,TRAIAN,"ŞCOALA GIMNAZIALĂ TRAIAN-SĂBĂOANI",407,"Alegeri Prezidentiale",1,999,406,376,30,0,400,6,1101,695,257,143
29,NEAMŢ,SĂBĂOANI,124206,SĂBĂOANI,"LICEUL TEORETIC ”VASILE ALECSANDRI” COMUNA SĂBĂOANI",408,"Alegeri Prezidentiale",1,1075,344,321,21,2,335,9,1200,856,243,92
29,NEAMŢ,SĂBĂOANI,124206,SĂBĂOANI,"LICEUL TEORETIC ”VASILE ALECSANDRI” COMUNA SĂBĂOANI",409,"Alegeri Prezidentiale",1,1862,682,656,26,0,669,13,2000,1318,497,172
29,NEAMŢ,SĂBĂOANI,124206,SĂBĂOANI,"LICEUL TEORETIC ”VASILE ALECSANDRI” COMUNA SĂBĂOANI",410,"Alegeri Prezidentiale",1,1116,348,341,4,3,343,5,1200,852,231,112
29,NEAMŢ,SĂBĂOANI,124206,SĂBĂOANI,"LICEUL TEORETIC ”VASILE ALECSANDRI” COMUNA SĂBĂOANI",411,"Alegeri Prezidentiale",1,1030,359,332,24,3,352,7,1100,741,232,120
29,NEAMŢ,SĂBĂOANI,124206,SĂBĂOANI,"LICEUL TEORETIC ”VASILE ALECSANDRI” COMUNA SĂBĂOANI",412,"Alegeri Prezidentiale",1,866,310,300,8,2,306,4,900,590,199,107
29,NEAMŢ,SĂBĂOANI,124206,SĂBĂOANI,"LICEUL TEORETIC ”VASILE ALECSANDRI” COMUNA SĂBĂOANI",413,"Alegeri Prezidentiale",1,1438,419,398,21,0,408,11,1601,1182,304,104
29,NEAMŢ,SĂBĂOANI,124206,SĂBĂOANI,"LICEUL TEORETIC ”VASILE ALECSANDRI” COMUNA SĂBĂOANI",414,"Alegeri Prezidentiale",1,1095,337,323,13,1,328,9,1200,863,241,87
29,NEAMŢ,SĂVINEŞTI,120824,SĂVINEŞTI,"SCOALA GIMNAZIALA I.GERVESCU SAVINESTI",415,"Alegeri Prezidentiale",1,1708,394,357,37,0,385,9,1900,1506,246,139
29,NEAMŢ,SĂVINEŞTI,120824,DUMBRAVA-DEAL,"SCOALA PRIMARA DUMBRAVA DEAL",416,"Alegeri Prezidentiale",1,358,172,149,23,0,167,5,400,228,113,54
29,NEAMŢ,SĂVINEŞTI,120824,SĂVINEŞTI,"GRADINITA CU PROGRAM NORMAL SAVINESTI",417,"Alegeri Prezidentiale",1,680,283,258,25,0,275,8,700,417,197,78
29,NEAMŢ,SĂVINEŞTI,120824,SĂVINEŞTI,"GRADINIŢA CU PROGRAM PRELUNGIT SAVINESTI",418,"Alegeri Prezidentiale",1,555,242,224,18,0,236,6,600,358,143,93
29,NEAMŢ,SĂVINEŞTI,120824,SĂVINEŞTI,"ŞCOALA GIMNAZIALA SĂVINESTI",419,"Alegeri Prezidentiale",2,1436,656,612,44,0,643,13,1600,944,397,246
29,NEAMŢ,SĂVINEŞTI,120824,SĂVINEŞTI,"SCOALA PRIMARA SAVINESTI",420,"Alegeri Prezidentiale",1,1235,573,541,32,0,563,10,1300,727,296,267
29,NEAMŢ,SECUIENI,124233,SECUIENI,"CĂMINUL CULTURAL",421,"Alegeri Prezidentiale",1,770,318,269,48,1,313,5,800,482,185,128
29,NEAMŢ,SECUIENI,124233,BAŞTA,"CĂMINUL CULTURAL",422,"Alegeri Prezidentiale",1,535,285,239,46,0,276,9,601,316,153,123
29,NEAMŢ,SECUIENI,124233,BUTNĂREŞTI,"CĂMINUL CULTURAL",423,"Alegeri Prezidentiale",1,919,374,334,40,0,366,8,1001,627,168,198
29,NEAMŢ,SECUIENI,124233,GIULEŞTI,CLĂDIRE,424,"Alegeri Prezidentiale",1,206,85,64,21,0,85,0,299,214,45,40
29,NEAMŢ,SECUIENI,124233,"SECUIENII NOI","ȘCOALA SECUIENII NOI",425,"Alegeri Prezidentiale",1,219,109,89,20,0,108,1,300,191,72,36
29,NEAMŢ,STĂNIŢA,124331,STĂNIŢA,"SCOALA GIMNAZIALA COMUNA STANITA",426,"Alegeri Prezidentiale",2,394,140,104,36,0,139,1,500,360,67,72
29,NEAMŢ,STĂNIŢA,124331,CHICEREA,"SCOALA PRIMARA NR. 5 CHICEREA",427,"Alegeri Prezidentiale",1,217,93,68,25,0,92,1,300,207,50,42
29,NEAMŢ,STĂNIŢA,124331,GHIDION,"SCOALA PRIMARA NR.2 GHIDION",428,"Alegeri Prezidentiale",1,299,114,91,23,0,114,0,400,286,57,57
29,NEAMŢ,STĂNIŢA,124331,"POIENILE OANCEI","SCOALA PRIMARA NR.4 POIENILE OANCEI",429,"Alegeri Prezidentiale",1,189,88,65,23,0,88,0,200,112,53,35
29,NEAMŢ,STĂNIŢA,124331,TODIRENI,"SCOALA PRIMARA NR.1 TODIRENI",430,"Alegeri Prezidentiale",1,242,90,73,17,0,86,4,301,211,36,50
29,NEAMŢ,STĂNIŢA,124331,VEJA,"SCOALA PRIMARA NR.3 VEJA",431,"Alegeri Prezidentiale",1,251,108,91,17,0,107,1,305,197,48,59
29,NEAMŢ,"ŞTEFAN CEL MARE",124411,SOCI,ŞCOALA,432,"Alegeri Prezidentiale",1,274,163,119,44,0,161,2,300,137,82,79
29,NEAMŢ,"ŞTEFAN CEL MARE",124411,GHIGOIEŞTI,"SCOALA PRIMARA",433,"Alegeri Prezidentiale",1,471,229,184,45,0,226,3,500,271,133,93
29,NEAMŢ,"ŞTEFAN CEL MARE",124411,CÂRLIGI,"GRĂDINIŢA CU PROGRAM NORMAL",434,"Alegeri Prezidentiale",1,421,191,150,41,0,188,3,500,309,112,76
29,NEAMŢ,"ŞTEFAN CEL MARE",124411,"ŞTEFAN CEL MARE","SCOALA GIMNAZIALA DR. EMANUIEL RIGLER",435,"Alegeri Prezidentiale",2,684,320,285,35,0,314,6,700,380,188,126
29,NEAMŢ,"ŞTEFAN CEL MARE",124411,"ŞTEFAN CEL MARE","SCOALA GIMNAZIALA DR. EMANUIEL RIGLER",436,"Alegeri Prezidentiale",1,706,306,289,17,0,302,4,800,494,158,144
29,NEAMŢ,TARCĂU,124493,TARCĂU,"ŞCOLA GIMNAZIALĂ ”IULIA HĂLĂUCESCU”, COMUNA TARCĂU, JUDEŢUL NEAMŢ",437,"Alegeri Prezidentiale",1,796,413,353,60,0,406,7,900,487,235,171
29,NEAMŢ,TARCĂU,124493,TARCĂU,"ŞCOLA GIMNAZIALĂ ”IULIA HĂLĂUCESCU”, COMUNA TARCĂU, JUDEŢUL NEAMŢ",438,"Alegeri Prezidentiale",1,826,358,328,30,0,348,10,900,542,210,138
29,NEAMŢ,TARCĂU,124493,STRAJA,GRĂDINIŢA,439,"Alegeri Prezidentiale",1,528,248,219,29,0,244,4,600,352,183,61
29,NEAMŢ,TARCĂU,124493,CAZACI,GRĂDINIŢA,440,"Alegeri Prezidentiale",1,426,211,186,25,0,206,5,500,289,135,71
29,NEAMŢ,TARCĂU,124493,BRATEŞ,GRĂDINIŢA,441,"Alegeri Prezidentiale",1,283,172,116,56,0,170,2,300,128,122,48
29,NEAMŢ,TAŞCA,124563,TAŞCA,"CAMIN CULTURAL",442,"Alegeri Prezidentiale",1,1396,787,687,100,0,766,21,1500,713,448,318
29,NEAMŢ,TAŞCA,124563,NEAGRA,"SCOALA NEAGRA",443,"Alegeri Prezidentiale",1,782,388,334,54,0,382,6,900,512,218,164
29,NEAMŢ,TAZLĂU,124616,TAZLĂU,"SCOALA GIMNAZIALA ”I.I. MIRONESCU”",444,"Alegeri Prezidentiale",1,1050,403,363,40,0,399,4,1100,697,262,137
29,NEAMŢ,TAZLĂU,124616,TAZLĂU,"CAMINUL CULTURAL",445,"Alegeri Prezidentiale",1,1207,479,451,27,1,473,6,1300,821,296,177
29,NEAMŢ,TĂMĂŞENI,124634,ADJUDENI,"LICEUL TEHNOLOGIC ADJUDENI",446,"Alegeri Prezidentiale",1,1415,525,494,31,0,518,7,1600,1075,431,87
29,NEAMŢ,TĂMĂŞENI,124634,TĂMĂŞENI,GRADINITA,447,"Alegeri Prezidentiale",1,1287,547,481,66,0,542,5,1400,853,389,153
29,NEAMŢ,TĂMĂŞENI,124634,ADJUDENI,GRADINITA,448,"Alegeri Prezidentiale",1,1555,455,420,35,0,450,5,1700,1245,402,48
29,NEAMŢ,TĂMĂŞENI,124634,TĂMĂŞENI,"SCOALA GIMNAZIALA COMUNA TAMASENI",449,"Alegeri Prezidentiale",1,1383,484,453,31,0,478,6,1500,1016,381,97
29,NEAMŢ,TĂMĂŞENI,124634,TĂMĂŞENI,"CAMINUL CULTURAL",450,"Alegeri Prezidentiale",1,1008,383,357,26,0,382,1,1100,717,269,113
29,NEAMŢ,TĂMĂŞENI,124634,ADJUDENI,"CENTRUL MEDICAL ADJUDENI",451,"Alegeri Prezidentiale",1,1098,394,374,20,0,390,4,1200,806,333,57
29,NEAMŢ,TIMIŞEŞTI,124661,TIMIŞEŞTI,"ŞCOALA GIMNAZIALĂ",452,"Alegeri Prezidentiale",1,1042,431,385,46,0,426,5,1100,669,217,209
29,NEAMŢ,TIMIŞEŞTI,124661,DUMBRAVA,"ŞCOALA GIMNAZIALĂ",453,"Alegeri Prezidentiale",1,1018,451,403,48,0,444,7,1100,649,239,205
29,NEAMŢ,TIMIŞEŞTI,124661,PLĂIEŞU,"ŞCOALA PRIMARĂ",454,"Alegeri Prezidentiale",1,644,294,264,30,0,292,2,700,406,143,149
29,NEAMŢ,TIMIŞEŞTI,124661,PREUTEŞTI,"ŞCOALA PRIMARĂ",455,"Alegeri Prezidentiale",1,440,212,185,27,0,209,3,500,288,103,106
29,NEAMŢ,TIMIŞEŞTI,124661,ZVORĂNEŞTI,"CASA DE PRĂZNUIRE A PAROHIEI ZVORĂNEŞTI",456,"Alegeri Prezidentiale",1,142,86,63,23,0,83,3,200,114,46,37
29,NEAMŢ,TRIFEŞTI,124723,TRIFEŞTI,"ȘCOALA CU CLASELE I - VIII",457,"Alegeri Prezidentiale",1,1845,800,715,85,0,771,29,2000,1200,450,321
29,NEAMŢ,TRIFEŞTI,124723,"MIRON COSTIN","ȘCOALA CU CLASELE I - VIII",458,"Alegeri Prezidentiale",1,845,326,288,38,0,321,5,901,575,167,154
29,NEAMŢ,TRIFEŞTI,124723,TRIFEŞTI,"ȘCOALA CU CLASELE I - IV",459,"Alegeri Prezidentiale",2,759,373,337,36,0,372,1,800,427,214,158
29,NEAMŢ,TRIFEŞTI,124723,"MIRON COSTIN","ȘCOALA CU CLASELE I-IV",460,"Alegeri Prezidentiale",1,689,284,248,36,0,281,3,700,416,184,97
29,NEAMŢ,TUPILAŢI,124750,TUPILAŢI,"SCOALA CU CLASELE I-VIII",461,"Alegeri Prezidentiale",1,923,490,398,92,0,478,12,1000,510,253,225
29,NEAMŢ,TUPILAŢI,124750,TOTOIEŞTI,"SCOALA CU CLASELE I-VIII",462,"Alegeri Prezidentiale",1,269,147,111,36,0,144,3,300,153,70,74
29,NEAMŢ,TUPILAŢI,124750,TUPILAŢI,"PRIMARIA TUPILAŢI",463,"Alegeri Prezidentiale",1,578,297,264,32,1,293,4,600,303,132,161
29,NEAMŢ,ŢIBUCANI,124803,"ŢIBUCANII DE JOS","FOSTA ȘCOALA PRIMARĂ (SALA DE FESTIVITĂȚI)",464,"Alegeri Prezidentiale",1,323,184,149,35,0,184,0,401,217,106,78
29,NEAMŢ,ŢIBUCANI,124803,DAVIDENI,"ȘCOALA GIMNAZIALĂ DAVIDENI",465,"Alegeri Prezidentiale",1,792,405,349,54,2,401,4,900,495,243,158
29,NEAMŢ,ŢIBUCANI,124803,ŢIBUCANI,"ȘCOALA GIMNAZIALĂ NR.1 ȚIBUCANI",466,"Alegeri Prezidentiale",1,1310,695,629,66,0,685,10,1400,705,302,383
29,NEAMŢ,ŢIBUCANI,124803,ŢIBUCANI,"ŞCOALA GIMNAZIALĂ NR.3 ȚIBUCANI",467,"Alegeri Prezidentiale",1,838,424,388,36,0,419,5,900,476,177,242
29,NEAMŢ,URECHENI,124849,URECHENI,"SCOALA GIMNAZIALA URECHENI",468,"Alegeri Prezidentiale",1,591,247,224,21,2,240,7,700,453,73,167
29,NEAMŢ,URECHENI,124849,URECHENI,"SCOALA GIMNAZIALA URECHENI",469,"Alegeri Prezidentiale",1,863,313,296,17,0,309,4,900,587,141,168
29,NEAMŢ,URECHENI,124849,URECHENI,"SCOALA GIMNAZIALA FUNDATURA",470,"Alegeri Prezidentiale",1,559,227,196,31,0,225,2,600,373,68,157
29,NEAMŢ,URECHENI,124849,URECHENI,"GRADINITA CU PROGRAM NORMAL CATUNA",471,"Alegeri Prezidentiale",1,515,215,188,27,0,212,3,600,385,89,123
29,NEAMŢ,URECHENI,124849,INGĂREŞTI,"SCOALA GIMNAZIALA INGARESTI",472,"Alegeri Prezidentiale",1,732,299,278,21,0,296,3,800,501,132,164
29,NEAMŢ,"VALEA URSULUI",124885,"VALEA URSULUI","CAMIN CULTURAL VALEA URSULUI",473,"Alegeri Prezidentiale",1,732,275,252,23,0,271,4,801,526,81,190
29,NEAMŢ,"VALEA URSULUI",124885,BUCIUM,"SCOALA BUCIUM , COMUNA VALEA URSULUI",474,"Alegeri Prezidentiale",1,581,224,191,33,0,221,3,600,376,79,142
29,NEAMŢ,"VALEA URSULUI",124885,CHILII,"SCOALA CHILII , COMUNA VALEA URSULUI",475,"Alegeri Prezidentiale",1,932,370,333,36,1,366,4,1001,631,178,188
29,NEAMŢ,"VALEA URSULUI",124885,GIURGENI,"SCOALA GIURGENI , COMUNA VALEA URSULUI",476,"Alegeri Prezidentiale",1,510,215,168,47,0,214,1,600,385,80,134
29,NEAMŢ,"VALEA URSULUI",124885,"MUNCELU DE JOS","SCOALA MUNCEL , COMUNA VALEA URSULUI",477,"Alegeri Prezidentiale",1,318,150,137,13,0,147,3,400,250,67,80
29,NEAMŢ,VĂLENI,125123,MORENI,"ŞCOALA GIMNAZIALA COMUNA VALENI",478,"Alegeri Prezidentiale",1,578,341,272,69,0,338,3,600,259,104,234
29,NEAMŢ,VĂLENI,125123,VĂLENI,"SALA SEDINTE CONSILIUL LOCAL VĂLENI",479,"Alegeri Prezidentiale",1,559,274,224,50,0,268,6,600,326,149,119
29,NEAMŢ,VÂNĂTORI-NEAMŢ,125016,VÂNĂTORI-NEAMŢ,"SCOALA GIMNAZIALA ”ARHIM. CHIRIAC NICOLAU”",480,"Alegeri Prezidentiale",1,1344,575,538,37,0,562,13,1500,925,351,211
29,NEAMŢ,VÂNĂTORI-NEAMŢ,125016,VÂNĂTORI-NEAMŢ,"GRADINITA NR.2 UNGURENI",481,"Alegeri Prezidentiale",1,1485,612,583,29,0,596,16,1601,989,279,317
29,NEAMŢ,VÂNĂTORI-NEAMŢ,125016,VÂNĂTORI-NEAMŢ,"SCOALA GIMNAZIALA ”ARHIM. CHIRIAC NICOLAU” NR.2",482,"Alegeri Prezidentiale",1,1379,615,581,34,0,601,14,1500,885,356,245
29,NEAMŢ,VÂNĂTORI-NEAMŢ,125016,LUNCA,"SCOALA GIMNAZIALA ”ARHIM. CHIRIAC NICOLAU”",483,"Alegeri Prezidentiale",1,1001,433,418,15,0,430,3,1100,667,233,197
29,NEAMŢ,VÂNĂTORI-NEAMŢ,125016,NEMŢIŞOR,"SCOALA GIMNAZIALA”ARHIM.CHIRIAC NECULAU” NEMTISOR",484,"Alegeri Prezidentiale",1,1326,540,505,35,0,524,16,1250,710,316,208
29,NEAMŢ,VÂNĂTORI-NEAMŢ,125016,"MÂNĂSTIREA NEAMŢ","MĂNĂSTIREA NEAMȚ",485,"Alegeri Prezidentiale",1,213,161,101,60,0,153,8,300,139,67,86
29,NEAMŢ,VÂNĂTORI-NEAMŢ,125016,VÂNĂTORI-NEAMŢ,"MANASTIREA SIHASTRIA",486,"Alegeri Prezidentiale",1,166,255,78,177,0,238,17,450,195,86,152
29,NEAMŢ,ZĂNEŞTI,125061,TRAIAN,"GRĂDINIŢA CU PROGRAM NORMAL, LOC TRAIAN",487,"Alegeri Prezidentiale",1,877,351,319,29,3,339,12,1000,649,196,143
29,NEAMŢ,ZĂNEŞTI,125061,ZĂNEŞTI,"ŞCOALA GIMNAZIALĂ NR. 2, LOC ZĂNEŞTI",488,"Alegeri Prezidentiale",1,1577,696,642,54,0,681,15,1701,1005,421,260
29,NEAMŢ,ZĂNEŞTI,125061,ZĂNEŞTI,"ŞCOALA GIMNAZIALĂ NR. 1, LOC ZĂNEŞTI",489,"Alegeri Prezidentiale",1,1456,706,672,34,0,690,16,1600,894,408,282
29,NEAMŢ,ZĂNEŞTI,125061,ZĂNEŞTI,"CENTRU CULTURAL MULTIFUNCTIONAL",490,"Alegeri Prezidentiale",1,1111,511,465,46,0,504,7,1200,689,332,172
30,OLT,"MUNICIPIUL SLATINA",125347,SLATINA,"COLEGIUL NAŢIONAL RADU GRECEANU",1,"Alegeri Prezidentiale",1,1245,666,577,89,0,652,14,1371,705,336,316
30,OLT,"MUNICIPIUL SLATINA",125347,SLATINA,"COLEGIUL NAŢIONAL RADU GRECEANU",2,"Alegeri Prezidentiale",1,1493,751,659,92,0,737,14,1644,893,400,337
30,OLT,"MUNICIPIUL SLATINA",125347,SLATINA,"COLEGIUL NAŢIONAL RADU GRECEANU",3,"Alegeri Prezidentiale",2,1811,950,870,80,0,920,30,1994,1044,255,665
30,OLT,"MUNICIPIUL SLATINA",125347,SLATINA,"ŞCOALA GENERALĂ NR. 1",4,"Alegeri Prezidentiale",1,1177,701,621,70,10,689,12,1296,595,295,394
30,OLT,"MUNICIPIUL SLATINA",125347,SLATINA,"ŞCOALA GENERALĂ NR. 1",5,"Alegeri Prezidentiale",1,964,479,449,30,0,468,11,1062,583,216,252
30,OLT,"MUNICIPIUL SLATINA",125347,SLATINA,"COLEGIUL NAŢIONAL ION MINULESCU",6,"Alegeri Prezidentiale",1,1462,711,624,87,0,690,21,1610,899,386,304
30,OLT,"MUNICIPIUL SLATINA",125347,SLATINA,"COLEGIUL NAŢIONAL ION MINULESCU",7,"Alegeri Prezidentiale",1,1549,715,663,52,0,683,32,1605,890,363,320
30,OLT,"MUNICIPIUL SLATINA",125347,SLATINA,"COLEGIUL NAŢIONAL ION MINULESCU",8,"Alegeri Prezidentiale",1,1405,833,702,131,0,809,24,1547,714,414,395
30,OLT,"MUNICIPIUL SLATINA",125347,SLATINA,"COLEGIUL NAŢIONAL ION MINULESCU",9,"Alegeri Prezidentiale",1,1359,663,630,31,2,641,22,1496,833,328,313
30,OLT,"MUNICIPIUL SLATINA",125347,SLATINA,"ŞCOALA GENERALĂ ŞTEFAN PROTOPOPESCU",10,"Alegeri Prezidentiale",1,1840,941,816,120,5,915,26,2025,1084,467,448
30,OLT,"MUNICIPIUL SLATINA",125347,SLATINA,"ŞCOALA GENERALĂ ŞTEFAN PROTOPOPESCU",11,"Alegeri Prezidentiale",1,1800,752,707,44,1,739,13,1981,1229,439,300
30,OLT,"MUNICIPIUL SLATINA",125347,SLATINA,"COLEGIUL NAŢIONAL VOCAŢIONAL NICOLAE TITULESCU",12,"Alegeri Prezidentiale",1,1605,840,746,94,0,824,16,1767,927,438,386
30,OLT,"MUNICIPIUL SLATINA",125347,SLATINA,"COLEGIUL NAŢIONAL VOCAŢIONAL NICOLAE TITULESCU",13,"Alegeri Prezidentiale",1,1524,812,737,75,0,792,20,1678,866,432,360
30,OLT,"MUNICIPIUL SLATINA",125347,SLATINA,"COLEGIUL NAŢIONAL VOCAŢIONAL NICOLAE TITULESCU",14,"Alegeri Prezidentiale",2,1234,655,595,60,0,637,18,1359,704,332,305
30,OLT,"MUNICIPIUL SLATINA",125347,SLATINA,"COLEGIUL NAŢIONAL VOCAŢIONAL NICOLAE TITULESCU",15,"Alegeri Prezidentiale",1,1044,549,510,39,0,536,13,1150,601,286,250
30,OLT,"MUNICIPIUL SLATINA",125347,SLATINA,"COLEGIUL NAŢIONAL VOCAŢIONAL NICOLAE TITULESCU",16,"Alegeri Prezidentiale",1,1266,575,540,34,1,556,19,1394,819,309,247
30,OLT,"MUNICIPIUL SLATINA",125347,SLATINA,"ŞCOALA GENERALĂ NICOLAE IORGA",17,"Alegeri Prezidentiale",1,1530,788,721,67,0,761,27,1684,896,418,343
30,OLT,"MUNICIPIUL SLATINA",125347,SLATINA,"ŞCOALA GENERALĂ NICOLAE IORGA",18,"Alegeri Prezidentiale",1,1357,728,649,79,0,712,16,1494,766,380,332
30,OLT,"MUNICIPIUL SLATINA",125347,SLATINA,"ŞCOALA CU CLASELE I-VIII EUGEN IONESCU",19,"Alegeri Prezidentiale",1,1645,724,669,55,0,707,17,1811,1087,379,328
30,OLT,"MUNICIPIUL SLATINA",125347,SLATINA,"ŞCOALA CU CLASELE I-VIII EUGEN IONESCU",20,"Alegeri Prezidentiale",1,1227,628,587,41,0,607,21,1351,723,323,284
30,OLT,"MUNICIPIUL SLATINA",125347,SLATINA,"ŞCOALA CU CLASELE I-VIII EUGEN IONESCU",21,"Alegeri Prezidentiale",1,1211,546,511,35,0,526,20,1334,788,269,257
30,OLT,"MUNICIPIUL SLATINA",125347,SLATINA,"ŞCOALA GENERALĂ NR. 7",22,"Alegeri Prezidentiale",1,1505,640,616,24,0,620,20,1657,1017,291,329
30,OLT,"MUNICIPIUL SLATINA",125347,SLATINA,"ŞCOALA GENERALĂ NR. 7",23,"Alegeri Prezidentiale",1,1234,633,591,42,0,614,19,1359,726,367,247
30,OLT,"MUNICIPIUL SLATINA",125347,SLATINA,"ŞCOALA GENERALĂ NR. 7",24,"Alegeri Prezidentiale",1,1388,694,614,80,0,675,19,1528,834,407,268
30,OLT,"MUNICIPIUL SLATINA",125347,SLATINA,"COLEGIUL ECONOMIC P.S. AURELIAN",25,"Alegeri Prezidentiale",1,1232,652,565,87,0,630,22,1357,705,371,259
30,OLT,"MUNICIPIUL SLATINA",125347,SLATINA,"COLEGIUL ECONOMIC P.S. AURELIAN",26,"Alegeri Prezidentiale",1,1821,793,694,99,0,779,14,2005,1212,441,338
30,OLT,"MUNICIPIUL SLATINA",125347,SLATINA,"LICEUL CU PROGRAM SPORTIV",27,"Alegeri Prezidentiale",1,1849,978,748,189,41,961,17,2035,1057,519,442
30,OLT,"MUNICIPIUL SLATINA",125347,SLATINA,"LICEUL CU PROGRAM SPORTIV",28,"Alegeri Prezidentiale",1,1737,882,819,63,0,859,23,1912,1030,501,358
30,OLT,"MUNICIPIUL SLATINA",125347,SLATINA,"LICEUL CU PROGRAM SPORTIV",29,"Alegeri Prezidentiale",1,1465,652,605,47,0,631,21,1613,961,337,294
30,OLT,"MUNICIPIUL SLATINA",125347,SLATINA,"ŞCOALA GENERALĂ NR. 3",30,"Alegeri Prezidentiale",1,1532,725,649,76,0,707,18,1687,962,400,307
30,OLT,"MUNICIPIUL SLATINA",125347,SLATINA,"ŞCOALA GENERALĂ NR. 3",31,"Alegeri Prezidentiale",1,1346,701,611,90,0,671,30,1482,781,353,318
30,OLT,"MUNICIPIUL SLATINA",125347,SLATINA,"ŞCOALA GENERALĂ NR. 3",32,"Alegeri Prezidentiale",1,884,454,383,71,0,447,7,974,520,257,190
30,OLT,"MUNICIPIUL SLATINA",125347,SLATINA,"ŞCOALA GENERALĂ NR. 3",33,"Alegeri Prezidentiale",1,1604,714,669,45,0,695,19,1766,1052,399,296
30,OLT,"MUNICIPIUL SLATINA",125347,SLATINA,"GRUPUL ŞCOLAR METALURGIC",34,"Alegeri Prezidentiale",1,1624,705,629,76,0,689,16,1788,1083,396,293
30,OLT,"MUNICIPIUL SLATINA",125347,SLATINA,"GRUPUL ŞCOLAR METALURGIC",35,"Alegeri Prezidentiale",1,1647,645,620,25,0,630,15,1813,1168,392,238
30,OLT,"MUNICIPIUL SLATINA",125347,SLATINA,"GRUPUL ŞCOLAR METALURGIC",36,"Alegeri Prezidentiale",2,778,417,400,17,0,406,11,865,448,218,188
30,OLT,"MUNICIPIUL SLATINA",125347,SLATINA,"ŞCOALA GENERALĂ CONSTANTIN BRÂNCOVEANU",37,"Alegeri Prezidentiale",1,1170,631,495,136,0,615,16,1288,657,328,287
30,OLT,"MUNICIPIUL SLATINA",125347,SLATINA,"ŞCOALA GENERALĂ CONSTANTIN BRÂNCOVEANU",38,"Alegeri Prezidentiale",1,1561,638,590,48,0,619,19,1719,1081,380,239
30,OLT,"MUNICIPIUL SLATINA",125347,SLATINA,"ŞCOALA GENERALĂ CONSTANTIN BRÂNCOVEANU",39,"Alegeri Prezidentiale",1,1679,783,695,88,0,761,22,1848,1065,476,285
30,OLT,"MUNICIPIUL SLATINA",125347,SLATINA,"ŞCOALA GENERALĂ CONSTANTIN BRÂNCOVEANU",40,"Alegeri Prezidentiale",1,1441,720,671,49,0,699,21,1587,867,414,285
30,OLT,"MUNICIPIUL SLATINA",125347,SLATINA,"ŞCOALA GENERALĂ CONSTANTIN BRÂNCOVEANU",41,"Alegeri Prezidentiale",1,1602,701,664,37,0,681,20,1764,1063,419,262
30,OLT,"MUNICIPIUL SLATINA",125347,SLATINA,"GRĂDINIȚA CU PROGRAM NORMAL NR. 5",42,"Alegeri Prezidentiale",1,1659,938,879,59,0,916,22,1826,888,451,465
30,OLT,"MUNICIPIUL SLATINA",125347,SLATINA,"GRUPUL ŞCOLAR INDUSTRIAL CONSTRUCŢII MAŞINI",43,"Alegeri Prezidentiale",1,1511,766,655,111,0,745,21,1664,898,407,338
30,OLT,"MUNICIPIUL SLATINA",125347,SLATINA,"GRUPUL ŞCOLAR INDUSTRIAL CONSTRUCŢII MAŞINI",44,"Alegeri Prezidentiale",1,1508,739,659,80,0,725,14,1660,921,443,282
30,OLT,"MUNICIPIUL SLATINA",125347,SLATINA,"GRUPUL ŞCOLAR INDUSTRIAL CONSTRUCŢII MAŞINI",45,"Alegeri Prezidentiale",1,1619,754,705,49,0,733,21,1782,1028,451,282
30,OLT,"MUNICIPIUL SLATINA",125347,SLATINA,"ŞCOALA CIREAŞOV",46,"Alegeri Prezidentiale",1,1247,655,624,31,0,644,11,1373,718,355,289
30,OLT,"MUNICIPIUL SLATINA",125347,SLATINA,"ŞCOALA GENERALĂ GEORGE POBORAN",47,"Alegeri Prezidentiale",1,1354,736,654,81,1,719,17,1491,755,414,305
30,OLT,"MUNICIPIUL SLATINA",125347,SLATINA,"ŞCOALA GENERALĂ GEORGE POBORAN",48,"Alegeri Prezidentiale",1,1211,529,491,38,0,519,10,1334,805,281,238
30,OLT,"MUNICIPIUL CARACAL",125472,CARACAL,"COLEGIUL NAŢIONAL IONIŢĂ ASAN",49,"Alegeri Prezidentiale",1,1759,693,618,74,1,679,14,1936,1243,278,401
30,OLT,"MUNICIPIUL CARACAL",125472,CARACAL,"GRĂDINIŢA CU PROGRAM PRELUNGIT NR.1",50,"Alegeri Prezidentiale",1,1826,846,688,51,107,838,8,2010,1164,365,473
30,OLT,"MUNICIPIUL CARACAL",125472,CARACAL,"GRĂDINIŢA CU PROGRAM NORMAL NR.4",51,"Alegeri Prezidentiale",1,1577,853,700,52,101,837,16,1736,883,365,472
30,OLT,"MUNICIPIUL CARACAL",125472,CARACAL,"LICEUL TEHNOLOGIC CONSTANTIN FILIPESCU",52,"Alegeri Prezidentiale",1,1828,752,707,45,0,736,16,2012,1260,355,381
30,OLT,"MUNICIPIUL CARACAL",125472,CARACAL,"LICEUL MIHAI VITEAZUL",53,"Alegeri Prezidentiale",1,1422,694,597,64,33,676,18,1566,872,345,331
30,OLT,"MUNICIPIUL CARACAL",125472,CARACAL,"COLEGIUL TEHNIC MATEI BASARAB",54,"Alegeri Prezidentiale",1,1763,685,634,51,0,664,21,1941,1256,365,299
30,OLT,"MUNICIPIUL CARACAL",125472,CARACAL,"GRĂDINIŢA CU PROGRAM PRELUNGIT NR.3",55,"Alegeri Prezidentiale",1,1603,736,652,82,2,719,17,1765,1029,391,328
30,OLT,"MUNICIPIUL CARACAL",125472,CARACAL,"ŞCOALA GIMNAZIALĂ NICOLAE TITULESCU",56,"Alegeri Prezidentiale",1,1700,742,676,66,0,728,14,1871,1129,377,351
30,OLT,"MUNICIPIUL CARACAL",125472,CARACAL,"ŞCOALA GIMNAZIALĂ NICOLAE TITULESCU",57,"Alegeri Prezidentiale",1,1510,778,693,85,0,759,19,1662,884,380,379
30,OLT,"MUNICIPIUL CARACAL",125472,CARACAL,"ŞCOALA GIMNAZIALĂ NR.2",58,"Alegeri Prezidentiale",1,1616,828,732,96,0,808,20,1779,951,435,373
30,OLT,"MUNICIPIUL CARACAL",125472,CARACAL,"GRĂDINIȚA CU PROGRAM PRELUNGIT NR.4",59,"Alegeri Prezidentiale",2,1644,743,687,55,1,736,7,1810,1067,383,353
30,OLT,"MUNICIPIUL CARACAL",125472,CARACAL,"GRĂDINIȚA CU PROGRAM PRELUNGIT NR. 4",60,"Alegeri Prezidentiale",1,1744,758,697,61,0,743,15,1920,1162,355,388
30,OLT,"MUNICIPIUL CARACAL",125472,CARACAL,"CENTRUL CULTURAL MUNICIPAL CARACAL",61,"Alegeri Prezidentiale",1,1266,667,606,61,0,657,10,1394,727,335,322
30,OLT,"MUNICIPIUL CARACAL",125472,CARACAL,"ŞCOALA GIMNAZIALĂ GHEORGHE MAGHERU",62,"Alegeri Prezidentiale",1,1788,956,885,71,0,926,30,1968,1012,414,512
30,OLT,"MUNICIPIUL CARACAL",125472,CARACAL,"ŞCOALA GIMNAZIALĂ NR. 3",63,"Alegeri Prezidentiale",1,1714,847,809,37,1,827,20,1887,1040,422,405
30,OLT,"MUNICIPIUL CARACAL",125472,CARACAL,"ŞCOALA GIMNAZIALĂ NR. 3",64,"Alegeri Prezidentiale",1,1836,897,849,48,0,884,13,2021,1124,382,502
30,OLT,"MUNICIPIUL CARACAL",125472,CARACAL,"ŞCOALA GIMNAZIALĂ NR.1",65,"Alegeri Prezidentiale",1,1591,824,775,49,0,813,11,1753,929,436,377
30,OLT,"ORAŞ BALŞ",125418,BALŞ,"SCOALA GIMNAZIALĂ NR 3 ROMANA",66,"Alegeri Prezidentiale",1,938,437,411,26,0,428,9,1033,596,186,242
30,OLT,"ORAŞ BALŞ",125418,BALŞ,"SCOALA GIMNAZIALĂ NR 2 VIRTINA",67,"Alegeri Prezidentiale",1,1209,632,507,125,0,620,12,1339,707,329,291
30,OLT,"ORAŞ BALŞ",125418,BALŞ,"SCOALA GIMNAZIALA NR. 1 BALS",68,"Alegeri Prezidentiale",1,1206,460,419,40,1,450,10,1328,868,198,252
30,OLT,"ORAŞ BALŞ",125418,BALŞ,"SCOALA GIMNAZIALA SPECIALA",69,"Alegeri Prezidentiale",1,1740,676,621,53,2,653,23,1915,1239,300,353
30,OLT,"ORAŞ BALŞ",125418,BALŞ,"LICEUL TEORETIC PETRE PANDREA",70,"Alegeri Prezidentiale",1,1462,640,561,79,0,628,12,1610,970,350,278
30,OLT,"ORAŞ BALŞ",125418,BALŞ,"LICEUL TEORETIC PETRE PANDREA",71,"Alegeri Prezidentiale",1,1451,605,528,77,0,592,13,1598,993,298,294
30,OLT,"ORAŞ BALŞ",125418,BALŞ,"SCOALA GIMNAZIALĂ ”MIHAIL DRUMES”",72,"Alegeri Prezidentiale",1,1691,786,684,61,41,758,28,1862,1076,399,359
30,OLT,"ORAŞ BALŞ",125418,BALŞ,"SCOALA GIMNAZIALĂ ”MIHAIL DRUMES”",73,"Alegeri Prezidentiale",1,1393,585,528,57,0,573,12,1534,949,328,245
30,OLT,"ORAŞ BALŞ",125418,BALŞ,"GRADINITA CU PROGRAM NORMAL NR 1",74,"Alegeri Prezidentiale",1,1298,522,466,56,0,513,9,1429,907,288,225
30,OLT,"ORAŞ BALŞ",125418,BALŞ,"GRADINITA CU PROGRAM NORMAL NR 1",75,"Alegeri Prezidentiale",1,1228,515,462,53,0,500,15,1352,837,301,199
30,OLT,"ORAŞ BALŞ",125418,BALŞ,"COLEGIUL TEHNIC",76,"Alegeri Prezidentiale",1,1429,623,510,113,0,614,9,1573,950,339,275
30,OLT,"ORAŞ BALŞ",125418,BALŞ,"COLEGIUL TEHNIC",77,"Alegeri Prezidentiale",1,1466,561,502,58,1,554,7,1614,1053,332,222
30,OLT,"ORAŞ BALŞ",125418,BALŞ,"SCOALA GIMNAZIALA TEIS",78,"Alegeri Prezidentiale",1,631,328,281,47,0,327,1,696,368,193,134
30,OLT,"ORAŞ CORABIA",125542,CORABIA,"ŞCOALA GIMNAZIALĂ NR. 1",79,"Alegeri Prezidentiale",1,1486,670,622,48,0,646,24,1636,966,308,338
30,OLT,"ORAŞ CORABIA",125542,CORABIA,"ŞCOALA GIMNAZIALĂ DUMITRU BUZDUN",80,"Alegeri Prezidentiale",1,1176,720,596,86,38,709,11,1295,575,330,379
30,OLT,"ORAŞ CORABIA",125542,CORABIA,"SCOALA GIMNAZIALAVIRGIL MAZILESCU",81,"Alegeri Prezidentiale",1,1019,411,378,33,0,404,7,1122,711,190,214
30,OLT,"ORAŞ CORABIA",125542,CORABIA,"ŞCOALA GIMNAZIALĂ VIRGIL MAZILESCU",82,"Alegeri Prezidentiale",1,1117,547,494,52,1,543,4,1230,683,266,277
30,OLT,"ORAŞ CORABIA",125542,CORABIA,"ŞCOALA GIMNAZIALĂ VIRGIL MAZILESCU",83,"Alegeri Prezidentiale",1,936,411,384,27,0,399,12,1031,620,211,188
30,OLT,"ORAŞ CORABIA",125542,CORABIA,"COLEGIUL NAŢIONALAL I.CUZA",84,"Alegeri Prezidentiale",1,986,407,343,64,0,395,12,1086,679,221,174
30,OLT,"ORAŞ CORABIA",125542,CORABIA,"COLEGIUL NAŢIONALAL I.CUZA",85,"Alegeri Prezidentiale",1,1180,602,544,54,4,590,12,1299,697,288,302
30,OLT,"ORAŞ CORABIA",125542,CORABIA,"ŞCOALA GIMNAZIALĂ MIHAIL EMINESCU",86,"Alegeri Prezidentiale",1,1199,444,408,36,0,432,12,1320,876,190,242
30,OLT,"ORAŞ CORABIA",125542,CORABIA,"ŞCOALA GIMNAZIALĂMIHAIL EMINESCU",87,"Alegeri Prezidentiale",1,1159,452,429,23,0,444,8,1276,824,201,243
30,OLT,"ORAŞ CORABIA",125542,CORABIA,"SCOALA CORABIA VECHE",88,"Alegeri Prezidentiale",1,1526,648,587,50,11,638,10,1680,1032,336,302
30,OLT,"ORAŞ CORABIA",125542,CORABIA,"ŞCOALA GIMNAZIALĂ CELEIU",89,"Alegeri Prezidentiale",1,1433,804,751,41,12,791,13,1578,774,342,449
30,OLT,"ORAŞ CORABIA",125542,VÂRTOPU,"GRADINIŢA SAT VÎRTOPU",90,"Alegeri Prezidentiale",1,334,154,129,25,0,152,2,369,215,81,71
30,OLT,"ORAŞ CORABIA",125542,"TUDOR VLADIMIRESCU","ŞCOALA GIMNAZIALĂ SAT TUDOR VLADIMIRESCU",91,"Alegeri Prezidentiale",1,487,243,219,23,1,243,0,537,294,149,94
30,OLT,"ORAŞ CORABIA",125542,CORABIA,"ŞCOALA CARTIER SILIŞTIOARA",92,"Alegeri Prezidentiale",1,421,236,207,28,1,234,2,465,229,112,122
30,OLT,"ORAŞ DRĂGĂNEŞTI-OLT",125622,DRĂGĂNEŞTI-OLT,"LICEUL T.VLADIMIRESCU DRĂGĂNEŞTI-OLT",93,"Alegeri Prezidentiale",1,1623,791,691,99,1,775,16,1787,996,396,379
30,OLT,"ORAŞ DRĂGĂNEŞTI-OLT",125622,DRĂGĂNEŞTI-OLT,"LICEUL T.VLADIMIRESCU DRĂGĂNEŞTI-OLT",94,"Alegeri Prezidentiale",1,1565,709,654,54,1,699,10,1723,1014,344,355
30,OLT,"ORAŞ DRĂGĂNEŞTI-OLT",125622,DRĂGĂNEŞTI-OLT,"LICEUL TEHNOLOGIC DRĂGĂNEŞTI-OLT",95,"Alegeri Prezidentiale",1,1194,420,387,32,1,411,9,1315,895,184,227
30,OLT,"ORAŞ DRĂGĂNEŞTI-OLT",125622,DRĂGĂNEŞTI-OLT,"LICEUL TEHNOLOGIC DRĂGĂNEŞTI-OLT",96,"Alegeri Prezidentiale",2,864,288,262,26,0,282,6,952,664,124,158
30,OLT,"ORAŞ DRĂGĂNEŞTI-OLT",125622,DRĂGĂNEŞTI-OLT,"LICEUL TEORETIC TUDOR VLADIMIRESCU",97,"Alegeri Prezidentiale",1,1813,889,835,54,0,863,26,1996,1107,459,404
30,OLT,"ORAŞ DRĂGĂNEŞTI-OLT",125622,COMANI,"ŞCOALA GIMNAZIALĂ COMANI",98,"Alegeri Prezidentiale",1,1172,620,555,62,3,614,6,1291,671,273,341
30,OLT,"ORAŞ DRĂGĂNEŞTI-OLT",125622,COMANI,"ŞCOALA GIMNAZIALĂ COMANI",99,"Alegeri Prezidentiale",1,1277,602,566,36,0,592,10,1406,804,294,298
30,OLT,"ORAŞ PIATRA-OLT",128105,PIATRA-OLT,"SALA DE SPORT PIATRA - OLT",100,"Alegeri Prezidentiale",1,967,552,489,59,4,545,7,1065,513,270,275
30,OLT,"ORAŞ PIATRA-OLT",128105,PIATRA-OLT,"SALA DE SPORT PIATRA - OLT",101,"Alegeri Prezidentiale",1,922,587,490,91,6,578,9,1016,429,267,311
30,OLT,"ORAŞ PIATRA-OLT",128105,"BISTRIŢA NOUĂ","SCOALA GENERALA CU CLASELE I-IV",102,"Alegeri Prezidentiale",1,420,261,222,35,4,255,6,462,201,103,152
30,OLT,"ORAŞ PIATRA-OLT",128105,"CRIVA DE SUS","GRADINITA CU PROGRAM NORMAL",103,"Alegeri Prezidentiale",1,967,737,542,188,7,724,13,1065,328,355,369
30,OLT,"ORAŞ PIATRA-OLT",128105,ENOŞEŞTI,"GRADINITA CU PROGRAM NORMAL",104,"Alegeri Prezidentiale",1,266,236,169,66,1,235,1,293,57,96,139
30,OLT,"ORAŞ PIATRA-OLT",128105,PIATRA,"GRADINITA CU PROGRAM NORMAL PIATRA",105,"Alegeri Prezidentiale",1,707,446,363,70,13,435,11,778,332,165,270
30,OLT,"ORAŞ PIATRA-OLT",128105,PIATRA,"GRADINITA PIATRA",106,"Alegeri Prezidentiale",1,952,654,555,94,5,638,16,1048,394,345,293
30,OLT,"ORAŞ POTCOAVA",128374,POTCOAVA,"ŞCOALA CU CLASELE. I-IV FĂLCOIENI",107,"Alegeri Prezidentiale",1,813,527,410,114,3,522,5,895,368,191,331
30,OLT,"ORAŞ POTCOAVA",128374,POTCOAVA,"LICEUL ”ŞTEFAN DIACONESCU” POTCOAVA",108,"Alegeri Prezidentiale",1,1254,756,655,100,1,744,12,1380,624,252,492
30,OLT,"ORAŞ POTCOAVA",128374,POTCOAVA,"LICEUL ”ŞTEFAN DIACONESCU” POTCOAVA",109,"Alegeri Prezidentiale",1,1134,583,553,27,3,577,6,1248,665,174,403
30,OLT,"ORAŞ POTCOAVA",128374,SINEŞTI,"ŞCOALA GENERALĂ SINEŞTI",110,"Alegeri Prezidentiale",2,1579,915,833,80,2,898,17,1737,822,400,498
30,OLT,"ORAŞ SCORNICEŞTI",128711,SCORNICEŞTI,"GRUPUL SCOLAR AGRICOL SCORNICEŞTI",111,"Alegeri Prezidentiale",2,1816,849,724,74,51,836,13,1899,1050,449,387
30,OLT,"ORAŞ SCORNICEŞTI",128711,SCORNICEŞTI,"SCOALA GEN.CLASELE I-VIII SCORNICESTI",112,"Alegeri Prezidentiale",1,1912,855,771,84,0,827,28,1904,1049,454,373
30,OLT,"ORAŞ SCORNICEŞTI",128711,MĂRGINENI-SLOBOZIA,"SCOALA GENERALA MĂRGINENI",113,"Alegeri Prezidentiale",1,1548,1124,878,246,0,1092,32,1703,579,607,485
30,OLT,"ORAŞ SCORNICEŞTI",128711,NEGRENI,"SCOALA GENERALA NEGRENI",114,"Alegeri Prezidentiale",1,996,482,419,63,0,471,11,1096,614,238,233
30,OLT,"ORAŞ SCORNICEŞTI",128711,BIRCII,"SCOALA GENERLA BIRCII",115,"Alegeri Prezidentiale",1,884,916,452,464,0,903,13,974,58,576,327
30,OLT,"ORAŞ SCORNICEŞTI",128711,MOGOŞEŞTI,"GRADINITA MOGOSESTI",116,"Alegeri Prezidentiale",1,435,259,202,57,0,254,5,479,220,141,113
30,OLT,"ORAŞ SCORNICEŞTI",128711,CONSTANTINEŞTI,"GRADINITA CONSTANTINESTI",117,"Alegeri Prezidentiale",1,449,303,262,41,0,302,1,494,191,117,185
30,OLT,"ORAŞ SCORNICEŞTI",128711,TEIUŞ,"GRADINITA TEIUS",118,"Alegeri Prezidentiale",1,456,206,181,25,0,202,4,502,296,83,119
30,OLT,"ORAŞ SCORNICEŞTI",128711,ŞUICA,"GRADINITA ȘUICA",119,"Alegeri Prezidentiale",1,200,124,101,23,0,119,5,220,96,52,67
30,OLT,"ORAŞ SCORNICEŞTI",128711,JITARU,JITARU,120,"Alegeri Prezidentiale",1,828,601,479,122,0,594,7,911,310,357,237
30,OLT,"ORAŞ SCORNICEŞTI",128711,CHIŢEASCA,"SCOALA GENERALA CHIȚEASCA",121,"Alegeri Prezidentiale",1,386,332,243,89,0,326,6,425,93,143,183
30,OLT,BALDOVINEŞTI,125677,BALDOVINEŞTI,"ŞCOALA GENERALĂ CU CLASELE I-VIII BALDOVINEŞTI",122,"Alegeri Prezidentiale",1,494,397,263,115,19,393,4,544,147,161,232
30,OLT,BALDOVINEŞTI,125677,PIETRIŞ,GRĂDINIŢĂ,123,"Alegeri Prezidentiale",1,279,213,159,47,7,211,2,307,94,55,156
30,OLT,BALDOVINEŞTI,125677,GUBANDRU,"ŞCOALA GENERALĂ CU CLASELE I-IV GUBANDRU",124,"Alegeri Prezidentiale",1,98,81,52,22,7,80,1,108,27,15,65
30,OLT,BĂBICIU,125659,BĂBICIU,"CĂMINUL CULTURAL BĂBICIU",125,"Alegeri Prezidentiale",1,718,518,407,63,48,514,4,790,272,169,345
30,OLT,BĂBICIU,125659,BĂBICIU,"CĂMINUL CULTURAL BĂBICIU",126,"Alegeri Prezidentiale",1,984,668,487,135,46,662,6,1083,415,238,424
30,OLT,BĂLTENI,130286,BĂLTENI,"ŞCOALA GIMNAZIALĂ ” ION I.GRAURE ” BĂLTENI",127,"Alegeri Prezidentiale",1,1337,707,617,90,0,700,7,1471,764,235,465
30,OLT,BĂRĂŞTI,125757,"BĂRĂŞTII DE VEDE","ŞCOALA GENERALĂ CLASELE I-VIII",128,"Alegeri Prezidentiale",1,660,606,381,217,8,598,8,726,120,263,335
30,OLT,BĂRĂŞTI,125757,"BĂRĂŞTII DE CEPTURI","ŞCOALA GENERALĂ CLASELE I-IV.",129,"Alegeri Prezidentiale",1,404,337,236,92,9,328,9,445,108,120,208
30,OLT,BĂRĂŞTI,125757,MOŢOEŞTI,"SEDIU FOSTĂ BRIGADĂ AGRICOLĂ",130,"Alegeri Prezidentiale",2,55,137,35,102,0,134,3,162,25,23,111
30,OLT,BÂRZA,125846,BÂRZA,"ȘCOALA GIMNAZIALĂ BÎRZA",131,"Alegeri Prezidentiale",1,902,529,459,70,0,519,10,993,464,239,280
30,OLT,BÂRZA,125846,BRANEŢ,"SCOALA GIMNAZIALĂ BRANEȚ",132,"Alegeri Prezidentiale",1,1269,599,521,78,0,596,3,1396,797,226,370
30,OLT,BOBICEŞTI,125873,BOBICEŞTI,"CAMINUL CULTURAL BOBICESTI",133,"Alegeri Prezidentiale",1,841,354,312,42,0,352,2,926,572,143,209
30,OLT,BOBICEŞTI,125873,BECHET,"SCOALA GENERALA BECHET",134,"Alegeri Prezidentiale",1,292,164,135,29,0,162,2,322,158,51,111
30,OLT,BOBICEŞTI,125873,CHINTEŞTI,"SCOALA GENERALA CHINTESTI",135,"Alegeri Prezidentiale",1,212,97,77,20,0,94,3,234,137,29,65
30,OLT,BOBICEŞTI,125873,LEOTEŞTI,"CĂMINUL CULTURAL",136,"Alegeri Prezidentiale",1,1270,574,501,73,0,565,9,1397,823,257,308
30,OLT,BRASTAVĂŢU,125962,BRASTAVĂŢU,"ŞCOALA GENERALĂ CU CLASELE I-VIII BRASTAVĂŢU",137,"Alegeri Prezidentiale",1,1270,642,528,81,33,635,7,1397,755,308,327
30,OLT,BRASTAVĂŢU,125962,BRASTAVĂŢU,"ŞCOALA GENERALĂ CU CLASELE I-VIII BRASTAVĂŢU",138,"Alegeri Prezidentiale",2,1401,687,571,66,50,683,4,1542,855,306,377
30,OLT,BRASTAVĂŢU,125962,CRUŞOVU,"ŞCOALA GENERALĂ CRUŞOVU",139,"Alegeri Prezidentiale",1,885,450,374,40,36,448,2,974,524,200,248
30,OLT,BRÂNCOVENI,126022,BRÂNCOVENI,"ȘCOALA GIMNAZIALĂ ”VOIEVOD BRÂNCOVEANU”",140,"Alegeri Prezidentiale",1,868,535,454,81,0,529,6,955,420,151,378
30,OLT,BRÂNCOVENI,126022,OCIOGI,"ŞCOALA GIMNAZIALĂ MATEI BASARAB",141,"Alegeri Prezidentiale",1,898,610,503,107,0,606,4,988,378,243,363
30,OLT,BRÂNCOVENI,126022,VĂLENI,"GRĂDINIŢA CU PROGRAM NORMAL DOMNIŢA BĂLAŞA",142,"Alegeri Prezidentiale",1,409,265,227,38,0,260,5,450,185,72,188
30,OLT,BREBENI,125999,BREBENI,"ŞCOALA CU CLASELE I-IV BREBENI",143,"Alegeri Prezidentiale",1,919,436,350,86,0,428,8,1011,575,255,173
30,OLT,BREBENI,125999,BREBENI,"ŞCOALA GIMNAZIALĂ BREBENI",144,"Alegeri Prezidentiale",1,1296,661,501,159,1,651,10,1426,765,303,348
30,OLT,BUCINIŞU,126077,BUCINIŞU,"ŞCOALA GENERALĂ BUCINIŞU",145,"Alegeri Prezidentiale",2,1595,991,842,149,0,980,11,1755,764,592,388
30,OLT,CĂLUI,130295,CĂLUI,"SCOALA GIMNAZIALA CALUI",146,"Alegeri Prezidentiale",1,740,440,354,68,18,426,14,814,374,156,270
30,OLT,CĂLUI,130295,"GURA CĂLUIU","GRADINITA CU PROGRAM NORMAL GURA CALUIU",147,"Alegeri Prezidentiale",1,485,274,233,38,3,267,7,534,260,123,144
30,OLT,CÂRLOGANI,126166,CÂRLOGANI,"SCOALA GIMNAZIALĂ CÎRLOGANI",148,"Alegeri Prezidentiale",2,1174,675,577,98,0,670,5,1293,618,163,507
30,OLT,CÂRLOGANI,126166,CEPARI,"SCOALA GIMNAZIALĂ CEPARI",149,"Alegeri Prezidentiale",1,717,441,364,77,0,435,6,789,348,131,304
30,OLT,CEZIENI,126102,CEZIENI,"SCOALA GIMANZIALA NICOLAE MARINEANU",150,"Alegeri Prezidentiale",1,974,564,458,106,0,558,6,1072,508,219,339
30,OLT,CEZIENI,126102,BONDREA,"CAMIN CULTURAL",151,"Alegeri Prezidentiale",1,180,99,87,12,0,97,2,198,99,38,59
30,OLT,CEZIENI,126102,CORLĂTEŞTI,"CENTRUL SOCIAL",152,"Alegeri Prezidentiale",1,270,163,129,34,0,161,2,297,134,65,96
30,OLT,CILIENI,126148,CILIENI,"LICEUL TEHNOLOGIC ION POPESCU CILIENI",153,"Alegeri Prezidentiale",1,1259,668,606,62,0,664,4,1385,717,234,430
30,OLT,CILIENI,126148,CILIENI,"LICEUL TEHNOLOGIC ION POPESCU CILIENI",154,"Alegeri Prezidentiale",1,1385,700,648,49,3,694,6,1524,824,231,463
30,OLT,COLONEŞTI,126228,COLONEŞTI,"CAMINUL CULTURAL ILIE MARTIN",155,"Alegeri Prezidentiale",1,576,633,317,291,25,630,3,634,1,177,453
30,OLT,COLONEŞTI,126228,BĂTĂRENI,"GRADINITA CU PROGRAM NORMAL BATARENI",156,"Alegeri Prezidentiale",1,151,209,94,110,5,209,0,267,58,5,204
30,OLT,COLONEŞTI,126228,MĂRUNŢEI,"SCOALA GENERALA MARIA TUDORACHE",157,"Alegeri Prezidentiale",1,327,311,189,108,14,310,1,360,49,89,221
30,OLT,COLONEŞTI,126228,VLAICI,"GRADINITA CU PROGRAM NORMAL VLAICI",158,"Alegeri Prezidentiale",1,277,309,151,146,12,305,4,405,96,79,226
30,OLT,CORBU,126326,CORBU,"ŞCOALA GIMNAZIALĂ CORBU",159,"Alegeri Prezidentiale",1,846,506,396,72,38,498,8,931,425,151,347
30,OLT,CORBU,126326,BUZEŞTI,"ŞCOALA GIMNAZIALĂ BUZEŞTI",160,"Alegeri Prezidentiale",1,505,401,316,69,16,399,2,556,155,111,288
30,OLT,CORBU,126326,MILCOVENI,"GRĂDINIŢA MILCOVENI",161,"Alegeri Prezidentiale",1,356,246,191,38,17,242,4,392,146,78,164
30,OLT,COTEANA,126380,COTEANA,"ŞCOALA GIMNAZIALĂ COTEANA",162,"Alegeri Prezidentiale",1,946,692,523,164,5,680,12,1041,349,394,286
30,OLT,COTEANA,126380,COTEANA,"ŞCOALA GIMNAZIALĂ COTEANA",163,"Alegeri Prezidentiale",1,883,717,484,225,8,703,14,972,255,391,312
30,OLT,CRÂMPOIA,126406,CRÂMPOIA,"LICEUL TEHNOLOGIC CRÎMPOIA",164,"Alegeri Prezidentiale",1,1118,516,468,48,0,513,3,1230,714,250,263
30,OLT,CRÂMPOIA,126406,CRÂMPOIA,"LICEUL TEHNOLOGIC CRÎMPOIA",165,"Alegeri Prezidentiale",1,1166,477,415,62,0,472,5,1283,806,248,224
30,OLT,CRÂMPOIA,126406,BUTA,"SCOALA CU CLASELE I-IV BUTA",166,"Alegeri Prezidentiale",1,637,313,276,37,0,309,4,701,388,172,137
30,OLT,CUNGREA,126503,CUNGREA,"PRIMĂRIE,STR.PRIMĂRIEI,NR.8",167,"Alegeri Prezidentiale",1,683,587,378,209,0,578,9,752,165,418,160
30,OLT,CUNGREA,126503,CEPEŞTI,"ŞCOALA GIMNAZIALĂ CEPEŞTI",168,"Alegeri Prezidentiale",2,648,520,404,116,0,519,1,713,193,285,234
30,OLT,CUNGREA,126503,SPĂTARU,"ŞCOALA GIMNAZIALĂ SPĂTARU",169,"Alegeri Prezidentiale",2,229,229,137,92,0,227,2,253,24,158,69
30,OLT,CURTIŞOARA,126433,CURTIŞOARA,"ŞCOALA CU CLASELE I-VIII CURTIŞOARA",170,"Alegeri Prezidentiale",2,1298,845,574,271,0,827,18,1428,583,368,459
30,OLT,CURTIŞOARA,126433,DOBROTINET,"ŞCOALA CU CLASELE I-VIII DOBROTINET",171,"Alegeri Prezidentiale",1,1349,871,716,155,0,858,13,1484,613,365,493
30,OLT,CURTIŞOARA,126433,PROASPEŢI,"ŞCOALA CU CLASELE I-IV PROASPEŢI",172,"Alegeri Prezidentiale",1,960,607,482,125,0,599,8,1056,449,237,362
30,OLT,DĂNEASA,126585,DĂNEASA,"CENTRUL SOCIAL DĂNEASA",173,"Alegeri Prezidentiale",1,1170,526,470,56,0,521,5,1287,761,253,268
30,OLT,DĂNEASA,126585,BERINDEI,"SCOALA BERINDEI",174,"Alegeri Prezidentiale",1,446,254,191,59,4,251,3,491,237,88,163
30,OLT,DĂNEASA,126585,CIOFLANU,"GRADINITA CIOFLANU",175,"Alegeri Prezidentiale",1,500,235,198,36,1,230,5,550,315,108,122
30,OLT,DĂNEASA,126585,PESTRA,"CAMINUL CULTURAL",176,"Alegeri Prezidentiale",1,422,209,179,25,5,201,8,465,256,95,106
30,OLT,DĂNEASA,126585,ZĂNOAGA,"SCOALA ZANOAGA",177,"Alegeri Prezidentiale",1,342,188,163,25,0,185,3,377,189,85,100
30,OLT,DEVESELU,126647,DEVESELU,"CĂMINUL CULTURAL",178,"Alegeri Prezidentiale",1,1364,824,649,97,78,803,21,1493,669,370,433
30,OLT,DEVESELU,126647,COMANCA,"CĂMINUL CULTURAL",179,"Alegeri Prezidentiale",1,1021,549,465,49,35,541,8,1124,575,229,312
30,OLT,DEVESELU,126647,DEVESELU,"CASA ARMATEI",180,"Alegeri Prezidentiale",1,236,88,72,16,0,85,3,258,170,49,36
30,OLT,DOBREŢU,126674,CURTIŞOARA,"CĂMINUL CULTURAL CURTIŞOARA",181,"Alegeri Prezidentiale",1,640,350,276,63,11,348,2,704,354,141,207
30,OLT,DOBREŢU,126674,HOREZU,"CĂMINUL CULTURAL HOREZU",182,"Alegeri Prezidentiale",1,377,330,242,71,17,324,6,415,85,82,242
30,OLT,DOBROSLOVENI,126718,DOBROSLOVENI,"SCOALA GIMNAZIALA DOBROSLOVENI",183,"Alegeri Prezidentiale",2,1102,541,487,54,0,535,6,1215,674,275,260
30,OLT,DOBROSLOVENI,126718,FRĂSINETU,"GRADINITA CU PROGRAM NORMAL FRASINETU",184,"Alegeri Prezidentiale",2,355,224,182,42,0,221,3,390,166,109,112
30,OLT,DOBROSLOVENI,126718,POTOPINU,"GRADINITA CU PROGRAM NORMAL POTOPINU",185,"Alegeri Prezidentiale",1,555,209,188,21,0,209,0,611,402,75,134
30,OLT,DOBROSLOVENI,126718,REŞCA,"SCOALA CU CLASELE I-VIII RESCA",186,"Alegeri Prezidentiale",1,1009,436,400,36,0,430,6,1110,674,206,224
30,OLT,DOBROTEASA,126772,DOBROTEASA,"ŞCOALA GIMNAZIALĂ CU CLASELE I-VIII DOBROTEASA",187,"Alegeri Prezidentiale",1,1273,816,631,185,0,805,11,1401,585,247,558
30,OLT,DOBRUN,126825,DOBRUN,"SCOALA DOBRUN",188,"Alegeri Prezidentiale",1,591,408,350,37,21,405,3,651,243,56,349
30,OLT,DOBRUN,126825,"ROŞIENII MARI","ȘCOALA ROȘIENII MARI",189,"Alegeri Prezidentiale",1,607,429,352,49,28,426,3,668,239,117,309
30,OLT,DRĂGHICENI,125490,DRĂGHICENI,"ŞCOALA GENERALĂ CU CLASELE I-VIII DRĂGHICENI",190,"Alegeri Prezidentiale",1,1509,842,722,119,1,833,9,1660,818,398,435
30,OLT,FĂGEŢELU,126905,FĂGEŢELU,"ŞCOALA GIMNAZIALĂ FĂGEŢELU",191,"Alegeri Prezidentiale",1,435,296,182,114,0,295,1,479,183,118,177
30,OLT,FĂGEŢELU,126905,CHILIA,"ŞCOALA CU CLASELE I-VIII CHILIA",192,"Alegeri Prezidentiale",1,251,256,133,123,0,254,2,277,21,94,160
30,OLT,FĂLCOIU,126978,FĂLCOIU,"ŞCOALA CU CLASELE I-VIII FĂLCOIU",193,"Alegeri Prezidentiale",1,974,489,373,47,69,485,4,1072,583,133,352
30,OLT,FĂLCOIU,126978,FĂLCOIU,"ŞCOALA CU CLASELE I-VIII FĂLCOIU",194,"Alegeri Prezidentiale",1,1045,497,382,71,44,492,5,1150,653,157,335
30,OLT,FĂLCOIU,126978,CIOROIAŞU,"ŞCOALA CU CLASELE I-VIII CIOROIU",195,"Alegeri Prezidentiale",1,1059,509,414,74,21,503,6,1165,656,246,257
30,OLT,FĂRCAŞELE,127019,FĂRCAŞELE,"GRADINITA FARCASELE",196,"Alegeri Prezidentiale",1,965,436,407,29,0,433,3,1062,626,196,237
30,OLT,FĂRCAŞELE,127019,"FĂRCAŞU DE JOS","GRADINITA FARCASU DE JOS",197,"Alegeri Prezidentiale",1,1470,753,683,66,4,743,10,1617,864,330,413
30,OLT,FĂRCAŞELE,127019,GHIMPAŢI,"SCOALA GIMNAZIALA FARCASELE",198,"Alegeri Prezidentiale",1,724,328,294,34,0,326,2,797,469,116,210
30,OLT,FĂRCAŞELE,127019,HOTĂRANI,"SCOALA GIMNAZIALA HOTARANI",199,"Alegeri Prezidentiale",1,736,335,312,23,0,331,4,810,475,133,198
30,OLT,GĂNEASA,127064,GĂNEASA,"ŞCOALA GIIMNAZIALĂ GĂNEASA",200,"Alegeri Prezidentiale",2,1476,951,742,194,15,929,22,1624,673,390,539
30,OLT,GĂNEASA,127064,DRANOVĂŢU,"ŞCOALA VECHE DRANOVĂŢU",201,"Alegeri Prezidentiale",1,878,721,488,226,7,716,5,966,245,250,466
30,OLT,GĂNEASA,127064,IZVORU,"ŞCOALA PRIMARĂ IZVORU",202,"Alegeri Prezidentiale",1,566,463,340,118,5,447,16,623,160,115,332
30,OLT,GĂVĂNEŞTI,130302,GĂVĂNEŞTI,"GRĂDINIŢA CU PROGRAM NORMAL GĂVĂNEŞTI",203,"Alegeri Prezidentiale",1,597,366,298,61,7,363,3,657,291,87,276
30,OLT,GĂVĂNEŞTI,130302,BĂLEASA,"SCOALA CU CLASELE I-VIII BALEASA",204,"Alegeri Prezidentiale",1,682,437,363,58,16,433,4,751,314,125,308
30,OLT,GĂVĂNEŞTI,130302,BROŞTENI,"SCOALA CU CLS.I-IV BROSTENI",205,"Alegeri Prezidentiale",1,311,203,164,32,7,203,0,343,140,53,150
30,OLT,GÂRCOV,125588,GÂRCOV,"GRĂDINIŢA CU PROGRAM NORMAL GÎRCOV",206,"Alegeri Prezidentiale",2,1235,655,589,44,22,650,5,1359,704,176,474
30,OLT,GÂRCOV,125588,URSA,"ŞCOALA GENERALĂ URSA",207,"Alegeri Prezidentiale",1,701,360,321,22,17,357,3,772,412,103,254
30,OLT,GHIMPEŢENI,130311,"GHIMPEŢENII NOI","GRĂDINIŢA CU PROGRAM NORMAL",208,"Alegeri Prezidentiale",1,380,236,212,20,4,234,2,418,182,83,151
30,OLT,GHIMPEŢENI,130311,GHIMPEŢENI,"ŞCOALA GIMNAZIALĂ GHIMPEŢENI",209,"Alegeri Prezidentiale",1,820,455,392,50,13,452,3,902,447,135,317
30,OLT,GIUVĂRĂŞTI,127126,GIUVĂRĂŞTI,"ŞCOALA CU CLASELE I-VIII GIUVĂRĂŞTI",210,"Alegeri Prezidentiale",1,965,423,380,43,0,415,8,1067,644,175,240
30,OLT,GIUVĂRĂŞTI,127126,GIUVĂRĂŞTI,"ŞCOALA CU CLASELE I-VIII GIUVĂRĂŞTI",211,"Alegeri Prezidentiale",1,906,450,423,27,0,445,5,997,547,168,277
30,OLT,GOSTAVĂŢU,127144,GOSTAVĂŢU,"ŞCOALA GENERALĂ GOSTAVĂŢU",212,"Alegeri Prezidentiale",1,1291,595,521,74,0,591,4,1421,826,251,340
30,OLT,GOSTAVĂŢU,127144,SLĂVENI,"CĂMINUL CULTURAL SLĂVENI",213,"Alegeri Prezidentiale",1,1089,532,462,70,0,524,8,1198,666,231,293
30,OLT,GRĂDINARI,127171,GRĂDINARI,"ŞCOALA GIMNAZIALĂ GRĂDINARI",214,"Alegeri Prezidentiale",1,808,419,357,62,0,413,6,889,470,139,274
30,OLT,GRĂDINARI,127171,PETCULEŞTI,"ŞCOALA PRIMARĂ PETCULEŞTI",215,"Alegeri Prezidentiale",1,859,306,273,33,0,305,1,945,639,43,262
30,OLT,GRĂDINARI,127171,"SATU NOU","ŞCOALA GENERALĂ I-IV SATU NOU",216,"Alegeri Prezidentiale",1,242,159,113,46,0,156,3,267,108,57,99
30,OLT,GRĂDINILE,130320,GRĂDINILE,"CENTRUL SOCIAL GRĂDINILE",217,"Alegeri Prezidentiale",1,1217,677,564,93,20,668,9,1339,662,251,417
30,OLT,GROJDIBODU,127224,GROJDIBODU,"GRĂDINIȚA CU PROGRAM NORMAL",218,"Alegeri Prezidentiale",1,844,458,403,45,10,456,2,929,471,169,287
30,OLT,GROJDIBODU,127224,GROJDIBODU,"GRĂDINIȚA CU PROGRAM NORMAL",219,"Alegeri Prezidentiale",1,878,384,331,42,11,379,5,966,582,162,217
30,OLT,GROJDIBODU,127224,HOTARU,"PRIMĂRIA VECHE HOTARU",220,"Alegeri Prezidentiale",1,585,314,277,29,8,310,4,644,330,82,228
30,OLT,"GURA PADINII",130339,"GURA PADINII","CĂMIN CULTURAL",221,"Alegeri Prezidentiale",1,1441,910,786,68,56,903,7,1586,676,368,535
30,OLT,IANCA,127251,IANCA,"SCOALA GIMNAZIALA ADA UMBRA IANCA",222,"Alegeri Prezidentiale",1,1054,488,447,29,12,485,3,1160,672,221,264
30,OLT,IANCA,127251,IANCA,"SCOALA GIMNAZIALA ADA UMBRA IANCA",223,"Alegeri Prezidentiale",1,1034,601,523,56,22,599,2,1138,537,234,365
30,OLT,IANCA,127251,POTELU,"SCOALA GIMNAZIALA GEORGE VISAN POTELU",224,"Alegeri Prezidentiale",1,999,627,531,77,19,620,7,1099,472,188,432
30,OLT,"IANCU JIANU",127288,"IANCU JIANU","SCOALA GENERALA NR 1 IANCU JIANU",225,"Alegeri Prezidentiale",1,1435,757,674,83,0,750,7,1571,814,510,240
30,OLT,"IANCU JIANU",127288,"IANCU JIANU","LICEUL IANCU JIANU",226,"Alegeri Prezidentiale",1,1284,672,607,65,0,665,7,1413,741,446,219
30,OLT,"IANCU JIANU",127288,DOBRICENI,"ŞCOALA GIMNAZIALĂ DOBRICENI",227,"Alegeri Prezidentiale",3,808,493,393,100,0,485,8,889,396,335,150
30,OLT,ICOANA,127322,ICOANA,"SCOALA GIMNAZIALA ICOANA",228,"Alegeri Prezidentiale",1,535,372,286,86,0,365,7,589,217,120,245
30,OLT,ICOANA,127322,FLORU,"CAMINUL CULTURAL FLORU",229,"Alegeri Prezidentiale",1,369,255,182,73,0,250,5,406,151,83,167
30,OLT,ICOANA,127322,URSOAIA,"SCOALA GIMNAZIALA URSOAIA",230,"Alegeri Prezidentiale",1,546,364,291,73,0,349,15,601,237,193,156
30,OLT,IPOTEŞTI,130348,IPOTEŞTI,"BAZA SPORTIVĂ",231,"Alegeri Prezidentiale",1,1203,584,470,114,0,579,5,1324,740,211,368
30,OLT,IZBICENI,127368,IZBICENI,"ŞCOALA VECHE",232,"Alegeri Prezidentiale",1,937,440,421,19,0,434,6,1031,591,164,270
30,OLT,IZBICENI,127368,IZBICENI,"GRĂDINIŢA CU PROGRAM NORMAL IZBICENI",233,"Alegeri Prezidentiale",1,1528,696,643,52,1,689,7,1681,985,291,398
30,OLT,IZBICENI,127368,IZBICENI,"ŞCOALA NOUA",234,"Alegeri Prezidentiale",1,1372,684,648,36,0,674,10,1510,826,311,363
30,OLT,IZVOARELE,127386,IZVOARELE,"LICEUL TEHNOLOGIC IZVOARELE",235,"Alegeri Prezidentiale",1,920,461,366,95,0,450,11,1012,551,173,277
30,OLT,IZVOARELE,127386,ALIMĂNEŞTI,"SCOALA GENERALA CU CLASELE I-VIII ALIMANESTI",236,"Alegeri Prezidentiale",1,1882,862,779,83,0,849,13,2071,1209,380,469
30,OLT,LELEASCA,127411,LELEASCA,"CAMIN CULTURAL LELEASCA",237,"Alegeri Prezidentiale",1,436,298,202,96,0,295,3,480,182,111,184
30,OLT,LELEASCA,127411,TONEŞTI,"SCOALA GENERALA TONESTI",238,"Alegeri Prezidentiale",1,283,246,137,109,0,245,1,312,66,131,114
30,OLT,LELEASCA,127411,URŞI,"CAMINUL CULTURAL URSI",239,"Alegeri Prezidentiale",1,380,315,199,116,0,310,5,418,103,136,174
30,OLT,MĂRUNŢEI,127493,MĂRUNŢEI,"ŞCOALA PRIMARĂ VIIŞOARA",240,"Alegeri Prezidentiale",1,837,268,236,32,0,266,2,921,653,132,134
30,OLT,MĂRUNŢEI,127493,MĂRUNŢEI,"ŞCOALA CU CLASELE I-VIII MĂRUNŢEI",241,"Alegeri Prezidentiale",1,1172,415,370,45,0,411,4,1290,875,213,198
30,OLT,MĂRUNŢEI,127493,BĂLĂNEŞTI,"ŞCOALA CU CLASELE I-VIII BĂLĂNEŞTI",242,"Alegeri Prezidentiale",1,1140,489,422,67,0,477,12,1254,765,170,307
30,OLT,MĂRUNŢEI,127493,"MALU ROŞU","ŞCOALA PRIMARĂ MALU-ROŞU",243,"Alegeri Prezidentiale",1,120,85,49,36,0,85,0,132,47,37,48
30,OLT,MIHĂEŞTI,127536,MIHĂEŞTI,"ŞCOALA MIHĂEŞTI",244,"Alegeri Prezidentiale",1,663,502,344,158,0,498,4,730,228,280,218
30,OLT,MIHĂEŞTI,127536,BUŞCA,"ŞCOALA BUSCA",245,"Alegeri Prezidentiale",1,524,401,311,90,0,394,7,577,176,248,146
30,OLT,MILCOV,127563,"MILCOVU DIN VALE","ŞCOALA GENERALĂ",246,"Alegeri Prezidentiale",1,203,220,134,86,0,220,0,324,104,82,138
30,OLT,MILCOV,127563,ULMI,"CĂMINUL CULTURAL ULMI",247,"Alegeri Prezidentiale",1,551,320,244,76,0,319,1,607,287,128,191
30,OLT,MILCOV,127563,"MILCOVU DIN DEAL","ŞCOALA GENERALĂ CU CLASELE I-VIII",248,"Alegeri Prezidentiale",1,492,334,222,112,0,328,6,542,208,157,171
30,OLT,MORUNGLAV,127625,MORUNGLAV,"CAMINUL CULTURAL",249,"Alegeri Prezidentiale",1,1196,511,454,57,0,504,7,1316,805,239,265
30,OLT,MORUNGLAV,127625,BĂRĂŞTI,"SCOALA GENERALA BARASTI",250,"Alegeri Prezidentiale",1,290,163,129,34,0,160,3,319,156,93,67
30,OLT,MORUNGLAV,127625,MORUNEŞTI,"SCOALA GENERALA MORUNESTI",251,"Alegeri Prezidentiale",1,491,234,201,33,0,233,1,541,307,70,163
30,OLT,MOVILENI,127689,MOVILENI,"ŞCOALA MOVILENI",252,"Alegeri Prezidentiale",1,992,491,426,60,5,485,6,1092,601,112,373
30,OLT,MOVILENI,127689,BACEA,"ŞCOALA BACEA",253,"Alegeri Prezidentiale",1,1055,539,475,45,19,523,16,1161,622,183,340
30,OLT,MOVILENI,127689,MOVILENI,"SCOALA GENERALA MOVILENI ( GRADINITA)",254,"Alegeri Prezidentiale",1,741,388,319,52,17,384,4,816,428,79,305
30,OLT,"NICOLAE TITULESCU",127714,"NICOLAE TITULESCU","SCOALA GIMNAZIALA",255,"Alegeri Prezidentiale",1,959,635,490,79,66,627,8,1055,420,174,453
30,OLT,OBÂRŞIA,127750,OBÂRŞIA,"ŞCOALA CU CLASELE I-IV OBÎRŞIA",256,"Alegeri Prezidentiale",1,556,342,290,41,11,340,2,612,270,132,208
30,OLT,OBÂRŞIA,127750,"CÂMPU PĂRULUI","ŞCOALA CU CLASELE I-IV CÎMPU PĂRULUI",257,"Alegeri Prezidentiale",1,253,173,139,26,8,171,2,279,106,82,89
30,OLT,OBÂRŞIA,127750,TABONU,"ŞCOALA CU CLASELE I-IV TABONU",258,"Alegeri Prezidentiale",1,115,90,70,14,6,89,1,127,37,27,62
30,OLT,OBÂRŞIA,127750,COTENI,"ŞCOALA CU CLASELE I-IV COTENI",259,"Alegeri Prezidentiale",1,178,126,103,19,4,126,0,196,70,34,92
30,OLT,OBÂRŞIA,127750,"OBÂRŞIA NOUĂ","SCOALA CU CLASELE I-VIII OBARSIA NOUA",260,"Alegeri Prezidentiale",1,933,462,395,50,17,455,7,1027,565,266,189
30,OLT,OBOGA,127812,OBOGA,"ŞCOALA GIMNAZIALĂ OBOGA",261,"Alegeri Prezidentiale",1,975,656,560,88,8,642,14,1073,417,160,482
30,OLT,OBOGA,127812,OBOGA,"ŞCOALA OBOGA DE JOS",262,"Alegeri Prezidentiale",1,400,274,190,74,10,271,3,440,166,57,214
30,OLT,OPORELU,127858,OPORELU,"CĂMINUL CULTURAL OPORELU",263,"Alegeri Prezidentiale",1,853,604,412,148,44,595,9,939,335,231,364
30,OLT,OPTAŞI-MĂGURA,127901,OPTAŞI,"ŞCOALA GIMNAZIALĂ OPTAŞI MĂGURA",264,"Alegeri Prezidentiale",1,999,787,579,162,46,781,6,1099,312,93,688
30,OLT,ORLEA,127938,ORLEA,"CĂMINUL CULTURAL",265,"Alegeri Prezidentiale",1,1341,679,617,62,0,671,8,1476,797,292,379
30,OLT,ORLEA,127938,ORLEA,"CĂMINUL CULTURAL",266,"Alegeri Prezidentiale",1,513,256,226,30,0,256,0,565,309,108,148
30,OLT,"OSICA DE JOS",130357,"OSICA DE JOS","ŞCOALA GIMNAZIALĂ OSICA DE JOS",267,"Alegeri Prezidentiale",1,1258,743,614,110,19,737,6,1384,641,415,322
30,OLT,"OSICA DE SUS",127983,VLĂDULENI,"CENTRU DE PROMOVARE A SĂNĂTĂŢII",268,"Alegeri Prezidentiale",1,488,338,215,114,9,332,6,537,199,175,157
30,OLT,"OSICA DE SUS",127983,"OSICA DE SUS","SPATIUL COMERCIAL DUDE GHEORGHE",269,"Alegeri Prezidentiale",1,951,574,473,87,14,568,6,1047,473,317,251
30,OLT,"OSICA DE SUS",127983,"OSICA DE SUS","ŞCOALA GENERALĂ NR. 2",270,"Alegeri Prezidentiale",1,1317,724,614,95,15,717,7,1449,725,361,356
30,OLT,"OSICA DE SUS",127983,GRECI,"ŞCOALA GENERALĂ GRECI",271,"Alegeri Prezidentiale",1,817,428,349,73,6,424,4,899,471,203,221
30,OLT,"OSICA DE SUS",127983,TOMENI,"ŞCOALA PRIMARĂ TOMENI",272,"Alegeri Prezidentiale",1,368,126,104,22,0,125,1,405,279,73,52
30,OLT,PÂRŞCOVENI,128178,OLARI,"SCOALA GIMNAZIALA OLARI",273,"Alegeri Prezidentiale",1,1109,660,543,106,11,643,17,1221,561,348,295
30,OLT,PÂRŞCOVENI,128178,PÂRŞCOVENI,"SCOALA GIMNAZIALA PIRSCOVENI",274,"Alegeri Prezidentiale",1,1344,952,748,190,14,933,19,1479,527,473,460
30,OLT,PERIEŢI,128052,"MIERLEŞTII DE SUS","CĂMIN CULTURAL",275,"Alegeri Prezidentiale",1,1644,890,754,136,0,877,13,1809,919,387,490
30,OLT,PLEŞOIU,128221,PLEŞOIU,"ŞCOALA GIMNAZIALĂ PLEŞOIU",276,"Alegeri Prezidentiale",2,1315,882,707,175,0,862,20,1447,565,274,588
30,OLT,PLEŞOIU,128221,DOBA,"ŞCOALA GIMNAZIALĂ DOBA",277,"Alegeri Prezidentiale",1,1117,726,593,133,0,716,10,1229,503,177,539
30,OLT,POBORU,128301,POBORU,"ŞCOALA GIMNAZIALĂ",278,"Alegeri Prezidentiale",1,587,420,315,105,0,412,8,646,226,144,268
30,OLT,POBORU,128301,CORNĂŢELU,"ŞCOALA GIMNAZIALĂ",279,"Alegeri Prezidentiale",2,761,466,383,83,0,463,3,838,372,157,306
30,OLT,POBORU,128301,SEACA,"ŞCOALA PRIMARĂ",280,"Alegeri Prezidentiale",1,217,119,107,12,0,118,1,239,120,40,78
30,OLT,PRISEACA,128436,PRISEACA,"ŞCOALA GENERALĂ CU CLASELE I-IV PRISEACA",281,"Alegeri Prezidentiale",1,1346,970,682,288,0,953,17,1481,511,495,458
30,OLT,RADOMIREŞTI,128472,RADOMIREŞTI,"CĂMIN CULTURAL",282,"Alegeri Prezidentiale",1,1030,500,405,95,0,494,6,1133,633,218,276
30,OLT,RADOMIREŞTI,128472,CRĂCIUNEI,"CĂMINUL CULTURAL",283,"Alegeri Prezidentiale",1,557,282,226,56,0,280,2,613,331,128,152
30,OLT,RADOMIREŞTI,128472,CĂLINEŞTI,"ŞCOALĂ VECHE",284,"Alegeri Prezidentiale",1,627,329,253,76,0,324,5,690,361,100,224
30,OLT,RADOMIREŞTI,128472,POIANA,"ŞCOALA POIANA",285,"Alegeri Prezidentiale",1,234,142,103,39,0,140,2,258,116,46,94
30,OLT,REDEA,128524,REDEA,"ȘCOALA GIMNAZIALĂ REDEA",286,"Alegeri Prezidentiale",2,883,447,350,67,30,440,7,972,525,212,228
30,OLT,REDEA,128524,REDEA,"ȘCOALA GIMNAZIALĂ REDEA",287,"Alegeri Prezidentiale",1,811,356,299,28,29,352,4,893,537,138,214
30,OLT,REDEA,128524,REDIŞOARA,"CĂMINUL CULTURAL REDIŞOARA",288,"Alegeri Prezidentiale",1,395,267,211,45,11,264,3,435,168,109,155
30,OLT,REDEA,128524,"VALEA SOARELUI","CĂMINUL CULTURAL VALEA SOARELUI",289,"Alegeri Prezidentiale",1,213,136,111,21,4,133,3,235,99,56,77
30,OLT,ROTUNDA,128560,ROTUNDA,"SEDIUL FOSTEI C.A.P.",290,"Alegeri Prezidentiale",1,1102,550,492,58,0,538,12,1213,663,206,332
30,OLT,ROTUNDA,128560,ROTUNDA,"SEDIUL FOSTEI C.A.P.",291,"Alegeri Prezidentiale",1,1149,574,523,51,0,565,9,1264,690,213,352
30,OLT,RUSĂNEŞTI,128588,RUSĂNEŞTI,"ŞCOALA GENERALĂ NR.1",292,"Alegeri Prezidentiale",1,1255,688,610,78,0,682,6,1381,693,282,400
30,OLT,RUSĂNEŞTI,128588,RUSĂNEŞTI,"ŞCOALA GENERALĂ NR.2",293,"Alegeri Prezidentiale",1,1287,683,590,93,0,681,2,1416,733,302,379
30,OLT,RUSĂNEŞTI,128588,JIENI,"ŞCOALA JIENI",294,"Alegeri Prezidentiale",1,965,516,464,52,0,510,6,1062,546,250,260
30,OLT,SÂMBUREŞTI,128882,SÂMBUREŞTI,"ŞCOALA GIMNAZIALĂ SÎMBUREŞTI",295,"Alegeri Prezidentiale",1,849,748,527,186,35,737,11,934,186,203,534
30,OLT,"SÂRBII - MĂGURA",130366,VITĂNEŞTI,"ŞCOALA GIMNAZIALĂ FLORIAN DIȚULEASA VITĂNEȘTI",296,"Alegeri Prezidentiale",1,863,539,409,90,40,534,5,950,411,190,344
30,OLT,"SÂRBII - MĂGURA",130366,VITĂNEŞTI,"ȘCOALA PRIMARĂ BRANIȘTE",297,"Alegeri Prezidentiale",1,690,492,395,63,34,490,2,759,267,135,355
30,OLT,SCĂRIŞOARA,128613,SCĂRIŞOARA,"ŞCOALA GIMNAZIALĂ SCĂRIŞOARA",298,"Alegeri Prezidentiale",1,912,366,323,43,0,356,10,1004,638,127,229
30,OLT,SCĂRIŞOARA,128613,SCĂRIŞOARA,"ŞCOALA GIMNAZIALĂ SCĂRIŞOARA",299,"Alegeri Prezidentiale",1,919,353,311,42,0,349,4,1011,658,152,197
30,OLT,SCĂRIŞOARA,128613,PLĂVICENI,"GRĂDINIŢA CU PROGRAM NORMAL PLĂVICENI",300,"Alegeri Prezidentiale",1,572,255,226,29,0,255,0,630,375,98,157
30,OLT,SCHITU,128659,SCHITU,"ŞCOALA GIMNAZIALĂ SCHITU",301,"Alegeri Prezidentiale",1,1099,580,465,115,0,573,7,1209,629,245,328
30,OLT,SCHITU,128659,GRECI,"ŞCOALA GIMNAZIALĂ GRECI",302,"Alegeri Prezidentiale",1,729,534,360,96,78,526,8,802,268,170,356
30,OLT,SCHITU,128659,LISA,"ŞCOALA PRIMARĂ LISA",303,"Alegeri Prezidentiale",1,306,163,133,30,0,159,4,337,174,49,110
30,OLT,SEACA,128864,SEACA,"GRADINITA CU PROGRAM NORMAL SEACA",304,"Alegeri Prezidentiale",1,1428,766,649,115,2,758,8,1571,805,218,540
30,OLT,SLĂTIOARA,125374,SLĂTIOARA,"GRĂDINIŢA SLĂTIOARA",305,"Alegeri Prezidentiale",1,872,624,468,156,0,613,11,960,336,354,259
30,OLT,SLĂTIOARA,125374,SLĂTIOARA,"GRĂDINIŢA SLĂTIOARA",306,"Alegeri Prezidentiale",1,999,673,517,156,0,659,14,1099,426,298,361
30,OLT,SLĂTIOARA,125374,SALCIA,"ŞCOALA GENERALĂ SALCIA",307,"Alegeri Prezidentiale",1,304,264,151,112,1,259,5,335,71,120,139
30,OLT,SPINENI,128962,ALUNIŞU,"SC GENERALA ALUNISU",308,"Alegeri Prezidentiale",1,370,253,156,97,0,248,5,407,154,79,169
30,OLT,SPINENI,128962,PROFA,"SCOALA GENERALA PROFA",309,"Alegeri Prezidentiale",1,429,324,203,121,0,318,6,472,148,133,185
30,OLT,SPINENI,128962,SPINENI,"CAMINUL CULTURAL SPINENI",310,"Alegeri Prezidentiale",2,527,309,214,95,0,301,8,580,271,97,204
30,OLT,SPRÂNCENATA,129040,SPRÂNCENATA,"CAMINUL CULTURAL VIESPESTI",311,"Alegeri Prezidentiale",1,1119,482,397,85,0,477,5,1231,749,177,300
30,OLT,SPRÂNCENATA,129040,"BÂRSEŞTII DE SUS","GPN BIRSESTII DE SUS",312,"Alegeri Prezidentiale",1,329,188,122,66,0,187,1,362,174,76,111
30,OLT,SPRÂNCENATA,129040,FRUNZARU,"SCOALA VECHE FRUNZARU",313,"Alegeri Prezidentiale",1,505,271,227,44,0,269,2,556,285,119,150
30,OLT,STOENEŞTI,129095,STOENEŞTI,"CĂMINUL CULTURAL STOENEŞTI",314,"Alegeri Prezidentiale",1,1037,436,391,45,0,426,10,1141,705,181,245
30,OLT,STOENEŞTI,129095,STOENEŞTI,"ŞCOALA GIMNAZIALĂ DIDU",315,"Alegeri Prezidentiale",1,827,394,348,46,0,385,9,910,516,160,225
30,OLT,STOICĂNEŞTI,129111,STOICĂNEŞTI,"SCOALA GENERALA",316,"Alegeri Prezidentiale",1,1109,437,396,41,0,435,2,1220,783,145,290
30,OLT,STOICĂNEŞTI,129111,STOICĂNEŞTI,"SCOALA GENERALA",317,"Alegeri Prezidentiale",1,1039,388,340,48,0,385,3,1143,755,119,266
30,OLT,STREJEŞTI,129139,STREJEŞTI,"ȘCOALA GIMNAZIALĂ STREJEȘTI",318,"Alegeri Prezidentiale",1,841,495,434,61,0,485,10,926,431,170,315
30,OLT,STREJEŞTI,129139,COLIBAŞI,"CAMIN C ULTURAL",319,"Alegeri Prezidentiale",1,391,289,235,54,0,287,2,431,142,154,133
30,OLT,STREJEŞTI,129139,"STREJEŞTII DE SUS","SCOALA GIMNAZIALA",320,"Alegeri Prezidentiale",1,1313,801,733,68,0,792,9,1445,644,215,577
30,OLT,STUDINA,129184,STUDINA,"CAMIN CULTURAL STUDINA",321,"Alegeri Prezidentiale",1,1276,1065,671,372,22,1056,9,1404,339,782,274
30,OLT,STUDINA,129184,STUDINIŢA,"CAMIN CULTURAL STUDINIȚA",322,"Alegeri Prezidentiale",1,947,514,444,62,8,509,5,1042,528,307,202
30,OLT,ŞERBĂNEŞTI,129246,ŞERBĂNEŞTI,"ŞCOALA DUMITRU POPOVICI",323,"Alegeri Prezidentiale",1,851,465,398,51,16,451,14,937,472,195,256
30,OLT,ŞERBĂNEŞTI,129246,ŞERBĂNEŞTI,"ŞCOALA DUMITRU POPOVICI",324,"Alegeri Prezidentiale",1,840,456,408,41,7,445,11,924,468,164,281
30,OLT,ŞERBĂNEŞTI,129246,"ŞERBĂNEŞTII DE SUS","GRĂDINIŢA ŞERBĂNEŞTII DE SUS",325,"Alegeri Prezidentiale",1,617,374,317,45,12,370,4,679,305,142,228
30,OLT,ŞOPÂRLIŢA,130384,ŞOPÂRLIŢA,"ŞCOALA CU CLASELE I-VIII",326,"Alegeri Prezidentiale",1,982,960,669,260,31,949,11,1081,121,540,409
30,OLT,"ŞTEFAN CEL MARE",129282,"ŞTEFAN CEL MARE","GRĂDINIŢA CU PROGRAM NORMAL",327,"Alegeri Prezidentiale",1,939,614,474,81,59,602,12,1033,419,212,390
30,OLT,"ŞTEFAN CEL MARE",129282,"IANCA NOUĂ","GRĂDINIŢA IANCA NOUĂ",328,"Alegeri Prezidentiale",2,473,294,262,22,10,291,3,521,227,131,160
30,OLT,TĂTULEŞTI,129317,TĂTULEŞTI,"ŞCOALA GIMNAZIALĂ TĂTULEŞTI",329,"Alegeri Prezidentiale",2,414,397,231,152,14,394,3,431,34,149,245
30,OLT,TĂTULEŞTI,129317,BĂRBĂLĂI,"ŞCOALA BĂRBĂLAI",330,"Alegeri Prezidentiale",1,175,172,98,65,9,171,1,193,21,42,129
30,OLT,TĂTULEŞTI,129317,MIRCEŞTI,"ŞCOALA MIRCEŞTI",331,"Alegeri Prezidentiale",2,125,151,76,68,7,147,4,165,14,48,99
30,OLT,TESLUI,129380,"CHERLEŞTII DIN DEAL","ŞCOALA GENERALĂ",332,"Alegeri Prezidentiale",1,1331,726,592,129,5,710,16,1465,739,307,403
30,OLT,TESLUI,129380,COMĂNIŢA,"ŞCOALA GENERALĂ COMĂNIŢA",333,"Alegeri Prezidentiale",1,765,502,353,117,32,495,7,842,340,117,378
30,OLT,"TIA MARE",129460,POTLOGENI,GRADINITA,334,"Alegeri Prezidentiale",1,1251,677,629,48,0,670,7,1378,701,196,474
30,OLT,"TIA MARE",129460,"TIA MARE",GRADINITA,335,"Alegeri Prezidentiale",1,1255,707,646,61,0,701,6,1381,674,234,467
30,OLT,"TIA MARE",129460,DOANCA,"SCOALA GIMNAZIALA",336,"Alegeri Prezidentiale",1,1037,594,568,26,0,590,4,1141,547,197,393
30,OLT,TOPANA,129503,TOPANA,"SCOALA GIMNAZIALA TOPANA",337,"Alegeri Prezidentiale",1,275,203,131,70,2,203,0,303,100,72,131
30,OLT,TOPANA,129503,CÂNDELEŞTI,"SCOALA CANDELESTI",338,"Alegeri Prezidentiale",1,77,83,45,35,3,83,0,85,2,20,63
30,OLT,TOPANA,129503,COJGĂREI,"SCOALA GOJGAREI",339,"Alegeri Prezidentiale",1,124,110,58,49,3,110,0,137,27,51,59
30,OLT,TOPANA,129503,UNGURENI,"SCOALA UNGURENI",340,"Alegeri Prezidentiale",1,96,100,47,49,4,97,3,106,6,30,67
30,OLT,TRAIAN,129567,TRAIAN,"ŞCOALA GIMNAZIALĂ TRAIAN",341,"Alegeri Prezidentiale",1,1252,594,523,59,12,577,17,1378,784,234,343
30,OLT,TRAIAN,129567,TRAIAN,"ŞCOALA GIMNAZIALĂ TRAIAN",342,"Alegeri Prezidentiale",1,1229,586,536,39,11,567,19,1352,766,247,320
30,OLT,TUFENI,129585,TUFENI,"LICEUL TEHNOLOGIC TUFENI",343,"Alegeri Prezidentiale",1,1232,692,539,153,0,681,11,1356,664,252,429
30,OLT,TUFENI,129585,STOBORĂŞTI,"ŞCOALA STOBORĂŞTI",344,"Alegeri Prezidentiale",1,941,457,396,61,0,449,8,1036,579,230,219
30,OLT,URZICA,129629,URZICA,"SCOALA NOUA CU CLASELE I- VIII URZICA",345,"Alegeri Prezidentiale",1,1152,689,586,65,38,684,5,1268,579,486,198
30,OLT,URZICA,129629,STĂVARU,"SEDIUL FOSTEI FERME NR 3 STAVARU",346,"Alegeri Prezidentiale",1,606,339,283,39,17,336,3,667,328,206,130
30,OLT,"VALEA MARE",129656,"VALEA MARE","SCOALA GIMNAZIALA",347,"Alegeri Prezidentiale",1,1280,655,569,82,4,642,13,1408,753,282,360
30,OLT,"VALEA MARE",129656,RECEA,"SCOALA GIMNAZIALA",348,"Alegeri Prezidentiale",1,554,354,299,55,0,346,8,610,256,112,234
30,OLT,"VALEA MARE",129656,"VALEA MARE","SCOALA GIMNAZIALĂ COMUNA VALEA MARE",349,"Alegeri Prezidentiale",1,643,312,243,69,0,309,3,708,396,120,189
30,OLT,"VALEA MARE",129656,TURIA,GRADINITA,350,"Alegeri Prezidentiale",1,499,304,232,72,0,300,4,549,245,114,186
30,OLT,VĂDASTRA,129718,VĂDASTRA,"CĂMINUL CULTURAL",351,"Alegeri Prezidentiale",1,1154,721,617,81,23,708,13,1270,549,298,410
30,OLT,VĂDĂSTRIŢA,129745,VĂDĂSTRIŢA,"CĂMINUL CULTURAL",352,"Alegeri Prezidentiale",1,1119,542,483,59,0,529,13,1231,689,280,249
30,OLT,VĂDĂSTRIŢA,129745,VĂDĂSTRIŢA,"CĂMINUL CULTURAL",353,"Alegeri Prezidentiale",1,1548,707,652,55,0,694,13,1703,996,316,378
30,OLT,VĂLENI,129763,VĂLENI,"ŞCOALA GENERALĂ VĂLENI",354,"Alegeri Prezidentiale",1,796,396,314,74,8,393,3,876,480,120,273
30,OLT,VĂLENI,129763,VĂLENI,"ŞCOALA GENERALĂ VĂLENI",355,"Alegeri Prezidentiale",1,849,400,332,56,12,399,1,934,534,116,283
30,OLT,VĂLENI,129763,MANDRA,"ŞCOALA GENERALĂ MANDRA",356,"Alegeri Prezidentiale",1,513,277,227,43,7,274,3,565,288,106,168
30,OLT,VÂLCELE,129987,VÂLCELE,"ȘCOALA VÎLCELE",357,"Alegeri Prezidentiale",1,1302,951,720,195,36,934,17,1433,482,362,572
30,OLT,VÂLCELE,129987,BĂRCĂNEŞTI,"ȘCOALA GENERALĂ",358,"Alegeri Prezidentiale",1,616,426,350,63,13,413,13,678,252,181,232
30,OLT,VERGULEASA,129816,POGANU,"CĂMINUL CULTURAL POGANU",359,"Alegeri Prezidentiale",1,926,543,413,118,12,534,9,1019,476,180,354
30,OLT,VERGULEASA,129816,CĂZĂNEŞTI,"SCOALA CU CLASELE I-IV CAZANESTI",360,"Alegeri Prezidentiale",1,706,400,307,80,13,396,4,777,377,124,272
30,OLT,VERGULEASA,129816,DUMITREŞTI,"ŞCOALA GENERALĂ I-IV",361,"Alegeri Prezidentiale",1,575,398,273,118,7,394,4,633,235,120,274
30,OLT,VIŞINA,129898,VIŞINA,"GRĂDINIŢA DE COPII",362,"Alegeri Prezidentiale",1,1150,663,563,77,23,654,9,1265,602,308,346
30,OLT,VIŞINA,129898,VIŞINA,"GRĂDINIŢA DE COPII",363,"Alegeri Prezidentiale",1,1255,759,660,76,23,749,10,1381,622,365,384
30,OLT,"VIŞINA NOUĂ",130375,"VIŞINA NOUĂ","BIBLIOTECA COMUNALĂ",364,"Alegeri Prezidentiale",1,1439,690,590,79,21,681,9,1583,893,351,330
30,OLT,VITOMIREŞTI,129914,VITOMIREŞTI,"LICEUL TEHNOLOGIC VITOMIRESTI",365,"Alegeri Prezidentiale",1,397,261,205,51,5,257,4,437,176,120,137
30,OLT,VITOMIREŞTI,129914,BULIMANU,"SCOALA CU CLASELE I-IV BULIMANU",366,"Alegeri Prezidentiale",1,168,139,95,43,1,135,4,185,46,28,107
30,OLT,VITOMIREŞTI,129914,DEJEŞTI,"GRADINITA CU PROGRAM NORMAL DEJESTI",367,"Alegeri Prezidentiale",1,568,433,310,112,11,429,4,625,192,104,325
30,OLT,VITOMIREŞTI,129914,DONEŞTI,"SCOALA CU CLASELE I-IV DONESTI",368,"Alegeri Prezidentiale",1,178,126,93,33,0,124,2,196,70,50,74
30,OLT,VITOMIREŞTI,129914,TREPTENI,"SCOALA CU CLASELE I-IV TREPTENI",369,"Alegeri Prezidentiale",1,267,147,120,26,1,146,1,294,147,66,80
30,OLT,VLĂDILA,130026,VLĂDILA,"ȘCOALA GIMNAZIALĂ VLĂDILA",370,"Alegeri Prezidentiale",1,829,406,348,52,6,403,3,912,506,168,235
30,OLT,VLĂDILA,130026,VLĂDILA,"ȘCOALA GIMNAZIALĂ VLĂDILA",371,"Alegeri Prezidentiale",1,825,365,327,28,10,360,5,908,543,148,212
30,OLT,VOINEASA,130062,VOINEASA,"SCOALA CU CLASELE I-VIII VOINEASA",372,"Alegeri Prezidentiale",3,703,463,399,64,0,462,1,774,311,130,332
30,OLT,VOINEASA,130062,MĂRGĂRITEŞTI,"SCOALA CU CLASELE I-VIII MARGARITESTI",373,"Alegeri Prezidentiale",1,583,416,350,66,0,412,4,642,226,114,298
30,OLT,VOINEASA,130062,RACOVIŢA,"SCOALA CU CLASELE I-IV RACOVITA",374,"Alegeri Prezidentiale",1,435,339,239,100,0,331,8,479,140,131,200
30,OLT,VULPENI,130124,GROPŞANI,"SCOALA GIMNAZIALA VULPENI-STRUCTURA GROPSANI",375,"Alegeri Prezidentiale",1,652,380,313,62,5,372,8,718,338,121,251
30,OLT,VULPENI,130124,PRISACA,"FOSTA SC. CU CLASELE I-IV PRISACA",376,"Alegeri Prezidentiale",1,299,162,119,42,1,162,0,329,167,51,111
30,OLT,VULPENI,130124,"VALEA SATULUI","SCOALA GIMNAZIALA VULPENI",377,"Alegeri Prezidentiale",1,804,521,405,114,2,512,9,885,364,173,339
30,OLT,VULTUREŞTI,130231,VULTUREŞTI,"ŞCOALA CU CLASELE I-VIII VULTUREŞTI",378,"Alegeri Prezidentiale",1,591,321,228,90,3,319,2,651,330,112,207
30,OLT,VULTUREŞTI,130231,"VALEA LUI ALB","ŞCOALA CU CLASELE I-IV VALEA LUI ALB",379,"Alegeri Prezidentiale",1,478,240,190,47,3,237,3,525,285,87,150
30,OLT,VULTUREŞTI,130231,DIENCI,"FOST SEDIU CAP DIENCI",380,"Alegeri Prezidentiale",1,761,525,386,128,11,518,7,838,313,161,357
31,PRAHOVA,"MUNICIPIUL PLOIEŞTI",130534,PLOIEŞTI,"PALATUL CULTURII",1,"Alegeri Prezidentiale",1,1251,736,660,75,1,720,16,1400,664,450,270
31,PRAHOVA,"MUNICIPIUL PLOIEŞTI",130534,PLOIEŞTI,"PALATUL CULTURII",2,"Alegeri Prezidentiale",1,872,556,447,109,0,544,12,1000,444,345,199
31,PRAHOVA,"MUNICIPIUL PLOIEŞTI",130534,PLOIEŞTI,"PALATUL CULTURII",3,"Alegeri Prezidentiale",1,1077,586,538,46,2,568,18,1200,614,388,180
31,PRAHOVA,"MUNICIPIUL PLOIEŞTI",130534,PLOIEŞTI,"COLEGIUL NAŢIONAL ”ALEXANDRU IOAN CUZA”",4,"Alegeri Prezidentiale",1,1065,649,565,83,1,627,22,1200,551,442,185
31,PRAHOVA,"MUNICIPIUL PLOIEŞTI",130534,PLOIEŞTI,"ŞCOALA GIMNAZIALĂ ”ELENA DOAMNA”",5,"Alegeri Prezidentiale",1,1340,772,721,51,0,759,13,1500,728,476,283
31,PRAHOVA,"MUNICIPIUL PLOIEŞTI",130534,PLOIEŞTI,"ŞCOALA GIMNAZIALĂ ”ELENA DOAMNA”",6,"Alegeri Prezidentiale",1,1255,730,674,56,0,718,12,1400,670,447,271
31,PRAHOVA,"MUNICIPIUL PLOIEŞTI",130534,PLOIEŞTI,"ŞCOALA GIMNAZIALĂ ”CANDIANO POPESCU”",7,"Alegeri Prezidentiale",1,1276,704,655,49,0,685,19,1400,696,463,222
31,PRAHOVA,"MUNICIPIUL PLOIEŞTI",130534,PLOIEŞTI,"ŞCOALA GIMNAZIALĂ ”CANDIANO POPESCU”",8,"Alegeri Prezidentiale",1,1221,557,469,25,63,544,13,1400,843,328,216
31,PRAHOVA,"MUNICIPIUL PLOIEŞTI",130534,PLOIEŞTI,"COLEGIUL NAŢIONAL ”ION LUCA CARAGIALE”",9,"Alegeri Prezidentiale",1,1493,678,622,56,0,665,13,1600,922,468,197
31,PRAHOVA,"MUNICIPIUL PLOIEŞTI",130534,PLOIEŞTI,"COLEGIUL NAŢIONAL ”ION LUCA CARAGIALE”",10,"Alegeri Prezidentiale",1,1174,661,581,79,1,648,13,1300,639,414,234
31,PRAHOVA,"MUNICIPIUL PLOIEŞTI",130534,PLOIEŞTI,"DIRECŢIA JUDEŢEANĂ PENTRU SPORT ŞI TINERET PRAHOVA",11,"Alegeri Prezidentiale",1,1211,638,580,58,0,630,8,1300,662,381,249
31,PRAHOVA,"MUNICIPIUL PLOIEŞTI",130534,PLOIEŞTI,"DIRECŢIA JUDEŢEANĂ PENTRU SPORT ŞI TINERET PRAHOVA",12,"Alegeri Prezidentiale",1,1321,785,700,41,44,765,20,1500,715,511,254
31,PRAHOVA,"MUNICIPIUL PLOIEŞTI",130534,PLOIEŞTI,"LICEUL TEHNOLOGIC UCECOM ”SPIRU HARET” (FOST GRUPUL SCOLAR DE ARTE SI MESERII ”SPIRU HARET”)",13,"Alegeri Prezidentiale",1,1131,588,523,65,0,569,19,1200,612,371,198
31,PRAHOVA,"MUNICIPIUL PLOIEŞTI",130534,PLOIEŞTI,"ANEXA ŞCOLII GIMNAZIALE ”SFÂNTA VINERI”",14,"Alegeri Prezidentiale",1,991,557,503,54,0,541,16,1100,543,335,206
31,PRAHOVA,"MUNICIPIUL PLOIEŞTI",130534,PLOIEŞTI,"MUZEUL JUDEŢEAN DE ISTORIE ŞI ARHEOLOGIE PRAHOVA",15,"Alegeri Prezidentiale",1,776,445,376,69,0,441,4,900,455,277,164
31,PRAHOVA,"MUNICIPIUL PLOIEŞTI",130534,PLOIEŞTI,"COLEGIUL NAŢIONAL ”MIHAI VITEAZUL”",16,"Alegeri Prezidentiale",1,682,404,327,76,1,394,10,800,396,288,106
31,PRAHOVA,"MUNICIPIUL PLOIEŞTI",130534,PLOIEŞTI,"CLUBUL SPORTIV ŞCOLAR",17,"Alegeri Prezidentiale",1,883,495,452,42,1,484,11,1000,505,341,143
31,PRAHOVA,"MUNICIPIUL PLOIEŞTI",130534,PLOIEŞTI,"S.C. ”ELECTRICA” S.A.",18,"Alegeri Prezidentiale",1,1134,569,540,29,0,558,11,1200,631,369,189
31,PRAHOVA,"MUNICIPIUL PLOIEŞTI",130534,PLOIEŞTI,"GRĂDINIŢA CU PROGRAM PRELUNGIT NR. 28 (GRADINITA NR. 28)",19,"Alegeri Prezidentiale",1,970,532,487,43,2,523,9,1100,568,352,171
31,PRAHOVA,"MUNICIPIUL PLOIEŞTI",130534,PLOIEŞTI,"OCOLUL SILVIC",20,"Alegeri Prezidentiale",1,1399,780,750,30,0,765,15,1500,720,523,242
31,PRAHOVA,"MUNICIPIUL PLOIEŞTI",130534,PLOIEŞTI,"OCOLUL SILVIC",21,"Alegeri Prezidentiale",2,1574,754,707,47,0,734,20,1700,946,474,260
31,PRAHOVA,"MUNICIPIUL PLOIEŞTI",130534,PLOIEŞTI,"ŞCOALA GIMNAZIALĂ ”NICOLAE TITULESCU”",22,"Alegeri Prezidentiale",1,1274,723,680,43,0,711,12,1400,677,484,227
31,PRAHOVA,"MUNICIPIUL PLOIEŞTI",130534,PLOIEŞTI,"ŞCOALA GIMNAZIALĂ ”NICOLAE TITULESCU”",23,"Alegeri Prezidentiale",1,1397,831,800,31,0,814,17,1500,669,579,235
31,PRAHOVA,"MUNICIPIUL PLOIEŞTI",130534,PLOIEŞTI,"ANEXA LICEULUI TEHNOLOGIC DE TRANSPORTURI (ANEXA GRUP SCOLAR INDUSTRIAL TRANSPORTURI (FOST LICEUL AUTO))",24,"Alegeri Prezidentiale",1,1634,841,803,38,0,826,15,1700,859,549,277
31,PRAHOVA,"MUNICIPIUL PLOIEŞTI",130534,PLOIEŞTI,"ŞCOALA GIMNAZIALĂ ”SFÂNTUL VASILE”",25,"Alegeri Prezidentiale",1,1459,886,826,60,0,864,22,1600,714,594,270
31,PRAHOVA,"MUNICIPIUL PLOIEŞTI",130534,PLOIEŞTI,"ŞCOALA GIMNAZIALĂ ”SFÂNTUL VASILE”",26,"Alegeri Prezidentiale",1,1329,788,725,63,0,774,14,1400,612,539,235
31,PRAHOVA,"MUNICIPIUL PLOIEŞTI",130534,PLOIEŞTI,"ŞCOALA GIMNAZIALĂ ”SFÂNTUL VASILE”",27,"Alegeri Prezidentiale",1,1292,797,730,67,0,780,17,1400,603,549,231
31,PRAHOVA,"MUNICIPIUL PLOIEŞTI",130534,PLOIEŞTI,"ŞCOALA GIMNAZIALĂ ”SFÂNTUL VASILE”",28,"Alegeri Prezidentiale",1,1254,749,680,69,0,732,17,1400,651,510,222
31,PRAHOVA,"MUNICIPIUL PLOIEŞTI",130534,PLOIEŞTI,"ŞCOALA GIMNAZIALĂ NR. 13 (FOSTA ŞCOALĂ GIMNAZIALĂ ”DIMITRIE BOLINTINEANU”)",29,"Alegeri Prezidentiale",1,1129,630,591,37,2,612,18,1200,570,388,224
31,PRAHOVA,"MUNICIPIUL PLOIEŞTI",130534,PLOIEŞTI,"ŞCOALA GIMNAZIALĂ NR. 13 (FOSTA ŞCOALĂ GIMNAZIALĂ ”DIMITRIE BOLINTINEANU”)",30,"Alegeri Prezidentiale",3,1013,543,520,23,0,533,10,1100,557,332,201
31,PRAHOVA,"MUNICIPIUL PLOIEŞTI",130534,PLOIEŞTI,"S.C. TRANSPORT CĂLĂTORI EXPRESS S.A.",31,"Alegeri Prezidentiale",1,1613,535,504,29,2,523,12,1700,1165,301,222
31,PRAHOVA,"MUNICIPIUL PLOIEŞTI",130534,PLOIEŞTI,"S.C. TRANSPORT CĂLĂTORI EXPRESS S.A.",32,"Alegeri Prezidentiale",1,1189,640,608,32,0,630,10,1300,660,397,233
31,PRAHOVA,"MUNICIPIUL PLOIEŞTI",130534,PLOIEŞTI,"S.C. TRANSPORT CĂLĂTORI EXPRESS S.A.",33,"Alegeri Prezidentiale",1,1049,531,494,36,1,524,7,1200,669,334,190
31,PRAHOVA,"MUNICIPIUL PLOIEŞTI",130534,PLOIEŞTI,"ȘCOALA GIMNAZIALĂ ”CANDIANO POPESCU” PLOIEȘTI",34,"Alegeri Prezidentiale",1,1577,793,769,24,0,766,27,1700,907,496,270
31,PRAHOVA,"MUNICIPIUL PLOIEŞTI",130534,PLOIEŞTI,"ŞCOALA GIMNAZIALĂ ”ANTON PANN”",35,"Alegeri Prezidentiale",1,1255,527,491,36,0,517,10,1400,873,347,170
31,PRAHOVA,"MUNICIPIUL PLOIEŞTI",130534,PLOIEŞTI,"ŞCOALA GIMNAZIALĂ ”ANTON PANN”",36,"Alegeri Prezidentiale",1,1418,582,549,33,0,572,10,1500,918,360,212
31,PRAHOVA,"MUNICIPIUL PLOIEŞTI",130534,PLOIEŞTI,"ŞCOALA GIMNAZIALĂ ”ANTON PANN”",37,"Alegeri Prezidentiale",1,798,300,275,25,0,294,6,900,600,182,112
31,PRAHOVA,"MUNICIPIUL PLOIEŞTI",130534,PLOIEŞTI,"ȘCOALA GIMNAZIALĂ ”ANTON PANN”",38,"Alegeri Prezidentiale",1,1534,683,654,28,1,661,22,1600,917,441,220
31,PRAHOVA,"MUNICIPIUL PLOIEŞTI",130534,PLOIEŞTI,"BLOCUL 24B PARTER",39,"Alegeri Prezidentiale",1,1342,710,674,36,0,691,19,1500,790,449,242
31,PRAHOVA,"MUNICIPIUL PLOIEŞTI",130534,PLOIEŞTI,"CANTINA DE AJUTOR SOCIAL",40,"Alegeri Prezidentiale",1,1450,716,684,32,0,705,11,1600,884,416,289
31,PRAHOVA,"MUNICIPIUL PLOIEŞTI",130534,PLOIEŞTI,"CANTINA DE AJUTOR SOCIAL",41,"Alegeri Prezidentiale",1,1498,783,757,26,0,765,18,1600,817,506,259
31,PRAHOVA,"MUNICIPIUL PLOIEŞTI",130534,PLOIEŞTI,"CANTINA DE AJUTOR SOCIAL",42,"Alegeri Prezidentiale",1,1311,699,641,30,28,686,13,1500,801,469,217
31,PRAHOVA,"MUNICIPIUL PLOIEŞTI",130534,PLOIEŞTI,"GHIŞEUL NR. 2 - OFICIUL POŞTAL PLOIEŞTI 1",43,"Alegeri Prezidentiale",1,1441,815,720,95,0,795,20,1600,785,485,310
31,PRAHOVA,"MUNICIPIUL PLOIEŞTI",130534,PLOIEŞTI,"LICEUL TEHNOLOGIC ”ANGHEL SALIGNY”",44,"Alegeri Prezidentiale",1,1130,486,439,47,0,476,10,1200,714,336,140
31,PRAHOVA,"MUNICIPIUL PLOIEŞTI",130534,PLOIEŞTI,"GRĂDINIŢA CU PROGRAM NORMAL NR. 4 (FOSTA GRADINITA DE COPII NR. 4)",45,"Alegeri Prezidentiale",1,806,523,422,33,68,513,10,900,377,345,168
31,PRAHOVA,"MUNICIPIUL PLOIEŞTI",130534,PLOIEŞTI,"ŞCOALA GIMNAZIALĂ ”IOAN GRIGORESCU”",46,"Alegeri Prezidentiale",2,1203,590,565,25,0,580,10,1300,710,395,185
31,PRAHOVA,"MUNICIPIUL PLOIEŞTI",130534,PLOIEŞTI,"ŞCOALA GIMNAZIALĂ ”IOAN GRIGORESCU”",47,"Alegeri Prezidentiale",1,1128,554,503,51,0,546,8,1200,646,381,165
31,PRAHOVA,"MUNICIPIUL PLOIEŞTI",130534,PLOIEŞTI,"ŞCOALA GIMNAZIALĂ ”IOAN GRIGORESCU”",48,"Alegeri Prezidentiale",1,1265,661,650,10,1,633,28,1400,739,439,194
31,PRAHOVA,"MUNICIPIUL PLOIEŞTI",130534,PLOIEŞTI,"ŞCOALA GIMNAZIALĂ ”RAREŞ VODĂ”",49,"Alegeri Prezidentiale",1,994,581,533,48,0,567,14,1100,519,404,163
31,PRAHOVA,"MUNICIPIUL PLOIEŞTI",130534,PLOIEŞTI,"CASA CORPULUI DIDACTIC",50,"Alegeri Prezidentiale",1,1103,578,543,35,0,563,15,1200,622,376,187
31,PRAHOVA,"MUNICIPIUL PLOIEŞTI",130534,PLOIEŞTI,"CASA CORPULUI DIDACTIC",51,"Alegeri Prezidentiale",1,861,490,460,30,0,474,16,900,410,296,178
31,PRAHOVA,"MUNICIPIUL PLOIEŞTI",130534,PLOIEŞTI,"COLEGIUL NAȚIONAL PEDAGOGIC ”REGINA MARIA” (FOST COLEGIUL NAȚIONAL ”JEAN MONNET”)”",52,"Alegeri Prezidentiale",1,1150,652,596,54,2,637,15,1300,648,437,200
31,PRAHOVA,"MUNICIPIUL PLOIEŞTI",130534,PLOIEŞTI,"LICEUL TEHNOLOGIC ADMINISTRATIV ŞI DE SERVICII ”VICTOR SLĂVESCU” ( FOSTA SCOALA NR. 32)",53,"Alegeri Prezidentiale",1,1154,647,583,60,4,632,15,1300,653,440,192
31,PRAHOVA,"MUNICIPIUL PLOIEŞTI",130534,PLOIEŞTI,"LICEUL TEHNOLOGIC ADMINISTRATIV ŞI DE SERVICII ”VICTOR SLĂVESCU” ( FOSTA SCOALA NR. 32)",54,"Alegeri Prezidentiale",1,1140,617,558,59,0,598,19,1300,683,380,218
31,PRAHOVA,"MUNICIPIUL PLOIEŞTI",130534,PLOIEŞTI,"ŞCOALA GIMNAZIALĂ ”GEORGE COŞBUC”",55,"Alegeri Prezidentiale",1,1253,709,661,48,0,691,18,1400,691,431,260
31,PRAHOVA,"MUNICIPIUL PLOIEŞTI",130534,PLOIEŞTI,"ŞCOALA GIMNAZIALĂ ”GEORGE COŞBUC”",56,"Alegeri Prezidentiale",1,1305,674,636,38,0,659,15,1400,726,431,228
31,PRAHOVA,"MUNICIPIUL PLOIEŞTI",130534,PLOIEŞTI,"ŞCOALA GIMNAZIALĂ SPECIALĂ NR. 1",57,"Alegeri Prezidentiale",1,1173,456,436,20,0,441,15,1300,844,285,156
31,PRAHOVA,"MUNICIPIUL PLOIEŞTI",130534,PLOIEŞTI,"ŞCOALA GIMNAZIALĂ SPECIALĂ NR. 1",58,"Alegeri Prezidentiale",1,817,395,375,20,0,387,8,900,505,254,133
31,PRAHOVA,"MUNICIPIUL PLOIEŞTI",130534,PLOIEŞTI,"LICEUL TEHNOLOGIC ”1 MAI”",59,"Alegeri Prezidentiale",1,1499,872,736,135,1,849,23,1700,828,572,277
31,PRAHOVA,"MUNICIPIUL PLOIEŞTI",130534,PLOIEŞTI,"LICEUL TEHNOLOGIC ”1 MAI”",60,"Alegeri Prezidentiale",1,1681,812,705,105,2,795,17,1800,988,487,308
31,PRAHOVA,"MUNICIPIUL PLOIEŞTI",130534,PLOIEŞTI,"LICEUL TEHNOLOGIC ”LAZĂR EDELEANU” (FOST COLEGIUL TEHNIC ”LAZĂR EDELEANU”, FOST LICEUL DE CHIMIE)",61,"Alegeri Prezidentiale",1,1289,760,698,62,0,749,11,1500,740,507,242
31,PRAHOVA,"MUNICIPIUL PLOIEŞTI",130534,PLOIEŞTI,"LICEUL TEHNOLOGIC ”LAZĂR EDELEANU” (FOST COLEGIUL TEHNIC ”LAZĂR EDELEANU”, FOST LICEUL DE CHIMIE)",62,"Alegeri Prezidentiale",1,1648,778,704,74,0,761,17,1800,1022,536,225
31,PRAHOVA,"MUNICIPIUL PLOIEŞTI",130534,PLOIEŞTI,"ŞCOALA GIMNAZIALĂ ”MIHAI EMINESCU”",63,"Alegeri Prezidentiale",1,1261,735,690,44,1,712,23,1400,665,462,250
31,PRAHOVA,"MUNICIPIUL PLOIEŞTI",130534,PLOIEŞTI,"ŞCOALA GIMNAZIALĂ ”MIHAI EMINESCU”",64,"Alegeri Prezidentiale",1,1347,751,681,70,0,721,30,1500,749,477,244
31,PRAHOVA,"MUNICIPIUL PLOIEŞTI",130534,PLOIEŞTI,"ŞCOALA NR. 19",65,"Alegeri Prezidentiale",1,1344,344,322,22,0,333,11,1400,1056,208,125
31,PRAHOVA,"MUNICIPIUL PLOIEŞTI",130534,PLOIEŞTI,"ŞCOALA GIMNAZIALĂ ”RADU STANIAN”",66,"Alegeri Prezidentiale",1,1023,600,536,64,0,588,12,1100,500,360,228
31,PRAHOVA,"MUNICIPIUL PLOIEŞTI",130534,PLOIEŞTI,"COLEGIUL DE ARTĂ ”CARMEN SYLVA”",67,"Alegeri Prezidentiale",1,926,490,467,22,1,482,8,1000,510,343,139
31,PRAHOVA,"MUNICIPIUL PLOIEŞTI",130534,PLOIEŞTI,"COLEGIUL DE ARTĂ ”CARMEN SYLVA”",68,"Alegeri Prezidentiale",1,798,475,441,32,2,464,11,900,425,309,155
31,PRAHOVA,"MUNICIPIUL PLOIEŞTI",130534,PLOIEŞTI,"S.C.APA NOVA S.R.L.",69,"Alegeri Prezidentiale",1,1038,728,571,52,105,717,11,1100,372,468,249
31,PRAHOVA,"MUNICIPIUL PLOIEŞTI",130534,PLOIEŞTI,"S.C.APA NOVA S.R.L.",70,"Alegeri Prezidentiale",1,860,474,334,30,110,463,11,900,426,217,246
31,PRAHOVA,"MUNICIPIUL PLOIEŞTI",130534,PLOIEŞTI,"COLEGIUL ”SPIRU HARET”(FOST LICEUL DE CONSTRUCTII MASINI)",71,"Alegeri Prezidentiale",1,927,586,420,63,103,574,12,1199,613,320,254
31,PRAHOVA,"MUNICIPIUL PLOIEŞTI",130534,PLOIEŞTI,"ŞCOALA GIMNAZIALĂ ”FLORIN COMIŞEL”",72,"Alegeri Prezidentiale",1,1380,723,691,31,1,710,13,1500,777,444,266
31,PRAHOVA,"MUNICIPIUL PLOIEŞTI",130534,PLOIEŞTI,"PALATUL COPIILOR (FOSTA SCOALA NR. 20)",73,"Alegeri Prezidentiale",1,1667,1003,925,78,0,969,34,1700,697,676,293
31,PRAHOVA,"MUNICIPIUL PLOIEŞTI",130534,PLOIEŞTI,"PALATUL COPIILOR (FOSTA SCOALA NR. 20)",74,"Alegeri Prezidentiale",1,1254,734,668,66,0,721,13,1400,666,480,241
31,PRAHOVA,"MUNICIPIUL PLOIEŞTI",130534,PLOIEŞTI,"PALATUL COPIILOR (FOSTA SCOALA NR. 20)",75,"Alegeri Prezidentiale",1,1393,708,698,10,0,696,12,1500,792,450,246
31,PRAHOVA,"MUNICIPIUL PLOIEŞTI",130534,PLOIEŞTI,"PALATUL COPIILOR (FOSTA SCOALA NR. 20)",76,"Alegeri Prezidentiale",1,805,451,397,54,0,437,14,900,449,295,142
31,PRAHOVA,"MUNICIPIUL PLOIEŞTI",130534,PLOIEŞTI,"PALATUL COPIILOR (FOSTA SCOALA NR. 20)",77,"Alegeri Prezidentiale",1,959,537,513,24,0,521,16,1100,563,371,150
31,PRAHOVA,"MUNICIPIUL PLOIEŞTI",130534,PLOIEŞTI,"ŞCOALA GIMNAZIALĂ ”I. A. BASSARABESCU” (ŞCOALA GIMNAZIALĂ I. A. BASARABESCU)",78,"Alegeri Prezidentiale",1,1527,893,800,93,0,879,14,1600,707,591,288
31,PRAHOVA,"MUNICIPIUL PLOIEŞTI",130534,PLOIEŞTI,"ŞCOALA GIMNAZIALĂ ”I. A. BASSARABESCU” (ŞCOALA GIMNAZIALĂ I. A. BASARABESCU)",79,"Alegeri Prezidentiale",1,1402,810,773,37,0,788,22,1500,690,563,225
31,PRAHOVA,"MUNICIPIUL PLOIEŞTI",130534,PLOIEŞTI,"ŞCOALA GIMNAZIALĂ ”I. A. BASSARABESCU” (ŞCOALA GIMNAZIALĂ I. A. BASARABESCU)",80,"Alegeri Prezidentiale",1,1960,1150,1079,71,0,1113,37,2100,950,774,339
31,PRAHOVA,"MUNICIPIUL PLOIEŞTI",130534,PLOIEŞTI,"ŞCOALA GIMNAZIALĂ ”I. A. BASSARABESCU” (ŞCOALA GIMNAZIALĂ I. A. BASARABESCU)",81,"Alegeri Prezidentiale",1,1474,893,782,72,39,870,23,1600,707,556,314
31,PRAHOVA,"MUNICIPIUL PLOIEŞTI",130534,PLOIEŞTI,"DIRECŢIA GENERALĂ DE ASISTENŢĂ SOCIALĂ ŞI PROTECŢIA COPILULUI PRAHOVA",82,"Alegeri Prezidentiale",1,1347,718,673,45,0,695,23,1500,782,460,235
31,PRAHOVA,"MUNICIPIUL PLOIEŞTI",130534,PLOIEŞTI,"DIRECŢIA GENERALĂ DE ASISTENŢĂ SOCIALĂ ŞI PROTECŢIA COPILULUI PRAHOVA",83,"Alegeri Prezidentiale",1,1328,812,747,65,0,789,23,1400,588,492,297
31,PRAHOVA,"MUNICIPIUL PLOIEŞTI",130534,PLOIEŞTI,"ŞCOALA GIMNAZIALĂ ”GEORGE EMIL PALADE”",84,"Alegeri Prezidentiale",1,1329,701,671,30,0,686,15,1400,699,406,280
31,PRAHOVA,"MUNICIPIUL PLOIEŞTI",130534,PLOIEŞTI,"ŞCOALA GIMNAZIALĂ ”GEORGE EMIL PALADE”",85,"Alegeri Prezidentiale",1,1293,660,594,55,11,649,11,1400,740,429,220
31,PRAHOVA,"MUNICIPIUL PLOIEŞTI",130534,PLOIEŞTI,"ŞCOALA GIMNAZIALĂ ”GEORGE EMIL PALADE”",86,"Alegeri Prezidentiale",1,1367,679,631,48,0,666,13,1500,821,443,223
31,PRAHOVA,"MUNICIPIUL PLOIEŞTI",130534,PLOIEŞTI,"ŞCOALA GIMNAZIALĂ ”GEORGE EMIL PALADE”",87,"Alegeri Prezidentiale",1,1206,610,583,27,0,600,10,1300,690,397,203
31,PRAHOVA,"MUNICIPIUL PLOIEŞTI",130534,PLOIEŞTI,"GRĂDINIŢA CU PROGRAM NORMAL NR. 50 (FOSTA GRĂDINIŢĂ NR. 50)",88,"Alegeri Prezidentiale",1,1083,660,625,35,0,642,18,1200,540,410,232
31,PRAHOVA,"MUNICIPIUL PLOIEŞTI",130534,PLOIEŞTI,"GRĂDINIŢA CU PROGRAM NORMAL NR. 50 (FOSTA GRĂDINIŢĂ NR. 50)",89,"Alegeri Prezidentiale",1,1219,656,624,32,0,636,20,1300,644,409,227
31,PRAHOVA,"MUNICIPIUL PLOIEŞTI",130534,PLOIEŞTI,"GRĂDINIŢA CU PROGRAM PRELUNGIT NR. 40 ( FOSTA GRĂDINIŢĂ NR. 40)",90,"Alegeri Prezidentiale",1,1174,590,567,23,0,576,14,1300,710,377,199
31,PRAHOVA,"MUNICIPIUL PLOIEŞTI",130534,PLOIEŞTI,"GRĂDINIŢA CU PROGRAM PRELUNGIT NR. 40 ( FOSTA GRĂDINIŢĂ NR. 40)",91,"Alegeri Prezidentiale",1,930,554,515,39,0,543,11,1000,446,341,202
31,PRAHOVA,"MUNICIPIUL PLOIEŞTI",130534,PLOIEŞTI,"GRĂDINIŢA CU PROGRAM PRELUNGIT NR. 40 ( FOSTA GRĂDINIŢĂ NR. 40)",92,"Alegeri Prezidentiale",1,1417,760,718,42,0,745,15,1500,740,467,278
31,PRAHOVA,"MUNICIPIUL PLOIEŞTI",130534,PLOIEŞTI,"ŞCOALA GIMNAZIALĂ ”TOMA CARAGIU”",93,"Alegeri Prezidentiale",1,1116,573,548,25,0,565,8,1200,627,384,181
31,PRAHOVA,"MUNICIPIUL PLOIEŞTI",130534,PLOIEŞTI,"ŞCOALA GIMNAZIALĂ ”TOMA CARAGIU”",94,"Alegeri Prezidentiale",1,912,519,483,36,0,502,17,1000,481,317,185
31,PRAHOVA,"MUNICIPIUL PLOIEŞTI",130534,PLOIEŞTI,"ŞCOALA GIMNAZIALĂ ”TOMA CARAGIU”",95,"Alegeri Prezidentiale",1,1312,695,664,31,0,670,25,1400,705,433,237
31,PRAHOVA,"MUNICIPIUL PLOIEŞTI",130534,PLOIEŞTI,"ŞCOALA GIMNAZIALĂ ”NICOLAE IORGA”",96,"Alegeri Prezidentiale",1,1373,690,598,92,0,676,14,1500,810,464,212
31,PRAHOVA,"MUNICIPIUL PLOIEŞTI",130534,PLOIEŞTI,"ŞCOALA GIMNAZIALĂ ”NICOLAE IORGA”",97,"Alegeri Prezidentiale",1,1255,693,660,33,0,675,18,1400,707,452,223
31,PRAHOVA,"MUNICIPIUL PLOIEŞTI",130534,PLOIEŞTI,"ŞCOALA GIMNAZIALĂ ”NICOLAE IORGA”",98,"Alegeri Prezidentiale",1,1301,642,608,34,0,633,9,1400,758,437,196
31,PRAHOVA,"MUNICIPIUL PLOIEŞTI",130534,PLOIEŞTI,"GRĂDINIŢA CU PROGRAM NORMAL NR. 39 (FOSTA GRĂDINIŢĂ NR. 39)",99,"Alegeri Prezidentiale",1,869,475,440,35,0,467,8,1000,525,330,137
31,PRAHOVA,"MUNICIPIUL PLOIEŞTI",130534,PLOIEŞTI,"GRĂDINIŢA CU PROGRAM NORMAL NR. 39 (FOSTA GRĂDINIŢĂ NR. 39)",100,"Alegeri Prezidentiale",1,848,437,409,28,0,427,10,900,463,277,150
31,PRAHOVA,"MUNICIPIUL PLOIEŞTI",130534,PLOIEŞTI,"GRĂDINIŢA CU PROGRAM NORMAL NR. 39 (FOSTA GRĂDINIŢĂ NR. 39)",101,"Alegeri Prezidentiale",1,1417,636,606,29,1,624,12,1508,872,411,213
31,PRAHOVA,"MUNICIPIUL PLOIEŞTI",130534,PLOIEŞTI,"GRĂDINIŢA CU PROGRAM PRELUNGIT ”SF. MUCENIC MINA” (FOSTA GRĂDINIŢĂ NR. 36 ”SF. MUCENIC MINA”)",102,"Alegeri Prezidentiale",1,1349,747,692,55,0,729,18,1500,753,482,247
31,PRAHOVA,"MUNICIPIUL PLOIEŞTI",130534,PLOIEŞTI,"GRĂDINIŢA CU PROGRAM PRELUNGIT ”SF. MUCENIC MINA” (FOSTA GRĂDINIŢĂ NR. 36 ”SF. MUCENIC MINA”)",103,"Alegeri Prezidentiale",1,1462,783,725,58,0,767,16,1600,817,504,263
31,PRAHOVA,"MUNICIPIUL PLOIEŞTI",130534,PLOIEŞTI,"GRĂDINIŢA CU PROGRAM PRELUNGIT ”SF. MUCENIC MINA” (FOSTA GRĂDINIŢĂ NR. 36 ”SF. MUCENIC MINA”)",104,"Alegeri Prezidentiale",1,1153,592,563,29,0,578,14,1200,608,368,210
31,PRAHOVA,"MUNICIPIUL PLOIEŞTI",130534,PLOIEŞTI,"GRĂDINIŢA CU PROGRAM PRELUNGIT ”SF. MUCENIC MINA” (FOSTA GRĂDINIŢĂ NR. 36 ”SF. MUCENIC MINA”)",105,"Alegeri Prezidentiale",1,1018,479,462,17,0,472,7,1100,621,318,154
31,PRAHOVA,"MUNICIPIUL PLOIEŞTI",130534,PLOIEŞTI,"GRĂDINIŢA CU PROGRAM PRELUNGIT NR. 47 (FOSTA GRĂDINIŢĂ NR. 47)",106,"Alegeri Prezidentiale",1,951,556,507,48,1,547,9,1000,444,359,188
31,PRAHOVA,"MUNICIPIUL PLOIEŞTI",130534,PLOIEŞTI,"GRĂDINIŢA CU PROGRAM PRELUNGIT NR. 47 (FOSTA GRĂDINIŢĂ NR. 47)",107,"Alegeri Prezidentiale",1,832,492,462,30,0,480,12,900,408,269,211
31,PRAHOVA,"MUNICIPIUL PLOIEŞTI",130534,PLOIEŞTI,"GRĂDINIŢA CU PROGRAM PRELUNGIT NR. 47 (FOSTA GRĂDINIŢĂ NR. 47)",108,"Alegeri Prezidentiale",1,891,458,436,22,0,448,10,1000,542,303,145
31,PRAHOVA,"MUNICIPIUL PLOIEŞTI",130534,PLOIEŞTI,"SISTEMUL DE GOSPODĂRIRE A APELOR PRAHOVA",109,"Alegeri Prezidentiale",1,1086,639,593,46,0,626,13,1200,561,419,207
31,PRAHOVA,"MUNICIPIUL PLOIEŞTI",130534,PLOIEŞTI,"AGENŢIA PENTRU PROTECŢIA MEDIULUI PRAHOVA",110,"Alegeri Prezidentiale",1,1160,687,631,56,0,668,19,1300,613,445,223
31,PRAHOVA,"MUNICIPIUL PLOIEŞTI",130534,PLOIEŞTI,"S.C. EXPLOATARE SISTEM ZONAL PRAHOVA S.A.",111,"Alegeri Prezidentiale",1,1091,660,596,64,0,644,16,1200,540,449,195
31,PRAHOVA,"MUNICIPIUL PLOIEŞTI",130534,PLOIEŞTI,"ŞCOALA GIMNAZIALĂ ”IENĂCHIŢĂ VĂCĂRESCU”",112,"Alegeri Prezidentiale",1,1422,769,741,27,1,747,22,1500,731,501,246
31,PRAHOVA,"MUNICIPIUL PLOIEŞTI",130534,PLOIEŞTI,"ŞCOALA GIMNAZIALĂ ”IENĂCHIŢĂ VĂCĂRESCU”",113,"Alegeri Prezidentiale",1,1447,814,776,38,0,797,17,1500,686,513,284
31,PRAHOVA,"MUNICIPIUL PLOIEŞTI",130534,PLOIEŞTI,"ŞCOALA GIMNAZIALĂ ”IENĂCHIŢĂ VĂCĂRESCU”",114,"Alegeri Prezidentiale",1,1301,770,734,36,0,748,22,1400,630,511,237
31,PRAHOVA,"MUNICIPIUL PLOIEŞTI",130534,PLOIEŞTI,"ŞCOALA GIMNAZIALĂ ”IENĂCHŢĂ VĂCĂRESCU”",115,"Alegeri Prezidentiale",1,921,533,496,37,0,518,15,1000,467,346,172
31,PRAHOVA,"MUNICIPIUL PLOIEŞTI",130534,PLOIEŞTI,"LICEUL TEHNOLOGIC ”TOMA N. SOCOLESCU” (FOST COLEGIUL TEHNIC ”TOMA N. SOCOLESCU”)",116,"Alegeri Prezidentiale",1,994,558,511,47,0,539,19,1100,542,345,194
31,PRAHOVA,"MUNICIPIUL PLOIEŞTI",130534,PLOIEŞTI,"LICEUL TEHNOLOGIC ”TOMA N. SOCOLESCU” (FOST COLEGIUL TEHNIC ”TOMA N. SOCOLESCU”)",117,"Alegeri Prezidentiale",1,719,439,364,75,0,435,4,800,361,297,138
31,PRAHOVA,"MUNICIPIUL PLOIEŞTI",130534,PLOIEŞTI,"LICEUL TEHNOLOGIC ”ELIE RADU” (FOST COLEGIUL TEHNIC ”ELIE RADU”)",118,"Alegeri Prezidentiale",1,1424,708,678,30,0,696,12,1500,792,424,272
31,PRAHOVA,"MUNICIPIUL PLOIEŞTI",130534,PLOIEŞTI,"LICEUL TEHNOLOGIC ”ELIE RADU” (FOST COLEGIUL TEHNIC ”ELIE RADU”)",119,"Alegeri Prezidentiale",1,1458,712,682,30,0,697,15,1600,888,447,250
31,PRAHOVA,"MUNICIPIUL PLOIEŞTI",130534,PLOIEŞTI,"LICEUL TEHNOLOGIC ”ELIE RADU” (FOST COLEGIUL TEHNIC ”ELIE RADU”)",120,"Alegeri Prezidentiale",1,852,488,444,42,2,472,16,900,412,299,173
31,PRAHOVA,"MUNICIPIUL PLOIEŞTI",130534,PLOIEŞTI,"ŞCOALA GIMNAZIALĂ PROFESOR ”NICOLAE SIMACHE”",121,"Alegeri Prezidentiale",1,1167,674,640,34,0,653,21,1300,626,378,275
31,PRAHOVA,"MUNICIPIUL PLOIEŞTI",130534,PLOIEŞTI,"ŞCOALA GIMNAZIALĂ PROFESOR ”NICOLAE SIMACHE”",122,"Alegeri Prezidentiale",1,1382,726,666,60,0,701,25,1500,774,440,261
31,PRAHOVA,"MUNICIPIUL PLOIEŞTI",130534,PLOIEŞTI,"ŞCOALA GIMNAZIALĂ PROFESOR ”NICOLAE SIMACHE”",123,"Alegeri Prezidentiale",1,1218,644,581,63,0,626,18,1300,656,406,220
31,PRAHOVA,"MUNICIPIUL PLOIEŞTI",130534,PLOIEŞTI,"ŞCOALA GIMNAZIALĂ ”NICOLAE BĂLCESCU”",124,"Alegeri Prezidentiale",1,1430,749,701,46,2,731,18,1500,751,461,270
31,PRAHOVA,"MUNICIPIUL PLOIEŞTI",130534,PLOIEŞTI,"ŞCOALA GIMNAZIALĂ ”NICOLAE BĂLCESCU”",125,"Alegeri Prezidentiale",1,1390,714,663,51,0,694,20,1500,786,471,223
31,PRAHOVA,"MUNICIPIUL PLOIEŞTI",130534,PLOIEŞTI,"ŞCOALA GIMNAZIALĂ ”NICOLAE BĂLCESCU”",126,"Alegeri Prezidentiale",1,1452,694,665,28,1,685,9,1600,906,429,256
31,PRAHOVA,"MUNICIPIUL PLOIEŞTI",130534,PLOIEŞTI,"ŞCOALA GIMNAZIALĂ ”NICOLAE BĂLCESCU”",127,"Alegeri Prezidentiale",1,1094,590,567,23,0,576,14,1200,610,344,232
31,PRAHOVA,"MUNICIPIUL PLOIEŞTI",130534,PLOIEŞTI,"GRĂDINIŢA CU PROGRAM NORMAL NR. 10 (FOSTA GRRĂDINIŢĂ DE COPII NR. 10)",128,"Alegeri Prezidentiale",1,1321,672,641,31,0,653,19,1400,728,430,223
31,PRAHOVA,"MUNICIPIUL PLOIEŞTI",130534,PLOIEŞTI,"GRĂDINIŢA CU PROGRAM NORMAL NR. 10 (FOSTA GRRĂDINIŢĂ DE COPII NR. 10)",129,"Alegeri Prezidentiale",1,935,482,436,46,0,467,15,1000,518,313,154
31,PRAHOVA,"MUNICIPIUL PLOIEŞTI",130534,PLOIEŞTI,"GRĂDINIŢA CU PROGRAM NORMAL NR. 10 (FOSTA GRRĂDINIŢĂ DE COPII NR. 10)",130,"Alegeri Prezidentiale",1,1075,531,511,20,0,516,15,1200,669,333,183
31,PRAHOVA,"MUNICIPIUL PLOIEŞTI",130534,PLOIEŞTI,"GRĂDINIȚA CU PROGRAM PRELUNGIT NR. 23",131,"Alegeri Prezidentiale",1,1040,499,479,20,0,487,12,1100,601,309,178
31,PRAHOVA,"MUNICIPIUL PLOIEŞTI",130534,PLOIEŞTI,"ŞCOALA GIMNAZIALĂ ”ION CREANGĂ”",132,"Alegeri Prezidentiale",1,1354,706,650,56,0,688,18,1500,794,447,241
31,PRAHOVA,"MUNICIPIUL PLOIEŞTI",130534,PLOIEŞTI,"ŞCOALA GIMNAZIALĂ ”ION CREANGĂ”",133,"Alegeri Prezidentiale",1,1249,738,705,33,0,708,30,1300,562,459,249
31,PRAHOVA,"MUNICIPIUL PLOIEŞTI",130534,PLOIEŞTI,"ŞCOALA GIMNAZIALĂ ”ION CREANGĂ”",134,"Alegeri Prezidentiale",1,1236,731,676,37,18,715,16,1400,669,489,226
31,PRAHOVA,"MUNICIPIUL PLOIEŞTI",130534,PLOIEŞTI,"ŞCOALA GIMNAZIALĂ ”ION CREANGĂ”",135,"Alegeri Prezidentiale",1,1187,684,636,47,1,670,14,1300,616,428,242
31,PRAHOVA,"MUNICIPIUL PLOIEŞTI",130534,PLOIEŞTI,"ŞCOALA GIMNAZIALĂ ”ION CREANGĂ”",136,"Alegeri Prezidentiale",1,1297,754,711,43,0,731,23,1400,646,509,222
31,PRAHOVA,"MUNICIPIUL PLOIEŞTI",130534,PLOIEŞTI,"ŞCOALA GIMNAZIALĂ ”ANDREI MUREŞANU” (ŞCOALA GIMNAZIALĂ ”ANDREI MUREŞEANU”)",137,"Alegeri Prezidentiale",1,1521,821,777,44,0,798,23,1600,779,525,273
31,PRAHOVA,"MUNICIPIUL PLOIEŞTI",130534,PLOIEŞTI,"ŞCOALA GIMNAZIALĂ ”ANDREI MUREŞANU” (ŞCOALA GIMNAZIALĂ ”ANDREI MUREŞEANU)",138,"Alegeri Prezidentiale",1,1250,623,582,40,1,615,8,1400,777,416,199
31,PRAHOVA,"MUNICIPIUL PLOIEŞTI",130534,PLOIEŞTI,"ŞCOALA GIMNAZIALĂ ”ANDREI MUREŞANU” (ŞCOALA GIMNAZIALĂ ”ANDREI MUREŞEANU)",139,"Alegeri Prezidentiale",2,983,494,475,18,1,477,17,1100,606,300,177
31,PRAHOVA,"MUNICIPIUL PLOIEŞTI",130534,PLOIEŞTI,"ŞCOALA GIMNAZIALĂ ”HENRI MATHIAS BERTHELOT”",140,"Alegeri Prezidentiale",1,868,511,456,50,5,492,19,1000,489,310,182
31,PRAHOVA,"MUNICIPIUL PLOIEŞTI",130534,PLOIEŞTI,"ŞCOALA GIMNAZIALĂ ”HENRI MATHIAS BERTHELOT”",141,"Alegeri Prezidentiale",1,1153,673,634,38,1,660,13,1300,627,443,217
31,PRAHOVA,"MUNICIPIUL PLOIEŞTI",130534,PLOIEŞTI,"ŞCOALA GIMNAZIALĂ ”HENRI MATHIAS BERTHELOT”",142,"Alegeri Prezidentiale",1,1143,653,600,53,0,648,5,1300,647,445,203
31,PRAHOVA,"MUNICIPIUL PLOIEŞTI",130534,PLOIEŞTI,"ŞCOALA GIMNAZIALĂ ”GRIGORE MOISIL”",143,"Alegeri Prezidentiale",1,1084,608,539,69,0,593,15,1200,592,398,195
31,PRAHOVA,"MUNICIPIUL PLOIEŞTI",130534,PLOIEŞTI,"ŞCOALA GIMNAZIALĂ ”GRIGORE MOISIL”",144,"Alegeri Prezidentiale",1,1115,616,550,65,1,605,11,1200,584,414,191
31,PRAHOVA,"MUNICIPIUL PLOIEŞTI",130534,PLOIEŞTI,"COLEGIUL NAŢIONAL ”NICHITA STĂNESCU”",145,"Alegeri Prezidentiale",1,887,486,440,46,0,470,16,1000,514,297,173
31,PRAHOVA,"MUNICIPIUL PLOIEŞTI",130534,PLOIEŞTI,"COLEGIUL NAŢIONAL ”NICHITA STĂNESCU”",146,"Alegeri Prezidentiale",1,961,513,472,41,0,500,13,1100,587,324,176
31,PRAHOVA,"MUNICIPIUL PLOIEŞTI",130534,PLOIEŞTI,"COLEGIUL NAŢIONAL ”NICHITA STĂNESCU”",147,"Alegeri Prezidentiale",1,965,552,512,40,0,538,14,1100,548,373,165
31,PRAHOVA,"MUNICIPIUL PLOIEŞTI",130534,PLOIEŞTI,"COLEGIUL NAŢIONAL ”NICHITA STĂNESCU”",148,"Alegeri Prezidentiale",1,1316,678,653,25,0,660,18,1400,722,440,220
31,PRAHOVA,"MUNICIPIUL PLOIEŞTI",130534,PLOIEŞTI,"ȘCOALA GIMNAZIALĂ ”ANDREI MUREȘANU”",149,"Alegeri Prezidentiale",1,1352,717,670,47,0,698,19,1500,783,487,211
31,PRAHOVA,"MUNICIPIUL PLOIEŞTI",130534,PLOIEŞTI,"ȘCOALA GIMNAZIALĂ ”ANDREI MUREȘANU”",150,"Alegeri Prezidentiale",1,1345,700,670,29,1,682,18,1500,800,461,221
31,PRAHOVA,"MUNICIPIUL PLOIEŞTI",130534,PLOIEŞTI,"LICEUL TEHNOLOGIC DE SERVICII ”SFÂNTUL APOSTOL ANDREI”",151,"Alegeri Prezidentiale",1,1375,688,623,65,0,670,18,1500,812,448,222
31,PRAHOVA,"MUNICIPIUL PLOIEŞTI",130534,PLOIEŞTI,"LICEUL TEHNOLOGIC DE SERVICII ”SFÂNTUL APOSTOL ANDREI”",152,"Alegeri Prezidentiale",1,1409,748,721,27,0,736,12,1500,752,496,240
31,PRAHOVA,"MUNICIPIUL PLOIEŞTI",130534,PLOIEŞTI,"LICEUL TEHNOLOGIC DE SERVICII ”SFÂNTUL APOSTOL ANDREI”",153,"Alegeri Prezidentiale",1,1354,821,618,26,177,797,24,1700,879,503,294
31,PRAHOVA,"MUNICIPIUL PLOIEŞTI",130534,PLOIEŞTI,"LICEUL TEHNOLOGIC DE SERVICII ”SFÂNTUL APOSTOL ANDREI”",154,"Alegeri Prezidentiale",1,1341,662,622,38,2,650,12,1500,838,399,251
31,PRAHOVA,"MUNICIPIUL PLOIEŞTI",130534,PLOIEŞTI,"LICEUL TEHNOLOGIC DE SERVICII ”SFÂNTUL APOSTOL ANDREI”",155,"Alegeri Prezidentiale",1,1297,659,635,23,1,641,18,1400,741,388,253
31,PRAHOVA,"MUNICIPIUL PLOIEŞTI",130534,PLOIEŞTI,"ŞCOALA PRIMARĂ NR. 22 (FOSTA ŞCOALĂ GIMNAZIALĂ ”MITICĂ APOSTOL”)",156,"Alegeri Prezidentiale",1,1348,609,569,40,0,596,13,1500,891,412,184
31,PRAHOVA,"MUNICIPIUL PLOIEŞTI",130534,PLOIEŞTI,"GARA PLOIEŞTI TRIAJ",157,"Alegeri Prezidentiale",1,170,123,81,42,0,120,3,200,77,61,59
31,PRAHOVA,"MUNICIPIUL CÂMPINA",131256,CÂMPINA,"CASA DE CULTURĂ ”GEO BOGZA”- (HOL)",158,"Alegeri Prezidentiale",1,1351,721,642,79,0,707,14,1500,779,497,210
31,PRAHOVA,"MUNICIPIUL CÂMPINA",131256,CÂMPINA,"COLEGIUL NAŢIONAL”NICOLAE GRIGORESCU” - (SALA DE CLASA)",159,"Alegeri Prezidentiale",1,1131,706,577,129,0,687,19,1300,594,432,255
31,PRAHOVA,"MUNICIPIUL CÂMPINA",131256,CÂMPINA,"COLEGIUL NAŢIONAL”NICOLAE GRIGORESCU” - (SALA DE CLASA)",160,"Alegeri Prezidentiale",1,1255,807,658,149,0,787,20,1400,593,526,261
31,PRAHOVA,"MUNICIPIUL CÂMPINA",131256,CÂMPINA,"CASA TINERETULUI (HOL MARE)",161,"Alegeri Prezidentiale",1,1040,522,425,97,0,510,12,1100,578,341,169
31,PRAHOVA,"MUNICIPIUL CÂMPINA",131256,CÂMPINA,"ŞCOALA GIMNAZIALĂ CENTRALĂ - (SALA DE CLASA)",162,"Alegeri Prezidentiale",1,1049,614,484,66,64,602,12,1200,586,378,224
31,PRAHOVA,"MUNICIPIUL CÂMPINA",131256,CÂMPINA,"LICEUL TEHNOLOGIC ENERGETIC -(CORP A-SALA DE CLASA NR.5-INTRAREA SECUNDARA)",163,"Alegeri Prezidentiale",1,1074,576,521,54,1,567,9,1200,624,398,169
31,PRAHOVA,"MUNICIPIUL CÂMPINA",131256,CÂMPINA,"LICEUL TEHNOLOGIC ENERGETIC - (CORP A SALA DE CLASA NR.3-INTRAREA PRINCIPALA)",164,"Alegeri Prezidentiale",1,881,459,411,48,0,452,7,1100,641,304,148
31,PRAHOVA,"MUNICIPIUL CÂMPINA",131256,CÂMPINA,"ȘCOALA GIMNAZIALĂ ”B.P.HASDEU” - (SALA DE SPORT)",165,"Alegeri Prezidentiale",1,1318,652,588,64,0,635,17,1400,748,453,182
31,PRAHOVA,"MUNICIPIUL CÂMPINA",131256,CÂMPINA,"CASA TINERETULUI (HOL MIC)",166,"Alegeri Prezidentiale",1,1434,758,707,50,1,741,17,1600,842,471,270
31,PRAHOVA,"MUNICIPIUL CÂMPINA",131256,CÂMPINA,"SC STEAUA ROMÂNĂ S.A. - (CANTINA)",167,"Alegeri Prezidentiale",1,1237,739,603,136,0,732,7,1200,461,483,249
31,PRAHOVA,"MUNICIPIUL CÂMPINA",131256,CÂMPINA,"COLEGIUL TEHNIC FORESTIER - (SALA DE SPORT)",168,"Alegeri Prezidentiale",1,1212,747,665,81,1,729,18,1300,553,452,277
31,PRAHOVA,"MUNICIPIUL CÂMPINA",131256,CÂMPINA,"COLEGIUL TEHNIC FORESTIER - (SALA DE SPORT)",169,"Alegeri Prezidentiale",1,1261,686,645,41,0,671,15,1400,714,442,229
31,PRAHOVA,"MUNICIPIUL CÂMPINA",131256,CÂMPINA,"COLEGIUL TEHNIC CONSTANTIN ISTRATI (CAMIN)",170,"Alegeri Prezidentiale",1,1612,796,741,53,2,775,21,1800,1004,520,255
31,PRAHOVA,"MUNICIPIUL CÂMPINA",131256,CÂMPINA,"COLEGIUL TEHNIC CONSTANTIN ISTRATI - SALA DE CLASA)",171,"Alegeri Prezidentiale",1,1558,884,769,82,33,869,15,1700,816,588,281
31,PRAHOVA,"MUNICIPIUL CÂMPINA",131256,CÂMPINA,"ȘCOALA GENERALĂ NR.5 - (SALA DE CLASA)",172,"Alegeri Prezidentiale",1,1190,698,629,69,0,681,17,1300,602,491,190
31,PRAHOVA,"MUNICIPIUL CÂMPINA",131256,CÂMPINA,"LICEUL TEHNOLOGIC MECANIC - (SALA DE SPORT)",173,"Alegeri Prezidentiale",1,1554,747,718,29,0,734,13,1700,953,487,247
31,PRAHOVA,"MUNICIPIUL CÂMPINA",131256,CÂMPINA,"LICEUL TEHNOLOGIC MECANIC - (CORP A SALA 2)",174,"Alegeri Prezidentiale",1,1308,750,692,56,2,742,8,1500,750,525,217
31,PRAHOVA,"MUNICIPIUL CÂMPINA",131256,CÂMPINA,"LICEUL TEHNOLOGIC MECANIC - (CORP A SALA 3)",175,"Alegeri Prezidentiale",1,1484,692,645,47,0,686,6,1600,908,439,247
31,PRAHOVA,"MUNICIPIUL CÂMPINA",131256,CÂMPINA,"ȘCOALA GENERALĂ NR.6 - (SALA DE CLASA)",176,"Alegeri Prezidentiale",1,1560,766,721,45,0,749,17,1700,934,451,298
31,PRAHOVA,"MUNICIPIUL CÂMPINA",131256,CÂMPINA,"ȘCOALA GIMNAZIALĂ ”ALEXANDRU IOAN CUZA” - (SALA DE CLASA-ETAJ 1)",177,"Alegeri Prezidentiale",1,1551,993,823,169,1,976,17,1700,707,682,294
31,PRAHOVA,"MUNICIPIUL CÂMPINA",131256,CÂMPINA,"ȘCOALA GIMNAZIALĂ ”ALEXANDRU IOAN CUZA” - (SALA DE SPORT)",178,"Alegeri Prezidentiale",1,1595,933,846,87,0,915,18,1800,867,614,301
31,PRAHOVA,"MUNICIPIUL CÂMPINA",131256,CÂMPINA,"SC ELECTROUTILAJ SA - (CANTINA - SALA DE PROTOCOL)",179,"Alegeri Prezidentiale",1,1670,839,776,63,0,811,28,1800,961,564,247
31,PRAHOVA,"MUNICIPIUL CÂMPINA",131256,CÂMPINA,"ȘCOALA GENERALĂ NR.3 - (SALA DE SPORT)",180,"Alegeri Prezidentiale",1,1666,1094,882,79,133,1080,14,1800,706,698,382
31,PRAHOVA,"ORAŞ AZUGA",130954,AZUGA,"LICEUL TEORETIC AZUGA",181,"Alegeri Prezidentiale",1,1724,991,816,120,55,967,24,1900,909,681,286
31,PRAHOVA,"ORAŞ AZUGA",130954,AZUGA,"LICEUL TEORETIC AZUGA",182,"Alegeri Prezidentiale",1,1036,671,496,175,0,649,22,1100,429,464,185
31,PRAHOVA,"ORAŞ AZUGA",130954,AZUGA,"GRĂDINIŢA DE COPII",183,"Alegeri Prezidentiale",1,1213,731,634,97,0,709,22,1300,569,467,242
31,PRAHOVA,"ORAŞ BĂICOI",130981,BĂICOI,"SALA DE SPORT TINERETULUI",184,"Alegeri Prezidentiale",1,1106,706,593,68,45,694,12,1200,494,456,238
31,PRAHOVA,"ORAŞ BĂICOI",130981,BĂICOI,"GRADINITA CU PROGRAM NORMAL TUFENI",185,"Alegeri Prezidentiale",1,1241,676,637,39,0,664,12,1300,624,447,217
31,PRAHOVA,"ORAŞ BĂICOI",130981,BĂICOI,"CLUBUL ELEVILOR",186,"Alegeri Prezidentiale",1,1448,827,753,73,1,816,11,1500,673,521,295
31,PRAHOVA,"ORAŞ BĂICOI",130981,BĂICOI,"GR. SC. C-TIN CANTACUZINO",187,"Alegeri Prezidentiale",1,1143,595,536,59,0,586,9,1300,705,380,206
31,PRAHOVA,"ORAŞ BĂICOI",130981,BĂICOI,"GR. SC. C-TIN CANTACUZINO",188,"Alegeri Prezidentiale",1,1075,647,579,68,0,635,12,1200,553,420,215
31,PRAHOVA,"ORAŞ BĂICOI",130981,BĂICOI,"GRADINITA LILIESTI",189,"Alegeri Prezidentiale",1,1030,557,519,38,0,547,10,1100,543,319,228
31,PRAHOVA,"ORAŞ BĂICOI",130981,BĂICOI,"GRADINITA LILIESTI",190,"Alegeri Prezidentiale",1,1011,577,520,57,0,559,18,1100,523,358,201
31,PRAHOVA,"ORAŞ BĂICOI",130981,BĂICOI,"SCOALA NUMARUL 3 LILIESTI",191,"Alegeri Prezidentiale",1,1451,701,669,31,1,691,10,1600,899,436,255
31,PRAHOVA,"ORAŞ BĂICOI",130981,BĂICOI,"SCOALA NUMARUL 3 LILIESTI SALA NR. 2",192,"Alegeri Prezidentiale",1,1575,868,815,53,0,854,14,1700,832,517,337
31,PRAHOVA,"ORAŞ BĂICOI",130981,BĂICOI,"CASA DE CULTURA LILIESTI",193,"Alegeri Prezidentiale",1,1363,803,676,98,29,791,12,1500,697,482,309
31,PRAHOVA,"ORAŞ BĂICOI",130981,BĂICOI,"SCOALA GENERALA DAMBU",194,"Alegeri Prezidentiale",1,1107,509,482,27,0,502,7,1200,691,314,188
31,PRAHOVA,"ORAŞ BĂICOI",130981,BĂICOI,"SCOALA GENERALA TINTEA",195,"Alegeri Prezidentiale",1,1265,672,601,71,0,653,19,1400,728,410,243
31,PRAHOVA,"ORAŞ BĂICOI",130981,BĂICOI,"CASA DE CULTURA TINTEA",196,"Alegeri Prezidentiale",1,1041,562,499,63,0,547,15,1100,538,333,214
31,PRAHOVA,"ORAŞ BOLDEŞTI-SCĂENI",131069,BOLDEŞTI-SCĂENI,"ȘCOALA GIMNAZIALĂ ”MIHAI VITEAZUL”",197,"Alegeri Prezidentiale",1,1003,643,522,102,19,632,11,1100,457,415,217
31,PRAHOVA,"ORAŞ BOLDEŞTI-SCĂENI",131069,BOLDEŞTI-SCĂENI,"ȘCOALA GIMNAZIALĂ ”MIHAI VITEAZUL”",198,"Alegeri Prezidentiale",1,1188,728,637,91,0,708,20,1300,572,452,256
31,PRAHOVA,"ORAŞ BOLDEŞTI-SCĂENI",131069,BOLDEŞTI-SCĂENI,"ȘCOALA GIMNAZIALĂ ”MIHAI VITEAZUL”",199,"Alegeri Prezidentiale",1,1230,705,649,56,0,691,14,1300,595,437,254
31,PRAHOVA,"ORAŞ BOLDEŞTI-SCĂENI",131069,BOLDEŞTI-SCĂENI,"GRĂDINIŢA CU PROGRAM NORMAL, NR.1",200,"Alegeri Prezidentiale",1,1386,687,651,36,0,673,14,1500,813,427,246
31,PRAHOVA,"ORAŞ BOLDEŞTI-SCĂENI",131069,BOLDEŞTI-SCĂENI,"ȘCOALA GIMNAZIALĂ NR.2",201,"Alegeri Prezidentiale",1,867,525,481,44,0,513,12,1000,475,333,180
31,PRAHOVA,"ORAŞ BOLDEŞTI-SCĂENI",131069,BOLDEŞTI-SCĂENI,"ȘCOALA GIMNAZIALĂ NR.2",202,"Alegeri Prezidentiale",1,1030,614,527,87,0,596,18,1100,486,384,212
31,PRAHOVA,"ORAŞ BOLDEŞTI-SCĂENI",131069,BOLDEŞTI-SCĂENI,"CASA DE CULTURĂ ”MIHAI EMINESCU”",203,"Alegeri Prezidentiale",1,878,608,504,104,0,598,10,1000,392,415,183
31,PRAHOVA,"ORAŞ BOLDEŞTI-SCĂENI",131069,BOLDEŞTI-SCĂENI,"LICEUL TEHNOLOGIC ”TEODOR DIAMANT”",204,"Alegeri Prezidentiale",1,1008,612,468,144,0,603,9,1100,488,395,208
31,PRAHOVA,"ORAŞ BOLDEŞTI-SCĂENI",131069,SECIU,"ȘCOALA PRIMARĂ SECIU",205,"Alegeri Prezidentiale",1,808,436,388,48,0,428,8,900,464,280,148
31,PRAHOVA,"ORAŞ BREAZA",131103,"PODU VADULUI","GRĂDINIȚA CU PROGRAM NORMAL PODU VADULUI",206,"Alegeri Prezidentiale",1,1357,782,647,134,1,772,10,1600,818,489,283
31,PRAHOVA,"ORAŞ BREAZA",131103,"BREAZA DE JOS","ȘCOALA GIMNAZIALĂ BREAZA DE JOS",207,"Alegeri Prezidentiale",1,971,541,455,85,1,529,12,1100,559,362,167
31,PRAHOVA,"ORAŞ BREAZA",131103,"BREAZA DE JOS","ȘCOALA GIMNAZIALĂ BREAZA DE JOS",208,"Alegeri Prezidentiale",1,1013,550,452,98,0,542,8,1100,550,336,206
31,PRAHOVA,"ORAŞ BREAZA",131103,"BREAZA DE SUS","LICEUL TEORETIC ”AUREL VLAICU” BREAZA",209,"Alegeri Prezidentiale",1,1421,825,673,152,0,808,17,1500,675,535,273
31,PRAHOVA,"ORAŞ BREAZA",131103,"BREAZA DE SUS","LICEUL TEORETIC ”AUREL VLAICU” BREAZA",210,"Alegeri Prezidentiale",1,1079,643,529,56,58,635,8,1200,557,428,207
31,PRAHOVA,"ORAŞ BREAZA",131103,"BREAZA DE SUS","LICEUL TEORETIC ”AUREL VLAICU” BREAZA",211,"Alegeri Prezidentiale",1,1576,844,754,90,0,831,13,1700,856,548,283
31,PRAHOVA,"ORAŞ BREAZA",131103,"BREAZA DE SUS","LICEUL TEORETIC ”AUREL VLAICU” BREAZA",212,"Alegeri Prezidentiale",1,874,637,465,172,0,625,12,1000,363,406,219
31,PRAHOVA,"ORAŞ BREAZA",131103,"BREAZA DE SUS","GRĂDINIŢA CU PROGRAM PRELUNGIT ȘI PROGRAM NORMAL ”CASTELUL FERMECAT”",213,"Alegeri Prezidentiale",1,887,465,425,40,0,459,6,1000,535,279,180
31,PRAHOVA,"ORAŞ BREAZA",131103,"BREAZA DE SUS","ȘCOALA GIMNAZIALĂ ”CONSTANTIN BRÂNCOVEANU” BREAZA",214,"Alegeri Prezidentiale",1,1294,849,696,153,0,837,12,1400,551,579,258
31,PRAHOVA,"ORAŞ BREAZA",131103,"GURA BELIEI","GRĂDINIŢA CU PROGRAM NORMAL GURA BELIEI ”ALBINUŢA”",215,"Alegeri Prezidentiale",1,1088,632,539,93,0,625,7,1200,568,420,205
31,PRAHOVA,"ORAŞ BREAZA",131103,NISTOREŞTI,"ȘCOALA GIMNAZIALĂ NISTOREȘTI",216,"Alegeri Prezidentiale",1,1092,652,512,139,1,649,3,1200,548,450,199
31,PRAHOVA,"ORAŞ BREAZA",131103,"VALEA TÂRSEI","ȘCOALA GIMNAZIALĂ VALEA TÂRSEI",217,"Alegeri Prezidentiale",1,1219,553,507,46,0,550,3,1300,747,346,204
31,PRAHOVA,"ORAŞ BUŞTENI",131210,BUŞTENI,"COLEGIUL ION KALINDERU",218,"Alegeri Prezidentiale",1,888,701,447,254,0,682,19,1000,299,502,180
31,PRAHOVA,"ORAŞ BUŞTENI",131210,BUŞTENI,"ŞCOALA GIMNAZIALĂ ”NESTOR URECHIA”",219,"Alegeri Prezidentiale",1,988,915,525,390,0,888,27,1100,185,644,244
31,PRAHOVA,"ORAŞ BUŞTENI",131210,BUŞTENI,"ŞCOALA GIMNAZIALĂ ”NESTOR URECHIA”",220,"Alegeri Prezidentiale",1,882,803,431,372,0,781,22,1000,197,571,210
31,PRAHOVA,"ORAŞ BUŞTENI",131210,BUŞTENI,"GRĂDINIŢA CU PP SI PN ”FRAM - URSUL POLAR”",221,"Alegeri Prezidentiale",1,608,415,324,91,0,406,9,700,285,270,136
31,PRAHOVA,"ORAŞ BUŞTENI",131210,BUŞTENI,"SEDIU FIRMĂ PAZĂ",222,"Alegeri Prezidentiale",1,1360,939,679,260,0,917,22,1500,561,659,258
31,PRAHOVA,"ORAŞ BUŞTENI",131210,BUŞTENI,"ŞCOALA GIMNAZIALĂ ”REGINA ELISABETA”",223,"Alegeri Prezidentiale",1,1298,894,687,206,1,866,28,1400,506,663,203
31,PRAHOVA,"ORAŞ BUŞTENI",131210,BUŞTENI,"ŞCOALA GIMNAZIALĂ ”CEZAR PETRESCU”",224,"Alegeri Prezidentiale",1,1283,737,618,119,0,719,18,1400,663,528,191
31,PRAHOVA,"ORAŞ BUŞTENI",131210,BUŞTENI,"ŞCOALA GIMNAZIALĂ ”CEZAR PETRESCU”",225,"Alegeri Prezidentiale",1,891,606,479,127,0,588,18,1000,394,395,193
31,PRAHOVA,"ORAŞ COMARNIC",131336,COMARNIC,"LICEUL SIMION STOLNICU",226,"Alegeri Prezidentiale",1,1526,796,725,71,0,782,14,1601,805,539,243
31,PRAHOVA,"ORAŞ COMARNIC",131336,COMARNIC,"SCOALA GIMNAZIALA COMARNIC NR.2",227,"Alegeri Prezidentiale",1,844,480,422,58,0,472,8,900,420,327,145
31,PRAHOVA,"ORAŞ COMARNIC",131336,COMARNIC,"SCOALA GIMNAZIALA COMARNIC NR.2",228,"Alegeri Prezidentiale",1,1299,628,590,38,0,619,9,1400,772,439,180
31,PRAHOVA,"ORAŞ COMARNIC",131336,POIANA,"SCOALA GIMNAZIALA COMARNIC",229,"Alegeri Prezidentiale",1,1475,717,648,69,0,705,12,1600,883,520,185
31,PRAHOVA,"ORAŞ COMARNIC",131336,POIANA,"GRADINITA CU PROGRAM NORMAL POIANA",230,"Alegeri Prezidentiale",1,876,462,446,16,0,457,5,1000,538,349,108
31,PRAHOVA,"ORAŞ COMARNIC",131336,"PODU LUNG","GRADINITA CU PROGRAM NORMAL PODUL LUNG",231,"Alegeri Prezidentiale",1,495,251,229,22,0,248,3,600,349,163,85
31,PRAHOVA,"ORAŞ COMARNIC",131336,GHIOŞEŞTI,"GRADINITA CU PROGRAM NORMAL GHIOȘEȘTI",232,"Alegeri Prezidentiale",1,1586,843,770,73,0,835,8,1700,857,526,309
31,PRAHOVA,"ORAŞ COMARNIC",131336,COMARNIC,"SCOALA PRIMARA GHIOȘEȘTI",233,"Alegeri Prezidentiale",1,1107,507,488,19,0,505,2,1200,693,358,147
31,PRAHOVA,"ORAŞ COMARNIC",131336,POSADA,"GRADINITA CU PROGRAM NORMAL POSADA",234,"Alegeri Prezidentiale",1,1149,509,457,52,0,503,6,1300,791,353,150
31,PRAHOVA,"ORAŞ MIZIL",131407,MIZIL,"SALA DE SPORT MIZIL",235,"Alegeri Prezidentiale",1,1549,593,549,44,0,579,14,1600,1007,303,276
31,PRAHOVA,"ORAŞ MIZIL",131407,MIZIL,"ŞCOALA GIMNAZIALĂ ” SFÂNTUL NICOLAE ”MIZIL",236,"Alegeri Prezidentiale",1,1268,507,468,39,0,501,6,1400,893,250,251
31,PRAHOVA,"ORAŞ MIZIL",131407,MIZIL,"ŞCOALA GIMNAZIALĂ NR.1 MIZIL",237,"Alegeri Prezidentiale",1,1009,458,439,19,0,456,2,1100,642,251,205
31,PRAHOVA,"ORAŞ MIZIL",131407,MIZIL,"LICEUL TEHNOLOGIC ”TASE DUMITRESCU” MIZIL",238,"Alegeri Prezidentiale",1,933,453,408,45,0,442,11,1000,547,242,200
31,PRAHOVA,"ORAŞ MIZIL",131407,MIZIL,"LICEUL TEHNOLOGIC ”TASE DUMITRESCU ” MIZIL",239,"Alegeri Prezidentiale",1,1050,340,311,29,0,328,12,1200,860,148,180
31,PRAHOVA,"ORAŞ MIZIL",131407,MIZIL,"PRIMĂRIA ORAŞ MIZIL",240,"Alegeri Prezidentiale",1,1084,573,513,60,0,567,6,1200,627,275,292
31,PRAHOVA,"ORAŞ MIZIL",131407,MIZIL,"PRIMĂRIA ORAŞ MIZIL",241,"Alegeri Prezidentiale",1,1020,457,432,25,0,448,9,1100,643,257,191
31,PRAHOVA,"ORAŞ MIZIL",131407,MIZIL,"CENTRUL CULTURAL ”ADRIAN PĂUNESCU”",242,"Alegeri Prezidentiale",1,1402,588,551,37,0,580,8,1500,912,297,283
31,PRAHOVA,"ORAŞ MIZIL",131407,MIZIL,"ŞCOALA GIMNAZIALĂ ” SFÂNTA MARIA ”MIZIL",243,"Alegeri Prezidentiale",1,1000,385,353,32,0,378,7,1100,715,233,145
31,PRAHOVA,"ORAŞ MIZIL",131407,MIZIL,"ŞCOALA GIMNAZIALĂ ” SFÂNTA MARIA ”MIZIL",244,"Alegeri Prezidentiale",1,1130,530,496,34,0,514,16,1300,770,307,207
31,PRAHOVA,"ORAŞ MIZIL",131407,MIZIL,"LICEUL TEORETIC ” GRIGORE TOCILESCU” MIZIL",245,"Alegeri Prezidentiale",1,994,473,410,46,17,466,7,1100,627,250,216
31,PRAHOVA,"ORAŞ PLOPENI",131443,PLOPENI,"CASA DE CULTURĂ PLOPENI",246,"Alegeri Prezidentiale",1,1238,723,661,62,0,703,20,1300,577,406,297
31,PRAHOVA,"ORAŞ PLOPENI",131443,PLOPENI,"SALA POLIVALENTĂ PLOPENI",247,"Alegeri Prezidentiale",1,1203,648,604,44,0,634,14,1300,652,380,254
31,PRAHOVA,"ORAŞ PLOPENI",131443,PLOPENI,"SALA POLIVALENTĂ PLOPENI",248,"Alegeri Prezidentiale",1,1081,637,584,53,0,620,17,1200,563,349,271
31,PRAHOVA,"ORAŞ PLOPENI",131443,PLOPENI,"COLEGIUL TEHNIC ”GHEORGHE LAZĂR” PLOPENI",249,"Alegeri Prezidentiale",1,1129,596,530,61,5,578,18,1300,704,340,238
31,PRAHOVA,"ORAŞ PLOPENI",131443,PLOPENI,"COLEGIUL TEHNIC ”GHEORGHE LAZĂR” PLOPENI",250,"Alegeri Prezidentiale",1,1471,733,685,45,3,718,15,1600,867,473,245
31,PRAHOVA,"ORAŞ PLOPENI",131443,PLOPENI,"ŞCOALA GIMNAZIALA ”CAROL I” PLOPENI",251,"Alegeri Prezidentiale",1,1362,782,726,51,5,759,23,1500,718,475,284
31,PRAHOVA,"ORAŞ SINAIA",131540,SINAIA,"COLEGIUL ”MIHAIL CANTACUZINO” SALA AP.1",252,"Alegeri Prezidentiale",1,1368,767,689,78,0,739,28,1408,641,534,205
31,PRAHOVA,"ORAŞ SINAIA",131540,SINAIA,"COLEGIUL ”MIHAIL CANTACUZINO” SALA AP.2",253,"Alegeri Prezidentiale",1,1030,619,528,91,0,601,18,1000,381,421,180
31,PRAHOVA,"ORAŞ SINAIA",131540,SINAIA,"SCOALA GIMNAZIALA ”PRINCIPESA MARIA”CORP B",254,"Alegeri Prezidentiale",1,765,514,402,80,32,507,7,800,286,353,154
31,PRAHOVA,"ORAŞ SINAIA",131540,SINAIA,"SCOALA GIMNAZIALA ”PRINCIPESA MARIA”CORP A",255,"Alegeri Prezidentiale",1,667,485,369,116,0,473,12,900,415,354,119
31,PRAHOVA,"ORAŞ SINAIA",131540,SINAIA,"SCOALA GIMNAZIALA ”PRINCIPESA MARIA”CORP A",256,"Alegeri Prezidentiale",1,1013,655,559,96,0,634,21,1000,345,466,168
31,PRAHOVA,"ORAŞ SINAIA",131540,SINAIA,"IMOBIL PROPRIETATE ORAS SINAIA",257,"Alegeri Prezidentiale",1,920,550,487,63,0,532,18,900,350,333,199
31,PRAHOVA,"ORAŞ SINAIA",131540,SINAIA,"CLUBUL SPORTIV CARPAŢI - SALA DE SPORT",258,"Alegeri Prezidentiale",1,793,651,371,280,0,637,14,1000,349,474,163
31,PRAHOVA,"ORAŞ SINAIA",131540,SINAIA,"ŞCOALA GIMNAZIALA ”GEORGE ENESCU” SALA 3 B",259,"Alegeri Prezidentiale",1,510,826,236,590,0,805,21,900,74,594,211
31,PRAHOVA,"ORAŞ SINAIA",131540,SINAIA,"ŞCOALA GIMNAZIALA ”GEORGE ENESCU” SALA I B",260,"Alegeri Prezidentiale",1,864,788,400,386,2,776,12,992,204,571,205
31,PRAHOVA,"ORAŞ SINAIA",131540,SINAIA,"CENTRUL CULTURAL ”CARMEN SYLVA”",261,"Alegeri Prezidentiale",1,552,354,255,99,0,347,7,600,246,234,113
31,PRAHOVA,"ORAŞ SINAIA",131540,SINAIA,"CENTRUL DE ACŢIUNE SI INFORMARE COMUNITARA",262,"Alegeri Prezidentiale",1,567,561,306,254,1,550,11,800,239,409,141
31,PRAHOVA,"ORAŞ SINAIA",131540,SINAIA,"CENTRUL INTERNATIONAL DE CONFERINŢE CASINO",263,"Alegeri Prezidentiale",1,636,585,307,277,1,573,12,900,315,425,148
31,PRAHOVA,"ORAŞ SLĂNIC",131577,PRĂJANI,"ŞCOALA PRĂJANI",264,"Alegeri Prezidentiale",1,1007,593,523,64,6,577,16,1100,507,325,252
31,PRAHOVA,"ORAŞ SLĂNIC",131577,SLĂNIC,"LICEUL TEORETIC ”ŞERBAN VODĂ”",265,"Alegeri Prezidentiale",1,1135,640,500,140,0,623,17,1200,560,323,300
31,PRAHOVA,"ORAŞ SLĂNIC",131577,SLĂNIC,"LICEUL TEORETIC ”ŞERBAN VODĂ”",266,"Alegeri Prezidentiale",1,1251,597,474,121,2,583,14,1400,803,363,220
31,PRAHOVA,"ORAŞ SLĂNIC",131577,GROŞANI,"SCOALA GROSANI",267,"Alegeri Prezidentiale",1,1389,659,609,50,0,646,13,1500,841,337,309
31,PRAHOVA,"ORAŞ URLAŢI",131620,URLAŢI,"GRĂDINIŢA DE COPII CU PROGRAM PRELUNGIT ”CLOPOȚICA” ORAȘUL URLAȚI",268,"Alegeri Prezidentiale",1,1529,777,720,57,0,769,8,1700,923,483,286
31,PRAHOVA,"ORAŞ URLAŢI",131620,URLAŢI,"LICEUL TEORETIC ”BRÂNCOVEANU VODĂ” ORAȘUL URLATI (CLADIREA VECHE)",269,"Alegeri Prezidentiale",1,1533,763,689,69,5,753,10,1600,837,460,293
31,PRAHOVA,"ORAŞ URLAŢI",131620,URLAŢI,"LICEUL TEORETIC ”BRÂNCOVEANU VODĂ” ORAȘUL URLAȚI",270,"Alegeri Prezidentiale",1,1474,638,583,55,0,631,7,1600,962,356,275
31,PRAHOVA,"ORAŞ URLAŢI",131620,URLAŢI,"ŞCOALA GIMNAZIALĂ ”CĂNUŢĂ IONESCU” ORAȘUL URLATI",271,"Alegeri Prezidentiale",1,1624,751,713,36,2,735,16,1800,1049,406,329
31,PRAHOVA,"ORAŞ URLAŢI",131620,URLAŢI,"”CASA DE CULTURĂ” ORAȘUL URLAŢI",272,"Alegeri Prezidentiale",1,1467,743,675,68,0,736,7,1600,857,440,296
31,PRAHOVA,"ORAŞ URLAŢI",131620,URLAŢI,"GRĂDINIȚA CU PROGRAM NORMAL ”JERCĂLĂI” ORAȘUL URLAȚI",273,"Alegeri Prezidentiale",1,804,314,291,23,0,304,10,900,586,200,104
31,PRAHOVA,"ORAŞ URLAŢI",131620,URLAŢI,"GRĂDINIȚA CU PROGRAM NORMAL ”VALEA URLOI” ORAȘUL URLAȚI",274,"Alegeri Prezidentiale",1,872,338,314,24,0,331,7,1000,662,240,91
31,PRAHOVA,"ORAŞ VĂLENII DE MUNTE",131817,"VĂLENII DE MUNTE","PRIMĂRIA VĂLENII DE MUNTE (CASA CĂSĂTORIILOR)",275,"Alegeri Prezidentiale",1,1020,584,511,73,0,572,12,1100,516,331,241
31,PRAHOVA,"ORAŞ VĂLENII DE MUNTE",131817,"VĂLENII DE MUNTE","CASA DE CULTURĂ (SALA MICĂ)",276,"Alegeri Prezidentiale",1,1319,725,652,72,1,711,14,1400,675,407,304
31,PRAHOVA,"ORAŞ VĂLENII DE MUNTE",131817,"VĂLENII DE MUNTE","CASA DE CULTURĂ (FOAIER)",277,"Alegeri Prezidentiale",1,1114,583,494,89,0,574,9,1200,617,323,251
31,PRAHOVA,"ORAŞ VĂLENII DE MUNTE",131817,"VĂLENII DE MUNTE","CLUBUL COPIILOR",278,"Alegeri Prezidentiale",1,876,464,432,32,0,452,12,1000,536,267,185
31,PRAHOVA,"ORAŞ VĂLENII DE MUNTE",131817,"VĂLENII DE MUNTE","ȘCOALA GIMNAZIALĂ ”INGINER GHEORGHE PĂNCULESCU”",279,"Alegeri Prezidentiale",1,1284,749,673,75,1,738,11,1400,651,427,311
31,PRAHOVA,"ORAŞ VĂLENII DE MUNTE",131817,"VĂLENII DE MUNTE","GRĂDINIȚA CU PROGRAM NORMAL NR. 1",280,"Alegeri Prezidentiale",1,1414,894,703,143,48,869,25,1600,706,540,329
31,PRAHOVA,"ORAŞ VĂLENII DE MUNTE",131817,"VĂLENII DE MUNTE","GRĂDINIȚA CU PROGRAM NORMAL NR. 4",281,"Alegeri Prezidentiale",1,997,525,487,37,1,513,12,1100,575,217,296
31,PRAHOVA,"ORAŞ VĂLENII DE MUNTE",131817,"VĂLENII DE MUNTE","LICEUL TEHNOLOGIC AGROMONTAN ”ROMEO CONSTANTINESCU”",282,"Alegeri Prezidentiale",1,955,564,507,57,0,553,11,1100,536,295,258
31,PRAHOVA,"ORAŞ VĂLENII DE MUNTE",131817,"VĂLENII DE MUNTE","ȘCOALA PRIMARĂ NR.4 (MIULEȘTI)",283,"Alegeri Prezidentiale",1,1214,683,605,78,0,666,17,1300,617,384,282
31,PRAHOVA,"ORAŞ VĂLENII DE MUNTE",131817,"VĂLENII DE MUNTE","ȘCOALA PRIMARĂ NR.2 (VALEA GARDULUI)",284,"Alegeri Prezidentiale",1,886,498,458,40,0,483,15,1000,502,265,218
31,PRAHOVA,ADUNAŢI,131899,ADUNAŢI,"CĂMIN CULTURAL",285,"Alegeri Prezidentiale",1,886,491,427,64,0,484,7,1000,509,266,218
31,PRAHOVA,ADUNAŢI,131899,ADUNAŢI,"GRĂDINIȚA „CASTELUL PITICILOR”",286,"Alegeri Prezidentiale",1,782,380,350,30,0,373,7,900,520,240,133
31,PRAHOVA,ALBEŞTI-PALEOLOGU,131933,ALBEŞTI-PALEOLOGU,"SCOALA GIMNAZIALA CLASELE I-VIII ALBESTI PALEOLOGU",287,"Alegeri Prezidentiale",1,1445,703,613,90,0,692,11,1600,897,469,223
31,PRAHOVA,ALBEŞTI-PALEOLOGU,131933,"VADU PĂRULUI","SCOALA GIMNAZIALA CLASELE I-VIII SAT VADU PĂRULUI",288,"Alegeri Prezidentiale",1,1557,687,627,60,0,680,7,1700,1013,425,255
31,PRAHOVA,ALBEŞTI-PALEOLOGU,131933,ALBEŞTI-MURU,"SCOALA GIMNAZIALA CU CLASELE I-IV SAT ALBESTI MURU",289,"Alegeri Prezidentiale",1,888,437,388,49,0,433,4,1000,563,288,145
31,PRAHOVA,ALBEŞTI-PALEOLOGU,131933,CIOCENI,"SCOALA GIMNAZIALA CU CLASELE I-VIII CIOCENI",290,"Alegeri Prezidentiale",1,716,370,337,33,0,363,7,800,430,187,176
31,PRAHOVA,ALUNIŞ,131988,ALUNIŞ,"SCOALA GIMNAZIALA GHEORGHE COSTESCU ALUNIS",291,"Alegeri Prezidentiale",1,1198,771,692,78,1,750,21,1300,529,375,375
31,PRAHOVA,ALUNIŞ,131988,ALUNIŞ,"SCOALA CU CLS. I-IV ALUNIS VALE",292,"Alegeri Prezidentiale",1,707,457,394,61,2,445,12,800,343,225,220
31,PRAHOVA,ALUNIŞ,131988,OSTROVU,"SCOALA GIMNAZIALA SAT OSTROVU",293,"Alegeri Prezidentiale",1,785,512,459,53,0,497,15,900,388,260,237
31,PRAHOVA,APOSTOLACHE,132011,APOSTOLACHE,"CONSILIUL LOCAL APOSTOLACHE",294,"Alegeri Prezidentiale",1,862,500,421,79,0,497,3,900,400,362,135
31,PRAHOVA,APOSTOLACHE,132011,APOSTOLACHE,"CONSILIUL LOCAL APOSTOLACHE",295,"Alegeri Prezidentiale",1,780,357,325,32,0,356,1,900,543,257,99
31,PRAHOVA,"ARICEŞTII RAHTIVANI",132075,"ARICEŞTII RAHTIVANI","ȘCOALA GIMNAZIALĂ COMUNA ARICEȘTII RAHTIVANI NR. 96A",296,"Alegeri Prezidentiale",1,1194,689,620,69,0,673,16,1300,611,473,200
31,PRAHOVA,"ARICEŞTII RAHTIVANI",132075,"ARICEŞTII RAHTIVANI","CĂMINUL CULTURAL ARICEȘTII RAHTIVANI, NR. 527A",297,"Alegeri Prezidentiale",1,1073,608,544,64,0,598,10,1200,592,433,165
31,PRAHOVA,"ARICEŞTII RAHTIVANI",132075,NEDELEA,"GRĂDINIȚA CU PROGRAM NORMAL NEDELEA NR. 47A",298,"Alegeri Prezidentiale",1,801,446,406,40,0,443,3,900,454,305,138
31,PRAHOVA,"ARICEŞTII RAHTIVANI",132075,NEDELEA,"ȘCOALA GIMNAZIALĂ SAT NEDELEA, COMUNA ARICEȘTII RAHTIVANI, NR. 491",299,"Alegeri Prezidentiale",1,1145,657,619,38,0,652,5,1300,643,502,150
31,PRAHOVA,"ARICEŞTII RAHTIVANI",132075,STOENEŞTI,"ȘCOALA GIMNAZIALĂ SAT STOENEȘTI NR. 14",300,"Alegeri Prezidentiale",1,1149,712,499,54,159,706,6,1300,588,353,353
31,PRAHOVA,"ARICEŞTII RAHTIVANI",132075,"TÂRGŞORU NOU","GRĂDINIȚA CU PROGRAM NORMAL TÎRGȘORU NOU, NR. 175",301,"Alegeri Prezidentiale",1,911,715,440,105,170,706,9,1000,285,354,352
31,PRAHOVA,"ARICEŞTII RAHTIVANI",132075,BUDA,"GRĂDINIȚA CU PROGRAM NORMAL BUDA NR. 46 A",302,"Alegeri Prezidentiale",1,425,256,204,52,0,252,4,500,244,175,77
31,PRAHOVA,"ARICEŞTII ZELETIN",132137,"ARICEŞTII ZELETIN","ŞCOALA GIMNAZIALĂ ATHANASIE JAN STOICESCU",303,"Alegeri Prezidentiale",1,938,534,461,73,0,532,2,1000,466,308,224
31,PRAHOVA,"BABA ANA",132164,"BABA ANA","SCOALA GIMNAZIALĂ BABA ANA",304,"Alegeri Prezidentiale",1,1536,716,660,56,0,711,5,1692,976,428,283
31,PRAHOVA,"BABA ANA",132164,CONDURATU,"SCOALA GIMNAZIALĂ CONDURATU",305,"Alegeri Prezidentiale",1,985,465,415,50,0,458,7,1100,635,295,163
31,PRAHOVA,"BABA ANA",132164,CIREŞANU,"SCOALA GIMNAZIALĂ CIREŞANU",306,"Alegeri Prezidentiale",1,678,290,256,34,0,289,1,700,410,170,119
31,PRAHOVA,"BABA ANA",132164,"SATU NOU","SCOALA CU CLS. I-IV SATU NOU",307,"Alegeri Prezidentiale",1,90,54,36,18,0,54,0,101,47,28,26
31,PRAHOVA,"BALTA DOAMNEI",132226,"BALTA DOAMNEI","ȘCOALA GIMNAZIALĂ SFINȚII ÎMPĂRAȚI BALTA DOAMNEI",308,"Alegeri Prezidentiale",1,1190,607,535,72,0,599,8,1300,693,338,261
31,PRAHOVA,"BALTA DOAMNEI",132226,BÂRA,"ȘCOALA PRIMARĂ DIN BÎRA",309,"Alegeri Prezidentiale",1,747,330,263,67,0,327,3,800,470,183,144
31,PRAHOVA,BĂLŢEŞTI,132271,BĂLŢEŞTI,"ŞCOALA CU CLASELE I-IV",310,"Alegeri Prezidentiale",1,1532,747,687,60,0,735,12,1700,953,551,184
31,PRAHOVA,BĂLŢEŞTI,132271,"PODENII VECHI","ŞCOALA PODENII VECHI",311,"Alegeri Prezidentiale",1,1396,754,677,77,0,746,8,1500,746,537,209
31,PRAHOVA,BĂNEŞTI,132315,BĂNEŞTI,"ŞCOALA GIMNAZIALĂ ”IOAN DUHOVNICUL” BĂNEŞTI",312,"Alegeri Prezidentiale",1,1390,838,712,111,15,824,14,1500,662,520,304
31,PRAHOVA,BĂNEŞTI,132315,BĂNEŞTI,"DISPENSAR UMAN BĂNEŞTI",313,"Alegeri Prezidentiale",1,1338,784,680,90,14,769,15,1500,716,519,250
31,PRAHOVA,BĂNEŞTI,132315,URLETA,"ŞCOALA GIMNAZIALĂ ”IOAN DUHOVNICUL” BĂNEŞTI",314,"Alegeri Prezidentiale",1,1077,624,544,72,8,615,9,1200,576,387,228
31,PRAHOVA,BĂNEŞTI,132315,URLETA,"ŞCOALA GIMNAZIALĂ ”IOAN DUHOVNICUL” BĂNEŞTI",315,"Alegeri Prezidentiale",1,976,550,452,82,16,539,11,1100,550,299,240
31,PRAHOVA,BĂRCĂNEŞTI,130552,BĂRCĂNEŞTI,"ŞCOALA GIMNAZIALĂ ”GHEORGHE LAZĂR” COMUNA BĂRCĂNEŞTI",316,"Alegeri Prezidentiale",1,1286,479,390,89,0,471,8,1400,921,264,207
31,PRAHOVA,BĂRCĂNEŞTI,130552,BĂRCĂNEŞTI,"ŞCOALA GIMNAZIALĂ ”GHEORGHE LAZĂR” COMUNA BĂRCĂNEŞTI",317,"Alegeri Prezidentiale",1,1396,599,554,45,0,587,12,1500,901,351,236
31,PRAHOVA,BĂRCĂNEŞTI,130552,GHIGHIU,"SEDIUL FOSTEI ŞCOLI CU CLASELE I-IV GHIGHIU",318,"Alegeri Prezidentiale",1,601,356,295,61,0,349,7,700,344,238,111
31,PRAHOVA,BĂRCĂNEŞTI,130552,PUŞCAŞI,"SEDIUL FOSTEI ŞCOLI CU CLASELE I-IV PUŞCAŞI",319,"Alegeri Prezidentiale",1,328,184,149,35,0,181,3,400,216,122,59
31,PRAHOVA,BĂRCĂNEŞTI,130552,ROMÂNEŞTI,"ŞCOALA GIMNAZIALĂ ROMÂNEŞTI",320,"Alegeri Prezidentiale",1,1580,623,541,82,0,608,15,1700,1077,384,224
31,PRAHOVA,BĂRCĂNEŞTI,130552,TĂTĂRANI,"ŞCOALA GIMNAZIALĂ TĂTĂRANI",321,"Alegeri Prezidentiale",1,1221,632,569,63,0,624,8,1400,768,427,197
31,PRAHOVA,BĂRCĂNEŞTI,130552,TĂTĂRANI,"ŞCOALA GIMNAZIALĂ TĂTĂRANI",322,"Alegeri Prezidentiale",1,1286,692,618,74,0,681,11,1400,708,489,192
31,PRAHOVA,BĂTRÂNI,136278,BĂTRÂNI,"SCOALA GIMNAZIALA, COMUNA BATRANI",323,"Alegeri Prezidentiale",1,904,436,410,26,0,427,9,1000,564,241,186
31,PRAHOVA,BĂTRÂNI,136278,BĂTRÂNI,"GRADINITA DE COPII",324,"Alegeri Prezidentiale",1,769,378,352,26,0,369,9,800,422,272,97
31,PRAHOVA,BERCENI,130614,BERCENI,"SCOALA GIMNAZIALA BERCENI,SALA DE SPORT PARTER",325,"Alegeri Prezidentiale",1,1312,658,580,77,1,650,8,1400,742,456,194
31,PRAHOVA,BERCENI,130614,BERCENI,"GRADINITA CU PROGRAM NORMAL-SALA MICA PARTER,COM.BERCENI,SAT BERCENI,STR.GRADINITEI NR. 358 A",326,"Alegeri Prezidentiale",1,759,360,323,36,1,353,7,800,440,239,114
31,PRAHOVA,BERCENI,130614,CORLĂTEŞTI,"SCOALA CU CLASELE I-VIII-SALA DE SPORT PARTER,COM.BERCENI,SAT CORLATESTI,STR.SCOLII,NR.139 A",327,"Alegeri Prezidentiale",1,1185,650,593,57,0,641,9,1300,650,471,170
31,PRAHOVA,BERCENI,130614,"CARTIERUL DÂMBU","CAMINUL CULTURAL -SALA MARE PARTER,COM.BERCENI,SAT DIMBU,STR.PLOPULUI,NR.73 A,",328,"Alegeri Prezidentiale",1,381,240,202,38,0,234,6,400,160,152,82
31,PRAHOVA,BERCENI,130614,CĂTUNU,"GRADINITA CU PROGRAM NORMAL,SALA MICA PARTER,COM.BERCENI,SAT CATUNU.STR.DEMOCRATIEI,NR.148 A",329,"Alegeri Prezidentiale",1,535,279,245,34,0,269,10,600,321,188,81
31,PRAHOVA,BERCENI,130614,"MOARA NOUĂ","GRADINITA CU PROGRAM NORMAL-SALA MARE PARTER,COM.BERCENI,SAT MOARA NOUA,STR.SCOLII,NR.106 C",330,"Alegeri Prezidentiale",1,882,409,337,40,32,406,3,1000,591,279,127
31,PRAHOVA,BERTEA,132342,BERTEA,"GRADINITA DE COPII NR.1",331,"Alegeri Prezidentiale",1,1387,660,618,42,0,644,16,1500,840,432,212
31,PRAHOVA,BERTEA,132342,BERTEA,"GRADINITA DE COPII NR.2",332,"Alegeri Prezidentiale",1,1164,535,492,42,1,524,11,1300,765,337,187
31,PRAHOVA,BLEJOI,130678,BLEJOI,"ȘCOALA GIMNAZIALĂ ”RADU TUDORAN” BLEJOI, SAT BLEJOI, NR. 510",333,"Alegeri Prezidentiale",1,1639,933,858,73,2,907,26,1800,867,643,264
31,PRAHOVA,BLEJOI,130678,BLEJOI,"GRĂDINIȚA CU PROGRAM NORMAL BLEJOI, SAT BLEJOI, NR. 511",334,"Alegeri Prezidentiale",1,1536,928,812,116,0,910,18,1700,772,632,278
31,PRAHOVA,BLEJOI,130678,PLOIEŞTIORI,"GRĂDINIȚA CU PROGRAM NORMAL PLOIEȘTIORI, SAT PLOIEȘTIORI, NR. 537",335,"Alegeri Prezidentiale",1,1094,669,594,75,0,659,10,1200,531,396,263
31,PRAHOVA,BLEJOI,130678,PLOIEŞTIORI,"CĂMINUL CULTURAL ”GEO BOGZA”, SAT PLOIEȘTIORI, NR. 174 B",336,"Alegeri Prezidentiale",1,1802,981,903,78,0,959,22,2000,1019,732,227
31,PRAHOVA,BLEJOI,130678,ŢÂNŢĂRENI,"GRĂDINIȚA CU PROGRAM NORMAL ȚÎNȚĂRENI, SAT ȚÎNȚĂRENI, NR. 232 E",337,"Alegeri Prezidentiale",1,1415,782,715,65,2,766,16,1500,718,509,257
31,PRAHOVA,BOLDEŞTI-GRADIŞTEA,132379,BOLDEŞTI,"CĂMİN CULTURAL BOLDEŞTİ",338,"Alegeri Prezidentiale",1,649,222,199,23,0,218,4,700,478,124,94
31,PRAHOVA,BOLDEŞTI-GRADIŞTEA,132379,GRADIŞTEA,"ŞCOALA GİMNAZİALĂ COMUNA BOLDEŞTİ-GRADİŞTEA,CORP B",339,"Alegeri Prezidentiale",1,698,312,279,33,0,304,8,800,488,223,81
31,PRAHOVA,BRAZI,130712,BĂTEŞTI,"SALA DE SPORT A ŞCOLII GIMNAZIALE ”DUMITRU HERA” BĂTEŞTI",340,"Alegeri Prezidentiale",1,1438,760,688,72,0,741,19,1600,840,484,257
31,PRAHOVA,BRAZI,130712,"BRAZII DE JOS","SALA DE FESTIVITĂŢI A PRIMĂRIEI COMUNEI BRAZI",341,"Alegeri Prezidentiale",1,639,341,300,41,0,336,5,700,359,258,78
31,PRAHOVA,BRAZI,130712,"BRAZII DE SUS","ŞCOALA GIMNAZIALĂ BRAZI",342,"Alegeri Prezidentiale",1,1017,550,496,54,0,540,10,1100,550,390,150
31,PRAHOVA,BRAZI,130712,POPEŞTI,"PUNCTUL DE LUCRU AL PRIMĂRIEI BRAZI DIN SATUL POPEŞTI",343,"Alegeri Prezidentiale",1,1449,733,678,54,1,715,18,1600,867,496,219
31,PRAHOVA,BRAZI,130712,NEGOIEŞTI,"SALA DE SPORT A ŞCOLII GIMNAZIALE ”PROFESOR OPREA MIHAI” SAT NEGOIEŞTI",344,"Alegeri Prezidentiale",1,1531,898,796,102,0,883,15,1700,802,615,268
31,PRAHOVA,BRAZI,130712,"BRAZII DE SUS","FOSTUL SEDIU AL GRADINŢEI DE COPII DIN COLONIA BRAZI",345,"Alegeri Prezidentiale",1,328,179,155,24,0,171,8,400,221,115,56
31,PRAHOVA,BRAZI,130712,STEJARU,"FOSTUL SEDIU AL ŞCOLII GIMNAZIALE DIN SATUL STEJARU",346,"Alegeri Prezidentiale",1,519,215,192,23,0,211,4,600,385,147,64
31,PRAHOVA,BREBU,132404,"BREBU MÂNĂSTIREI","ŞCOALA GIMNAZIALĂ MATEI BASARAB CORP B, SAT BREBU MÎNĂSTIREI, NR.803",347,"Alegeri Prezidentiale",1,872,610,465,145,0,605,5,1000,390,440,165
31,PRAHOVA,BREBU,132404,"BREBU MÂNĂSTIREI","ŞCOALA GIMNAZIALĂ MATEI BASARAB CORP A, SAT BREBU MÎNĂSTIREI, NR.799",348,"Alegeri Prezidentiale",1,1502,863,749,114,0,850,13,1600,737,613,237
31,PRAHOVA,BREBU,132404,"BREBU MEGIEŞESC","ŞCOALA GIMNAZIALĂ MATEI BASARAB, ŞCOALĂ PRIMARĂ STRUCTURĂ, NR.2, SAT BREBU MEGIEŞESC, NR.53",349,"Alegeri Prezidentiale",1,1457,833,735,98,0,813,20,1600,767,592,221
31,PRAHOVA,BREBU,132404,"BREBU MEGIEŞESC","ŞCOALA GIMNAZIALĂ MATEI BASARAB, ŞCOALĂ PRIMARĂ STRUCTURĂ, SAT BREBU MEGIEŞESC, NR.278",350,"Alegeri Prezidentiale",1,1061,628,574,54,0,617,11,1200,572,433,184
31,PRAHOVA,BREBU,132404,PIETRICEAUA,"ŞCOALA GIMNAZIALĂ MATEI BASARAB, ŞCOALĂ GIMNAZIALĂ PIETRICEAUA, SAT PIETRICEAUA, NR.1",351,"Alegeri Prezidentiale",1,929,432,402,30,0,426,6,1000,568,323,103
31,PRAHOVA,BREBU,132404,"PODU CHEII","ŞCOALA GIMNAZIALĂ MATEI BASARAB, ŞCOALĂ PRIMARĂ STRUCTURĂ, SAT PODU CHEII, NR.12",352,"Alegeri Prezidentiale",1,135,94,77,17,0,92,2,200,106,74,18
31,PRAHOVA,BUCOV,130785,BUCOV,"CAMIN CULTURAL BUCOV",353,"Alegeri Prezidentiale",1,1528,799,687,92,20,786,13,1700,901,543,243
31,PRAHOVA,BUCOV,130785,BUCOV,"CAMIN CULTURAL BUCOV",354,"Alegeri Prezidentiale",1,1524,759,667,92,0,752,7,1700,941,520,232
31,PRAHOVA,BUCOV,130785,BUCOV,"CAMIN CULTURAL BUCOV",355,"Alegeri Prezidentiale",1,1315,702,654,48,0,688,14,1400,698,507,181
31,PRAHOVA,BUCOV,130785,CHIŢORANI,"CAMIN CULTURAL CHITORANI",356,"Alegeri Prezidentiale",1,1317,686,585,101,0,674,12,1400,714,503,171
31,PRAHOVA,BUCOV,130785,PLEAŞA,"CAMIN CULTURAL PLEASA",357,"Alegeri Prezidentiale",1,1218,690,630,60,0,679,11,1300,610,468,211
31,PRAHOVA,BUCOV,130785,PLEAŞA,"CAMIN CULTURAL PLEASA",358,"Alegeri Prezidentiale",1,1336,731,682,49,0,721,10,1500,769,494,227
31,PRAHOVA,BUCOV,130785,PLEAŞA,"CLUB PLEASA",359,"Alegeri Prezidentiale",1,1071,488,445,43,0,483,5,1200,712,353,130
31,PRAHOVA,CĂLUGĂRENI,132459,CĂLUGĂRENI,"VECHIUL SEDIU AL PRIMARIEI",360,"Alegeri Prezidentiale",1,944,441,387,54,0,435,6,1000,559,228,207
31,PRAHOVA,CĂRBUNEŞTI,132486,CĂRBUNEŞTI,"ŞCOALA GIMNAZIALĂ CĂRBUNEŞTI",361,"Alegeri Prezidentiale",1,1384,533,474,59,0,526,7,1500,967,328,198
31,PRAHOVA,CEPTURA,132510,"CEPTURA DE JOS","SCOALA CU CLASELE I-VIII ”NICHITA STANESCU” CEPTURA",362,"Alegeri Prezidentiale",1,933,528,439,87,2,519,9,1000,472,287,232
31,PRAHOVA,CEPTURA,132510,"CEPTURA DE JOS","SCOALA CU CLASELE I-VIII ”NICHITA STANESCU” CEPTURA",363,"Alegeri Prezidentiale",1,903,526,452,74,0,515,11,1000,474,299,216
31,PRAHOVA,CEPTURA,132510,"CEPTURA DE SUS","SEDIUL SERVICIULUI PUBLIC DE GOSPODARIE COMUNALA CEPTURA",364,"Alegeri Prezidentiale",1,495,265,219,45,1,257,8,500,235,120,137
31,PRAHOVA,CEPTURA,132510,ŞOIMEŞTI,"GRADINITA DE COPII SOIMESTI",365,"Alegeri Prezidentiale",1,600,317,286,31,0,314,3,700,383,184,130
31,PRAHOVA,CEPTURA,132510,ROTARI,"SCOALA CU CLASELE I - VIII ROTARI",366,"Alegeri Prezidentiale",1,629,278,246,32,0,277,1,700,422,148,129
31,PRAHOVA,CEPTURA,132510,"MALU ROŞU","SCOALA CU CLASELE I - IV",367,"Alegeri Prezidentiale",1,129,71,51,20,0,70,1,200,129,39,31
31,PRAHOVA,CERAŞU,132574,CERAŞU,"LICEUL TEHNOLOGIC CERAŞU",368,"Alegeri Prezidentiale",1,1244,703,620,77,6,694,9,1400,697,425,269
31,PRAHOVA,CERAŞU,132574,"VALEA BORULUI","ŞCOALA GIMNAZIALĂ VALEA BORULUI",369,"Alegeri Prezidentiale",1,693,413,345,56,12,405,8,800,387,247,158
31,PRAHOVA,CERAŞU,132574,SLON,"ŞCOALA GIMNAZIALĂ SLON",370,"Alegeri Prezidentiale",1,783,419,389,27,3,417,2,900,481,270,147
31,PRAHOVA,CERAŞU,132574,SLON,"ŞCOALA GIMNAZIALĂ SLON",371,"Alegeri Prezidentiale",1,901,500,463,27,10,496,4,1000,500,290,206
31,PRAHOVA,CHIOJDEANCA,132645,CHIOJDEANCA,"GRADINITA CHIOJDEANCA",372,"Alegeri Prezidentiale",1,785,520,451,54,15,515,5,900,380,294,221
31,PRAHOVA,CHIOJDEANCA,132645,TRENU,"SCOALA TRENU",373,"Alegeri Prezidentiale",1,466,321,254,52,15,317,4,500,179,163,154
31,PRAHOVA,CIORANI,132681,"CIORANII DE JOS","LICEUL CIORANI",374,"Alegeri Prezidentiale",1,983,492,436,46,10,482,10,1100,608,97,385
31,PRAHOVA,CIORANI,132681,"CIORANII DE JOS","LICEUL CIORANI",375,"Alegeri Prezidentiale",1,1517,731,629,83,19,725,6,1600,869,220,505
31,PRAHOVA,CIORANI,132681,"CIORANII DE JOS","ȘCOALA CU CLASELE I-IV",376,"Alegeri Prezidentiale",1,982,457,404,42,11,450,7,1100,643,68,382
31,PRAHOVA,CIORANI,132681,"CIORANII DE SUS","ȘCOALA GENERALĂ CIORANII DE SUS",377,"Alegeri Prezidentiale",1,883,456,408,37,11,449,7,1000,544,98,351
31,PRAHOVA,CIORANI,132681,"CIORANII DE SUS",PRIMĂRIA,378,"Alegeri Prezidentiale",1,956,541,498,38,5,539,2,1000,459,142,397
31,PRAHOVA,"COCORĂŞTII COLŢ",136241,"COCORĂŞTII COLŢ","CASA DE CULTURA RURALA",379,"Alegeri Prezidentiale",1,1378,659,560,99,0,645,14,1500,841,453,192
31,PRAHOVA,"COCORĂŞTII COLŢ",136241,"COCORĂŞTII GRIND","SCOALA PRIMARA COCORASTII GRIND",380,"Alegeri Prezidentiale",1,947,481,435,46,0,475,6,1000,519,344,131
31,PRAHOVA,"COCORĂŞTII MISLII",132716,"COCORĂŞTII MISLII","CĂMIN CULTURAL",381,"Alegeri Prezidentiale",1,1574,867,809,58,0,848,19,1700,833,558,290
31,PRAHOVA,"COCORĂŞTII MISLII",132716,GORUNA,"CĂMIN CULTURAL",382,"Alegeri Prezidentiale",1,1228,672,603,69,0,661,11,1400,728,406,255
31,PRAHOVA,COLCEAG,132752,COLCEAG,"SCOALA GIMNAZIALA, COMUNA COLCEAG PJ",383,"Alegeri Prezidentiale",1,1094,431,363,68,0,427,4,1200,769,249,178
31,PRAHOVA,COLCEAG,132752,VÂLCELELE,"SCOALA PRIMARA VILCELELE - COLCEAG - STRUCTURA",384,"Alegeri Prezidentiale",1,424,155,127,28,0,149,6,500,345,78,71
31,PRAHOVA,COLCEAG,132752,INOTEŞTI,"SCOALA GIMNAZIALA INOTESTI-COLCEAG-STRUCTURA",385,"Alegeri Prezidentiale",1,1462,735,646,89,0,726,9,1600,865,381,345
31,PRAHOVA,COLCEAG,132752,PAREPA-RUŞANI,"SCOALA GIMNAZIALA PAREPA-RUSANI-COLCEAG-STRUCTURA",386,"Alegeri Prezidentiale",1,784,336,268,68,0,332,4,900,564,172,160
31,PRAHOVA,CORNU,132805,"CORNU DE JOS","GRĂDINIŢA CU PROGRAM NORMAL",387,"Alegeri Prezidentiale",1,1363,811,677,131,3,794,17,1500,689,447,347
31,PRAHOVA,CORNU,132805,"CORNU DE SUS","GRĂDINIŢA CU PROGRAM NORMAL",388,"Alegeri Prezidentiale",1,858,566,509,47,10,555,11,1100,534,298,257
31,PRAHOVA,CORNU,132805,"CORNU DE JOS","ŞCOALA GIMNAZIALĂ ”PROFESOR CRISTEA STĂNESCU”",389,"Alegeri Prezidentiale",1,1444,981,770,200,11,955,26,1400,419,503,452
31,PRAHOVA,COSMINELE,132841,"COSMINA DE JOS","BIBLIOTECA COMUNALĂ COSMINELE",390,"Alegeri Prezidentiale",1,820,498,425,71,2,492,6,900,402,320,172
31,PRAHOVA,DRAJNA,132896,"DRAJNA DE JOS","ȘCOALA GIMNAZIALĂ ”PLATON MOCANU”",391,"Alegeri Prezidentiale",1,1425,848,708,103,37,837,11,1600,752,476,361
31,PRAHOVA,DRAJNA,132896,"DRAJNA DE JOS","GRĂDINIȚA PLĂIȘANI",392,"Alegeri Prezidentiale",1,714,361,332,29,0,353,8,800,439,204,149
31,PRAHOVA,DRAJNA,132896,"DRAJNA DE SUS","ȘCOALA GIMNAZIALĂ DRAJNA DE SUS",393,"Alegeri Prezidentiale",1,1241,638,519,119,0,636,2,1400,762,396,240
31,PRAHOVA,DRAJNA,132896,OGRETIN,"GRĂDINIȚA CU PROGRAM NORMAL OGRETIN",394,"Alegeri Prezidentiale",1,1058,450,393,56,1,445,5,1200,750,311,134
31,PRAHOVA,DRĂGĂNEŞTI,133018,DRĂGĂNEŞTI,"GRĂDINIȚA DRĂGĂNEȘTI",395,"Alegeri Prezidentiale",1,1017,417,364,53,0,410,7,1100,683,266,144
31,PRAHOVA,DRĂGĂNEŞTI,133018,BĂRĂITARU,"ȘCOALA PRIMARĂ ” LEONIDA SECRETEANU”",396,"Alegeri Prezidentiale",1,670,366,322,44,0,363,3,700,334,243,120
31,PRAHOVA,DRĂGĂNEŞTI,133018,BELCIUG,"ȘCOALA CU CLASELE I-IV BELCIUG",397,"Alegeri Prezidentiale",1,440,202,166,36,0,201,1,500,298,119,82
31,PRAHOVA,DRĂGĂNEŞTI,133018,"CORNU DE JOS","ȘCOALA CU CLASELE I-IV CORNU DE JOS",398,"Alegeri Prezidentiale",1,488,231,202,29,0,228,3,500,269,148,80
31,PRAHOVA,DRĂGĂNEŞTI,133018,MERI,"ȘCOALA PRIMARĂ MERI",399,"Alegeri Prezidentiale",1,853,354,327,27,0,353,1,900,546,228,125
31,PRAHOVA,DRĂGĂNEŞTI,133018,HĂTCĂRĂU,"COOPERATIVA DE CONSUM",400,"Alegeri Prezidentiale",1,348,162,131,31,0,161,1,400,238,102,59
31,PRAHOVA,DUMBRAVA,133090,DUMBRAVA,"CĂMIN CULTURAL LOCALITATEA DUMBRAVA",401,"Alegeri Prezidentiale",1,1305,647,584,63,0,643,4,1400,753,416,227
31,PRAHOVA,DUMBRAVA,133090,ZĂNOAGA,"CĂMIN CULTURAL LOCALITATEA ZĂNOAGA",402,"Alegeri Prezidentiale",1,797,442,393,49,0,435,7,900,458,339,96
31,PRAHOVA,DUMBRAVA,133090,CIUPELNIŢA,"CĂMIN CULTURAL LOCALITATEA CIUPELNIŢA",403,"Alegeri Prezidentiale",1,1400,635,576,59,0,626,9,1500,865,454,172
31,PRAHOVA,DUMBRĂVEŞTI,131461,DUMBRĂVEŞTI,"CĂMIN CULTURAL",404,"Alegeri Prezidentiale",1,1175,650,572,78,0,639,11,1300,650,400,239
31,PRAHOVA,DUMBRĂVEŞTI,131461,PLOPENI,"SALA DE UTILITATE PUBLICĂ",405,"Alegeri Prezidentiale",1,1310,737,680,57,0,718,19,1400,663,416,302
31,PRAHOVA,DUMBRĂVEŞTI,131461,SFÂRLEANCA,"FOSTA ŞCOALĂ SAT SFÂRLEANCA",406,"Alegeri Prezidentiale",1,491,267,234,33,0,263,4,500,233,157,106
31,PRAHOVA,FÂNTÂNELE,133278,FÂNTÂNELE,"CAMINUL CULTURAL",407,"Alegeri Prezidentiale",1,809,478,389,65,24,476,2,900,422,267,209
31,PRAHOVA,FÂNTÂNELE,133278,FÂNTÂNELE,"CAMINUL CULTURAL",408,"Alegeri Prezidentiale",1,826,498,395,76,27,496,2,900,402,232,264
31,PRAHOVA,"FILIPEŞTII DE PĂDURE",133161,"FILIPEŞTII DE PĂDURE","CLUBUL ”MINERUL”",409,"Alegeri Prezidentiale",1,1004,494,463,31,0,486,8,1100,606,304,182
31,PRAHOVA,"FILIPEŞTII DE PĂDURE",133161,"FILIPEŞTII DE PĂDURE","ȘCOALA VECHE",410,"Alegeri Prezidentiale",2,1576,774,733,40,1,757,17,1700,926,479,278
31,PRAHOVA,"FILIPEŞTII DE PĂDURE",133161,"FILIPEŞTII DE PĂDURE","LICEUL TEORETIC",411,"Alegeri Prezidentiale",1,1506,820,728,92,0,808,12,1700,880,543,265
31,PRAHOVA,"FILIPEŞTII DE PĂDURE",133161,DIŢEŞTI,"ȘCOALA GIMNAZIALĂ ”IOAN MOGA”",412,"Alegeri Prezidentiale",1,1165,516,484,32,0,511,5,1300,784,336,175
31,PRAHOVA,"FILIPEŞTII DE PĂDURE",133161,DIŢEŞTI,"GRADINIȚA NR.1",413,"Alegeri Prezidentiale",1,1066,430,406,24,0,427,3,1200,770,271,156
31,PRAHOVA,"FILIPEŞTII DE PĂDURE",133161,DIŢEŞTI,"GRADINIȚA NR. 2",414,"Alegeri Prezidentiale",1,952,413,382,31,0,412,1,1000,587,277,135
31,PRAHOVA,"FILIPEŞTII DE PĂDURE",133161,MINIERI,"LICEUL TEHNOLOGIC",415,"Alegeri Prezidentiale",1,1107,504,478,26,0,499,5,1200,696,308,191
31,PRAHOVA,"FILIPEŞTII DE TÂRG",133214,"FILIPEŞTII DE TÂRG","CǍMIN FILIPEŞTII DE TÎRG (SALĂ ȘEDINȚĂ VIDEOCLUB)",416,"Alegeri Prezidentiale",1,1045,514,474,40,0,509,5,1200,686,352,157
31,PRAHOVA,"FILIPEŞTII DE TÂRG",133214,"FILIPEŞTII DE TÂRG","ṢCOALA FILIPEṢTII DE TȊRG",417,"Alegeri Prezidentiale",1,1170,565,530,35,0,551,14,1300,735,401,150
31,PRAHOVA,"FILIPEŞTII DE TÂRG",133214,BRĂTĂŞANCA,"ṢCOALA GENERALǍ BRǍTǍṢANCA",418,"Alegeri Prezidentiale",1,1665,860,794,66,0,841,19,1800,940,650,191
31,PRAHOVA,"FILIPEŞTII DE TÂRG",133214,"MĂRGINENII DE JOS","ṢCOALA GENERALǍ MǍRGINENII DE JOS (ṢCOALA NOUǍ)",419,"Alegeri Prezidentiale",1,1553,538,507,30,1,531,7,1700,1162,323,208
31,PRAHOVA,"FILIPEŞTII DE TÂRG",133214,"MĂRGINENII DE JOS","ṢCOALA GENERALǍ MǍRGINENII DE JOS (ṢCOALA VECHE)",420,"Alegeri Prezidentiale",1,1161,335,318,17,0,329,6,1300,965,131,198
31,PRAHOVA,FLOREŞTI,133330,FLOREŞTI,"GRADINITA DE COPII FLORESTI",421,"Alegeri Prezidentiale",1,1252,747,613,83,51,738,9,1400,653,521,217
31,PRAHOVA,FLOREŞTI,133330,FLOREŞTI,"SCOALA CU CLASELE I - VIII FLORESTI (LOCALUL NOU)",422,"Alegeri Prezidentiale",1,1516,765,709,56,0,754,11,1700,935,513,241
31,PRAHOVA,FLOREŞTI,133330,FLOREŞTI,"SCOALA CU CLASELE I-VIII FLORESTI (LOCALUL VECHI)",423,"Alegeri Prezidentiale",1,1508,797,723,74,0,785,12,1700,903,584,201
31,PRAHOVA,FLOREŞTI,133330,CĂTINA,"SCOALA CU CLASELE I-VIII CATINA",424,"Alegeri Prezidentiale",1,860,496,387,32,77,485,11,900,404,341,144
31,PRAHOVA,FLOREŞTI,133330,CĂTINA,"CAMINUL CULTURAL CALINESTI",425,"Alegeri Prezidentiale",1,1089,579,510,69,0,568,11,1200,621,396,172
31,PRAHOVA,FULGA,133394,"FULGA DE JOS","CAMINUL CULTURAL FULGA DE JOS",426,"Alegeri Prezidentiale",1,1202,456,395,61,0,453,3,1300,844,222,231
31,PRAHOVA,FULGA,133394,"FULGA DE SUS","SCOALA GIMNAZIALA ”LAURENTIU FULGA”",427,"Alegeri Prezidentiale",1,1380,615,525,90,0,609,6,1500,885,349,260
31,PRAHOVA,GHERGHIŢA,133429,GHERGHIŢA,"ŞCOALA GIMAZIALĂ GHERGHIŢA, NUMĂRUL 125",428,"Alegeri Prezidentiale",1,1012,621,507,72,42,614,7,1100,479,225,389
31,PRAHOVA,GHERGHIŢA,133429,MALAMUC,"GRĂDINIŢA CU PROGRAM NORMAL MALAMUC, NUMĂRUL 149C",429,"Alegeri Prezidentiale",1,324,230,181,32,17,226,4,400,170,108,118
31,PRAHOVA,GHERGHIŢA,133429,INDEPENDENŢA,"ŞCOALA PRIMARĂ INDEPENDENŢA, NUMĂRUL 23",430,"Alegeri Prezidentiale",1,180,118,88,30,0,117,1,200,82,62,55
31,PRAHOVA,GORGOTA,133508,GORGOTA,"GRĂDINIȚA CU PROGRAM NORMAL SAT GORGOTA, COMUNA GORGOTA",431,"Alegeri Prezidentiale",1,1179,633,576,57,0,624,9,1300,667,451,173
31,PRAHOVA,GORGOTA,133508,POTIGRAFU,"ȘCOALA GIMNAZIALĂ SAT POTIGRAFU, COMUNA GORGOTA",432,"Alegeri Prezidentiale",1,1046,564,503,61,0,559,5,1200,636,399,160
31,PRAHOVA,GORGOTA,133508,"POIENARII APOSTOLI","ȘCOALA GIMNAZIALĂ SAT POIENARII APOSTOLI, COMUNA GORGOTA",433,"Alegeri Prezidentiale",1,1125,588,506,82,0,583,5,1200,612,395,188
31,PRAHOVA,GORGOTA,133508,CRIVINA,"ȘCOALA PRIMARĂ SAT CRIVINA, COMUNA GORGOTA",434,"Alegeri Prezidentiale",1,773,382,338,44,0,380,2,800,418,262,118
31,PRAHOVA,GORNET,133562,GORNET,"SCOALA GIMNAZIALA GORNET",435,"Alegeri Prezidentiale",1,955,556,510,44,2,551,5,1100,544,323,228
31,PRAHOVA,GORNET,133562,GORNET,"CĂMINUL CULTURAL GORNET",436,"Alegeri Prezidentiale",1,981,599,557,41,1,593,6,1100,501,350,243
31,PRAHOVA,GORNET,133562,CUIB,"SCOALA PRIMARA CUIB",437,"Alegeri Prezidentiale",1,261,166,146,20,0,164,2,300,134,80,84
31,PRAHOVA,GORNET,133562,NUCET,"SCOALA PRIMARA NUCET",438,"Alegeri Prezidentiale",1,148,91,68,23,0,91,0,200,109,38,53
31,PRAHOVA,GORNET-CRICOV,133615,GORNET-CRICOV,"CĂMIN CULTURAL GORNET-CRICOV",439,"Alegeri Prezidentiale",1,768,437,353,84,0,429,8,800,363,310,119
31,PRAHOVA,GORNET-CRICOV,133615,COŞERELE,"GRĂDINIȚA COȘERELE",440,"Alegeri Prezidentiale",1,658,285,243,42,0,279,6,700,415,187,92
31,PRAHOVA,GORNET-CRICOV,133615,DOBROTA,"GRĂDINIȚA DOBROTA",441,"Alegeri Prezidentiale",1,373,184,145,39,0,180,4,400,216,130,50
31,PRAHOVA,"GURA VADULUI",133688,"GURA VADULUI","CĂMINUL CULTURAL, NR. 212",442,"Alegeri Prezidentiale",1,1130,524,474,50,0,517,7,1200,676,298,219
31,PRAHOVA,"GURA VADULUI",133688,PERŞUNARI,"CĂMIN CULTURAL",443,"Alegeri Prezidentiale",1,648,322,274,48,0,315,7,700,378,207,108
31,PRAHOVA,"GURA VITIOAREI",131835,"GURA VITIOAREI","SCOALA GIMNAZIALA GURA VITIOAREI",444,"Alegeri Prezidentiale",1,1671,828,745,82,1,811,17,1800,972,507,304
31,PRAHOVA,"GURA VITIOAREI",131835,FĂGETU,"SCOALA PRIMARA FAGETU",445,"Alegeri Prezidentiale",1,948,547,491,56,0,538,9,1000,453,333,205
31,PRAHOVA,"GURA VITIOAREI",131835,"POIANA COPĂCENI","SCOALA GIMNAZIALA POIANA COPACENI",446,"Alegeri Prezidentiale",1,845,438,407,31,0,432,6,900,462,261,171
31,PRAHOVA,"GURA VITIOAREI",131835,"BUGHEA DE JOS","SCOALA GIMNAZIALA BUGHEA DE JOS",447,"Alegeri Prezidentiale",1,860,402,362,40,0,399,3,900,498,263,136
31,PRAHOVA,"GURA VITIOAREI",131835,FUNDENI,"GRADINITA CU PROGRAM NORMAL FUNDENI",448,"Alegeri Prezidentiale",1,503,265,234,31,0,261,4,600,335,182,79
31,PRAHOVA,IORDĂCHEANU,133722,IORDĂCHEANU,"GRǍDINIȚA IORDǍCHEANU",449,"Alegeri Prezidentiale",1,1005,455,413,42,0,449,6,1100,645,315,134
31,PRAHOVA,IORDĂCHEANU,133722,MOCEŞTI,"ŞCOALA MOCEŞTI",450,"Alegeri Prezidentiale",1,969,404,368,36,0,401,3,1100,696,238,163
31,PRAHOVA,IORDĂCHEANU,133722,"VALEA CUCULUI","CLǍDIRE NOUǍ - FOST SEDIU C.A.P.",451,"Alegeri Prezidentiale",1,1051,519,472,47,0,514,5,1100,581,341,173
31,PRAHOVA,IORDĂCHEANU,133722,VĂRBILA,"ŞCOALA VǍRBILA",452,"Alegeri Prezidentiale",1,1152,479,437,42,0,469,10,1300,821,265,204
31,PRAHOVA,IZVOARELE,133795,IZVOARELE,"ŞCOALA GIMNAZIALĂ TRAIAN SĂVULESCU IZVOARELE",453,"Alegeri Prezidentiale",1,1029,538,483,55,0,532,6,1100,562,338,194
31,PRAHOVA,IZVOARELE,133795,IZVOARELE,"ŞCOALA GIMNAZIALĂ TRAIAN SĂVULESCU IZVOARELE",454,"Alegeri Prezidentiale",1,922,447,422,25,0,441,6,1000,553,237,204
31,PRAHOVA,IZVOARELE,133795,HOMORÂCIU,"ŞCOALA GIMNAZIALĂ HOMORÎCIU",455,"Alegeri Prezidentiale",1,931,460,421,39,0,454,6,1000,540,269,185
31,PRAHOVA,IZVOARELE,133795,HOMORÂCIU,"ŞCOALA GIMNAZIALĂ HOMORÎCIU",456,"Alegeri Prezidentiale",1,791,350,310,40,0,343,7,900,550,247,96
31,PRAHOVA,IZVOARELE,133795,SCHIULEŞTI,"ŞCOALA GIMNAZIALĂ SCHIULEȘTI",457,"Alegeri Prezidentiale",1,999,460,412,48,0,454,6,1100,640,257,197
31,PRAHOVA,IZVOARELE,133795,"MALU VÂNĂT","ŞCOALA PRIMARĂ MALU-VÎNĂT",458,"Alegeri Prezidentiale",1,683,356,293,63,0,347,9,800,444,211,136
31,PRAHOVA,JUGURENI,133866,JUGURENI,"CĂMINUL CULTURAL",459,"Alegeri Prezidentiale",1,390,298,208,46,44,295,3,400,102,86,209
31,PRAHOVA,LAPOŞ,133919,LAPOŞ,"CĂMINUL CULTURAL",460,"Alegeri Prezidentiale",1,915,532,473,59,0,528,4,1000,468,313,215
31,PRAHOVA,LIPĂNEŞTI,133964,LIPĂNEŞTI,"BAZA SPORTIVA",461,"Alegeri Prezidentiale",1,690,423,354,69,0,413,10,800,377,279,134
31,PRAHOVA,LIPĂNEŞTI,133964,ŞIPOTU,"SCOALA GIMNAZIALA ”EROILOR” LIPANESTI",462,"Alegeri Prezidentiale",1,858,455,393,62,0,446,9,900,445,286,160
31,PRAHOVA,LIPĂNEŞTI,133964,ŞIPOTU,"SCOALA GIMNAZIALA ”EROILOR” LIPANESTI",463,"Alegeri Prezidentiale",1,1006,490,442,48,0,485,5,1100,610,343,142
31,PRAHOVA,LIPĂNEŞTI,133964,ZAMFIRA,"SCOALA GIMNAZIALA ”SPIREA SORESCU”ZAMFIRA",464,"Alegeri Prezidentiale",1,925,514,436,78,0,501,13,1000,486,303,198
31,PRAHOVA,LIPĂNEŞTI,133964,LIPĂNEŞTI,"BAZA SPORTIVA 1",465,"Alegeri Prezidentiale",1,750,441,401,37,3,432,9,800,359,271,161
31,PRAHOVA,MĂGURELE,134014,MĂGURELE,"CĂMINUL CULTURAL MĂGURELE",466,"Alegeri Prezidentiale",1,1283,710,636,74,0,698,12,1400,690,481,217
31,PRAHOVA,MĂGURELE,134014,MĂGURELE,"GRĂDINIŢA DE COPII ”MICUL PRINŢ” MĂGURELE",467,"Alegeri Prezidentiale",1,1399,775,697,78,0,761,14,1500,725,527,234
31,PRAHOVA,MĂGURELE,134014,"COADA MALULUI","GRĂDINIŢA DE COPII SAT COADA MALULUI",468,"Alegeri Prezidentiale",1,678,381,337,44,0,371,10,700,319,254,117
31,PRAHOVA,MĂGURELE,134014,IAZU,"GRĂDINIŢA DE COPII SAT IAZU",469,"Alegeri Prezidentiale",1,506,308,260,48,0,302,6,600,292,242,60
31,PRAHOVA,MĂGURENI,134050,MĂGURENI,"ȘCOALA PRIMARĂ MĂGURENI, CORP B, SAT MĂGURENI, NR.201",470,"Alegeri Prezidentiale",1,1380,722,661,61,0,713,9,1500,778,500,213
31,PRAHOVA,MĂGURENI,134050,MĂGURENI,"ȘCOALA PRIMARĂ SATUL BANULUI, SAT MĂGURENI, NR.541",471,"Alegeri Prezidentiale",1,971,485,449,36,0,483,2,1100,615,318,165
31,PRAHOVA,MĂGURENI,134050,MĂGURENI,"ȘCOALA GIMNAZIALĂ MĂGURENI,CORP A, SAT MĂGURENI, NR.982",472,"Alegeri Prezidentiale",1,1297,634,585,49,0,625,9,1300,666,447,178
31,PRAHOVA,MĂGURENI,134050,"LUNCA PRAHOVEI","ȘCOALA PRIMARĂ LUNCA PRAHOVEI, SAT LUNCA PRAHOVEI, NR.39",473,"Alegeri Prezidentiale",1,927,407,374,33,0,399,8,1000,593,216,183
31,PRAHOVA,MĂGURENI,134050,"COCORĂŞTII CAPLII","CĂMIN CULTURAL COCORĂȘTII CAPLII, SAT COCORĂȘTII CAPLII, NR.130",474,"Alegeri Prezidentiale",1,680,354,313,41,0,349,5,800,446,254,95
31,PRAHOVA,MĂNECIU,134096,MĂNECIU-UNGURENI,"GRĂDINIȚA CU PROGRAM NORMAL NR.3",475,"Alegeri Prezidentiale",1,1374,754,718,36,0,746,8,1500,746,473,273
31,PRAHOVA,MĂNECIU,134096,MĂNECIU-UNGURENI,"GRĂDINIȚA CU PROGRAM NORMAL NR.3",476,"Alegeri Prezidentiale",1,1306,651,613,38,0,644,7,1400,749,418,226
31,PRAHOVA,MĂNECIU,134096,GHEABA,"LICEUL TEHNOLOGIC MĂNECIU NR.5",477,"Alegeri Prezidentiale",1,1240,667,589,78,0,660,7,1400,733,451,209
31,PRAHOVA,MĂNECIU,134096,GHEABA,"LICEUL TEHNOLOGIC MĂNECIU NR.5",478,"Alegeri Prezidentiale",1,1102,571,518,53,0,556,15,1200,629,336,220
31,PRAHOVA,MĂNECIU,134096,MĂNECIU-PĂMÂNTENI,"ŞCOALA GIMNAZIALĂ MĂNECIU-PĂMÎNTENI, NR.267",479,"Alegeri Prezidentiale",1,880,415,393,22,0,409,6,1000,585,310,99
31,PRAHOVA,MĂNECIU,134096,MĂNECIU-PĂMÂNTENI,"ŞCOALA GIMNAZIALĂ MĂNECIU-PĂMÎNTENI, NR.267",480,"Alegeri Prezidentiale",1,933,435,401,34,0,433,2,1000,565,289,144
31,PRAHOVA,MĂNECIU,134096,MĂNECIU-PĂMÂNTENI,"ŞCOALA GIMNAZIALĂ MĂNECIU-PĂMÎNTENI, NR.1229",481,"Alegeri Prezidentiale",1,1553,748,692,56,0,737,11,1700,952,486,251
31,PRAHOVA,MĂNECIU,134096,CHEIA,"ŞCOALA PRIMARĂ CHEIA, NR.1",482,"Alegeri Prezidentiale",1,319,333,138,195,0,325,8,400,67,209,116
31,PRAHOVA,MĂNEŞTI,134194,MĂNEŞTI,"CĂMIN CULTURAL",483,"Alegeri Prezidentiale",1,876,492,430,60,2,490,2,1000,508,321,169
31,PRAHOVA,MĂNEŞTI,134194,ZALHANAUA,"SALĂ MULTIFUNCȚIONALĂ ZALHANAUA",484,"Alegeri Prezidentiale",1,816,390,352,38,0,384,6,900,510,268,116
31,PRAHOVA,MĂNEŞTI,134194,"COADA IZVORULUI","ȘCOALA COADA IZVORULUI",485,"Alegeri Prezidentiale",1,746,463,412,51,0,459,4,800,337,325,134
31,PRAHOVA,MĂNEŞTI,134194,BĂLTIŢA,"SALĂ MULTIFUNCȚIONALĂ BĂLTIȚA",486,"Alegeri Prezidentiale",1,714,345,305,33,7,340,5,800,455,239,101
31,PRAHOVA,OLARI,136250,"OLARII VECHI","ȘCOALA PRIMARӐ OLARII-VECHI, SAT OLARII-VECHI",487,"Alegeri Prezidentiale",1,600,339,302,37,0,335,4,700,361,146,189
31,PRAHOVA,OLARI,136250,OLARI,"ȘCOALA GIMNAZIALӐ OLARI, SAT OLARI",488,"Alegeri Prezidentiale",1,570,326,275,51,0,320,6,600,274,150,170
31,PRAHOVA,OLARI,136250,FÂNARI,"ȘCOALA PRIMARӐ FȂNARI, SAT FȂNARI",489,"Alegeri Prezidentiale",1,329,212,178,34,0,206,6,400,188,64,142
31,PRAHOVA,PĂCUREŢI,134336,PĂCUREŢI,"GRĂDINIŢA CU PROGRAM NORMAL PĂCUREŢI",490,"Alegeri Prezidentiale",1,1015,481,438,43,0,477,4,1100,619,221,256
31,PRAHOVA,PĂCUREŢI,134336,MATIŢA,"ŞCOALA GIMNAZIALĂ",491,"Alegeri Prezidentiale",1,635,296,266,30,0,291,5,700,404,189,102
31,PRAHOVA,PĂULEŞTI,130847,PĂULEŞTI,"SCOALA GENERALA CU CL.I-VIII ARH.TOMA T.SOCOLESCU PAULESTI",492,"Alegeri Prezidentiale",1,1441,1070,816,195,59,1051,19,1600,530,687,364
31,PRAHOVA,PĂULEŞTI,130847,PĂULEŞTI,"CENTRUL CULTURAL ARH.TOMA T.SOCOLESCU PAULESTI",493,"Alegeri Prezidentiale",1,1312,946,777,168,1,925,21,1400,454,613,312
31,PRAHOVA,PĂULEŞTI,130847,COCOŞEŞTI,"SALA MULTIFUNCTIONALA COCOSESTI",494,"Alegeri Prezidentiale",1,813,575,499,76,0,565,10,900,325,361,204
31,PRAHOVA,PĂULEŞTI,130847,GĂGENI,"SCOALA GENERALA CU CLS.I-VIII VLAD MUSATESCU GAGENI",495,"Alegeri Prezidentiale",1,798,533,413,120,0,526,7,900,367,357,169
31,PRAHOVA,PĂULEŞTI,130847,GĂGENI,"CAMINUL CULTURAL GAGENI",496,"Alegeri Prezidentiale",1,1081,675,590,85,0,665,10,1200,525,489,176
31,PRAHOVA,PLOPU,134390,PLOPU,"GRADINITA CU PROGRAM NORMAL PLOPU",497,"Alegeri Prezidentiale",1,868,549,456,91,2,541,8,900,351,402,139
31,PRAHOVA,PLOPU,134390,NISIPOASA,"SCOALA CU CLS. I-IV NISIPOASA",498,"Alegeri Prezidentiale",1,674,476,391,85,0,468,8,699,223,308,160
31,PRAHOVA,PLOPU,134390,GÂLMEIA,"FOSTA SCOALA CU CLS. I-IV GALMEIA",499,"Alegeri Prezidentiale",1,186,159,105,54,0,158,1,199,40,138,20
31,PRAHOVA,PLOPU,134390,HÂRSA,"FOSTA SCOALA CU CLS. I-IV HARSA",500,"Alegeri Prezidentiale",1,217,133,109,23,1,132,1,301,168,111,21
31,PRAHOVA,"PODENII NOI",134443,SĂLCIOARA,"SCOALA CU CLASELE I-VIII PODENII NOI",501,"Alegeri Prezidentiale",1,1262,503,451,52,0,500,3,1400,897,388,112
31,PRAHOVA,"PODENII NOI",134443,"VALEA DULCE","GRĂDINIŢA CU PROGRAM NORMAL VALEA-DULCE",502,"Alegeri Prezidentiale",1,801,354,319,35,0,350,4,900,546,244,106
31,PRAHOVA,"PODENII NOI",134443,POPEŞTI,"GRADINITA DE COPII POPESTI",503,"Alegeri Prezidentiale",1,464,233,198,35,0,230,3,500,267,150,80
31,PRAHOVA,"PODENII NOI",134443,MEHEDINŢA,"SCOALA CU CLASELE I-VIII MEHEDINTA",504,"Alegeri Prezidentiale",1,1313,529,469,60,0,527,2,1400,871,303,224
31,PRAHOVA,"POIANA CÂMPINA",131274,"POIANA CÂMPINA","ŞCOALA GIMNAZIALĂ ”ÎNVĂŢĂTOR ION MATEESCU” POIANA-CĂMPINA",505,"Alegeri Prezidentiale",1,1030,594,503,91,0,587,7,1100,506,418,169
31,PRAHOVA,"POIANA CÂMPINA",131274,"POIANA CÂMPINA","PRIMARIA COMUNEI POIANA-CÂMPINA",506,"Alegeri Prezidentiale",1,1236,733,625,103,5,718,15,1400,667,502,216
31,PRAHOVA,"POIANA CÂMPINA",131274,"POIANA CÂMPINA","BIBLIOTECA ”DIMITRIE GUSTI” COMUNA POIANA-CĂMPINA",507,"Alegeri Prezidentiale",1,615,378,322,56,0,368,10,700,322,264,104
31,PRAHOVA,"POIANA CÂMPINA",131274,PIETRIŞU,"ŞCOALA GENERALĂ PIETRIŞU",508,"Alegeri Prezidentiale",1,474,249,226,23,0,248,1,500,251,172,76
31,PRAHOVA,"POIANA CÂMPINA",131274,BOBOLIA,"CĂMINUL CULTURAL BOBOLIA",509,"Alegeri Prezidentiale",1,879,558,498,60,0,545,13,1000,442,405,140
31,PRAHOVA,"POIENARII BURCHII",134559,"POIENARII BURCHII","SCOALA GIMANZIALA POIENARII BURCHII",510,"Alegeri Prezidentiale",1,957,508,415,93,0,499,9,1000,492,333,166
31,PRAHOVA,"POIENARII BURCHII",134559,CĂRBUNARI,"GRADINITA DE COPII SAT CARBUNARI",511,"Alegeri Prezidentiale",1,608,308,259,49,0,300,8,700,392,216,84
31,PRAHOVA,"POIENARII BURCHII",134559,POIENARII-RALI,"SCOALA POIENARII RALI",512,"Alegeri Prezidentiale",1,819,440,349,91,0,432,8,900,460,257,175
31,PRAHOVA,"POIENARII BURCHII",134559,OLOGENI,"ANEXA PRIMARIE SAT OLOGENI",513,"Alegeri Prezidentiale",1,1073,470,379,91,0,470,0,1200,730,261,209
31,PRAHOVA,"POIENARII BURCHII",134559,TĂTĂRĂI,"CAMIN CULTURAL TATARAI",514,"Alegeri Prezidentiale",1,448,238,183,55,0,232,6,500,262,122,110
31,PRAHOVA,POSEŞTI,134648,BODEŞTI,"CĂMINUL CULTURAL DIN SATUL POSEŞTII-PĂMÂNTENI",515,"Alegeri Prezidentiale",1,655,360,295,64,1,351,9,700,340,212,139
31,PRAHOVA,POSEŞTI,134648,"NUCŞOARA DE JOS","CLADIREA FOSTEI PRIMARII RANCEZI DIN SATUL NUCSOARA DE JOS",516,"Alegeri Prezidentiale",1,1245,617,566,51,0,608,9,1400,783,326,282
31,PRAHOVA,POSEŞTI,134648,"VALEA PLOPULUI","CĂMIN CULTURAL",517,"Alegeri Prezidentiale",1,771,334,291,43,0,330,4,900,566,172,158
31,PRAHOVA,POSEŞTI,134648,TÂRLEŞTI,"FOSTA ŞCOALĂ GENERALĂ CU CLASELE I-IV DIN SATUL TÂRLEŞTI",518,"Alegeri Prezidentiale",1,474,236,200,36,0,236,0,500,264,140,96
31,PRAHOVA,PREDEAL-SĂRARI,134755,PREDEAL,"ȘCOALA GIMNAZIALĂ ”MĂNĂSTIREANU MIHAI” PREDEAL",519,"Alegeri Prezidentiale",1,725,361,340,21,0,353,8,800,439,210,143
31,PRAHOVA,PREDEAL-SĂRARI,134755,ZÎMBROAIA,"ȘCOALA ELEMENTARĂ ZÎMBROAIA",520,"Alegeri Prezidentiale",1,143,75,52,23,0,74,1,200,125,35,39
31,PRAHOVA,PREDEAL-SĂRARI,134755,"VITIOARA DE SUS","ȘCOALA GIMNAZIALĂ VITIOARA DE SUS",521,"Alegeri Prezidentiale",1,993,457,416,41,0,451,6,1100,643,293,158
31,PRAHOVA,"PROVIŢA DE JOS",134853,"PROVIŢA DE JOS","SCOALA GIMNAZIALA PROVITA DE JOS",522,"Alegeri Prezidentiale",1,901,438,348,89,1,431,7,1000,562,268,163
31,PRAHOVA,"PROVIŢA DE JOS",134853,DRĂGĂNEASA,"GRADINITA CU PROGRAM NORMAL DRAGANEASA",523,"Alegeri Prezidentiale",1,926,417,380,37,0,413,4,1000,583,265,148
31,PRAHOVA,"PROVIŢA DE SUS",134899,"PROVIŢA DE SUS","ŞCOALA GIMNAZIALĂ CU CLASELE I-VIII”MITROPOLIT PIMEN GEORGESCU” PROVIŢA DE SUS",524,"Alegeri Prezidentiale",1,1342,743,644,82,17,734,9,1500,757,364,370
31,PRAHOVA,"PROVIŢA DE SUS",134899,IZVORU,"GRĂDINŢA CU PROGRAM NORMAL IZVORU",525,"Alegeri Prezidentiale",1,301,183,153,30,0,182,1,400,217,104,78
31,PRAHOVA,"PUCHENII MARI",134942,"PUCHENII MARI","SCOALA GIMNAZIALA,COMUNA PUCHENII MARI",526,"Alegeri Prezidentiale",1,1035,606,482,124,0,593,13,1100,494,466,127
31,PRAHOVA,"PUCHENII MARI",134942,PIETROŞANI,"SCOALA GIMNAZIALA PIETROSANI",527,"Alegeri Prezidentiale",1,971,479,416,63,0,474,5,1100,621,357,117
31,PRAHOVA,"PUCHENII MARI",134942,PIETROŞANI,"GRADINITA CU PROGRAM NORMALPIETROSANI",528,"Alegeri Prezidentiale",1,952,468,427,41,0,454,14,1000,532,365,89
31,PRAHOVA,"PUCHENII MARI",134942,PUCHENII-MOŞNENI,"SCOALA GIMNAZIALA PUCHENII MOSNENI",529,"Alegeri Prezidentiale",1,1220,615,536,79,0,607,8,1300,685,428,179
31,PRAHOVA,"PUCHENII MARI",134942,MIROSLĂVEŞTI,"SCOALA PRIMARA MIROSLAVESTI",530,"Alegeri Prezidentiale",1,1507,724,666,58,0,713,11,1700,976,491,222
31,PRAHOVA,"PUCHENII MARI",134942,ODĂILE,"GRADINITA CU PROGRAM NORMAL ODAILE",531,"Alegeri Prezidentiale",1,1322,664,599,65,0,654,10,1500,836,450,204
31,PRAHOVA,RÂFOV,135020,MĂLĂIEŞTI,"SCOALA PRIMARA MALAIESTI",532,"Alegeri Prezidentiale",1,643,404,357,47,0,396,8,600,196,175,221
31,PRAHOVA,RÂFOV,135020,"MOARA DOMNEASCĂ","SCOALA PRIMARA MOARA DOMNEASCA",533,"Alegeri Prezidentiale",1,798,458,407,51,0,451,7,901,443,231,220
31,PRAHOVA,RÂFOV,135020,BUDA,"SCOALA GIMNAZILA BUDA",534,"Alegeri Prezidentiale",1,846,527,477,50,0,518,9,900,373,294,224
31,PRAHOVA,RÂFOV,135020,PALANCA,"SCOALA PRIMARA PALANCA",535,"Alegeri Prezidentiale",1,853,469,422,47,0,461,8,900,431,232,229
31,PRAHOVA,RÂFOV,135020,GOGA,"SCOALA PRIMARA GOGA",536,"Alegeri Prezidentiale",1,387,256,191,65,0,251,5,400,144,140,111
31,PRAHOVA,RÂFOV,135020,SICRITA,"SCOALA PRIMARA SICRITA",537,"Alegeri Prezidentiale",1,408,208,185,23,0,206,2,500,292,121,85
31,PRAHOVA,RÂFOV,135020,RÂFOV,"FOSTUL SEDIU AL PRIMARIEI",538,"Alegeri Prezidentiale",1,278,177,134,43,0,177,0,299,122,94,83
31,PRAHOVA,RÂFOV,135020,BUCHILAŞI,"SCOALA DEZAFECTATA BUCHILASI",539,"Alegeri Prezidentiale",1,122,91,59,32,0,90,1,200,109,52,38
31,PRAHOVA,SALCIA,135128,SALCIA,"SCOALA GIMNAZIALA",540,"Alegeri Prezidentiale",1,795,343,310,33,0,341,2,900,557,185,156
31,PRAHOVA,SĂLCIILE,135146,SĂLCIILE,"SCOALA NOUA",541,"Alegeri Prezidentiale",1,733,407,321,53,33,403,4,800,393,287,116
31,PRAHOVA,SĂLCIILE,135146,SĂLCIILE,"CAMINUL CULTURAL",542,"Alegeri Prezidentiale",1,706,416,302,85,29,410,6,800,384,293,117
31,PRAHOVA,SÂNGERU,135244,SÂNGERU,"LICEUL TEHNOLOGIC",543,"Alegeri Prezidentiale",1,1268,366,343,23,0,363,3,1400,1034,186,177
31,PRAHOVA,SÂNGERU,135244,SÂNGERU,"LICEUL TEHNOLOGIC",544,"Alegeri Prezidentiale",1,693,290,263,27,0,288,2,800,510,135,153
31,PRAHOVA,SÂNGERU,135244,"MIREŞU MARE","ŞCOALA GIMNAZIALĂ",545,"Alegeri Prezidentiale",1,1167,480,444,36,0,474,6,1300,820,310,164
31,PRAHOVA,SÂNGERU,135244,BUTUCI,"GRĂDINIŢA CU PROGRAM NORMAL",546,"Alegeri Prezidentiale",1,413,233,213,20,0,232,1,500,267,136,96
31,PRAHOVA,SÂNGERU,135244,TISA,"GRĂDINIŢA CU PROGRAM NORMAL",547,"Alegeri Prezidentiale",1,557,241,209,32,0,238,3,600,359,155,83
31,PRAHOVA,SCORŢENI,135164,SCORŢENI,"SCOALA GIMNAZIALA SCORTENI",548,"Alegeri Prezidentiale",1,1184,576,506,69,1,562,14,1300,724,322,240
31,PRAHOVA,SCORŢENI,135164,MISLEA,"SCOALA GIMNAZIALA MISLEA",549,"Alegeri Prezidentiale",1,1500,714,654,60,0,704,10,1700,986,418,286
31,PRAHOVA,SCORŢENI,135164,"BORDENII MARI","GRADINITA BORDENII MARI",550,"Alegeri Prezidentiale",1,1192,637,578,59,0,624,13,1300,663,358,266
31,PRAHOVA,SCORŢENI,135164,SÂRCA,"SCOALA GIMNAZIALA BORDENI",551,"Alegeri Prezidentiale",1,823,384,345,39,0,380,4,900,516,255,125
31,PRAHOVA,SECĂRIA,135226,SECĂRIA,"ŞCOALA GIMNAZIALĂ COMUNA SECĂRIA",552,"Alegeri Prezidentiale",1,1023,523,487,36,0,518,5,1100,577,313,205
31,PRAHOVA,STARCHIOJD,135315,STARCHIOJD,"GRĂDINIŢA DE COPII DIN SATUL STARCHIOJD",553,"Alegeri Prezidentiale",1,1348,624,575,49,0,622,2,1500,876,397,225
31,PRAHOVA,STARCHIOJD,135315,STARCHIOJD,"GRĂDINIŢA DE COPII DIN GÎRBEASCA",554,"Alegeri Prezidentiale",1,1172,528,500,28,0,515,13,1300,772,324,191
31,PRAHOVA,STARCHIOJD,135315,"VALEA ANEI","ŞCOALA DIN SATUL VALEA ANEI",555,"Alegeri Prezidentiale",1,433,205,163,42,0,205,0,500,295,115,90
31,PRAHOVA,SURANI,135404,SURANI,"ŞCOALA PRIMARĂ",556,"Alegeri Prezidentiale",1,1424,783,673,98,12,772,11,1600,817,576,196
31,PRAHOVA,ŞIRNA,135431,TĂRICENI,"ŞCOALA GIMNAZIALĂ, SAT TĂRICENI",557,"Alegeri Prezidentiale",1,870,427,365,62,0,426,1,1000,573,282,144
31,PRAHOVA,ŞIRNA,135431,TĂRICENI,"ŞCOALA GIMNAZIALĂ, SAT TĂRICENI",558,"Alegeri Prezidentiale",1,673,286,261,24,1,285,1,700,414,170,115
31,PRAHOVA,ŞIRNA,135431,ŞIRNA,"ŞCOALA PRIMARĂ, SAT ŞIRNA",559,"Alegeri Prezidentiale",1,609,307,269,38,0,307,0,700,393,224,83
31,PRAHOVA,ŞIRNA,135431,VARNIŢA,"ŞCOALA GIMNAZIALĂ, SAT VARNIŢA",560,"Alegeri Prezidentiale",1,728,306,279,27,0,305,1,800,494,212,93
31,PRAHOVA,ŞIRNA,135431,HĂBUD,"ŞCOALA GIMNAZIALĂ, SAT HĂBUD",561,"Alegeri Prezidentiale",1,642,296,249,47,0,292,4,700,404,190,102
31,PRAHOVA,ŞIRNA,135431,BRĂTEŞTI,"ŞCOALA PRIMARĂ, SAT BRĂTEŞTI",562,"Alegeri Prezidentiale",1,403,189,166,23,0,188,1,500,311,126,62
31,PRAHOVA,ŞOIMARI,135501,MĂGURA,"CĂMIN CULTURAL",563,"Alegeri Prezidentiale",1,427,210,184,26,0,210,0,500,290,116,94
31,PRAHOVA,ŞOIMARI,135501,ŞOIMARI,"ȘCOALA GIMNAZIALĂ ”MINERVA ALEXANDRESCU”",564,"Alegeri Prezidentiale",1,1400,568,507,61,0,562,6,1700,1132,321,241
31,PRAHOVA,ŞOIMARI,135501,LOPATNIŢA,"GRĂDINIȚA CU PROGRAM NORMAL",565,"Alegeri Prezidentiale",1,565,252,230,22,0,251,1,600,348,163,88
31,PRAHOVA,ŞOTRILE,135547,"PLAIU CÂMPINEI","SCOALA SAT PLAIU CAMPINEI, NR 35",566,"Alegeri Prezidentiale",1,668,332,298,34,0,325,7,700,368,139,186
31,PRAHOVA,ŞOTRILE,135547,SECIURI,"ŞCOALA SAT SECIURI, NR 17",567,"Alegeri Prezidentiale",1,293,141,131,10,0,140,1,300,159,87,53
31,PRAHOVA,ŞOTRILE,135547,"LUNCA MARE","ŞCOALA SAT LUNCA-MARE, NR 166",568,"Alegeri Prezidentiale",1,385,237,201,36,0,233,4,400,163,137,96
31,PRAHOVA,ŞOTRILE,135547,VISTIERU,"ŞCOALA SAT VISTIERU, NR 25",569,"Alegeri Prezidentiale",1,456,170,145,25,0,167,3,500,330,73,94
31,PRAHOVA,ŞOTRILE,135547,ŞOTRILE,"ŞCOALA GIMNAZIALĂ, SAT SOTRILE, NR 364",570,"Alegeri Prezidentiale",1,828,357,330,27,0,353,4,900,543,202,151
31,PRAHOVA,ŞTEFEŞTI,135618,SCURTEŞTI,"GRĂDINIŢA DE COPII",571,"Alegeri Prezidentiale",1,624,301,284,17,0,298,3,700,399,172,126
31,PRAHOVA,ŞTEFEŞTI,135618,ŞTEFEŞTI,"SCOALA GIMNAZIALA STEFESTI",572,"Alegeri Prezidentiale",1,1257,618,580,38,0,614,4,1400,782,361,253
31,PRAHOVA,TALEA,135654,TALEA,"SCOALA GIMNAZIALA TALEA",573,"Alegeri Prezidentiale",1,858,550,491,53,6,548,2,900,350,339,209
31,PRAHOVA,TĂTARU,135681,TĂTARU,"CAMIN CULTURAL",574,"Alegeri Prezidentiale",1,227,145,110,25,10,143,2,300,155,79,64
31,PRAHOVA,TĂTARU,135681,PODGORIA,"CAMIN CULTURAL",575,"Alegeri Prezidentiale",1,476,258,204,42,12,254,4,500,242,179,75
31,PRAHOVA,"TÂRGŞORU VECHI",130892,STREJNICU,"BAZA SPORTIVA CONPET",576,"Alegeri Prezidentiale",1,1831,948,877,71,0,933,15,2000,1052,700,233
31,PRAHOVA,"TÂRGŞORU VECHI",130892,STREJNICU,"GRĂDINIŢA CU PROGRAM NORMAL STREJNICU",577,"Alegeri Prezidentiale",1,1441,793,698,95,0,784,9,1600,807,553,231
31,PRAHOVA,"TÂRGŞORU VECHI",130892,STREJNICU,"ŞCOALA GIMNAZIALĂ STREJNICU",578,"Alegeri Prezidentiale",1,1622,884,774,110,0,870,14,1800,916,663,207
31,PRAHOVA,"TÂRGŞORU VECHI",130892,STREJNICU,"CĂMINUL CULTURAL STREJNICU",579,"Alegeri Prezidentiale",1,861,462,407,55,0,453,9,900,438,332,121
31,PRAHOVA,"TÂRGŞORU VECHI",130892,"TÂRGŞORU VECHI","ŞCOALA GIMNAZIALĂ TIRGŞORU VECHI",580,"Alegeri Prezidentiale",1,1057,477,431,45,1,472,5,1200,723,367,105
31,PRAHOVA,"TÂRGŞORU VECHI",130892,"TÂRGŞORU VECHI","GRĂDINIŢA CU PROGRAM NORMAL TÎRGŞORU VECHI",581,"Alegeri Prezidentiale",2,903,472,430,42,0,468,4,1000,528,350,118
31,PRAHOVA,"TÂRGŞORU VECHI",130892,STĂNCEŞTI,"ŞCOALA GENERALĂ CU CLASELE I-IV STĂNCEŞTI",582,"Alegeri Prezidentiale",1,824,373,333,40,0,368,5,900,527,276,92
31,PRAHOVA,TEIŞANI,135725,TEIŞANI,"ȘCOALA GIMNAZIALĂ ”DUMITRU BREZEANU”,SAT TEIȘANI,NR.160",583,"Alegeri Prezidentiale",1,1449,679,628,51,0,673,6,1600,921,390,283
31,PRAHOVA,TEIŞANI,135725,"VALEA STÂLPULUI","SC.MALI AUTO EXPRES SRL, SAT VALEA STÎLPULUI,NR.58",584,"Alegeri Prezidentiale",1,179,137,112,25,0,130,7,200,63,81,49
31,PRAHOVA,TEIŞANI,135725,OLTENI,"SCOALA GIMNAZIALĂ ”MOISE VASILESCU”, SAT OLTENI, NR.147",585,"Alegeri Prezidentiale",1,1407,620,550,70,0,611,9,1600,980,434,177
31,PRAHOVA,TELEGA,135789,TELEGA,"ŞCOALA GIMNAZIALA NR.1 TELEGA",586,"Alegeri Prezidentiale",1,1126,654,556,98,0,646,8,1200,546,450,196
31,PRAHOVA,TELEGA,135789,TELEGA,"SCOALA GENERALA NR.2 TELEGA-VALE",587,"Alegeri Prezidentiale",1,1460,773,712,61,0,769,4,1600,827,538,231
31,PRAHOVA,TELEGA,135789,TELEGA,"GRĂDINIŢA NR.1 TELEGA",588,"Alegeri Prezidentiale",1,1130,616,553,62,1,603,13,1200,584,372,231
31,PRAHOVA,TELEGA,135789,BUŞTENARI,"ŞCOALA GIMNAZIALĂ SAT BUŞTENARI",589,"Alegeri Prezidentiale",1,499,211,184,27,0,210,1,600,389,140,70
31,PRAHOVA,TELEGA,135789,MELICEŞTI,"SCOALA PRIMARA SAT MELICEŞTI",590,"Alegeri Prezidentiale",1,392,204,187,17,0,201,3,500,296,153,48
31,PRAHOVA,TINOSU,135850,TINOSU,"CĂMINUL CULTURAL TINOSU, LOCALITATEA TINOSU",591,"Alegeri Prezidentiale",1,923,460,398,62,0,456,4,1000,540,322,134
31,PRAHOVA,TINOSU,135850,PREDEŞTI,"ŞCOALA PRIMARĂ SAT PREDEŞTI, LOCALITATEA PREDEŞTI",592,"Alegeri Prezidentiale",1,541,288,253,35,0,285,3,600,312,192,93
31,PRAHOVA,TINOSU,135850,PISCULEŞTI,"ŞCOALA PRIMARĂ SAT PISCULEŞTI, LOCALITATEA PISCULEŞTI",593,"Alegeri Prezidentiale",1,503,207,184,23,0,201,6,600,393,120,81
31,PRAHOVA,TOMŞANI,135896,MAGULA,"ŞCOALA GIMNAZIALĂ ”PROF.DINU MIHAIL-DAN” SAT MAGULA, COMUNA TOMŞANI, JUDEŢUL PRAHOVA",594,"Alegeri Prezidentiale",1,1304,676,634,42,0,664,12,1400,724,376,288
31,PRAHOVA,TOMŞANI,135896,MAGULA,"ṢCOALA VECHE MAGULA, SAT MAGULA, NR. 406A",595,"Alegeri Prezidentiale",1,1067,509,476,33,0,505,4,1200,691,247,258
31,PRAHOVA,TOMŞANI,135896,LOLOIASCA,"CĂMIN CULTURAL LOLOIASCA, SAT LOLOIASCA, NR. 6V",596,"Alegeri Prezidentiale",1,1199,588,525,63,0,579,9,1300,712,306,273
31,PRAHOVA,"VADU SĂPAT",136269,"VADU SĂPAT","ȘCOALĂ GIMNAZIALĂ VADU SĂPAT, COMUNA VADU SĂPAT, SAT VADU SĂPAT",597,"Alegeri Prezidentiale",1,1353,626,568,58,0,612,14,1500,874,354,258
31,PRAHOVA,"VALEA CĂLUGĂREASCĂ",135949,ARVA,"CAMIN CULTURAL",598,"Alegeri Prezidentiale",1,1112,553,498,55,0,545,8,1200,647,317,228
31,PRAHOVA,"VALEA CĂLUGĂREASCĂ",135949,"VALEA CĂLUGĂREASCĂ","SCOALA GIMNAZIALA ION IONESCU VALEA CALUGAREASCA",599,"Alegeri Prezidentiale",1,1440,698,638,60,0,687,11,1600,902,430,257
31,PRAHOVA,"VALEA CĂLUGĂREASCĂ",135949,"VALEA CĂLUGĂREASCĂ","SCOALA GIMNAZIALA ION IONESCU VALEA CALUGAREASCA",600,"Alegeri Prezidentiale",1,912,390,350,40,0,378,12,1000,610,226,152
31,PRAHOVA,"VALEA CĂLUGĂREASCĂ",135949,"VALEA NICOVANI","SCOAL GIMNAZIALA NICOVANI",601,"Alegeri Prezidentiale",1,1143,577,512,65,0,571,6,1300,723,373,198
31,PRAHOVA,"VALEA CĂLUGĂREASCĂ",135949,DÂRVARI,"GRADINITA DIRVARI",602,"Alegeri Prezidentiale",1,465,248,221,27,0,246,2,500,252,141,105
31,PRAHOVA,"VALEA CĂLUGĂREASCĂ",135949,COSLEGI,"GRADINITA COSLEGI",603,"Alegeri Prezidentiale",1,549,232,207,25,0,230,2,600,368,159,71
31,PRAHOVA,"VALEA CĂLUGĂREASCĂ",135949,RADILA,"GRADINITA RADILA",604,"Alegeri Prezidentiale",1,242,112,94,18,0,112,0,300,188,59,53
31,PRAHOVA,"VALEA CĂLUGĂREASCĂ",135949,PANTAZI,"SCOAL PRIMARA PANTAZI",605,"Alegeri Prezidentiale",1,949,414,375,39,0,408,6,1000,586,262,146
31,PRAHOVA,"VALEA CĂLUGĂREASCĂ",135949,RACHIERI,"SCOAL GIMNAZIALA RACHIERI",606,"Alegeri Prezidentiale",1,1182,542,512,24,6,537,5,1300,758,217,320
31,PRAHOVA,"VALEA CĂLUGĂREASCĂ",135949,"VALEA POPII","COLEGIUL AGRICOL GHEORGHE IONESCU SISESTI",607,"Alegeri Prezidentiale",1,748,358,306,52,0,349,9,800,442,224,125
31,PRAHOVA,"VALEA CĂLUGĂREASCĂ",135949,"VALEA MANTEI","CABANA DE VANATOARE",608,"Alegeri Prezidentiale",1,88,49,25,24,0,49,0,100,51,23,26
31,PRAHOVA,"VALEA DOFTANEI",136107,TEŞILA,"LICEUL TEHNOLOGIC ”CAROL I” VALEA DOFTANEI",609,"Alegeri Prezidentiale",1,1331,601,534,67,0,597,4,1500,899,478,119
31,PRAHOVA,"VALEA DOFTANEI",136107,TRĂISTENI,"PRIMĂRIA TRĂISTENI",610,"Alegeri Prezidentiale",1,965,487,406,81,0,481,6,1100,613,388,93
31,PRAHOVA,"VALEA DOFTANEI",136107,TRĂISTENI,"ŞCOALA CU CLASELE I-VIII ”EROU INV.I.DRĂGĂNESCU”TRĂISTENI",611,"Alegeri Prezidentiale",1,1029,485,456,29,0,480,5,1100,615,365,115
31,PRAHOVA,"VALEA DOFTANEI",136107,TEŞILA,"GRĂDINIŢA NR.1 TEŞILA",612,"Alegeri Prezidentiale",1,1161,530,488,42,0,525,5,1300,770,422,103
31,PRAHOVA,"VALEA DOFTANEI",136107,TEŞILA,"GRĂDINIŢA NR.2 TEŞILA",613,"Alegeri Prezidentiale",1,977,501,454,47,0,498,3,1100,599,392,106
31,PRAHOVA,VĂRBILĂU,136134,VĂRBILĂU,"ȘCOALA PRIMARĂ VĂRBILĂU",614,"Alegeri Prezidentiale",1,880,402,369,33,0,389,13,1000,598,189,200
31,PRAHOVA,VĂRBILĂU,136134,VĂRBILĂU,"ȘCOALA PRIMARĂ VĂRBILĂU",615,"Alegeri Prezidentiale",1,824,371,347,24,0,363,8,900,529,179,184
31,PRAHOVA,VĂRBILĂU,136134,VĂRBILĂU,"ȘCOALA GIMNAZIALĂ VĂRBILĂU",616,"Alegeri Prezidentiale",1,1161,535,469,66,0,524,11,1300,765,228,296
31,PRAHOVA,VĂRBILĂU,136134,LIVADEA,"ȘCOALA PRIMARĂ LIVADEA",617,"Alegeri Prezidentiale",1,855,432,375,57,0,428,4,900,468,208,220
31,PRAHOVA,VĂRBILĂU,136134,"POIANA VĂRBILĂU","ȘCOALA PRIMARĂ POIANA VĂRBILĂU",618,"Alegeri Prezidentiale",1,1065,480,444,36,0,471,9,1200,720,211,260
31,PRAHOVA,VĂRBILĂU,136134,COŢOFENEŞTI,"ȘCOALA PRIMARĂ COȚOFENEȘTI",619,"Alegeri Prezidentiale",1,702,384,334,50,0,379,5,800,416,224,155
31,PRAHOVA,VÂLCĂNEŞTI,136198,VÂLCĂNEŞTI,"CENTRUL CULTURAL VÎLCĂNEŞTI",620,"Alegeri Prezidentiale",1,1375,692,649,41,2,685,7,1500,808,431,254
31,PRAHOVA,VÂLCĂNEŞTI,136198,VÂLCĂNEŞTI,"GRĂDINIŢA CU PROGRAM NORMAL NR.2 VÎLCĂNEŞTI",621,"Alegeri Prezidentiale",1,753,402,371,24,7,399,3,800,398,251,148
31,PRAHOVA,VÂLCĂNEŞTI,136198,CÂRJARI,"ŞCOALA GIMNAZIALĂ,COMUNA VÎLCĂNEŞTI, SAT CÎRJARI",622,"Alegeri Prezidentiale",1,611,292,271,15,6,288,4,700,408,189,99
31,PRAHOVA,VÂLCĂNEŞTI,136198,TRESTIOARA,"BIBLIOTECA SĂTEASCĂ TRESTIOARA",623,"Alegeri Prezidentiale",1,361,166,149,16,1,162,4,400,234,104,58
32,"SATU MARE","MUNICIPIUL SATU MARE",136483,"SATU MARE","GRADINITA CU PROGRAM PRELUNGIT ”DRAGA MEA” (GRADINITA ”DRAGA MEA”(",1,"Alegeri Prezidentiale",1,1755,592,538,54,0,582,10,1800,1208,463,119
32,"SATU MARE","MUNICIPIUL SATU MARE",136483,"SATU MARE","GRADINITA CU PROGRAM PRELUNGIT ”DRAGA MEA” (GRADINITA ”DRAGA MEA”(",2,"Alegeri Prezidentiale",1,1701,747,717,30,0,740,7,1800,1053,558,182
32,"SATU MARE","MUNICIPIUL SATU MARE",136483,"SATU MARE","ASOCIAŢIA CARITAS SATU MARE CANTRUL SOCIAL DESCHIS LA CASA PRIETENIEI",3,"Alegeri Prezidentiale",1,1052,509,454,55,0,497,12,1100,591,344,153
32,"SATU MARE","MUNICIPIUL SATU MARE",136483,"SATU MARE","ȘCOALA GIMNAZIALĂ ” ION CREANGĂ ”(ŞC. CU CLS.I-VIII” ION CREANGĂ ”)",4,"Alegeri Prezidentiale",1,1365,648,608,40,0,641,7,1500,852,484,157
32,"SATU MARE","MUNICIPIUL SATU MARE",136483,"SATU MARE","ȘCOALA GIMNAZIALĂ ” ION CREANGĂ ”(ŞC. CU CLS.I-VIII” ION CREANGĂ ”)",5,"Alegeri Prezidentiale",1,1227,592,566,25,1,583,9,1300,708,443,140
32,"SATU MARE","MUNICIPIUL SATU MARE",136483,"SATU MARE","ȘCOALA GIMNAZIALĂ ” ION CREANGĂ ”(ŞC. CU CLS.I-VIII” ION CREANGĂ ”)",6,"Alegeri Prezidentiale",1,1219,599,563,36,0,588,11,1300,701,443,145
32,"SATU MARE","MUNICIPIUL SATU MARE",136483,"SATU MARE","ȘCOALA GIMNAZIALĂ ” ION CREANGĂ ”(ŞC. CU CLS.I-VIII” ION CREANGĂ ”)",7,"Alegeri Prezidentiale",1,1512,672,654,18,0,660,12,1700,1028,528,132
32,"SATU MARE","MUNICIPIUL SATU MARE",136483,"SATU MARE","ȘCOALA GIMNAZIALĂ ” LUCIAN BLAGA ” (ŞC. CU CLS.I-VIII ” LUCIAN BLAGA ”)",8,"Alegeri Prezidentiale",1,1370,606,567,39,0,600,6,1500,894,466,134
32,"SATU MARE","MUNICIPIUL SATU MARE",136483,"SATU MARE","ȘCOALA GIMNAZIALĂ ” LUCIAN BLAGA ” (ŞC. CU CLS.I-VIII ” LUCIAN BLAGA ”)",9,"Alegeri Prezidentiale",1,1252,595,551,44,0,585,10,1400,805,472,113
32,"SATU MARE","MUNICIPIUL SATU MARE",136483,"SATU MARE","ȘCOALA GIMNAZIALĂ ” LUCIAN BLAGA ” (ŞC. CU CLS.I-VIII ” LUCIAN BLAGA ”)",10,"Alegeri Prezidentiale",1,1177,524,495,29,0,518,6,1300,776,404,114
32,"SATU MARE","MUNICIPIUL SATU MARE",136483,"SATU MARE","ȘCOALA GIMNAZIALĂ ” LUCIAN BLAGA ” (ŞC. CU CLS.I-VIII ” LUCIAN BLAGA ”)",11,"Alegeri Prezidentiale",1,1323,575,551,24,0,569,6,1500,925,449,120
32,"SATU MARE","MUNICIPIUL SATU MARE",136483,"SATU MARE","ȘCOALA GIMNAZIALĂ ” OCTAVIAN GOGA ” (ŞC. CU CLS.I-VIII” OCTAVIAN GOGA ”)",12,"Alegeri Prezidentiale",1,1267,517,456,61,0,507,10,1400,883,394,113
32,"SATU MARE","MUNICIPIUL SATU MARE",136483,"SATU MARE","ȘCOALA GIMNAZIALĂ ” OCTAVIAN GOGA ” (ŞC. CU CLS.I-VIII” OCTAVIAN GOGA ”)",13,"Alegeri Prezidentiale",1,1210,507,468,39,0,504,3,1300,793,361,143
32,"SATU MARE","MUNICIPIUL SATU MARE",136483,"SATU MARE","ȘCOALA GIMNAZIALĂ ” OCTAVIAN GOGA ” (ŞC. CU CLS.I-VIII” OCTAVIAN GOGA ”)",14,"Alegeri Prezidentiale",1,1384,588,568,20,0,572,16,1500,912,441,131
32,"SATU MARE","MUNICIPIUL SATU MARE",136483,"SATU MARE","ȘCOALA GIMNAZIALĂ ” OCTAVIAN GOGA ” (ŞC. CU CLS.I-VIII” OCTAVIAN GOGA ”)",15,"Alegeri Prezidentiale",1,1544,697,675,22,0,685,12,1700,1003,513,172
32,"SATU MARE","MUNICIPIUL SATU MARE",136483,"SATU MARE","GRĂDINIŢA CU PROGRAM NORMAL NR.21",16,"Alegeri Prezidentiale",1,1341,618,578,40,0,612,6,1500,882,473,139
32,"SATU MARE","MUNICIPIUL SATU MARE",136483,"SATU MARE","GRĂDINIŢA CU PROGRAM NORMAL NR.21",17,"Alegeri Prezidentiale",1,1690,710,664,46,0,701,9,1900,1190,545,156
32,"SATU MARE","MUNICIPIUL SATU MARE",136483,"SATU MARE","UNIVERSITATEA TEHNICĂ CLUJ NAPOCA - FILIALA SATU MARE (GRĂDINIŢA CU PROGRAM NORMAL NR.21)",18,"Alegeri Prezidentiale",1,1667,771,735,36,0,762,9,1800,1029,572,190
32,"SATU MARE","MUNICIPIUL SATU MARE",136483,"SATU MARE","UNIVERSITATEA TEHNICĂ CLUJ NAPOCA - FILIALA SATU MARE (GRĂDINIŢA CU PROGRAM NORMAL NR.21)",19,"Alegeri Prezidentiale",1,1554,739,710,29,0,733,6,1692,953,558,175
32,"SATU MARE","MUNICIPIUL SATU MARE",136483,"SATU MARE","ŞC. CU CLS.I-VIII NR. 9",20,"Alegeri Prezidentiale",1,1224,574,536,38,0,560,14,1300,726,438,122
32,"SATU MARE","MUNICIPIUL SATU MARE",136483,"SATU MARE","LICEUL TEORETIC GERMAN ” JOHANN ETTINGER ”",21,"Alegeri Prezidentiale",1,1783,816,736,80,0,807,9,2000,1184,663,144
32,"SATU MARE","MUNICIPIUL SATU MARE",136483,"SATU MARE","COLEGIUL TEHNIC ” ELISA ZAMFIRESCU ” (COL.TEHNIC ELISA ZAMFIRESCU(GRUP ŞC. DE INDUSTRIE UŞOARĂ ))",22,"Alegeri Prezidentiale",1,1444,720,671,48,1,710,10,1600,880,548,162
32,"SATU MARE","MUNICIPIUL SATU MARE",136483,"SATU MARE","ȘCOALA GIMNAZIALĂ ” MIRCEA ELIADE ” ( ŞC. CU CLS.I-VIII” MIRCEA ELIADE ”)",23,"Alegeri Prezidentiale",1,1440,603,546,57,0,593,10,1600,997,440,153
32,"SATU MARE","MUNICIPIUL SATU MARE",136483,"SATU MARE","ȘCOALA GIMNAZIALĂ ” MIRCEA ELIADE ” ( ŞC. CU CLS.I-VIII” MIRCEA ELIADE ”)",24,"Alegeri Prezidentiale",1,1666,724,671,53,0,711,13,1800,1076,550,161
32,"SATU MARE","MUNICIPIUL SATU MARE",136483,"SATU MARE","ȘCOALA GIMNAZIALĂ ” MIRCEA ELIADE ” ( ŞC. CU CLS.I-VIII” MIRCEA ELIADE ”)",25,"Alegeri Prezidentiale",1,1385,451,410,41,0,449,2,1500,1049,366,83
32,"SATU MARE","MUNICIPIUL SATU MARE",136483,"SATU MARE","ȘCOALA GIMNAZIALĂ ” MIRCEA ELIADE ” ( ŞC. CU CLS.I-VIII” MIRCEA ELIADE ”)",26,"Alegeri Prezidentiale",1,1227,489,476,13,0,479,10,1393,904,334,145
32,"SATU MARE","MUNICIPIUL SATU MARE",136483,"SATU MARE","GRĂDINIŢA CU PROGRAM PRELUNGIT NR. 9",27,"Alegeri Prezidentiale",1,1300,548,513,34,1,538,10,1400,852,385,153
32,"SATU MARE","MUNICIPIUL SATU MARE",136483,"SATU MARE","GRĂDINIŢA CU PROGRAM PRELUNGIT NR. 9",28,"Alegeri Prezidentiale",1,1376,474,445,29,0,467,7,1500,1026,354,113
32,"SATU MARE","MUNICIPIUL SATU MARE",136483,"SATU MARE","ȘCOALA GIMNAZIALĂ ” BĂLCESCU-PETOFI ” (ŞC. CU CLS.I-VIII ” BĂLCESCU-PETOFI ”)",29,"Alegeri Prezidentiale",1,1406,643,572,71,0,633,10,1500,857,487,146
32,"SATU MARE","MUNICIPIUL SATU MARE",136483,"SATU MARE","ȘCOALA GIMNAZIALĂ ” BĂLCESCU-PETOFI ” (ŞC. CU CLS.I-VIII ” BĂLCESCU-PETOFI ”)",30,"Alegeri Prezidentiale",1,1892,760,732,28,0,748,12,2100,1340,590,158
32,"SATU MARE","MUNICIPIUL SATU MARE",136483,"SATU MARE","ȘCOALA GIMNAZIALĂ ” BĂLCESCU-PETOFI ” (ŞC. CU CLS.I-VIII ” BĂLCESCU-PETOFI ”)",31,"Alegeri Prezidentiale",1,1370,662,519,17,126,647,15,1734,1072,457,190
32,"SATU MARE","MUNICIPIUL SATU MARE",136483,"SATU MARE","GRĂDINIŢA CU PROGRAM PRELUNGIT NR.13",32,"Alegeri Prezidentiale",1,1277,569,541,28,0,560,9,1400,831,399,161
32,"SATU MARE","MUNICIPIUL SATU MARE",136483,"SATU MARE","GRĂDINIŢA CU PROGRAM PRELUNGIT NR. 5",33,"Alegeri Prezidentiale",1,1169,484,456,28,0,479,5,1300,816,378,101
32,"SATU MARE","MUNICIPIUL SATU MARE",136483,"SATU MARE","GRĂDINIŢA CU PROGRAM PRELUNGIT NR. 5",34,"Alegeri Prezidentiale",1,1331,575,557,18,0,570,5,1500,925,407,163
32,"SATU MARE","MUNICIPIUL SATU MARE",136483,"SATU MARE","ȘCOALA GIMNAZIALĂ ” AVRAM IANCU ” (ŞC. CU CLS.I-VIII” AVRAM IANCU ”) (GRĂDINIŢA CU PROGRAM PRELUNGIT ”VOINICELUL” CORP ” B ”)",35,"Alegeri Prezidentiale",1,1203,458,440,18,0,454,4,1300,842,337,117
32,"SATU MARE","MUNICIPIUL SATU MARE",136483,"SATU MARE","ȘCOALA GIMNAZIALĂ ” AVRAM IANCU ” ( ŞC. CU CLS.I-VIII ” AVRAM IANCU ”)",36,"Alegeri Prezidentiale",1,1193,590,530,60,0,577,13,1300,710,415,162
32,"SATU MARE","MUNICIPIUL SATU MARE",136483,"SATU MARE","ȘCOALA GIMNAZIALĂ ” AVRAM IANCU ” (ŞC. CU CLS.I-VIII” AVRAM IANCU ”)",37,"Alegeri Prezidentiale",1,1314,626,577,49,0,618,8,1392,766,435,183
32,"SATU MARE","MUNICIPIUL SATU MARE",136483,"SATU MARE","ȘCOALA GIMNAZIALĂ ” AVRAM IANCU ” (ŞC. CU CLS.I-VIII” AVRAM IANCU ”)",38,"Alegeri Prezidentiale",1,1457,640,616,24,0,626,14,1600,960,454,172
32,"SATU MARE","MUNICIPIUL SATU MARE",136483,"SATU MARE","ȘCOALA GIMNAZIALĂ ” AVRAM IANCU ” (ŞC. CU CLS.I-VIII” AVRAM IANCU ”)",39,"Alegeri Prezidentiale",1,1290,545,522,23,0,540,5,1408,863,432,108
32,"SATU MARE","MUNICIPIUL SATU MARE",136483,"SATU MARE","ȘCOALA GIMNAZIALĂ ” AVRAM IANCU ” (ŞC. CU CLS.I-VIII” AVRAM IANCU ”) (GRĂDINIŢA CU PROGRAM PRELUNGIT ”VOINICELUL”)",40,"Alegeri Prezidentiale",1,1312,564,537,27,0,561,3,1400,836,410,151
32,"SATU MARE","MUNICIPIUL SATU MARE",136483,"SATU MARE","LICEUL TEHNOLOGIC IND. ALIM ” GEORGE EMIL PALADE ”. ( GRUPUL ŞCOLAR DE IND. ALIMENTARĂ ”GEORGE EMIL PALADE” )",41,"Alegeri Prezidentiale",1,1374,575,535,40,0,569,6,1500,925,448,121
32,"SATU MARE","MUNICIPIUL SATU MARE",136483,"SATU MARE","LICEUL TEHNOLOGIC IND. ALIM ” GEORGE EMIL PALADE ”. ( GRUPUL ŞCOLAR DE IND. ALIMENTARĂ ”GEORGE EMIL PALADE” )",42,"Alegeri Prezidentiale",1,1414,664,601,63,0,648,16,1600,936,479,169
32,"SATU MARE","MUNICIPIUL SATU MARE",136483,"SATU MARE","LICEUL TEHNOLOGIC IND. ALIM ” GEORGE EMIL PALADE ”. ( GRUPUL ŞCOLAR DE IND. ALIMENTARĂ ”GEORGE EMIL PALADE” )",43,"Alegeri Prezidentiale",1,1309,525,505,20,0,520,5,1400,875,404,116
32,"SATU MARE","MUNICIPIUL SATU MARE",136483,"SATU MARE","LICEUL TEHNOLOGIC IND. ALIM ” GEORGE EMIL PALADE ”. ( GRUPUL ŞCOLAR DE IND. ALIMENTARĂ ”GEORGE EMIL PALADE” )",44,"Alegeri Prezidentiale",1,1532,664,647,17,0,653,11,1700,1036,496,157
32,"SATU MARE","MUNICIPIUL SATU MARE",136483,"SATU MARE","LICEUL TEHNOLOGIC IND. ALIM ” GEORGE EMIL PALADE ”. ( GRUPUL ŞCOLAR DE IND. ALIMENTARĂ ”GEORGE EMIL PALADE” )",45,"Alegeri Prezidentiale",1,1336,556,529,27,0,548,8,1492,936,388,160
32,"SATU MARE","MUNICIPIUL SATU MARE",136483,SĂTMĂREL,"ȘCOALA GIMNAZIALĂ - SĂTMĂREL ( ŞC. CU CLS.I-VIII - SĂTMĂREL)",46,"Alegeri Prezidentiale",1,1168,531,507,23,1,526,5,1300,769,429,97
32,"SATU MARE","MUNICIPIUL SATU MARE",136483,"SATU MARE","ASOCIAŢIA JUDEŢEANĂ DE FOTBAL ( ŞC. NR.15 )",47,"Alegeri Prezidentiale",1,1998,793,751,41,1,774,19,2192,1399,643,131
32,"SATU MARE","MUNICIPIUL SATU MARE",136483,"SATU MARE","SECŢIA DE DRUMURI NAŢIONALE",48,"Alegeri Prezidentiale",1,1768,775,749,26,0,759,16,1900,1125,595,164
32,"SATU MARE","MUNICIPIUL SATU MARE",136483,"SATU MARE","CENTRUL JUDEȚEAN DE EXCELENȚĂ SATU MARE",49,"Alegeri Prezidentiale",1,1394,582,525,57,0,570,12,1500,918,453,117
32,"SATU MARE","MUNICIPIUL SATU MARE",136483,"SATU MARE","ȘCOALA GIMNAZIALĂ ” DR. VASILE LUCACIU ” ( SC. CU CL. I-VIII ”DR. V. LUCACIU” )",50,"Alegeri Prezidentiale",1,1178,524,490,34,0,510,14,1300,776,394,116
32,"SATU MARE","MUNICIPIUL SATU MARE",136483,"SATU MARE","ȘCOALA GIMNAZIALĂ ” DR. VASILE LUCACIU ” ( SC. CU CL. I-VIII ”DR. V. LUCACIU” )",51,"Alegeri Prezidentiale",1,993,505,465,40,0,497,8,1100,595,365,132
32,"SATU MARE","MUNICIPIUL SATU MARE",136483,"SATU MARE","GRĂDINIŢA NR.15",52,"Alegeri Prezidentiale",1,1207,549,495,54,0,528,21,1300,751,405,123
32,"SATU MARE","MUNICIPIUL SATU MARE",136483,"SATU MARE","LICEUL TEOLOGIC”NICOLAE STEINHARDT ”",53,"Alegeri Prezidentiale",1,1560,589,545,44,0,579,10,1700,1111,455,124
32,"SATU MARE","MUNICIPIUL SATU MARE",136483,"SATU MARE","LICEUL TEOLOGIC”NICOLAE STEINHARDT ”",54,"Alegeri Prezidentiale",1,1519,611,586,25,0,601,10,1700,1089,450,151
32,"SATU MARE","MUNICIPIUL SATU MARE",136483,"SATU MARE","GRĂDINIŢA CU PROGRAM PRELUNGIT NR.12",55,"Alegeri Prezidentiale",1,1333,465,404,20,41,463,2,1500,1035,367,96
32,"SATU MARE","MUNICIPIUL SATU MARE",136483,"SATU MARE","GRĂDINIŢA CU PROGRAM PRELUNGIT – ” 14 MAI ”",56,"Alegeri Prezidentiale",1,1586,546,530,16,0,531,15,1700,1154,379,152
32,"SATU MARE","MUNICIPIUL SATU MARE",136483,"SATU MARE","GRĂDINIŢA CU PROGRAM PRELUNGIT – ” 14 MAI ”",57,"Alegeri Prezidentiale",1,1091,427,396,31,0,424,3,1200,773,317,107
32,"SATU MARE","MUNICIPIUL SATU MARE",136483,"SATU MARE","LICEUL TEHNOLOGIC ” CONSTANTIN BRÂNCUȘ ” (GRUP SCOLAR ”CONSTANTIN BRANCUS ” SATU MARE)",58,"Alegeri Prezidentiale",1,1395,670,610,52,8,659,11,1500,830,477,182
32,"SATU MARE","MUNICIPIUL SATU MARE",136483,"SATU MARE","LICEUL CU PROGRAM SPORTIV",59,"Alegeri Prezidentiale",1,1218,530,490,39,1,508,22,1300,770,422,86
32,"SATU MARE","MUNICIPIUL SATU MARE",136483,"SATU MARE","ȘCOALA GIMNAZIALĂ ” GRIGORE MOISIL ” (ŞC. CU CLS.I-VIII” GRIGORE MOISIL ”)",60,"Alegeri Prezidentiale",1,1166,788,464,27,297,764,24,1500,712,360,404
32,"SATU MARE","MUNICIPIUL SATU MARE",136483,"SATU MARE","ȘCOALA GIMNAZIALĂ ” GRIGORE MOISIL ” (ŞC. CU CLS.I-VIII” GRIGORE MOISIL ”)",61,"Alegeri Prezidentiale",1,1017,527,448,79,0,518,9,1100,573,393,125
32,"SATU MARE","MUNICIPIUL SATU MARE",136483,"SATU MARE","COLEGIUL TEHNIC DE TRANSP. ŞI TELECOMUNICAŢII ” I.C. BRĂTIANU ”",62,"Alegeri Prezidentiale",1,1314,629,561,53,15,610,19,1400,771,440,170
32,"SATU MARE","MUNICIPIUL SATU MARE",136483,"SATU MARE","LICEUL TEOLOGIC ROMANO-CATOLIC ” HÁM JÁNOS ”",63,"Alegeri Prezidentiale",1,908,365,318,47,0,349,16,1000,635,246,103
32,"SATU MARE","MUNICIPIUL SATU MARE",136483,"SATU MARE","LICEUL REFORMAT ( LICEUL TEOLOGIC REFORMAT)",64,"Alegeri Prezidentiale",1,953,569,406,72,91,549,20,1200,631,409,140
32,"SATU MARE","MUNICIPIUL SATU MARE",136483,"SATU MARE","GRĂDINIŢA CU PROG. PRELUNGIT ” DUMBRAVA MINUNATĂ ” (GRĂDINIŢA ”DUMBRAVA MINUNATĂ” )",65,"Alegeri Prezidentiale",1,1277,547,515,32,0,532,15,1400,853,391,141
32,"SATU MARE","MUNICIPIUL SATU MARE",136483,"SATU MARE","COLEGIUL NAŢIONAL ” DOAMNA STANCA ”",66,"Alegeri Prezidentiale",1,899,395,337,58,0,386,9,1000,605,296,90
32,"SATU MARE","MUNICIPIUL SATU MARE",136483,"SATU MARE","ȘCOALA GIMNAZIALĂ ” RÁKÓCZI FERENC ”",67,"Alegeri Prezidentiale",1,1204,474,441,33,0,467,7,1300,826,382,85
32,"SATU MARE","MUNICIPIUL SATU MARE",136483,"SATU MARE","ȘCOALA GIMNAZIALĂ ” RÁKÓCZI FERENC ”",68,"Alegeri Prezidentiale",1,1599,668,638,30,0,650,18,1700,1032,531,119
32,"SATU MARE","MUNICIPIUL SATU MARE",136483,"SATU MARE","ȘCOALA GIMNAZIALĂ ” CONSTANTIN BRÂNCOVEANU ”",69,"Alegeri Prezidentiale",1,1547,781,689,92,0,772,9,1700,919,540,232
32,"SATU MARE","MUNICIPIUL SATU MARE",136483,"SATU MARE","COLEGIUL NAŢIONAL” MIHAI EMINESCU ”",70,"Alegeri Prezidentiale",1,1048,527,432,95,0,511,16,1200,673,364,147
32,"SATU MARE","MUNICIPIUL SATU MARE",136483,"SATU MARE","COLEGIUL ECONOMIC ” GHEORGHE DRAGOŞ ” (GRUP ŞC. ECONOMIC” GHEORGHE DRAGOŞ ”)",71,"Alegeri Prezidentiale",1,1577,823,748,69,6,807,16,1700,877,597,210
32,"SATU MARE","MUNICIPIUL SATU MARE",136483,"SATU MARE","GRĂDINIŢA CU PROGRAM PRELUNGIT",72,"Alegeri Prezidentiale",1,1097,444,416,28,0,438,6,1202,758,327,111
32,"SATU MARE","MUNICIPIUL SATU MARE",136483,"SATU MARE","GRĂDINIŢA CU PROGRAM PRELUNGIT",73,"Alegeri Prezidentiale",1,1214,520,496,23,1,513,7,1300,780,403,110
32,"SATU MARE","MUNICIPIUL SATU MARE",136483,"SATU MARE","GRĂDINIŢA CU PROGRAM PRELUNGIT",74,"Alegeri Prezidentiale",1,1104,460,436,24,0,451,9,1200,740,309,142
32,"SATU MARE","MUNICIPIUL CAREI",136526,CAREI,"LICEUL ROMANO-CATOLIC”JOSEPHUS CALASANTIUS”",75,"Alegeri Prezidentiale",1,1627,486,447,39,0,472,14,1800,1314,290,182
32,"SATU MARE","MUNICIPIUL CAREI",136526,CAREI,"COLEGIUL TEHNIC ”IULIU MANIU”",76,"Alegeri Prezidentiale",1,1349,496,466,30,0,485,11,1500,1004,344,141
32,"SATU MARE","MUNICIPIUL CAREI",136526,CAREI,"LICEUL TEHNOLOGIC ”SIMION BĂRNUŢIU”",77,"Alegeri Prezidentiale",1,1574,451,430,20,1,442,9,1692,1241,340,102
32,"SATU MARE","MUNICIPIUL CAREI",136526,CAREI,"ŞCOALA GIMNAZIALĂ NR.1",78,"Alegeri Prezidentiale",1,1631,532,485,47,0,510,22,1800,1268,337,173
32,"SATU MARE","MUNICIPIUL CAREI",136526,CAREI,"ŞCOALA GIMNAZIALĂ ”VASILE LUCACIU” NR.2",79,"Alegeri Prezidentiale",1,1749,586,564,22,0,578,8,1900,1314,407,171
32,"SATU MARE","MUNICIPIUL CAREI",136526,CAREI,"GRĂDINIŢA CU PROGRAM NORMAL NR.9",80,"Alegeri Prezidentiale",1,1190,398,374,24,0,390,8,1300,902,287,103
32,"SATU MARE","MUNICIPIUL CAREI",136526,CAREI,"GRĂDINIŢA CU PROGRAM NORMAL NR.10",81,"Alegeri Prezidentiale",1,1843,599,564,35,0,582,17,2000,1401,409,173
32,"SATU MARE","MUNICIPIUL CAREI",136526,CAREI,"ŞCOALA GIMNAZIALĂ NR.3",82,"Alegeri Prezidentiale",1,1618,678,634,43,1,660,18,1800,1122,460,200
32,"SATU MARE","MUNICIPIUL CAREI",136526,CAREI,"LICEUL TEORETIC CAREI",83,"Alegeri Prezidentiale",1,1630,494,453,41,0,491,3,1800,1306,330,161
32,"SATU MARE","MUNICIPIUL CAREI",136526,CAREI,"GRĂDINIŢA CU PROGRAM NORMAL NR.5",84,"Alegeri Prezidentiale",1,1868,574,521,38,15,564,10,2000,1426,389,175
32,"SATU MARE","MUNICIPIUL CAREI",136526,CAREI,"GRĂDINIŢA CU PROGRAM NORMAL NR.8",85,"Alegeri Prezidentiale",1,1226,447,416,31,0,443,4,1300,853,321,122
32,"SATU MARE","MUNICIPIUL CAREI",136526,CAREI,"MUZEUL MUNICIPAL CAREI",86,"Alegeri Prezidentiale",1,1936,663,617,46,0,649,14,2000,1337,469,180
32,"SATU MARE","MUNICIPIUL CAREI",136526,CAREI,"SCOALA GENERALA NR4",87,"Alegeri Prezidentiale",1,1012,339,265,14,60,330,9,1492,1153,232,98
32,"SATU MARE","MUNICIPIUL CAREI",136526,IANCULEŞTI,"GRĂDINIŢA CU PROGRAM NORMAL IANCULEŞTI",88,"Alegeri Prezidentiale",1,285,164,138,26,0,164,0,300,136,91,73
32,"SATU MARE","ORAŞ ARDUD",136848,ARDUD,"LICEUL TEHNOLOGIC",89,"Alegeri Prezidentiale",1,1984,796,709,87,0,784,12,2200,1404,614,170
32,"SATU MARE","ORAŞ ARDUD",136848,ARDUD,"BIBLIOTECA ARDUD",90,"Alegeri Prezidentiale",1,1943,516,487,29,0,508,8,2100,1584,397,111
32,"SATU MARE","ORAŞ ARDUD",136848,"BABA NOVAC","SCOALA GENERALĂ BABA NOVAC",91,"Alegeri Prezidentiale",1,462,221,176,44,1,220,1,600,379,155,65
32,"SATU MARE","ORAŞ ARDUD",136848,GERĂUŞA,"SCOALA GENERALĂ GERĂUŞA",92,"Alegeri Prezidentiale",1,429,180,147,33,0,178,2,500,320,137,41
32,"SATU MARE","ORAŞ ARDUD",136848,MĂDĂRAS,"SCOALA GENERALĂ MĂDĂRAS",93,"Alegeri Prezidentiale",1,967,475,419,56,0,467,8,1100,625,355,112
32,"SATU MARE","ORAŞ LIVADA",138039,LIVADA,"SCOALA GIMNAZIALĂ ”PETOFI SANDOR” LIVADA",94,"Alegeri Prezidentiale",1,996,321,302,19,0,315,6,1100,779,267,48
32,"SATU MARE","ORAŞ LIVADA",138039,LIVADA,"GRADINITA CU PROGRAM NORMAL LIVADA",95,"Alegeri Prezidentiale",1,1420,449,414,35,0,443,6,1600,1151,379,64
32,"SATU MARE","ORAŞ LIVADA",138039,LIVADA,"ŞCOALA GIMNAZIALĂ PETOFI SANDOR LIVADA",96,"Alegeri Prezidentiale",1,1669,527,465,62,0,515,12,1800,1273,452,63
32,"SATU MARE","ORAŞ LIVADA",138039,ADRIAN,"ŞCOALA PRIMARĂ ADRIAN",97,"Alegeri Prezidentiale",1,432,132,119,13,0,124,8,500,368,107,17
32,"SATU MARE","ORAŞ LIVADA",138039,DUMBRAVA,"ŞCOALA GIMNAZIALĂ ”IOSIF ŢIPROC” DUMBRAVA",98,"Alegeri Prezidentiale",1,949,334,310,24,0,329,5,1100,766,232,97
32,"SATU MARE","ORAŞ LIVADA",138039,"LIVADA MICĂ","GRĂDINIŢA LIVADA MICĂ",99,"Alegeri Prezidentiale",1,256,115,96,19,0,114,1,300,185,78,36
32,"SATU MARE","ORAŞ NEGREŞTI-OAŞ",136599,NEGREŞTI-OAŞ,"SCOALA GEN.NR,2",100,"Alegeri Prezidentiale",1,1142,327,305,22,0,321,6,1210,883,220,101
32,"SATU MARE","ORAŞ NEGREŞTI-OAŞ",136599,NEGREŞTI-OAŞ,"SCOALA GEN.NR,2",101,"Alegeri Prezidentiale",1,1189,352,302,50,0,350,2,1301,949,203,147
32,"SATU MARE","ORAŞ NEGREŞTI-OAŞ",136599,NEGREŞTI-OAŞ,"SCOALA GEN.NR,3",102,"Alegeri Prezidentiale",1,1295,498,441,57,0,492,6,1400,902,335,157
32,"SATU MARE","ORAŞ NEGREŞTI-OAŞ",136599,NEGREŞTI-OAŞ,"SCOALA GEN.NR.3",103,"Alegeri Prezidentiale",1,1368,429,405,24,0,427,2,1500,1071,294,133
32,"SATU MARE","ORAŞ NEGREŞTI-OAŞ",136599,NEGREŞTI-OAŞ,"SCOALA GENERALA NR.3",104,"Alegeri Prezidentiale",1,1485,549,521,25,3,541,8,1600,1051,366,175
32,"SATU MARE","ORAŞ NEGREŞTI-OAŞ",136599,NEGREŞTI-OAŞ,"SCOALA GEN.NR.1",105,"Alegeri Prezidentiale",1,1020,403,362,39,2,396,7,1100,697,258,138
32,"SATU MARE","ORAŞ NEGREŞTI-OAŞ",136599,NEGREŞTI-OAŞ,"SCOALA GEN,NR.1",106,"Alegeri Prezidentiale",1,994,400,378,22,0,396,4,1101,701,255,141
32,"SATU MARE","ORAŞ NEGREŞTI-OAŞ",136599,NEGREŞTI-OAŞ,"LICEUL TEORETIC",107,"Alegeri Prezidentiale",1,1312,565,465,32,68,559,6,1400,835,367,192
32,"SATU MARE","ORAŞ NEGREŞTI-OAŞ",136599,NEGREŞTI-OAŞ,"LICEUL TEORETIC",108,"Alegeri Prezidentiale",1,1227,432,383,48,1,426,6,1300,868,281,145
32,"SATU MARE","ORAŞ NEGREŞTI-OAŞ",136599,NEGREŞTI-OAŞ,"LICEUL TEORETIC",109,"Alegeri Prezidentiale",1,1289,503,448,55,0,496,7,1400,897,268,228
32,"SATU MARE","ORAŞ NEGREŞTI-OAŞ",136599,TUR,"CLADIRE DISPENSAR TUR",110,"Alegeri Prezidentiale",1,1591,450,428,22,0,444,6,1700,1250,248,196
32,"SATU MARE","ORAŞ TĂŞNAD",136642,TĂŞNAD,"ŞCOALA GIMNAZIALĂ TĂŞNAD",111,"Alegeri Prezidentiale",1,1207,554,490,57,7,545,9,1300,746,380,165
32,"SATU MARE","ORAŞ TĂŞNAD",136642,TĂŞNAD,"ŞCOALA GIMNAZIALĂ TĂŞNAD",112,"Alegeri Prezidentiale",1,1571,636,559,73,4,625,11,1700,1064,446,179
32,"SATU MARE","ORAŞ TĂŞNAD",136642,TĂŞNAD,"ŞCOALA GIMNAZIALĂ TĂŞNAD",113,"Alegeri Prezidentiale",1,1612,672,635,37,0,657,15,1700,1028,499,158
32,"SATU MARE","ORAŞ TĂŞNAD",136642,TĂŞNAD,"CASA DE CULTURĂ",114,"Alegeri Prezidentiale",1,1714,672,622,49,1,656,16,1800,1128,428,228
32,"SATU MARE","ORAŞ TĂŞNAD",136642,BLAJA,"GRĂDINIŢA CU PROGRAM NORMAL BLAJA",115,"Alegeri Prezidentiale",1,162,104,85,19,0,102,2,200,96,68,34
32,"SATU MARE","ORAŞ TĂŞNAD",136642,CIG,"GRĂDINIŢA CU PROGRAM NORMAL CIG",116,"Alegeri Prezidentiale",1,360,141,133,8,0,140,1,400,259,100,40
32,"SATU MARE","ORAŞ TĂŞNAD",136642,SĂRĂUAD,"ŞCOALA GIMNAZIALĂ SĂRĂUAD",117,"Alegeri Prezidentiale",1,836,394,371,23,0,388,6,900,506,253,135
32,"SATU MARE","ORAŞ TĂŞNAD",136642,"VALEA MORII","GRĂDINIŢA CU PROGRAM NORMAL VALEA MORII",118,"Alegeri Prezidentiale",1,144,78,63,15,0,78,0,200,122,68,10
32,"SATU MARE",ACÂŞ,136713,ACÂŞ,"PRIMĂRIA COMUNEI ACÂŞ",119,"Alegeri Prezidentiale",1,1522,546,510,36,0,532,14,1600,1054,460,72
32,"SATU MARE",ACÂŞ,136713,MIHĂIENI,"ŞCOALA GENERALĂ MIHAIENI",120,"Alegeri Prezidentiale",1,368,110,89,21,0,109,1,400,290,84,25
32,"SATU MARE",ACÂŞ,136713,UNIMĂT,"ŞCOALA GENERALĂ UNIMĂT",121,"Alegeri Prezidentiale",1,323,179,152,27,0,179,0,400,221,122,57
32,"SATU MARE",AGRIŞ,179873,AGRIŞ,"PRIMARIA AGRIS",122,"Alegeri Prezidentiale",1,892,195,175,20,0,185,10,1000,805,149,36
32,"SATU MARE",AGRIŞ,179873,AGRIŞ,"GRĂDINIŢA CU PROGRAM NORMAL AGRIŞUL NOU",123,"Alegeri Prezidentiale",1,238,89,69,20,0,89,0,300,211,61,28
32,"SATU MARE",AGRIŞ,179873,CIUPERCENI,"ŞCOALA PRIMARĂ CIUPERCENI",124,"Alegeri Prezidentiale",1,494,151,127,24,0,151,0,600,449,129,22
32,"SATU MARE",ANDRID,136768,ANDRID,"SC. GIMNAZIALA ANDRID",125,"Alegeri Prezidentiale",1,977,288,268,20,0,283,5,1102,814,191,92
32,"SATU MARE",ANDRID,136768,DINDEŞTI,"SC. PRIMARA DINDESTI",126,"Alegeri Prezidentiale",1,606,265,244,20,1,263,2,700,435,189,74
32,"SATU MARE",ANDRID,136768,IRINA,"SC. GIMNAZIALA IRINA",127,"Alegeri Prezidentiale",1,417,62,51,11,0,60,2,508,446,35,25
32,"SATU MARE",APA,136802,APA,"CENTRU CULTURAL ”EMIL MATEI” APA",128,"Alegeri Prezidentiale",1,1058,494,435,57,2,487,7,1100,606,345,142
32,"SATU MARE",APA,136802,APA,"SCOALA GIMNAZIALĂ ”VASILE LUCACIU” APA",129,"Alegeri Prezidentiale",1,847,342,281,60,1,332,10,900,558,224,108
32,"SATU MARE",APA,136802,SOMEŞENI,"GRĂDINIŢA DIN SATUL SOMEŞENI",130,"Alegeri Prezidentiale",1,247,151,123,28,0,148,3,300,149,108,40
32,"SATU MARE",BĂTARCI,136919,BĂTARCI,"SCOALA GIMNAZIALA BĂTARCI",131,"Alegeri Prezidentiale",1,1859,568,545,22,1,563,5,1900,1332,343,220
32,"SATU MARE",BĂTARCI,136919,COMLĂUŞA,"SCOALA PRIMARĂ COMLĂUȘA",132,"Alegeri Prezidentiale",1,875,292,278,14,0,291,1,1000,708,197,94
32,"SATU MARE",BĂTARCI,136919,TĂMĂŞENI,"ŞCOALA PRIMARĂ TĂMĂŞENI",133,"Alegeri Prezidentiale",1,320,159,145,14,0,152,7,400,241,126,26
32,"SATU MARE",BÂRSĂU,137103,"BÂRSĂU DE SUS","PRIMARIA BÂRSĂU",134,"Alegeri Prezidentiale",1,1310,807,684,101,22,805,2,1400,593,442,363
32,"SATU MARE",BÂRSĂU,137103,"BÂRSĂU DE JOS","SEDIU ADMINISTRATIV",135,"Alegeri Prezidentiale",1,517,306,241,59,6,296,10,598,292,184,112
32,"SATU MARE",BELTIUG,136964,BELTIUG,"SCOALA GIMNAZIALA BELTIUG",136,"Alegeri Prezidentiale",1,1102,595,525,65,5,590,5,1200,605,529,61
32,"SATU MARE",BELTIUG,136964,BOLDA,"CĂMINUL CULTURAL BOLDA",137,"Alegeri Prezidentiale",1,48,37,15,22,0,36,1,100,63,24,12
32,"SATU MARE",BELTIUG,136964,GHIRIŞA,"ŞCOALA PRIMARĂ GHIRIŞA",138,"Alegeri Prezidentiale",1,569,168,154,14,0,164,4,600,432,155,9
32,"SATU MARE",BELTIUG,136964,GIUNGI,"CĂMINUL CULTURAL GIUNGI",139,"Alegeri Prezidentiale",1,114,79,55,24,0,78,1,199,120,67,11
32,"SATU MARE",BELTIUG,136964,RĂTEŞTI,"ŞCOALA GIMNAZIALĂ RĂTEŞTI",140,"Alegeri Prezidentiale",1,616,273,252,21,0,269,4,700,427,241,28
32,"SATU MARE",BELTIUG,136964,ŞANDRA,"GRĂDINIŢA DE COPII ŞANDRA",141,"Alegeri Prezidentiale",1,223,99,77,22,0,97,2,301,202,78,19
32,"SATU MARE",BERVENI,137032,BERVENI,"SCOALA GENERALA BERVENI",142,"Alegeri Prezidentiale",1,1678,254,238,16,0,245,9,1800,1546,213,32
32,"SATU MARE",BERVENI,137032,LUCĂCENI,"SCOALA GENERALA LUCACENI",143,"Alegeri Prezidentiale",1,1237,440,412,28,0,436,4,1300,860,271,165
32,"SATU MARE",BIXAD,137069,BIXAD,"SCOALA GENERALA BIXAD",144,"Alegeri Prezidentiale",1,1201,279,253,26,0,279,0,1250,971,216,63
32,"SATU MARE",BIXAD,137069,BIXAD,"SCOALA GENERALA BIXAD",145,"Alegeri Prezidentiale",1,1139,290,273,17,0,288,2,1200,910,199,89
32,"SATU MARE",BIXAD,137069,BOINEŞTI,"BOINESTI SCOALA GENERALA",146,"Alegeri Prezidentiale",1,1406,363,336,27,0,360,3,1500,1137,288,72
32,"SATU MARE",BIXAD,137069,TRIP,"TRIP SCOALA GENERALA",147,"Alegeri Prezidentiale",1,1330,360,308,26,26,357,3,1400,1040,253,104
32,"SATU MARE",BIXAD,137069,TRIP,"TRIP SCOALA GENERALA",148,"Alegeri Prezidentiale",1,1154,219,210,9,0,218,1,1200,981,172,46
32,"SATU MARE",BOGDAND,137130,BOGDAND,"PRIMARIA COMUNEI BOGDAND",149,"Alegeri Prezidentiale",1,773,134,120,14,0,132,2,800,666,121,11
32,"SATU MARE",BOGDAND,137130,BABŢA,"ŞCOALA CU CLASELE I-VIII",150,"Alegeri Prezidentiale",1,521,269,219,50,0,267,2,600,331,147,120
32,"SATU MARE",BOGDAND,137130,CORUND,"ŞCOALA CU CLASELE I-VIII",151,"Alegeri Prezidentiale",1,365,196,177,19,0,194,2,400,204,105,89
32,"SATU MARE",BOGDAND,137130,SER,"ŞCOALA CU CLASELE I-IV",152,"Alegeri Prezidentiale",1,583,108,92,16,0,107,1,600,492,87,20
32,"SATU MARE",BOTIZ,137185,BOTIZ,"PRIMARIA BOTIZ",153,"Alegeri Prezidentiale",1,1442,566,515,51,0,562,4,1600,1034,431,131
32,"SATU MARE",BOTIZ,137185,BOTIZ,"SCOALA GIMNAZIALA CU CLASELE I-IV OSVAREU",154,"Alegeri Prezidentiale",1,1699,647,583,64,0,640,7,1800,1153,487,153
32,"SATU MARE",CĂLINEŞTI-OAŞ,137229,CĂLINEŞTI-OAŞ,"PRIMARIA CALINESTI OAS",155,"Alegeri Prezidentiale",1,1355,410,384,26,0,409,1,1400,990,301,108
32,"SATU MARE",CĂLINEŞTI-OAŞ,137229,COCA,"SCOALA COCA",156,"Alegeri Prezidentiale",1,862,244,230,14,0,241,3,1000,756,202,39
32,"SATU MARE",CĂLINEŞTI-OAŞ,137229,LECHINŢA,"SCOALA LECHINTA",157,"Alegeri Prezidentiale",1,660,228,216,12,0,225,3,700,472,184,41
32,"SATU MARE",CĂLINEŞTI-OAŞ,137229,"PĂŞUNEA MARE","SCOALA PASUNEA MARE",158,"Alegeri Prezidentiale",1,327,98,79,19,0,97,1,400,302,83,14
32,"SATU MARE",CĂLINEŞTI-OAŞ,137229,CĂLINEŞTI-OAŞ,"SPCLEP CALINESTI OAS",159,"Alegeri Prezidentiale",1,872,276,262,14,0,274,2,1000,724,216,58
32,"SATU MARE",CĂMĂRZANA,137274,CĂMĂRZANA,"PRIMARIA COM. CAMARZANA",160,"Alegeri Prezidentiale",1,1058,265,221,16,28,263,2,1197,932,201,62
32,"SATU MARE",CĂMĂRZANA,137274,CĂMĂRZANA,"SCOALA GENERALA CAMARZANA",161,"Alegeri Prezidentiale",1,914,267,230,20,17,265,2,1000,733,198,67
32,"SATU MARE",CĂMIN,179677,CĂMIN,"SCOALA GIMNAZIALA CAMIN",162,"Alegeri Prezidentiale",1,1146,371,353,18,0,367,4,1200,829,322,45
32,"SATU MARE",CĂPLENI,136553,CĂPLENI,"PRIMĂRIA COMUNEI CĂPLENI",163,"Alegeri Prezidentiale",1,1195,165,158,7,0,158,7,1299,1134,137,21
32,"SATU MARE",CĂPLENI,136553,CĂPLENI,"ŞCOALA GIMNAZIALĂ ” FÉNYI ISTVÁN ” CĂPLENI",164,"Alegeri Prezidentiale",1,1458,323,315,8,0,320,3,1600,1277,251,69
32,"SATU MARE",CĂUAŞ,137292,CĂUAŞ,"ȘCOALA GIMNAZIALĂ",165,"Alegeri Prezidentiale",1,545,254,232,22,0,251,3,599,345,135,116
32,"SATU MARE",CĂUAŞ,137292,GHILEŞTI,"ȘCOALA GENERALĂ",166,"Alegeri Prezidentiale",1,74,48,25,23,0,47,1,100,52,19,28
32,"SATU MARE",CĂUAŞ,137292,RĂDULEŞTI,"MAGAZIN MIXT",167,"Alegeri Prezidentiale",1,97,50,33,17,0,50,0,200,150,27,23
32,"SATU MARE",CĂUAŞ,137292,"ADY ENDRE","CĂMINUL CULTURAL",168,"Alegeri Prezidentiale",1,106,41,28,13,0,41,0,200,159,25,16
32,"SATU MARE",CĂUAŞ,137292,HOTOAN,"CĂMINUL CULTURAL",169,"Alegeri Prezidentiale",1,141,69,42,27,0,69,0,200,131,42,27
32,"SATU MARE",CĂUAŞ,137292,GHENCI,"CĂMINUL CULTURAL",170,"Alegeri Prezidentiale",1,1050,258,235,23,0,253,5,1100,842,195,58
32,"SATU MARE",CEHAL,137363,CEHĂLUŢ,"CAMIN CULTURAL",171,"Alegeri Prezidentiale",1,494,236,218,17,1,231,5,600,364,146,85
32,"SATU MARE",CEHAL,137363,CEHAL,"SCOALA CEHAL",172,"Alegeri Prezidentiale",1,644,410,352,33,25,405,5,700,290,200,205
32,"SATU MARE",CEHAL,137363,ORBĂU,"CLADIRE PRIMARIE",173,"Alegeri Prezidentiale",1,178,129,103,26,0,126,3,202,73,48,78
32,"SATU MARE",CERTEZE,137407,CERTEZE,"SCOALA GIMNAZIALA CERTEZE",174,"Alegeri Prezidentiale",1,1453,322,299,23,0,320,2,1500,1178,209,111
32,"SATU MARE",CERTEZE,137407,CERTEZE,"SCOALA GIMNAZIALA CERTEZE",175,"Alegeri Prezidentiale",1,1375,322,297,25,0,321,1,1500,1178,205,116
32,"SATU MARE",CERTEZE,137407,HUTA-CERTEZE,"IMOBIL PROPRIETATE PRIVATA IDENTIFICAT PRIN CF NR 1722 NR TOP 1053/100 SITUATE IN COMUNA CERTEZE SAT HUTA CERTEZE NR 157 JUD SATU MARE",176,"Alegeri Prezidentiale",1,961,269,252,17,0,269,0,1000,731,212,57
32,"SATU MARE",CERTEZE,137407,MOIŞENI,"GRĂDINIŢA CU PROGRAM NORMAL MOIŞENI",177,"Alegeri Prezidentiale",1,1142,263,238,25,0,262,1,1200,937,162,100
32,"SATU MARE",CIUMEŞTI,179882,CIUMEŞTI,"CĂMINUL CULTURAL",178,"Alegeri Prezidentiale",1,1124,265,236,29,0,259,6,1200,935,210,49
32,"SATU MARE",CRAIDOROLŢ,137443,CRAIDOROLŢ,"PRIMARIA CRAIDOROLT",179,"Alegeri Prezidentiale",1,851,314,275,39,0,310,4,900,586,178,132
32,"SATU MARE",CRAIDOROLŢ,137443,CRIŞENI,"ŞCOALA PRIMARĂ CRIŞENI",180,"Alegeri Prezidentiale",1,148,92,64,28,0,90,2,200,108,56,34
32,"SATU MARE",CRAIDOROLŢ,137443,ERIU-SÂNCRAI,"ŞCOALA PRIMARĂ ERIU SÂNCRAI",181,"Alegeri Prezidentiale",1,491,183,169,14,0,179,4,600,417,124,55
32,"SATU MARE",CRAIDOROLŢ,137443,"SATU MIC","ŞCOALA PRIMARĂ SATU MIC",182,"Alegeri Prezidentiale",1,167,89,72,17,0,89,0,200,111,34,55
32,"SATU MARE",CRUCIŞOR,137504,CRUCIŞOR,"SCOALA CU CLASELE I-IV CRUCISOR",183,"Alegeri Prezidentiale",1,469,306,247,47,12,304,2,500,194,192,112
32,"SATU MARE",CRUCIŞOR,137504,IEGHERIŞTE,"SCOALA CU CLS. I-IV IEGHERISTE",184,"Alegeri Prezidentiale",1,428,236,207,26,3,235,1,500,264,154,81
32,"SATU MARE",CRUCIŞOR,137504,"POIANA CODRULUI","SCOALA GIMNAZIALA POIANA CODRULUI",185,"Alegeri Prezidentiale",1,1224,707,648,49,10,695,12,1300,593,372,323
32,"SATU MARE",CULCIU,137540,"CULCIU MARE","SEDIUL CONSILIULUI LOCAL AL COMUNEI CULCIU",186,"Alegeri Prezidentiale",1,677,277,240,37,0,273,4,700,423,192,81
32,"SATU MARE",CULCIU,137540,APATEU,"GRADINIŢA APATEU",187,"Alegeri Prezidentiale",1,274,108,89,19,0,107,1,300,192,66,41
32,"SATU MARE",CULCIU,137540,CĂRĂŞEU,"ŞCOALA DE GIMNAZIALĂ BEM JOZSEF CĂRĂŞEU",188,"Alegeri Prezidentiale",1,937,223,208,15,0,214,9,1000,777,164,50
32,"SATU MARE",CULCIU,137540,COROD,"GRADINIŢA COROD",189,"Alegeri Prezidentiale",1,408,148,132,16,0,137,11,408,260,98,39
32,"SATU MARE",CULCIU,137540,"CULCIU MIC","ŞCOALA PRIMARĂ CULCIU-MIC",190,"Alegeri Prezidentiale",1,586,143,119,24,0,135,8,600,457,101,34
32,"SATU MARE",CULCIU,137540,LIPĂU,"ŞCOALA PRIMARĂ LIPĂU",191,"Alegeri Prezidentiale",1,456,208,168,40,0,204,4,500,292,145,59
32,"SATU MARE",DOBA,137611,DOBA,"PRIMARIA COMUNEI DOBA",192,"Alegeri Prezidentiale",1,989,331,301,30,0,329,2,1100,769,252,77
32,"SATU MARE",DOBA,137611,BOGHIŞ,"ŞCOALA GENERALĂ BOGHIŞ",193,"Alegeri Prezidentiale",1,690,184,166,18,0,184,0,800,616,159,25
32,"SATU MARE",DOBA,137611,DACIA,"CĂMIN CULTURAL DACIA",194,"Alegeri Prezidentiale",1,132,95,68,27,0,95,0,200,105,56,39
32,"SATU MARE",DOBA,137611,PAULIAN,"CAMINUL CULTURAL",195,"Alegeri Prezidentiale",1,410,216,181,34,1,213,3,500,284,133,80
32,"SATU MARE",DOBA,137611,TRAIAN,"CĂMIN CULTURAL TRAIAN",196,"Alegeri Prezidentiale",1,172,87,62,25,0,85,2,200,113,45,40
32,"SATU MARE",DOROLŢ,137675,DOROLŢ,"PRIMARIA COMUNEI DOROLT",197,"Alegeri Prezidentiale",1,1458,360,324,36,0,351,9,1500,1140,283,68
32,"SATU MARE",DOROLŢ,137675,ATEA,"CAMIN CULTURAL ATEA",198,"Alegeri Prezidentiale",1,314,108,98,10,0,106,2,400,292,99,7
32,"SATU MARE",DOROLŢ,137675,DARA,"SCOALA DARA",199,"Alegeri Prezidentiale",1,1014,129,120,9,0,125,4,1100,971,100,25
32,"SATU MARE",DOROLŢ,137675,PETEA,"CAMIN CULTURAL PETEA",200,"Alegeri Prezidentiale",1,335,129,90,39,0,126,3,390,261,105,21
32,"SATU MARE",FOIENI,137728,FOIENI,"CONSILIUL LOCAL FOIENI",201,"Alegeri Prezidentiale",1,1620,369,353,16,0,359,10,1692,1323,307,52
32,"SATU MARE","GHERŢA MICĂ",137746,"GHERŢA MICĂ","PRIMARIA COMUNEI",202,"Alegeri Prezidentiale",1,1543,402,383,19,0,401,1,1600,1198,272,129
32,"SATU MARE","GHERŢA MICĂ",137746,"GHERŢA MICĂ","SCOALA GIMNAZIALA",203,"Alegeri Prezidentiale",1,1251,351,342,9,0,345,6,1300,949,229,116
32,"SATU MARE",HALMEU,137764,HALMEU,"ŞCOALA CU CLS.I-VIII HALMEU",204,"Alegeri Prezidentiale",1,1689,513,476,37,0,497,16,1800,1287,335,162
32,"SATU MARE",HALMEU,137764,HALMEU,"ŞCOALA CU CLS.I-VIII HALMEU",205,"Alegeri Prezidentiale",1,1356,386,363,23,0,379,7,1400,1014,271,108
32,"SATU MARE",HALMEU,137764,BĂBEŞTI,"GRĂDINIŢA BĂBEŞTI",206,"Alegeri Prezidentiale",1,334,76,57,19,0,73,3,410,334,59,14
32,"SATU MARE",HALMEU,137764,DOBOLŢ,"GRĂDINIŢA DABOLŢ",207,"Alegeri Prezidentiale",1,349,88,77,11,0,85,3,390,302,72,13
32,"SATU MARE",HALMEU,137764,MESTEACĂN,"GRĂDINIŢA MESTEACĂN",208,"Alegeri Prezidentiale",1,369,100,92,8,0,99,1,400,300,69,30
32,"SATU MARE",HODOD,137844,HODOD,"SEDIUL PRIMARIEI COMUNEI HODOD",209,"Alegeri Prezidentiale",1,701,184,160,24,0,179,5,800,616,144,35
32,"SATU MARE",HODOD,137844,"GIURTELECU HODODULUI","SCOALA GIMNAZIALA GIURTELECU HODODULUI",210,"Alegeri Prezidentiale",1,467,188,150,38,0,187,1,500,312,111,76
32,"SATU MARE",HODOD,137844,LELEI,"SCOALA PRIMARA LELEI",211,"Alegeri Prezidentiale",1,455,95,75,20,0,94,1,500,405,64,30
32,"SATU MARE",HODOD,137844,"NADIŞU HODODULUI","CENTRU SOCIAL NADISU HODODULUI",212,"Alegeri Prezidentiale",1,638,161,148,13,0,156,5,700,539,118,38
32,"SATU MARE",HOMOROADE,137899,"HOMORODU DE MIJLOC","SCOALA CLS. I-VIII HOMORODU DE MIJLOC",213,"Alegeri Prezidentiale",1,544,287,239,48,0,285,2,625,338,183,102
32,"SATU MARE",HOMOROADE,137899,CHILIA,"SCOALA CHILIA",214,"Alegeri Prezidentiale",1,179,118,83,35,0,116,2,200,82,72,44
32,"SATU MARE",HOMOROADE,137899,"HOMORODU DE JOS","SCOALA CLS I-IV HOMORODU DE JOS",215,"Alegeri Prezidentiale",1,292,128,110,18,0,126,2,401,273,91,35
32,"SATU MARE",HOMOROADE,137899,NECOPOI,"SCOALA NECOPOI",216,"Alegeri Prezidentiale",1,171,89,65,24,0,88,1,200,111,55,33
32,"SATU MARE",HOMOROADE,137899,SOLDUBA,"SCOALA SOLDUBA",217,"Alegeri Prezidentiale",1,203,114,85,29,0,111,3,299,185,70,41
32,"SATU MARE",LAZURI,137960,LAZURI,"CAMIN CULTURAL NOU",218,"Alegeri Prezidentiale",1,1325,452,402,49,1,443,9,1400,948,365,78
32,"SATU MARE",LAZURI,137960,BERCU,"SCOALA CU CLASELE I-IV BERCU",219,"Alegeri Prezidentiale",1,520,114,103,11,0,110,4,600,486,94,16
32,"SATU MARE",LAZURI,137960,NISIPENI,"SCOALA CU CLASELE I-VIII NISIPENI",220,"Alegeri Prezidentiale",1,725,126,115,11,0,125,1,800,674,95,30
32,"SATU MARE",LAZURI,137960,NOROIENI,"SCOALA CU CLASELE I-IV NOROIENI",221,"Alegeri Prezidentiale",1,328,103,92,11,0,103,0,399,296,87,16
32,"SATU MARE",LAZURI,137960,PELEŞ,"SCOALA CU CLASELE I-VIII PELES",222,"Alegeri Prezidentiale",1,745,141,128,13,0,139,2,800,659,110,29
32,"SATU MARE",LAZURI,137960,PELIŞOR,"SCOALA CU CLASELE I-IV PELISOR",223,"Alegeri Prezidentiale",1,233,65,52,13,0,64,1,300,235,52,12
32,"SATU MARE",LAZURI,137960,LAZURI,"ȘCOALA GIMNAZIALĂ ”PETŐFI SÁNDOR” LAZURI",224,"Alegeri Prezidentiale",1,1158,388,364,24,0,380,8,1200,812,304,76
32,"SATU MARE","MEDIEŞU AURIT",138084,"MEDIEŞU AURIT","PRIMARIA MEDIESU AURIT",225,"Alegeri Prezidentiale",1,881,453,407,46,0,450,3,1000,547,302,148
32,"SATU MARE","MEDIEŞU AURIT",138084,"MEDIEŞU AURIT","SCOALA MEDIESU AURIT",226,"Alegeri Prezidentiale",1,1284,556,503,53,0,553,3,1400,844,340,213
32,"SATU MARE","MEDIEŞU AURIT",138084,IOJIB,"SCOALA GENERALA",227,"Alegeri Prezidentiale",1,946,287,263,24,0,286,1,975,688,247,39
32,"SATU MARE","MEDIEŞU AURIT",138084,POTĂU,"SCOALA GENERALA",228,"Alegeri Prezidentiale",1,824,329,303,26,0,328,1,900,571,267,61
32,"SATU MARE","MEDIEŞU AURIT",138084,ROMÂNEŞTI,"SCOALA GENERALA",229,"Alegeri Prezidentiale",1,647,245,231,13,1,237,8,700,455,146,91
32,"SATU MARE","MEDIEŞU AURIT",138084,BĂBĂŞEŞTI,GRADINITA,230,"Alegeri Prezidentiale",1,531,294,227,67,0,290,4,600,306,192,98
32,"SATU MARE","MEDIEŞU AURIT",138084,MEDIEŞ-RÂTURI,"SCOALA GENERALA",231,"Alegeri Prezidentiale",1,243,121,104,17,0,121,0,300,179,90,31
32,"SATU MARE","MEDIEŞU AURIT",138084,MEDIEŞ-VII,"SCOALA GENERALA",232,"Alegeri Prezidentiale",1,157,78,52,26,0,77,1,200,122,58,19
32,"SATU MARE",MICULA,138164,MICULA,"CENTRU CULTURAL TURISTIC",233,"Alegeri Prezidentiale",1,1151,331,295,36,0,327,4,1200,869,252,75
32,"SATU MARE",MICULA,138164,MICULA,"GRADINITA NR. II MICULA",234,"Alegeri Prezidentiale",1,1425,404,367,37,0,394,10,1500,1096,300,94
32,"SATU MARE",MICULA,138164,"MICULA NOUĂ","CASĂ DE LOCUIT MICULA NOUA",235,"Alegeri Prezidentiale",1,606,194,172,22,0,189,5,700,506,117,72
32,"SATU MARE",MOFTIN,138208,"MOFTINU MARE","SCOALA GENERALA",236,"Alegeri Prezidentiale",1,1168,393,339,54,0,390,3,1200,807,335,55
32,"SATU MARE",MOFTIN,138208,"MOFTINU MIC","CAMINUL CULTURAL",237,"Alegeri Prezidentiale",1,1036,436,400,36,0,430,6,1100,664,269,161
32,"SATU MARE",MOFTIN,138208,DOMĂNEŞTI,"SCOALA GENERALA CL I-VIIII",238,"Alegeri Prezidentiale",1,899,380,361,19,0,378,2,1000,620,236,142
32,"SATU MARE",MOFTIN,138208,SÂNMICLĂUŞ,"GRADINITA DE COPII",239,"Alegeri Prezidentiale",1,444,191,165,26,0,189,2,500,309,93,96
32,"SATU MARE",ODOREU,138280,ODOREU,"CĂMINUL CULTURAL ODOREU",240,"Alegeri Prezidentiale",1,1400,548,520,28,0,541,7,1500,952,440,101
32,"SATU MARE",ODOREU,138280,ODOREU,"SCOALA GIMNAZIALA ODOREU",241,"Alegeri Prezidentiale",1,1315,490,465,25,0,485,5,1400,910,359,126
32,"SATU MARE",ODOREU,138280,ODOREU,"SCOALA GIMNAZIALA ODOREU",242,"Alegeri Prezidentiale",1,1320,543,519,24,0,536,7,1400,857,440,96
32,"SATU MARE",ODOREU,138280,BERINDAN,"CASA DE TIP FAMILIAL” IRIS”",243,"Alegeri Prezidentiale",1,102,59,36,23,0,59,0,200,141,46,13
32,"SATU MARE",ODOREU,138280,MĂRTINEŞTI,"AFTER SCHOOL, MARTINESTI NR. 51",244,"Alegeri Prezidentiale",1,722,422,352,70,0,418,4,800,378,338,80
32,"SATU MARE","ORAŞU NOU",138351,"ORAŞU NOU","SCOALA GIMNAZIALA ORASU NOU SALA DE CLASĂ 1",245,"Alegeri Prezidentiale",1,722,247,231,16,0,240,7,800,553,208,32
32,"SATU MARE","ORAŞU NOU",138351,"ORAŞU NOU","SCOALA GIMNAZIALA ORASU NOU SALA DE CLASĂ 2",246,"Alegeri Prezidentiale",1,879,310,294,16,0,307,3,1000,690,276,31
32,"SATU MARE","ORAŞU NOU",138351,"ORAŞU NOU-VII","GRĂDINIȚĂ CU PROGRAM NORMAL",247,"Alegeri Prezidentiale",1,332,141,115,26,0,140,1,400,259,96,44
32,"SATU MARE","ORAŞU NOU",138351,PRILOG,"GRĂDINIȚĂ CU PROGRAM NORMAL",248,"Alegeri Prezidentiale",1,502,189,170,19,0,188,1,600,411,153,35
32,"SATU MARE","ORAŞU NOU",138351,PRILOG-VII,"IMOBIL, CASA DE LOCUIT",249,"Alegeri Prezidentiale",1,135,66,49,15,2,63,3,200,134,36,27
32,"SATU MARE","ORAŞU NOU",138351,PRILOG-VII,"CLĂDIREA SCOLII",250,"Alegeri Prezidentiale",1,105,63,38,25,0,63,0,152,89,49,14
32,"SATU MARE","ORAŞU NOU",138351,"REMETEA OAŞULUI","SCOALĂ PRIMARĂ REMETEA OAȘ",251,"Alegeri Prezidentiale",1,435,123,109,14,0,122,1,500,377,92,30
32,"SATU MARE",PĂULEŞTI,138431,PĂULEŞTI,"ȘCOALA GIMNAZIALĂ PĂULEȘTI",252,"Alegeri Prezidentiale",1,1479,785,720,65,0,776,9,1500,715,587,189
32,"SATU MARE",PĂULEŞTI,138431,AMAŢI,"ŞCOALA GENERALĂ AMAŢI",253,"Alegeri Prezidentiale",1,898,353,329,24,0,346,7,1008,655,273,73
32,"SATU MARE",PĂULEŞTI,138431,AMBUD,"GRĂDINIȚA CU PROGRAM NORMAL AMBUD",254,"Alegeri Prezidentiale",1,953,307,294,13,0,294,13,1000,693,248,46
32,"SATU MARE",PĂULEŞTI,138431,HRIP,"ŞCOALA GENERALĂ HRIP",255,"Alegeri Prezidentiale",1,546,207,178,29,0,202,5,600,393,154,48
32,"SATU MARE",PĂULEŞTI,138431,PETIN,"ŞCOALA GENERALĂ PETIN",256,"Alegeri Prezidentiale",1,619,193,184,9,0,192,1,700,507,155,37
32,"SATU MARE",PĂULEŞTI,138431,RUŞENI,"ŞCOALA GENERALĂ RUŞENI",257,"Alegeri Prezidentiale",1,192,124,78,46,0,122,2,300,176,70,52
32,"SATU MARE",PETREŞTI,138501,PETREŞTI,"ŞCOALA GIMNAZIALĂ DR. STEFAN VONHÁZ",258,"Alegeri Prezidentiale",1,1323,262,239,23,0,256,6,1408,1146,225,31
32,"SATU MARE",PETREŞTI,138501,"DINDEŞTIU MIC","SCOALA GIMNAZIALA DR. STEFAN VONHAZ PETRESTI",259,"Alegeri Prezidentiale",1,328,73,56,17,0,72,1,400,327,59,13
32,"SATU MARE",PIR,138538,PIR,"SCOALA CU CLS. I-VIII PIR",260,"Alegeri Prezidentiale",1,1140,275,254,21,0,265,10,1200,925,149,116
32,"SATU MARE",PIR,138538,SĂRVĂZEL,"SCOALA PRIMARA",261,"Alegeri Prezidentiale",1,104,41,27,14,0,41,0,200,159,17,24
32,"SATU MARE",PIŞCOLT,138574,PIŞCOLT,"PRIMARIA COMUNEI PISCOLT",262,"Alegeri Prezidentiale",1,901,331,316,15,0,328,3,1000,669,239,89
32,"SATU MARE",PIŞCOLT,138574,PIŞCOLT,"PRIMARIA COMUNEI PISCOLT",263,"Alegeri Prezidentiale",1,883,239,224,15,0,234,5,1000,761,149,85
32,"SATU MARE",PIŞCOLT,138574,RESIGHEA,"ȘCOALA GIMNAZIALĂ PIȘCOLT",264,"Alegeri Prezidentiale",1,349,168,147,21,0,166,2,400,232,120,46
32,"SATU MARE",PIŞCOLT,138574,"SCĂRIŞOARA NOUĂ","ȘCOALA GIMNAZIALĂ PIȘCOLT",265,"Alegeri Prezidentiale",1,321,176,131,45,0,173,3,400,224,102,71
32,"SATU MARE",POMI,138618,ACIUA,"CAMIN CULTURAL",266,"Alegeri Prezidentiale",1,58,97,29,68,0,93,4,110,13,51,42
32,"SATU MARE",POMI,138618,BICĂU,"CAMIN CULTURAL",267,"Alegeri Prezidentiale",1,104,87,55,32,0,84,3,200,113,37,47
32,"SATU MARE",POMI,138618,BORLEŞTI,"SCOALA GENERALA",268,"Alegeri Prezidentiale",1,616,325,225,100,0,320,5,690,365,211,109
32,"SATU MARE",POMI,138618,POMI,"PRIMARIA POMI",269,"Alegeri Prezidentiale",1,736,420,346,73,1,416,4,792,372,282,134
32,"SATU MARE",PORUMBEŞTI,180028,PORUMBEŞTI,"ŞCOALA GIMNAZIALĂ PORUMBEŞTI",270,"Alegeri Prezidentiale",1,1209,274,259,15,0,268,6,1300,1026,220,48
32,"SATU MARE",PORUMBEŞTI,180028,CIDREAG,"ŞCOALA GIMNAZIALĂ CIDREAG",271,"Alegeri Prezidentiale",1,848,202,190,12,0,198,4,901,699,134,64
32,"SATU MARE",RACŞA,180091,RACŞA,"ȘCOALA GENERALĂ",272,"Alegeri Prezidentiale",1,1150,457,387,30,40,455,2,1200,743,145,310
32,"SATU MARE",RACŞA,180091,RACŞA,"ȘCOALA GIMNAZIALĂ",273,"Alegeri Prezidentiale",1,1074,408,344,34,30,405,3,1200,792,150,255
32,"SATU MARE",RACŞA,180091,RACŞA-VII,"ŞCOALA PRIMARĂ",274,"Alegeri Prezidentiale",1,222,127,107,19,1,127,0,299,172,82,45
32,"SATU MARE",SANISLĂU,138663,SANISLĂU,"GRĂDINIŢA SANISLĂU",275,"Alegeri Prezidentiale",1,1361,340,308,31,1,338,2,1500,1160,272,66
32,"SATU MARE",SANISLĂU,138663,SANISLĂU,"ŞCOALA CU CL. I-VIII GH. BULGĂR-SANISLĂU",276,"Alegeri Prezidentiale",1,1243,362,340,22,0,354,8,1299,937,218,136
32,"SATU MARE",SANISLĂU,138663,HOREA,"CĂMIN CULTURAL SAT HOREA",277,"Alegeri Prezidentiale",1,120,85,52,33,0,85,0,202,117,54,31
32,"SATU MARE",SANISLĂU,138663,"MARNA NOUĂ","CĂMIN CULTURAL SAT MARNA NOUĂ",278,"Alegeri Prezidentiale",1,287,171,141,30,0,166,5,399,228,95,71
32,"SATU MARE",SANTĂU,138734,SANTĂU,"SCOALA GIMNAZIALA SANTAU",279,"Alegeri Prezidentiale",1,1400,593,544,45,4,591,2,1500,907,519,72
32,"SATU MARE",SANTĂU,138734,CHEREUŞA,"SC. PRIM. CHEREUŞA",280,"Alegeri Prezidentiale",1,470,212,189,23,0,211,1,500,288,175,36
32,"SATU MARE",SANTĂU,138734,SUDURĂU,"GRĂDINIŢA SUDURĂU",281,"Alegeri Prezidentiale",1,142,72,58,14,0,72,0,200,128,59,13
32,"SATU MARE",SĂCĂŞENI,138770,SĂCĂŞENI,"PRIMARIA SACASENI",282,"Alegeri Prezidentiale",1,810,267,240,26,1,257,10,892,625,190,67
32,"SATU MARE",SĂCĂŞENI,138770,CHEGEA,"CAMIN CULTURAL CHEGEA",283,"Alegeri Prezidentiale",1,135,76,51,25,0,75,1,200,124,47,28
32,"SATU MARE",SĂUCA,138805,SĂUCA,"SCOALA CU CLASELE I-VIII SAUCA",284,"Alegeri Prezidentiale",1,324,144,127,17,0,140,4,399,255,85,55
32,"SATU MARE",SĂUCA,138805,BECHENI,"SCALA CU CLS.I-VIII BECHENI",285,"Alegeri Prezidentiale",1,413,152,145,7,0,141,11,500,348,100,41
32,"SATU MARE",SĂUCA,138805,CEAN,"SCOALA CU CLS.I-IV CEAN",286,"Alegeri Prezidentiale",1,222,114,86,28,0,111,3,300,186,69,42
32,"SATU MARE",SĂUCA,138805,SILVAŞ,"SCOALA SILVAS",287,"Alegeri Prezidentiale",1,127,74,60,14,0,72,2,200,126,50,22
32,"SATU MARE",SOCOND,138869,SOCOND,"SCOALA GIMNAZIALA SOCOND",288,"Alegeri Prezidentiale",1,516,213,193,20,0,209,4,600,387,159,50
32,"SATU MARE",SOCOND,138869,CUŢA,"CAMINUL CULTURAL CUTA",289,"Alegeri Prezidentiale",1,261,130,104,20,6,128,2,300,170,71,57
32,"SATU MARE",SOCOND,138869,SOCONZEL,"GRADINITA CU PROGRAM NORMAL",290,"Alegeri Prezidentiale",1,233,124,103,14,7,122,2,300,176,97,25
32,"SATU MARE",SOCOND,138869,HODIŞA,"CAMINUL CULTURAL HODISA",291,"Alegeri Prezidentiale",1,182,115,94,21,0,114,1,300,185,80,34
32,"SATU MARE",SOCOND,138869,STÂNA,"SCOALA GIMNAZIALA STANA",292,"Alegeri Prezidentiale",1,796,452,430,22,0,447,5,900,448,65,382
32,"SATU MARE",SUPUR,138921,"SUPURU DE JOS","PRIMARIA COMUNEI SUPUR",293,"Alegeri Prezidentiale",1,1016,494,429,65,0,491,3,1100,606,255,236
32,"SATU MARE",SUPUR,138921,DOBRA,"ȘCOALA GIMNAZIALĂ DOBRA",294,"Alegeri Prezidentiale",1,762,193,169,24,0,182,11,800,607,109,73
32,"SATU MARE",SUPUR,138921,GIOROCUTA,"ȘCOALA GIMNAZIALĂ GIOROCUTA",295,"Alegeri Prezidentiale",1,588,247,210,37,0,240,7,700,453,100,140
32,"SATU MARE",SUPUR,138921,"HUREZU MARE","ȘCOALA GIMNAZIALĂ ”MOISE SORA NOVAC” HUREZU MARE",296,"Alegeri Prezidentiale",1,278,163,118,45,0,161,2,400,237,87,74
32,"SATU MARE",SUPUR,138921,RACOVA,"GRĂDINIȚĂ CU PROGRAM NORMAL",297,"Alegeri Prezidentiale",1,154,91,69,22,0,91,0,200,109,67,24
32,"SATU MARE",SUPUR,138921,SECHEREŞA,"CĂMIN CULTURAL SECHEREȘA",298,"Alegeri Prezidentiale",1,52,32,20,12,0,32,0,100,68,24,8
32,"SATU MARE",SUPUR,138921,"SUPURU DE SUS","ȘCOALA PRIMARĂ ” IOAN GALU” SUPURU DE SUS",299,"Alegeri Prezidentiale",1,402,204,153,51,0,200,4,500,296,95,105
32,"SATU MARE","TARNA MARE",139009,"TARNA MARE","PRIMARIA TARNA MARE",300,"Alegeri Prezidentiale",1,1651,677,628,43,6,672,5,1700,1023,458,214
32,"SATU MARE","TARNA MARE",139009,BOCICĂU,"CĂMINUL CULTURAL BOCICĂU",301,"Alegeri Prezidentiale",1,481,212,193,16,3,210,2,600,388,145,65
32,"SATU MARE","TARNA MARE",139009,"VALEA SEACĂ","ȘCOALA GIMNAZIALĂ VALEA SEACĂ",302,"Alegeri Prezidentiale",1,956,299,276,19,4,298,1,1000,701,223,75
32,"SATU MARE",TÂRŞOLŢ,139143,TÂRŞOLŢ,"SCOALA GIMNAZIALA TARSOLT",303,"Alegeri Prezidentiale",1,1314,278,264,14,0,276,2,1400,1122,244,32
32,"SATU MARE",TÂRŞOLŢ,139143,TÂRŞOLŢ,"SCOALA GIMNAZIALA TARSOLT",304,"Alegeri Prezidentiale",1,815,148,140,8,0,148,0,900,752,137,11
32,"SATU MARE",TÂRŞOLŢ,139143,ALICENI,"SCOALA GIMNAZIALA ALICENI",305,"Alegeri Prezidentiale",1,343,91,79,12,0,91,0,400,309,83,8
32,"SATU MARE",TEREBEŞTI,139054,TEREBEŞTI,"PRIMARIA TEREBESTI",306,"Alegeri Prezidentiale",1,629,234,205,27,2,233,1,700,466,174,59
32,"SATU MARE",TEREBEŞTI,139054,GELU,"CENTRU DE ZI INGRIJIRE BATRANI",307,"Alegeri Prezidentiale",1,427,255,225,30,0,251,4,500,245,162,89
32,"SATU MARE",TEREBEŞTI,139054,PIŞCARI,"SCOALA PRIMARA PISCARI",308,"Alegeri Prezidentiale",1,381,193,164,27,2,188,5,500,307,92,96
32,"SATU MARE",TIREAM,139107,PORTIŢA,"GRADINITA CU PROGRAM NORMAL",309,"Alegeri Prezidentiale",1,146,82,58,24,0,82,0,200,118,43,39
32,"SATU MARE",TIREAM,139107,TIREAM,"PRIMARIA COMUNEI TIREAM",310,"Alegeri Prezidentiale",1,1394,313,292,21,0,312,1,1500,1187,253,59
32,"SATU MARE",TIREAM,139107,VEZENDIU,"SCOALA PRIMARA VEZENDIU",311,"Alegeri Prezidentiale",1,367,149,115,34,0,145,4,400,251,96,49
32,"SATU MARE",TURŢ,139170,TURŢ,"LICEUL TEHNOLOGIC ANGHEL SALIGNY TURT, CORPUL A",312,"Alegeri Prezidentiale",1,1479,460,444,16,0,453,7,1600,1140,286,167
32,"SATU MARE",TURŢ,139170,TURŢ,"LICEUL TEHNOLOGIC ANGHEL SALIGNY TURT, CORPUL B",313,"Alegeri Prezidentiale",1,1275,410,391,19,0,404,6,1600,1190,308,96
32,"SATU MARE",TURŢ,139170,TURŢ,"SCOALA CU CLASELE I-VIII NR. 2",314,"Alegeri Prezidentiale",1,1404,458,442,16,0,454,4,1500,1042,338,116
32,"SATU MARE",TURŢ,139170,TURŢ,"GRADINITA CU PROGRAM NORMAL SUSANI",315,"Alegeri Prezidentiale",1,916,267,257,10,0,264,3,992,725,173,91
32,"SATU MARE",TURŢ,139170,"GHERŢA MARE","ȘCOALA GIMNAZIALĂ GHERȚA MARE, CORP A",316,"Alegeri Prezidentiale",1,1353,425,409,16,0,424,1,1400,975,312,112
32,"SATU MARE",TURULUNG,139214,TURULUNG,PRIMĂRIA,317,"Alegeri Prezidentiale",1,902,168,149,19,0,166,2,1000,832,156,10
32,"SATU MARE",TURULUNG,139214,TURULUNG,"SCOALA GIMNAZIALA TURULUNG",318,"Alegeri Prezidentiale",1,1214,290,277,13,0,281,9,1300,1010,187,94
32,"SATU MARE",TURULUNG,139214,DRĂGUŞENI,"SCOALA GIMNAZIALA DRAGUSENI",319,"Alegeri Prezidentiale",1,1120,343,302,26,15,342,1,1200,857,197,145
32,"SATU MARE",TURULUNG,139214,TURULUNG-VII,GRADINITA,320,"Alegeri Prezidentiale",1,166,63,48,15,0,60,3,200,137,50,10
32,"SATU MARE",URZICENI,139250,URZICENI,"CAMIN CULTURAL URZICENI",321,"Alegeri Prezidentiale",1,1091,309,273,36,0,303,6,1200,891,283,20
32,"SATU MARE",URZICENI,139250,URZICENI-PĂDURE,"CĂMIN CULTURAL URZICENI PĂDURE",322,"Alegeri Prezidentiale",1,153,52,44,8,0,50,2,200,148,32,18
32,"SATU MARE","VALEA VINULUI",139287,"VALEA VINULUI","PRIMARIA COMUNIE VALEA VINULUI",323,"Alegeri Prezidentiale",1,644,344,298,37,9,342,2,700,356,210,132
32,"SATU MARE","VALEA VINULUI",139287,"VALEA VINULUI","SCOALA CU CLASELE I-IV MARIUS",324,"Alegeri Prezidentiale",1,193,135,95,35,5,135,0,370,235,82,53
32,"SATU MARE","VALEA VINULUI",139287,"VALEA VINULUI","SCOALA CU CLASELE I-IV ROSIORI",325,"Alegeri Prezidentiale",1,336,195,154,37,4,195,0,403,208,129,66
32,"SATU MARE","VALEA VINULUI",139287,"VALEA VINULUI","SCOALA CU CLASELE I-IV SII",326,"Alegeri Prezidentiale",1,438,195,157,36,2,191,4,499,304,102,89
32,"SATU MARE",VAMA,139330,VAMA,"GRADINITA CU PROGRAM NORMAL VAMA",327,"Alegeri Prezidentiale",1,1743,561,525,36,0,554,7,1800,1239,443,111
32,"SATU MARE",VAMA,139330,VAMA,"SCOALA GIMNAZIALA VAMA",328,"Alegeri Prezidentiale",1,1586,479,451,28,0,475,4,1700,1221,416,59
32,"SATU MARE",VETIŞ,139358,VETIŞ,"CAMINUL CULTURAL VETIS",329,"Alegeri Prezidentiale",1,1955,705,646,59,0,701,4,2000,1295,594,107
32,"SATU MARE",VETIŞ,139358,DECEBAL,"CAMINUL CULTURAL DIN DECEBAL",330,"Alegeri Prezidentiale",1,1114,510,464,46,0,504,6,1200,690,346,158
32,"SATU MARE",VETIŞ,139358,OAR,"CĂMINUL CULTURAL OAR",331,"Alegeri Prezidentiale",1,1340,311,288,23,0,309,2,1400,1089,278,31
32,"SATU MARE","VIILE SATU MARE",139394,"VIILE SATU MARE","PRIMĂRIA VIILE SATU MARE",332,"Alegeri Prezidentiale",1,903,347,295,51,1,343,4,1000,653,278,65
32,"SATU MARE","VIILE SATU MARE",139394,"VIILE SATU MARE","ŞCOALA PRIMARĂ DEALU MARE",333,"Alegeri Prezidentiale",1,521,222,191,31,0,219,3,600,378,142,77
32,"SATU MARE","VIILE SATU MARE",139394,CIONCHEŞTI,"GRADINITA CIONCHEŞTI",334,"Alegeri Prezidentiale",1,245,162,126,36,0,162,0,300,138,131,31
32,"SATU MARE","VIILE SATU MARE",139394,MEDIŞA,"ŞCOALA PRIMARĂ MEDIŞA",335,"Alegeri Prezidentiale",1,176,86,58,28,0,83,3,200,114,44,39
32,"SATU MARE","VIILE SATU MARE",139394,TĂTĂREŞTI,"ŞCOALA PRIMARĂ TĂTĂREŞTI",336,"Alegeri Prezidentiale",1,537,273,205,65,3,269,4,600,327,182,87
32,"SATU MARE","VIILE SATU MARE",139394,"VIILE SATU MARE","ȘCOALA LIPA",337,"Alegeri Prezidentiale",1,622,260,213,47,0,256,4,700,440,224,32
33,SĂLAJ,"MUNICIPIUL ZALĂU",139704,ZALĂU,"COLEGIUL NAŢIONAL ”SILVANIA”",1,"Alegeri Prezidentiale",1,1852,933,873,60,0,919,14,1900,967,669,250
33,SĂLAJ,"MUNICIPIUL ZALĂU",139704,ZALĂU,"CASA MUNICIPALĂ DE CULTURĂ",2,"Alegeri Prezidentiale",1,1830,889,817,71,1,872,17,1900,1011,678,194
33,SĂLAJ,"MUNICIPIUL ZALĂU",139704,ZALĂU,"GRĂDINIŢA CU PROGRAM PRELUNGIT NR. 1",3,"Alegeri Prezidentiale",1,1592,722,687,34,1,707,15,1600,878,488,219
33,SĂLAJ,"MUNICIPIUL ZALĂU",139704,ZALĂU,"PRIMĂRIA MUNICIPIULUI ZALĂU",4,"Alegeri Prezidentiale",1,1242,587,553,34,0,578,9,1300,713,450,128
33,SĂLAJ,"MUNICIPIUL ZALĂU",139704,ZALĂU,"STADIONUL MUNICIPAL SEDIUL CLUBULUI SPORTIV MUNICIPAL",5,"Alegeri Prezidentiale",1,1204,571,520,51,0,568,3,1300,729,425,143
33,SĂLAJ,"MUNICIPIUL ZALĂU",139704,ZALĂU,"LICEUL CU PROGRAM SPORTIV ”AVRAM IANCU”",6,"Alegeri Prezidentiale",1,1878,968,925,43,0,944,24,1900,932,737,207
33,SĂLAJ,"MUNICIPIUL ZALĂU",139704,ZALĂU,"LICEUL CU PROGRAM SPORTIV ”AVRAM IANCU”",7,"Alegeri Prezidentiale",1,1556,735,655,43,37,725,10,1600,865,552,173
33,SĂLAJ,"MUNICIPIUL ZALĂU",139704,ZALĂU,"LICEUL CU PROGRAM SPORTIV ”AVRAM IANCU”",8,"Alegeri Prezidentiale",1,1735,844,776,68,0,831,13,1800,956,623,208
33,SĂLAJ,"MUNICIPIUL ZALĂU",139704,ZALĂU,"DIRECŢIA DE SĂNĂTATE PUBLICĂ SĂLAJ",9,"Alegeri Prezidentiale",1,1054,566,524,42,0,559,7,1100,534,373,186
33,SĂLAJ,"MUNICIPIUL ZALĂU",139704,ZALĂU,"CLĂDIREA TRANSILVANIA",10,"Alegeri Prezidentiale",1,1276,659,624,35,0,646,13,1300,641,464,182
33,SĂLAJ,"MUNICIPIUL ZALĂU",139704,ZALĂU,"ȘCOALA GIMNAZIALĂ ”SIMION BĂRNUȚIU”",11,"Alegeri Prezidentiale",1,1521,742,685,56,1,722,20,1600,858,501,221
33,SĂLAJ,"MUNICIPIUL ZALĂU",139704,ZALĂU,"ŞCOALA GIMNAZIALĂ ”GHEORGHE LAZĂR”",12,"Alegeri Prezidentiale",1,1754,810,755,54,1,793,17,1800,990,559,234
33,SĂLAJ,"MUNICIPIUL ZALĂU",139704,ZALĂU,"LICEUL TEHNOLOGIC ”MIHAI VITEAZU”",13,"Alegeri Prezidentiale",1,965,472,427,41,4,465,7,1100,628,315,150
33,SĂLAJ,"MUNICIPIUL ZALĂU",139704,ZALĂU,"LICEUL TEHNOLOGIC ”MIHAI VITEAZU”",14,"Alegeri Prezidentiale",1,1258,583,541,42,0,581,2,1300,717,409,172
33,SĂLAJ,"MUNICIPIUL ZALĂU",139704,ZALĂU,"ŞCOALA GIMNAZIALĂ ”POROLISSUM”",15,"Alegeri Prezidentiale",1,1735,861,776,58,27,845,16,1800,939,594,251
33,SĂLAJ,"MUNICIPIUL ZALĂU",139704,ZALĂU,"ŞCOALA GIMNAZIALĂ ”POROLISSUM”",16,"Alegeri Prezidentiale",1,1755,817,778,38,1,797,20,1800,983,580,217
33,SĂLAJ,"MUNICIPIUL ZALĂU",139704,ZALĂU,"ŞCOALA GIMNAZIALĂ ”IULIU MANIU”",17,"Alegeri Prezidentiale",1,1744,825,720,97,8,805,20,1800,975,561,244
33,SĂLAJ,"MUNICIPIUL ZALĂU",139704,ZALĂU,"GRĂDINIŢA CU PROGRAM PRELUNGIT ”VOINICEL”",18,"Alegeri Prezidentiale",1,990,454,425,29,0,451,3,1100,646,321,130
33,SĂLAJ,"MUNICIPIUL ZALĂU",139704,ZALĂU,"GRĂDINIŢA CU PROGRAM PRELUNGIT ”VOINICEL”",19,"Alegeri Prezidentiale",1,1150,493,471,22,0,485,8,1200,707,345,140
33,SĂLAJ,"MUNICIPIUL ZALĂU",139704,ZALĂU,"SALA SPORTURILOR",20,"Alegeri Prezidentiale",1,1744,809,710,99,0,799,10,1800,991,582,217
33,SĂLAJ,"MUNICIPIUL ZALĂU",139704,ZALĂU,"SALA SPORTURILOR",21,"Alegeri Prezidentiale",1,1645,748,692,56,0,739,9,1700,952,572,167
33,SĂLAJ,"MUNICIPIUL ZALĂU",139704,ZALĂU,"ȘCOALA GIMNAZIALĂ ”CORNELIU COPOSU”",22,"Alegeri Prezidentiale",1,1298,572,546,26,0,565,7,1400,828,407,158
33,SĂLAJ,"MUNICIPIUL ZALĂU",139704,ZALĂU,"ŞCOALA GIMNAZIALĂ ”CORNELIU COPOSU”",23,"Alegeri Prezidentiale",1,1590,787,705,82,0,774,13,1600,813,595,179
33,SĂLAJ,"MUNICIPIUL ZALĂU",139704,ZALĂU,"ŞCOALA GIMNAZIALĂ ”CORNELIU COPOSU”",24,"Alegeri Prezidentiale",1,1455,650,623,27,0,648,2,1500,850,507,141
33,SĂLAJ,"MUNICIPIUL ZALĂU",139704,ZALĂU,"ŞCOALA GIMNAZIALĂ ”CORNELIU COPOSU”",25,"Alegeri Prezidentiale",1,1191,639,597,42,0,634,5,1200,561,495,139
33,SĂLAJ,"MUNICIPIUL ZALĂU",139704,ZALĂU,"LICEUL TEHNOLOGIC ”VOIEVOD GELU”",26,"Alegeri Prezidentiale",1,1497,761,710,51,0,756,5,1600,839,596,160
33,SĂLAJ,"MUNICIPIUL ZALĂU",139704,ZALĂU,"LICEUL TEHNOLOGIC ”VOIEVOD GELU”",27,"Alegeri Prezidentiale",1,1830,884,852,32,0,866,18,1900,1016,670,196
33,SĂLAJ,"MUNICIPIUL ZALĂU",139704,ZALĂU,"LICEUL TEHNOLOGIC ”VOIEVOD GELU”",28,"Alegeri Prezidentiale",1,1509,735,639,44,52,729,6,1600,865,534,195
33,SĂLAJ,"MUNICIPIUL ZALĂU",139704,ZALĂU,"GRĂDINIŢA CU PROGRAM PRELUNGIT ”LICURICI”",29,"Alegeri Prezidentiale",1,1865,884,764,65,55,878,6,2000,1116,660,218
33,SĂLAJ,"MUNICIPIUL ZALĂU",139704,ZALĂU,"LICEUL DE ARTĂ ”IOAN SIMA”",30,"Alegeri Prezidentiale",1,1658,804,763,41,0,797,7,1800,996,593,204
33,SĂLAJ,"MUNICIPIUL ZALĂU",139704,ZALĂU,"ŞCOALA POSTLICEALĂ SANITARĂ",31,"Alegeri Prezidentiale",1,1413,678,646,32,0,667,11,1500,822,466,201
33,SĂLAJ,"MUNICIPIUL ZALĂU",139704,ZALĂU,"GRĂDINIŢA CU PROGRAM PRELUNGIT ”PITICII ISTEȚI”",32,"Alegeri Prezidentiale",1,1581,798,746,52,0,787,11,1700,902,583,204
33,SĂLAJ,"MUNICIPIUL ZALĂU",139704,ZALĂU,"COLEGIUL TEHNIC ”ALESANDRU PAPIU ILARIAN”",33,"Alegeri Prezidentiale",1,1145,535,497,38,0,526,9,1300,765,344,182
33,SĂLAJ,"MUNICIPIUL ZALĂU",139704,ZALĂU,"COLEGIUL TEHNIC ”ALESANDRU PAPIU ILARIAN”",34,"Alegeri Prezidentiale",1,972,454,426,28,0,445,9,1100,646,276,169
33,SĂLAJ,"MUNICIPIUL ZALĂU",139704,ZALĂU,"LICEUL TEORETIC ”GHEORGHE ŞINCAI”",35,"Alegeri Prezidentiale",1,1444,775,721,54,0,766,9,1600,825,542,224
33,SĂLAJ,"MUNICIPIUL ZALĂU",139704,ZALĂU,"ŞCOALA GIMNAZIALĂ ”MIHAI EMINESCU”",36,"Alegeri Prezidentiale",1,1654,792,760,30,2,779,13,1800,1008,535,244
33,SĂLAJ,"MUNICIPIUL ZALĂU",139704,ZALĂU,"CLUB S.C. COMPANIA DE APĂ SOMEŞ S.A. SUCURSALA MUNICIPIULUI ZALĂU",37,"Alegeri Prezidentiale",1,1307,619,589,30,0,611,8,1400,781,429,182
33,SĂLAJ,"MUNICIPIUL ZALĂU",139704,ZALĂU,"ŞCOALA GENERALĂ ”GEORGE COŞBUC”, CARTIER ORTELEC",38,"Alegeri Prezidentiale",1,1642,822,799,22,1,819,3,1800,978,573,246
33,SĂLAJ,"MUNICIPIUL ZALĂU",139704,STÂNA,"ŞCOALA PRIMARĂ STÎNA",39,"Alegeri Prezidentiale",1,237,129,114,15,0,126,3,300,171,79,47
33,SĂLAJ,"ORAŞ CEHU SILVANIEI",139740,"CEHU SILVANIEI","LICEUL TEHNOLOGIC ”GHEORGHE POP DE BĂSEȘTI”",40,"Alegeri Prezidentiale",1,1464,487,453,34,0,484,3,1600,1113,376,108
33,SĂLAJ,"ORAŞ CEHU SILVANIEI",139740,"CEHU SILVANIEI","ȘCOALA GIMNAZIALĂ ”ANDREI MUREȘANU”",41,"Alegeri Prezidentiale",1,1503,502,475,22,5,498,4,1600,1098,382,116
33,SĂLAJ,"ORAŞ CEHU SILVANIEI",139740,"CEHU SILVANIEI","PIAȚA TRANDAFIRILOR NR. 29 CLUBUL COPIILOR",42,"Alegeri Prezidentiale",1,1439,553,518,35,0,543,10,1600,1047,406,137
33,SĂLAJ,"ORAŞ CEHU SILVANIEI",139740,"HOROATU CEHULUI","HOROATU CEHULUI NR. 23 ȘCOALA PRIMARĂ",43,"Alegeri Prezidentiale",1,141,98,78,20,0,97,1,200,102,75,22
33,SĂLAJ,"ORAŞ CEHU SILVANIEI",139740,MOTIŞ,"SAT MOTIȘ NR. 228 ȘCOALA GIMNAZIALĂ ”GHEORGHE ȘINCAI”",44,"Alegeri Prezidentiale",1,601,287,279,8,0,285,2,700,413,188,97
33,SĂLAJ,"ORAŞ CEHU SILVANIEI",139740,NADIŞ,"SAT NADIȘ NR.127 ȘCOALA PRIMARĂ",45,"Alegeri Prezidentiale",1,424,298,260,38,0,297,1,500,202,199,98
33,SĂLAJ,"ORAŞ CEHU SILVANIEI",139740,ULCIUG,"SAT ULCIUG NR.86 CĂMINUL CULTURAL",46,"Alegeri Prezidentiale",1,739,266,260,6,0,250,16,800,534,197,53
33,SĂLAJ,"ORAŞ JIBOU",139811,JIBOU,"CASA DE CULTURĂ",47,"Alegeri Prezidentiale",1,1829,840,774,65,1,826,14,1900,1060,493,333
33,SĂLAJ,"ORAŞ JIBOU",139811,JIBOU,"LICEUL TEHNOLOGIC ”OCTAVIAN GOGA”",48,"Alegeri Prezidentiale",1,1547,694,641,29,24,690,4,1700,1006,418,272
33,SĂLAJ,"ORAŞ JIBOU",139811,JIBOU,"LICEUL TEHNOLOGIC ”OCTAVIASN GOGA”PARTER,SALA DE CLASA NR.2",49,"Alegeri Prezidentiale",1,1277,625,587,38,0,614,11,1400,775,395,219
33,SĂLAJ,"ORAŞ JIBOU",139811,JIBOU,"ȘCOALĂ GIMNAZIALĂ ”LUCIAN BLAGA” PARTER SALĂ DE CLASĂ NR.1,STR.GAROAFELOR NR.7",50,"Alegeri Prezidentiale",1,1670,815,765,50,0,797,18,1700,885,457,340
33,SĂLAJ,"ORAŞ JIBOU",139811,JIBOU,"LICEUL TEORETIC ”ION AGÂRBICEANU”",51,"Alegeri Prezidentiale",1,1758,690,601,55,34,683,7,1800,1110,407,276
33,SĂLAJ,"ORAŞ JIBOU",139811,CUCEU,GRĂDINIȚĂ,52,"Alegeri Prezidentiale",1,388,155,124,31,0,155,0,400,245,94,61
33,SĂLAJ,"ORAŞ JIBOU",139811,HUSIA,"ȘCOALA CU CLASELE I-IV",53,"Alegeri Prezidentiale",1,205,117,99,18,0,116,1,250,133,74,42
33,SĂLAJ,"ORAŞ JIBOU",139811,RONA,"ȘCOALA CU CLASELE I-IV",54,"Alegeri Prezidentiale",1,308,187,170,17,0,187,0,350,163,88,99
33,SĂLAJ,"ORAŞ JIBOU",139811,VAR,"CAMIN CULTURAL VAR",55,"Alegeri Prezidentiale",1,422,244,222,22,0,241,3,500,256,130,111
33,SĂLAJ,"ORAŞ ŞIMLEU SILVANIEI",139884,"ŞIMLEU SILVANIEI","ȘCOALA GIMNAZIALĂ ”HOREA”",56,"Alegeri Prezidentiale",1,1652,796,750,46,0,785,11,1700,904,553,232
33,SĂLAJ,"ORAŞ ŞIMLEU SILVANIEI",139884,"ŞIMLEU SILVANIEI","LICEUL TEHNOLOGIC ”IOAN OSSIAN”",57,"Alegeri Prezidentiale",1,1515,686,647,39,0,671,15,1600,914,430,241
33,SĂLAJ,"ORAŞ ŞIMLEU SILVANIEI",139884,"ŞIMLEU SILVANIEI","CENTRUL CULTURAL",58,"Alegeri Prezidentiale",1,1465,653,609,44,0,638,15,1500,847,509,129
33,SĂLAJ,"ORAŞ ŞIMLEU SILVANIEI",139884,"ŞIMLEU SILVANIEI","COLEGIUL TEHNIC ”IULIU MANIU”",59,"Alegeri Prezidentiale",1,1533,756,696,36,24,734,22,1600,844,539,195
33,SĂLAJ,"ORAŞ ŞIMLEU SILVANIEI",139884,"ŞIMLEU SILVANIEI","CENTRUL ȘCOLAR PENTRU EDUCAȚIE INCLUZIVĂ",60,"Alegeri Prezidentiale",1,1864,712,663,49,0,699,13,2000,1288,535,164
33,SĂLAJ,"ORAŞ ŞIMLEU SILVANIEI",139884,"ŞIMLEU SILVANIEI","CLUBUL COPIILOR",61,"Alegeri Prezidentiale",1,1710,733,694,39,0,725,8,1800,1067,534,191
33,SĂLAJ,"ORAŞ ŞIMLEU SILVANIEI",139884,"ŞIMLEU SILVANIEI","GRĂDINIȚA CU PROGRAM PRELUNGIT NR.3",62,"Alegeri Prezidentiale",1,1549,680,648,32,0,672,8,1600,920,514,158
33,SĂLAJ,"ORAŞ ŞIMLEU SILVANIEI",139884,CEHEI,"ŞCOALA PRIMARĂ",63,"Alegeri Prezidentiale",1,770,376,354,22,0,372,4,839,463,282,90
33,SĂLAJ,"ORAŞ ŞIMLEU SILVANIEI",139884,PUSTA,"ŞCOALA GIMNAZIALĂ NR.1",64,"Alegeri Prezidentiale",1,1408,482,469,13,0,463,19,1500,1018,330,133
33,SĂLAJ,AGRIJ,139937,AGRIJ,"CĂMIN CULTURAL AGRIJ",65,"Alegeri Prezidentiale",1,828,429,372,57,0,426,3,900,471,252,174
33,SĂLAJ,AGRIJ,139937,"RĂSTOLŢU- DEŞERT","ŞCOALA CU CLASELE I-IV",66,"Alegeri Prezidentiale",1,272,180,144,36,0,176,4,350,170,105,71
33,SĂLAJ,ALMAŞU,139982,ALMAŞU,"PRIMĂRIA COMUNEI ALMAŞU",67,"Alegeri Prezidentiale",1,803,380,332,48,0,377,3,891,511,299,78
33,SĂLAJ,ALMAŞU,139982,JEBUCU,"CĂMINUL CULTURAL JEBUCU",68,"Alegeri Prezidentiale",1,282,191,145,46,0,187,4,350,159,160,27
33,SĂLAJ,ALMAŞU,139982,MESTEACĂNU,"SCOALA PRIMARA MESTEACANU",69,"Alegeri Prezidentiale",1,283,192,146,45,1,191,1,350,158,125,66
33,SĂLAJ,ALMAŞU,139982,PETRINZEL,"CĂMINUL CULTURAL PETRINZEL",70,"Alegeri Prezidentiale",1,97,56,34,22,0,54,2,150,94,47,7
33,SĂLAJ,ALMAŞU,139982,STANA,"CĂMINUL CULTURAL STANA",71,"Alegeri Prezidentiale",1,101,92,50,42,0,92,0,150,58,87,5
33,SĂLAJ,ALMAŞU,139982,ŢĂUDU,"ŞCOALA CU CLASELE I-IV ŢĂUDU",72,"Alegeri Prezidentiale",1,99,83,53,30,0,82,1,150,67,67,15
33,SĂLAJ,BĂBENI,140084,BĂBENI,"CORP B , BIBLIOTECA COMUNALĂ",73,"Alegeri Prezidentiale",1,456,283,227,56,0,279,4,492,209,164,115
33,SĂLAJ,BĂBENI,140084,CIOCMANI,"ŞCOALA VECHE CIOCMANI",74,"Alegeri Prezidentiale",1,460,304,230,72,2,297,7,492,188,184,113
33,SĂLAJ,BĂBENI,140084,CLIŢ,"ŞCOALA CLIŢ",75,"Alegeri Prezidentiale",1,176,129,99,30,0,129,0,200,71,72,57
33,SĂLAJ,BĂBENI,140084,PIROŞA,"CLĂDIRE MULTIFUNCŢIONALĂ",76,"Alegeri Prezidentiale",1,79,62,46,16,0,62,0,100,38,45,17
33,SĂLAJ,BĂBENI,140084,POIENIŢA,"ŞCOALA POIENIŢA",77,"Alegeri Prezidentiale",1,176,116,86,28,2,116,0,200,84,64,52
33,SĂLAJ,BĂLAN,140146,BĂLAN,"ŞCOALA GIMNAZIALĂ BĂLAN",78,"Alegeri Prezidentiale",1,760,397,334,63,0,393,4,800,403,263,130
33,SĂLAJ,BĂLAN,140146,CHECHIŞ,"AFTER SCHOOL CHECHIŞ",79,"Alegeri Prezidentiale",1,482,353,258,95,0,352,1,500,147,182,170
33,SĂLAJ,BĂLAN,140146,CHENDREA,"ŞCOALA PRIMARĂ ”IOANICHIE DRUHORA” CHENDREA",80,"Alegeri Prezidentiale",1,653,344,313,31,0,342,2,700,356,192,150
33,SĂLAJ,BĂLAN,140146,GĂLPÂIA,"ŞCOALA PRIMARĂ GĂLPÎIA",81,"Alegeri Prezidentiale",2,327,189,144,45,0,185,4,400,211,90,95
33,SĂLAJ,BĂLAN,140146,"GÂLGĂU ALMAŞULUI","ŞCOALA GIMNAZIALĂ GÎLGĂU ALMAŞULUI",82,"Alegeri Prezidentiale",1,819,469,397,72,0,469,0,900,431,270,199
33,SĂLAJ,BĂNIŞOR,140208,BĂNIŞOR,"PRIMĂRIA BĂNIȘOR, NR. 29",83,"Alegeri Prezidentiale",1,531,292,246,45,1,289,3,600,308,185,104
33,SĂLAJ,BĂNIŞOR,140208,BAN,"CAMIN CULTURAL BAN, NR. 55",84,"Alegeri Prezidentiale",1,359,220,176,44,0,217,3,400,180,142,75
33,SĂLAJ,BĂNIŞOR,140208,PECEIU,"ŞCOALA PECEIU, NR. 137",85,"Alegeri Prezidentiale",1,739,424,375,49,0,422,2,800,376,348,74
33,SĂLAJ,BENESAT,140244,BENESAT,"ŞCOALA PRIMARĂ BENESAT",86,"Alegeri Prezidentiale",1,350,186,148,37,1,184,2,400,214,137,47
33,SĂLAJ,BENESAT,140244,ALUNIŞ,"ŞCOALA GIMNAZIALĂ ”AVRAM IANCU”",87,"Alegeri Prezidentiale",1,459,285,246,39,0,275,10,500,215,207,68
33,SĂLAJ,BENESAT,140244,BIUŞA,"ŞCOALA PRIMARĂ BIUŞA",88,"Alegeri Prezidentiale",1,401,196,181,15,0,190,6,450,254,138,52
33,SĂLAJ,BOBOTA,140280,BOBOTA,"GRĂDINIȚA BOBOTA",89,"Alegeri Prezidentiale",1,1159,569,498,68,3,566,3,1300,731,370,196
33,SĂLAJ,BOBOTA,140280,DERŞIDA,"ȘCOALA DERȘIDA",90,"Alegeri Prezidentiale",1,1481,668,613,54,1,659,9,1600,932,399,260
33,SĂLAJ,BOBOTA,140280,ZALNOC,"ȘCOALA ZALNOC",91,"Alegeri Prezidentiale",1,377,143,120,23,0,142,1,400,257,99,43
33,SĂLAJ,BOCŞA,140324,BOCŞA,"ȘCOALA GIMNAZIALĂ ”SIMION BĂRNUȚIU” BOCȘA",92,"Alegeri Prezidentiale",1,763,405,339,62,4,400,5,800,395,315,85
33,SĂLAJ,BOCŞA,140324,BORLA,"ȘCOALA GIMNAZIALĂ NR.1 BORLA",93,"Alegeri Prezidentiale",1,1314,247,232,15,0,233,14,1400,1153,184,49
33,SĂLAJ,BOCŞA,140324,SĂLĂJENI,"ȘCOALA CU CLASELE I-IV SĂLĂJENI",94,"Alegeri Prezidentiale",1,442,244,197,47,0,242,2,500,256,174,68
33,SĂLAJ,BOCŞA,140324,CÂMPIA,"ȘCOALA CU CLASELE I-IV CÎMPIA",95,"Alegeri Prezidentiale",1,202,147,111,36,0,146,1,250,103,107,39
33,SĂLAJ,BOGHIŞ,180037,BOGHIŞ,"PRIMĂRIA COMUNEI BOGHIŞ",96,"Alegeri Prezidentiale",1,1262,384,343,41,0,368,16,1400,1016,254,114
33,SĂLAJ,BOGHIŞ,180037,BOZIEŞ,"CĂMINUL CULTURAL BOZIEŞ",97,"Alegeri Prezidentiale",1,207,102,87,15,0,98,4,250,148,70,28
33,SĂLAJ,BUCIUMI,140379,BODIA,"ŞCOALA CU CLASELE I-IV",98,"Alegeri Prezidentiale",1,215,146,114,32,0,142,4,300,154,91,51
33,SĂLAJ,BUCIUMI,140379,BOGDANA,"ŞCOALA CU CLASELE I-IV",99,"Alegeri Prezidentiale",1,373,248,185,63,0,245,3,400,152,103,142
33,SĂLAJ,BUCIUMI,140379,RĂSTOLŢ,"ŞCOALA CU CLASELE I-IV",100,"Alegeri Prezidentiale",1,162,139,90,49,0,139,0,200,61,75,64
33,SĂLAJ,BUCIUMI,140379,"SÂNGEORGIU DE MESEŞ","ŞCOALA CU CLASELE I-IV",101,"Alegeri Prezidentiale",1,228,169,113,56,0,169,0,300,131,101,68
33,SĂLAJ,BUCIUMI,140379,BUCIUMI,"PRIMĂRIA BUCIUMI",102,"Alegeri Prezidentiale",1,989,645,543,101,1,640,5,1100,455,344,296
33,SĂLAJ,CAMĂR,140440,CAMĂR,"PRIMĂRIA COMUNEI CAMĂR",103,"Alegeri Prezidentiale",1,1321,401,369,32,0,386,15,1400,999,294,92
33,SĂLAJ,CARASTELEC,140477,DUMUSLĂU,"ŞCOALA PRIMARĂ",104,"Alegeri Prezidentiale",1,29,29,11,18,0,29,0,100,71,20,9
33,SĂLAJ,CARASTELEC,140477,CARASTELEC,"CENTRUL LOCAL DE INFORMARE TURISTICĂ",105,"Alegeri Prezidentiale",1,810,235,215,19,1,232,3,900,665,181,51
33,SĂLAJ,CHIEŞD,140501,CHIEŞD,"SALA DE SPORT CHIEȘD",106,"Alegeri Prezidentiale",1,1575,654,625,29,0,652,2,1600,946,351,301
33,SĂLAJ,CHIEŞD,140501,"SIGHETU SILVANIEI","ȘCOALA PRIMARĂ SIGHETU SILVANIEI",107,"Alegeri Prezidentiale",1,395,212,175,37,0,210,2,400,188,107,103
33,SĂLAJ,CIZER,140547,CIZER,"ŞCOALA GIMNAZIALĂ CIZER",108,"Alegeri Prezidentiale",1,1309,623,567,56,0,617,6,1400,777,466,151
33,SĂLAJ,CIZER,140547,PLESCA,"ŞCOALA GIMNAZIALĂ PLESCA",109,"Alegeri Prezidentiale",1,166,103,73,30,0,103,0,200,97,87,16
33,SĂLAJ,CIZER,140547,PRIA,"CĂMINUL CULTURAL",110,"Alegeri Prezidentiale",1,323,203,132,71,0,201,2,400,197,136,65
33,SĂLAJ,COŞEIU,140583,COŞEIU,"PRIMĂRIA COMUNEI COŞEIU",111,"Alegeri Prezidentiale",1,352,199,164,35,0,197,2,400,201,147,50
33,SĂLAJ,COŞEIU,140583,ARCHID,"ŞCOALA GIMNAZIALĂ ARCHID",112,"Alegeri Prezidentiale",1,378,72,58,14,0,69,3,400,328,59,10
33,SĂLAJ,COŞEIU,140583,CHILIOARA,"ŞCOALA CU CLASELE I-IV CHILIOARA",113,"Alegeri Prezidentiale",1,239,194,124,69,1,190,4,300,106,132,58
33,SĂLAJ,CRASNA,140627,CRASNA,"CĂMINUL CULTURAL ”PETŐFI SÁNDOR”",114,"Alegeri Prezidentiale",1,1904,598,511,40,47,578,20,2100,1502,438,140
33,SĂLAJ,CRASNA,140627,CRASNA,"CENTRU DE INFORMARE TURISTICA",115,"Alegeri Prezidentiale",1,1812,484,454,28,2,471,13,1900,1416,390,81
33,SĂLAJ,CRASNA,140627,HUSENI,"CENTRUL DE ZI PENTRU COPII",116,"Alegeri Prezidentiale",1,413,218,193,25,0,214,4,500,282,107,107
33,SĂLAJ,CRASNA,140627,MARIN,"CENTRUL DE ZI PENTRU COPII",117,"Alegeri Prezidentiale",1,740,398,325,73,0,390,8,800,402,299,91
33,SĂLAJ,CRASNA,140627,RATIN,"CENTRUL DE ZI PENTRU COPII",118,"Alegeri Prezidentiale",1,407,143,129,14,0,128,15,500,357,62,66
33,SĂLAJ,CREACA,140672,CREACA,"ȘCOALA GIMNAZIALĂ MARCUS AURELIUS CREACA",119,"Alegeri Prezidentiale",1,367,184,150,34,0,184,0,400,216,108,76
33,SĂLAJ,CREACA,140672,BREBI,"ȘCOALA GENERALĂ BREBI",120,"Alegeri Prezidentiale",1,441,218,185,33,0,214,4,500,282,139,75
33,SĂLAJ,CREACA,140672,JAC,"ȘCOALA GIMNAZIALĂ JAC",121,"Alegeri Prezidentiale",1,568,310,258,52,0,299,11,600,290,215,84
33,SĂLAJ,CREACA,140672,BRUSTURI,"ȘCOALA GENERALĂ BRUSTURI",122,"Alegeri Prezidentiale",1,134,102,72,30,0,102,0,150,48,67,35
33,SĂLAJ,CREACA,140672,LUPOAIA,"ȘCOALA GENERALĂ LUPOAIA",123,"Alegeri Prezidentiale",1,234,129,99,30,0,124,5,300,171,76,48
33,SĂLAJ,CREACA,140672,BORZA,"ȘCOALA GENERALĂ BORZA",124,"Alegeri Prezidentiale",1,155,92,49,43,0,89,3,200,108,41,48
33,SĂLAJ,CREACA,140672,PRODĂNEŞTI,"ȘCOALA GENERALĂ PRODĂNEȘTI",125,"Alegeri Prezidentiale",1,208,110,94,16,0,109,1,250,140,63,46
33,SĂLAJ,CREACA,140672,CIGLEAN,"ȘCOALA GENERALĂ CIGLEAN",126,"Alegeri Prezidentiale",1,119,74,61,13,0,74,0,150,76,24,50
33,SĂLAJ,CRISTOLŢ,140770,CRISTOLŢ,"CĂMINUL CULTURAL CRISTOLȚ",127,"Alegeri Prezidentiale",1,497,231,200,31,0,229,2,600,369,159,70
33,SĂLAJ,CRISTOLŢ,140770,MUNCEL,"ŞCOALA PRIMARĂ MUNCEL",128,"Alegeri Prezidentiale",1,139,84,69,15,0,84,0,200,116,52,32
33,SĂLAJ,CRISTOLŢ,140770,"POIANA ONŢII","ŞCOALA PRIMARĂ POIANA ONŢII",129,"Alegeri Prezidentiale",1,65,50,33,17,0,50,0,100,50,35,15
33,SĂLAJ,CRISTOLŢ,140770,VĂLENI,"ŞCOALA PRIMARĂ VĂLENI",130,"Alegeri Prezidentiale",1,325,173,140,33,0,172,1,400,227,100,72
33,SĂLAJ,CRIŞENI,140823,CRIŞENI,"ȘCOALA GIMNAZIALĂ ” VASILE BREBAN ”” CRIȘENI",131,"Alegeri Prezidentiale",1,1473,994,861,114,19,982,12,1600,606,732,250
33,SĂLAJ,CRIŞENI,140823,CRISTUR-CRIŞENI,"ȘCOALA PRIMARĂ CRISTUR-CRIȘENI",132,"Alegeri Prezidentiale",1,423,176,160,16,0,170,6,500,324,151,19
33,SĂLAJ,CRIŞENI,140823,GÂRCEIU,"ȘCOALA PRIMARĂ GÎRCEIU",133,"Alegeri Prezidentiale",1,668,335,286,49,0,334,1,700,365,239,95
33,SĂLAJ,CUZĂPLAC,140869,CUZĂPLAC,"ȘCOALA GIMNAZIALĂ CUZĂPLAC, NR.242",134,"Alegeri Prezidentiale",1,433,265,222,43,0,264,1,500,235,144,120
33,SĂLAJ,CUZĂPLAC,140869,GĂLĂŞENI,"CĂMINUL CULTURAL GĂLĂȘENI, NR.50",135,"Alegeri Prezidentiale",1,84,69,28,41,0,69,0,150,81,36,33
33,SĂLAJ,CUZĂPLAC,140869,MIERŢA,"ŞCOALA CU CLASELE I-IV MIERȚA, NR.97",136,"Alegeri Prezidentiale",1,108,76,53,23,0,76,0,150,74,33,43
33,SĂLAJ,CUZĂPLAC,140869,PETRINDU,"CENTRUL DE ZI PETRINDU, NR.78",137,"Alegeri Prezidentiale",1,330,217,181,36,0,214,3,400,183,114,100
33,SĂLAJ,CUZĂPLAC,140869,RUGINOASA,"CĂMINUL CULTURAL RUGINOASA, NR.22",138,"Alegeri Prezidentiale",1,74,59,27,32,0,58,1,150,91,35,23
33,SĂLAJ,CUZĂPLAC,140869,TĂMAŞA,"ȘCOALA CU CLASELE I-IV TĂMAȘA, NR.219",139,"Alegeri Prezidentiale",1,261,191,158,33,0,189,2,300,109,77,112
33,SĂLAJ,DOBRIN,140958,DOBRIN,"CĂMINUL CULTURAL",140,"Alegeri Prezidentiale",1,351,136,114,22,0,135,1,400,264,91,44
33,SĂLAJ,DOBRIN,140958,DOBA,"ȘCOALA ELEMENTARĂ",141,"Alegeri Prezidentiale",1,273,80,68,12,0,78,2,300,220,61,17
33,SĂLAJ,DOBRIN,140958,DOBA,"CENTRUL DE ZI DOBA",142,"Alegeri Prezidentiale",1,228,89,77,12,0,86,3,300,211,58,28
33,SĂLAJ,DOBRIN,140958,NAIMON,"CĂMINUL CULTURAL NAIMON",143,"Alegeri Prezidentiale",1,117,45,20,25,0,45,0,150,105,36,9
33,SĂLAJ,DOBRIN,140958,VERVEGHIU,"ȘCOALA ELEMENTARĂ VERVEGHIU",144,"Alegeri Prezidentiale",1,376,89,76,13,0,82,7,400,311,63,19
33,SĂLAJ,DRAGU,141027,DRAGU,"PRIMĂRIA DRAGU, NR.120",145,"Alegeri Prezidentiale",1,528,224,180,41,3,222,2,600,376,115,107
33,SĂLAJ,DRAGU,141027,ADALIN,"ȘCOALA CU CLASELE I-IV, NR.100",146,"Alegeri Prezidentiale",1,121,72,39,33,0,72,0,150,78,53,19
33,SĂLAJ,DRAGU,141027,UGRUŢIU,"CĂMINUL CULTURAL, NR.20",147,"Alegeri Prezidentiale",1,19,46,6,40,0,46,0,100,54,29,17
33,SĂLAJ,DRAGU,141027,VOIVODENI,"ȘCOALA CU CLASELE I-IV, NR.117",148,"Alegeri Prezidentiale",1,240,155,97,58,0,151,4,300,145,113,38
33,SĂLAJ,"FILDU DE JOS",141081,"FILDU DE JOS","ŞCOALA PRIMARĂ FILDU DE JOS",149,"Alegeri Prezidentiale",1,181,148,109,39,0,148,0,200,52,112,36
33,SĂLAJ,"FILDU DE JOS",141081,"FILDU DE MIJLOC","CĂMINUL CULTURAL FILDU DE MIJLOC",150,"Alegeri Prezidentiale",1,310,217,178,39,0,214,3,350,133,121,93
33,SĂLAJ,"FILDU DE JOS",141081,"FILDU DE SUS","CĂMINUL CULTURAL FILDU DE SUS",151,"Alegeri Prezidentiale",1,310,247,205,35,7,244,3,350,103,89,155
33,SĂLAJ,"FILDU DE JOS",141081,TETIŞU,"ŞCOALA PRIMARĂ TETIŞU",152,"Alegeri Prezidentiale",1,231,142,116,26,0,138,4,300,158,102,36
33,SĂLAJ,GÂLGĂU,141134,"BÂRSĂU MARE","ȘCOALA CU CLASELE I-IV",153,"Alegeri Prezidentiale",1,181,138,86,52,0,137,1,200,62,109,28
33,SĂLAJ,GÂLGĂU,141134,CĂPÂLNA,"ȘCOALA CU CLASELE I-IV",154,"Alegeri Prezidentiale",1,235,223,149,73,1,222,1,300,77,176,46
33,SĂLAJ,GÂLGĂU,141134,CHIZENI,"ȘCOALA CU CLASELE I-IV",155,"Alegeri Prezidentiale",1,83,62,48,14,0,61,1,150,88,26,35
33,SĂLAJ,GÂLGĂU,141134,GLOD,"CAMIN CULTURAL",156,"Alegeri Prezidentiale",1,386,240,173,67,0,233,7,400,160,166,67
33,SĂLAJ,GÂLGĂU,141134,GÂLGĂU,"LICEUL TEHNOLOGIC",157,"Alegeri Prezidentiale",1,508,324,251,73,0,322,2,600,276,208,114
33,SĂLAJ,GÂLGĂU,141134,DOBROCINA,"CASA PARTICULARA",158,"Alegeri Prezidentiale",1,137,103,71,32,0,100,3,200,97,68,32
33,SĂLAJ,GÂLGĂU,141134,FODORA,"ȘCOALA GIMNAZIALĂ",159,"Alegeri Prezidentiale",1,338,202,147,55,0,200,2,400,198,158,42
33,SĂLAJ,GÂRBOU,141232,GÂRBOU,"PRIMĂRIA GÎRBOU",160,"Alegeri Prezidentiale",1,479,223,176,47,0,222,1,550,327,145,77
33,SĂLAJ,GÂRBOU,141232,SOLOMON,"CĂMINUL CULTURAL",161,"Alegeri Prezidentiale",1,288,170,136,33,1,169,1,350,180,91,78
33,SĂLAJ,GÂRBOU,141232,CĂLACEA,"ȘCOALA PRIMARĂ",162,"Alegeri Prezidentiale",1,215,144,110,34,0,140,4,250,106,79,61
33,SĂLAJ,GÂRBOU,141232,POPTELEAC,"ȘCOALA PRIMARĂ",163,"Alegeri Prezidentiale",1,263,140,113,27,0,139,1,300,160,105,34
33,SĂLAJ,GÂRBOU,141232,CERNUC,"CĂMINUL CULTURAL CERNUC",164,"Alegeri Prezidentiale",1,149,106,63,43,0,105,1,200,94,58,47
33,SĂLAJ,GÂRBOU,141232,BEZDED,"CĂMINUL CULTURAL",165,"Alegeri Prezidentiale",1,93,77,44,33,0,76,1,150,73,36,40
33,SĂLAJ,GÂRBOU,141232,FABRICA,"ȘCOALA PRIMARĂ",166,"Alegeri Prezidentiale",1,81,55,39,16,0,55,0,150,95,23,32
33,SĂLAJ,HALMĂŞD,141312,HALMĂŞD,"ȘCOALA GIMNAZIALA HALMĂȘD",167,"Alegeri Prezidentiale",1,877,442,409,33,0,440,2,1000,558,273,167
33,SĂLAJ,HALMĂŞD,141312,ALEUŞ,ȘCOALĂ,168,"Alegeri Prezidentiale",1,239,122,101,17,4,122,0,300,178,53,69
33,SĂLAJ,HALMĂŞD,141312,CERIŞA,"ȘCOALA VECHE",169,"Alegeri Prezidentiale",1,447,237,221,16,0,232,5,500,263,133,99
33,SĂLAJ,HALMĂŞD,141312,DRIGHIU,"ȘCOALA NOUĂ DRIGHIU",170,"Alegeri Prezidentiale",1,311,164,128,34,2,164,0,350,186,125,39
33,SĂLAJ,HERECLEAN,141376,HERECLEAN,"CĂMINUL CULTURAL HERECLEAN",171,"Alegeri Prezidentiale",1,465,296,233,60,3,290,6,500,204,202,88
33,SĂLAJ,HERECLEAN,141376,BADON,"ŞCOALA PRIMARĂ BADON",172,"Alegeri Prezidentiale",1,575,409,313,78,18,402,7,600,191,297,105
33,SĂLAJ,HERECLEAN,141376,BOCŞIŢA,"CĂMINUL CULTURAL BOCȘIȚA",173,"Alegeri Prezidentiale",1,64,64,30,34,0,63,1,100,36,42,21
33,SĂLAJ,HERECLEAN,141376,DIOŞOD,"ȘCOALA PRIMARĂ DIOȘOD",174,"Alegeri Prezidentiale",1,684,230,196,34,0,229,1,700,470,166,63
33,SĂLAJ,HERECLEAN,141376,GURUSLĂU,"ŞCOALA GIMNAZIALĂ GURUSLĂU",175,"Alegeri Prezidentiale",1,530,196,172,24,0,193,3,600,404,157,36
33,SĂLAJ,HERECLEAN,141376,PANIC,"ŞCOALA GIMNAZIALĂ PANIC",176,"Alegeri Prezidentiale",2,886,313,280,31,2,311,2,1000,687,262,49
33,SĂLAJ,HIDA,141447,BAICA,"CĂMINUL CULTURAL",177,"Alegeri Prezidentiale",1,102,65,42,23,0,64,1,150,85,37,27
33,SĂLAJ,HIDA,141447,MILUANI,"CĂMINUL CULTURAL",178,"Alegeri Prezidentiale",1,18,55,4,51,0,55,0,100,45,40,15
33,SĂLAJ,HIDA,141447,HIDA,PRIMĂRIA,179,"Alegeri Prezidentiale",1,866,406,359,47,0,404,2,900,494,311,93
33,SĂLAJ,HIDA,141447,RACÂŞ,"ŞCOALA GENERALĂ",180,"Alegeri Prezidentiale",1,421,208,160,48,0,207,1,500,292,130,77
33,SĂLAJ,HIDA,141447,TRESTIA,"ŞCOALA GENERALĂ",181,"Alegeri Prezidentiale",1,242,121,94,27,0,121,0,300,179,65,56
33,SĂLAJ,HIDA,141447,"SÂNPETRU ALMAŞULUI","CĂMINUL CULTURAL",182,"Alegeri Prezidentiale",1,331,224,152,72,0,223,1,400,176,153,70
33,SĂLAJ,HIDA,141447,STUPINI,"CĂMINUL CULTURAL",183,"Alegeri Prezidentiale",1,98,101,50,51,0,98,3,150,49,74,24
33,SĂLAJ,HIDA,141447,PĂDURIŞ,"ŞCOALA GENERALĂ",184,"Alegeri Prezidentiale",1,29,28,10,18,0,28,0,100,72,19,9
33,SĂLAJ,"HOROATU CRASNEI",141535,STÂRCIU,"SCOALA GENERALA",185,"Alegeri Prezidentiale",1,764,390,302,88,0,385,5,800,410,314,71
33,SĂLAJ,"HOROATU CRASNEI",141535,ŞEREDEIU,"CĂMINUL CULTURAL",186,"Alegeri Prezidentiale",1,190,164,88,76,0,161,3,250,86,101,60
33,SĂLAJ,"HOROATU CRASNEI",141535,"HOROATU CRASNEI","CAMIN CULTURAL HOROATU CRASNEI",187,"Alegeri Prezidentiale",1,771,407,344,57,6,407,0,800,393,261,146
33,SĂLAJ,"HOROATU CRASNEI",141535,HUREZ,"ȘCOALA HUREZ",188,"Alegeri Prezidentiale",1,288,168,126,42,0,168,0,300,132,112,56
33,SĂLAJ,ILEANDA,141580,DĂBÂCENI,"ŞCOALA GENERALĂ",189,"Alegeri Prezidentiale",1,156,110,90,19,1,110,0,200,90,63,47
33,SĂLAJ,ILEANDA,141580,NEGRENI,"ŞCOALA GENERALĂ",190,"Alegeri Prezidentiale",1,91,51,36,15,0,50,1,150,99,22,28
33,SĂLAJ,ILEANDA,141580,"PERII VADULUI","ŞCOALA GENERALĂ",191,"Alegeri Prezidentiale",1,96,79,50,29,0,79,0,150,71,61,18
33,SĂLAJ,ILEANDA,141580,PODIŞU,"ŞCOALA GENERALĂ",192,"Alegeri Prezidentiale",1,112,75,53,22,0,75,0,150,75,46,29
33,SĂLAJ,ILEANDA,141580,RĂSTOCI,"ŞCOALA GENERALĂ",193,"Alegeri Prezidentiale",1,112,100,70,30,0,99,1,150,50,56,43
33,SĂLAJ,ILEANDA,141580,ROGNA,"ŞCOALA GENERALĂ",194,"Alegeri Prezidentiale",1,62,43,24,19,0,42,1,100,57,18,24
33,SĂLAJ,ILEANDA,141580,ŞASA,"ŞCOALA GENERALĂ",195,"Alegeri Prezidentiale",1,46,41,24,17,0,41,0,100,59,20,21
33,SĂLAJ,ILEANDA,141580,ILEANDA,"PIATA AGROALIMENTARA ILEANDA",196,"Alegeri Prezidentiale",1,1016,543,430,113,0,538,5,1100,557,275,263
33,SĂLAJ,ILEANDA,141580,DOLHENI,"ŞCOALA GENERALĂ DOLHENI",197,"Alegeri Prezidentiale",1,73,56,37,19,0,56,0,100,44,34,22
33,SĂLAJ,ILEANDA,141580,LUMINIŞU,"ŞCOALA GENERALĂ LUMINIŞU",198,"Alegeri Prezidentiale",1,73,67,44,23,0,67,0,100,33,52,15
33,SĂLAJ,IP,141722,IP,"CERCUL GOSPODARILOR",199,"Alegeri Prezidentiale",1,1442,496,457,39,0,488,8,1600,1104,378,110
33,SĂLAJ,IP,141722,"COSNICIU DE JOS","ȘCOALA GIMAZIALĂ COSNICIU DE JOS",200,"Alegeri Prezidentiale",1,521,241,227,14,0,237,4,600,359,162,75
33,SĂLAJ,IP,141722,"COSNICIU DE SUS","CĂMINUL CULTURAL",201,"Alegeri Prezidentiale",1,236,141,124,17,0,137,4,300,159,92,45
33,SĂLAJ,IP,141722,ZĂUAN,"CĂMINUL CULTURAL ZĂUAN",202,"Alegeri Prezidentiale",1,816,238,205,33,0,235,3,900,662,205,30
33,SĂLAJ,LETCA,141786,LETCA,"PRIMĂRIA COMUNEI LETCA",203,"Alegeri Prezidentiale",1,433,299,239,60,0,298,1,499,200,181,117
33,SĂLAJ,LETCA,141786,CIULA,"CLĂDIREA FOSTULUI CONSILIU CIULA",204,"Alegeri Prezidentiale",1,77,64,35,29,0,63,1,150,86,29,34
33,SĂLAJ,LETCA,141786,COZLA,"ŞCOALA COZLA",205,"Alegeri Prezidentiale",1,198,115,93,22,0,113,2,250,135,70,43
33,SĂLAJ,LETCA,141786,CUCIULAT,"ŞCOALA CUCIULAT",206,"Alegeri Prezidentiale",1,139,96,75,21,0,95,1,200,104,38,57
33,SĂLAJ,LETCA,141786,LEMNIU,"ŞCOALA LEMNIU",207,"Alegeri Prezidentiale",1,345,240,190,50,0,239,1,400,160,101,138
33,SĂLAJ,LETCA,141786,PURCĂREŢ,"ŞCOALA PURCĂREŢ",208,"Alegeri Prezidentiale",1,80,77,48,29,0,76,1,150,73,53,23
33,SĂLAJ,LETCA,141786,ŞOIMUŞENI,"ŞCOALA ŞOIMUŞENI",209,"Alegeri Prezidentiale",1,56,57,37,20,0,57,0,100,43,27,30
33,SĂLAJ,LETCA,141786,TOPLIŢA,"ŞCOALA TOPLIŢA",210,"Alegeri Prezidentiale",1,94,84,62,22,0,84,0,150,66,39,45
33,SĂLAJ,LETCA,141786,VĂLIŞOARA,"ŞCOALA VĂLIŞOARA",211,"Alegeri Prezidentiale",1,22,25,8,17,0,24,1,100,75,21,3
33,SĂLAJ,LOZNA,141884,CORMENIŞ,"ȘCOALA CU CLASELE I-IV CORMENIȘ",212,"Alegeri Prezidentiale",1,150,134,92,42,0,134,0,200,66,101,33
33,SĂLAJ,LOZNA,141884,"VALEA LOZNEI","ȘCOALA CU CLASELE I-IV VALEA LOZNEI",213,"Alegeri Prezidentiale",1,151,117,74,43,0,116,1,200,83,77,39
33,SĂLAJ,LOZNA,141884,LOZNA,"PRIMĂRIA COMUNEI LOZNA",214,"Alegeri Prezidentiale",1,462,286,203,83,0,285,1,501,215,173,112
33,SĂLAJ,MARCA,141946,MARCA,"PRIMĂRIA VECHE MARCA",215,"Alegeri Prezidentiale",1,1121,505,454,51,0,500,5,1200,695,397,103
33,SĂLAJ,MARCA,141946,PORŢ,"ŞCOALA PRIMARĂ PORŢ",216,"Alegeri Prezidentiale",1,224,142,122,20,0,142,0,200,58,108,34
33,SĂLAJ,MARCA,141946,LEŞMIR,"ŞCOALA PRIMARĂ LEŞMIR",217,"Alegeri Prezidentiale",1,329,116,97,19,0,109,7,400,284,102,7
33,SĂLAJ,MARCA,141946,ŞUMAL,"CĂMINUL CULTURAL ŞUMAL",218,"Alegeri Prezidentiale",1,414,214,190,24,0,214,0,500,286,186,28
33,SĂLAJ,MĂERIŞTE,142006,MĂERIŞTE,"ŞCOALA GIMNAZIALĂ MĂERIȘTE",219,"Alegeri Prezidentiale",1,597,326,279,43,4,324,2,600,274,218,106
33,SĂLAJ,MĂERIŞTE,142006,"GIURTELECU ŞIMLEULUI","ŞCOALA GIMNAZIALĂ GIURTELECU ȘIMLEULUI",220,"Alegeri Prezidentiale",1,703,392,339,44,9,390,2,800,408,302,88
33,SĂLAJ,MĂERIŞTE,142006,CRIŞTELEC,"ŞCOALA CU CLASELE I-IV CRIȘTELEC",221,"Alegeri Prezidentiale",1,412,232,209,23,0,226,6,450,218,156,70
33,SĂLAJ,MĂERIŞTE,142006,DOH,"ŞCOALA CU CLASELE I-IV DOH",222,"Alegeri Prezidentiale",1,175,98,83,15,0,96,2,200,102,63,33
33,SĂLAJ,MĂERIŞTE,142006,MĂLĂDIA,"ŞCOALA CU CLASELE I-IV MĂLĂDIA",223,"Alegeri Prezidentiale",1,156,106,80,26,0,103,3,200,94,77,26
33,SĂLAJ,MĂERIŞTE,142006,"UILEACU ŞIMLEULUI","ŞCOALA CU CLASELE I-IV UILEACU ȘIMLEULUI",224,"Alegeri Prezidentiale",1,370,127,114,13,0,123,4,400,273,108,15
33,SĂLAJ,"MESEŞENII DE JOS",142079,"MESEŞENII DE JOS","PRIMĂRIA COMUNEI MESEŞENII DE JOS",225,"Alegeri Prezidentiale",1,535,348,278,70,0,344,4,600,252,143,201
33,SĂLAJ,"MESEŞENII DE JOS",142079,AGHIREŞ,"CENTRUL AFTER SCHOOL",226,"Alegeri Prezidentiale",1,1208,573,498,75,0,563,10,1300,727,416,147
33,SĂLAJ,"MESEŞENII DE JOS",142079,FETINDIA,"ŞCOALA GIMNAZIALĂ FETINDIA",227,"Alegeri Prezidentiale",1,158,135,80,55,0,135,0,200,65,96,39
33,SĂLAJ,"MESEŞENII DE JOS",142079,"MESEŞENII DE SUS","CENTRUL DE ZI",228,"Alegeri Prezidentiale",1,644,396,305,91,0,391,5,700,304,263,128
33,SĂLAJ,MIRŞID,142122,MIRŞID,"SALA DE ŞEDINŢE A PRIMĂRIEI",229,"Alegeri Prezidentiale",1,555,320,270,45,5,317,3,600,280,189,128
33,SĂLAJ,MIRŞID,142122,FIRMINIŞ,"CĂMINUL CULTURAL FIRMINIŞ",230,"Alegeri Prezidentiale",1,117,123,60,62,1,122,1,150,27,83,39
33,SĂLAJ,MIRŞID,142122,MOIGRAD-POROLISSUM,"ŞCOALA CU CLASE I-IV",231,"Alegeri Prezidentiale",1,444,222,192,30,0,220,2,500,278,154,66
33,SĂLAJ,MIRŞID,142122,POPENI,"ŞCOALA CU CLASE I-IV",232,"Alegeri Prezidentiale",1,736,388,346,36,6,383,5,800,412,179,204
33,SĂLAJ,NĂPRADEA,142177,NĂPRADEA,"PRIMĂRIA NĂPRADEA",233,"Alegeri Prezidentiale",1,644,319,263,56,0,317,2,694,375,194,123
33,SĂLAJ,NĂPRADEA,142177,CHEUD,"ŞCOALA GIMNAZIALĂ ”PETRE HOSSU”",234,"Alegeri Prezidentiale",1,698,387,332,54,1,387,0,800,413,181,206
33,SĂLAJ,NĂPRADEA,142177,SOMEŞ-GURUSLĂU,"ŞCOALA SOMEŞ GURUSLĂU",235,"Alegeri Prezidentiale",1,350,193,153,40,0,191,2,400,207,119,72
33,SĂLAJ,NĂPRADEA,142177,TRANIŞ,"ŞCOALA TRANIŞ",236,"Alegeri Prezidentiale",1,279,141,116,25,0,140,1,300,159,83,57
33,SĂLAJ,NĂPRADEA,142177,VĂDURELE,"ŞCOALA VĂDURELE",237,"Alegeri Prezidentiale",1,166,104,86,18,0,104,0,200,96,65,39
33,SĂLAJ,NUŞFALĂU,142239,BILGHEZ,"CĂMINUL CULTURAL",238,"Alegeri Prezidentiale",1,334,115,98,16,1,112,3,400,285,95,17
33,SĂLAJ,NUŞFALĂU,142239,NUŞFALĂU,"CENTRUL DE INFORMARE TURISTICĂ",239,"Alegeri Prezidentiale",1,1316,542,510,32,0,533,9,1300,758,371,162
33,SĂLAJ,NUŞFALĂU,142239,NUŞFALĂU,"PRIMĂRIA NUȘFALĂU - SALA DE ȘEDINȚE",240,"Alegeri Prezidentiale",1,1413,515,490,25,0,498,17,1500,985,391,107
33,SĂLAJ,PERICEI,142284,PERICEI,"GRĂDINIȚA CU PROGRAM PRELUNGIT NR.1 PERICEI",241,"Alegeri Prezidentiale",1,1099,325,309,15,1,314,11,1200,875,263,51
33,SĂLAJ,PERICEI,142284,PERICEI,"PRIMĂRIA COMUNEI PERICEI",242,"Alegeri Prezidentiale",1,1247,465,445,20,0,447,18,1300,835,375,72
33,SĂLAJ,PERICEI,142284,BĂDĂCIN,"ȘCOALA GENERALĂ BĂDĂCIN",243,"Alegeri Prezidentiale",1,550,298,239,59,0,294,4,600,302,242,52
33,SĂLAJ,PERICEI,142284,SICI,"CENTRU DE INFORMARE ȘI MARKETING TURISTIC",244,"Alegeri Prezidentiale",1,142,82,49,33,0,81,1,200,118,44,37
33,SĂLAJ,PLOPIŞ,142337,PLOPIŞ,"CĂMINUL CULTURAL PLOPIȘ",245,"Alegeri Prezidentiale",1,810,376,324,52,0,372,4,900,524,296,76
33,SĂLAJ,PLOPIŞ,142337,IAZ,"CENTRUL CULTURAL IAZ",246,"Alegeri Prezidentiale",1,610,230,200,29,1,226,4,700,470,190,36
33,SĂLAJ,PLOPIŞ,142337,FĂGETU,"CĂMINUL CULTURAL FĂGETU",247,"Alegeri Prezidentiale",1,527,242,206,36,0,242,0,600,358,213,29
33,SĂLAJ,"POIANA BLENCHII",142373,"POIANA BLENCHII","ŞCOALA GIMNAZIALĂ POIANA BLENCHII",248,"Alegeri Prezidentiale",1,607,342,278,63,1,338,4,700,358,216,122
33,SĂLAJ,"POIANA BLENCHII",142373,GOSTILA,"ŞCOALA CU CLASELE I-IV GOSTILA",249,"Alegeri Prezidentiale",1,322,182,145,37,0,181,1,400,218,109,72
33,SĂLAJ,ROMÂNAŞI,142426,ROMÂNAŞI,"CENTRUL DE INFORMARE ȘI MARKETING TURISTIC",250,"Alegeri Prezidentiale",1,803,413,342,71,0,410,3,900,487,310,100
33,SĂLAJ,ROMÂNAŞI,142426,CHICHIŞA,"ȘCOALA CU CLASELE I-IV CHICHIȘA",251,"Alegeri Prezidentiale",1,193,125,94,31,0,123,2,250,125,79,44
33,SĂLAJ,ROMÂNAŞI,142426,CIUMĂRNA,"ȘCOALA CU CLASELE I-IV CIUMĂRNA",252,"Alegeri Prezidentiale",1,333,227,163,64,0,225,2,400,173,157,68
33,SĂLAJ,ROMÂNAŞI,142426,PĂUŞA,"ȘCOALA CU CLASELE I-IV PĂUȘA",253,"Alegeri Prezidentiale",1,409,231,191,40,0,231,0,450,219,149,82
33,SĂLAJ,ROMÂNAŞI,142426,"POARTA SĂLAJULUI","ȘCOALA CU CLASELE I-IV POARTA SĂLAJULUI",254,"Alegeri Prezidentiale",1,374,238,172,66,0,234,4,400,162,170,64
33,SĂLAJ,ROMÂNAŞI,142426,ROMITA,"ȘCOALA CU CLASELE I-IV ROMITA",255,"Alegeri Prezidentiale",1,245,125,90,35,0,124,1,300,175,92,32
33,SĂLAJ,RUS,142499,RUS,"ŞCOALA GIMNAZIALĂ RUS",256,"Alegeri Prezidentiale",1,593,316,266,50,0,314,2,600,284,179,135
33,SĂLAJ,RUS,142499,FÂNTÂNELE-RUS,"ŞCOALA PRIMARĂ FÎNTÎNELE-RUS",257,"Alegeri Prezidentiale",1,148,114,87,27,0,113,1,200,86,70,43
33,SĂLAJ,RUS,142499,BUZAŞ,"ŞCOALA PRIMARĂ BUZAŞ",258,"Alegeri Prezidentiale",1,112,100,66,34,0,99,1,200,100,62,37
33,SĂLAJ,SĂLĂŢIG,142550,SĂLĂŢIG,"ȘCOALA GIMNAZIALĂ ”PETRE DULFU” SĂLĂȚIG",259,"Alegeri Prezidentiale",1,400,183,168,15,0,182,1,450,267,145,37
33,SĂLAJ,SĂLĂŢIG,142550,BULGARI,"ȘCOALA PRIMARĂ BULGARI",260,"Alegeri Prezidentiale",1,183,114,95,19,0,112,2,200,86,73,39
33,SĂLAJ,SĂLĂŢIG,142550,DEJA,"ȘCOALA GIMNAZIALĂ DEJA",261,"Alegeri Prezidentiale",1,987,194,180,14,0,182,12,1100,906,130,52
33,SĂLAJ,SĂLĂŢIG,142550,MINEU,"ȘCOALA PRIMARĂ MINEU",262,"Alegeri Prezidentiale",1,264,97,76,21,0,97,0,300,203,65,32
33,SĂLAJ,SĂLĂŢIG,142550,NOŢIG,"ȘCOALA PRIMARĂ NOȚIG",263,"Alegeri Prezidentiale",1,381,214,165,49,0,212,2,400,186,176,36
33,SĂLAJ,SÂG,142612,SÂG,"PRIMĂRIA SÎG",264,"Alegeri Prezidentiale",1,571,239,221,18,0,239,0,600,361,206,33
33,SĂLAJ,SÂG,142612,FIZEŞ,"CĂMINUL CULTURAL FIZEȘ",265,"Alegeri Prezidentiale",1,270,137,106,31,0,137,0,300,163,95,42
33,SĂLAJ,SÂG,142612,MAL,"CĂMINUL CULTURAL MAL",266,"Alegeri Prezidentiale",1,910,437,396,41,0,428,9,1000,563,248,180
33,SĂLAJ,SÂG,142612,SÂRBI,"ȘCOALA PRIMARĂ SÎRBI",267,"Alegeri Prezidentiale",1,216,91,71,20,0,91,0,250,159,67,24
33,SĂLAJ,SÂG,142612,TUSA,"CĂMINUL CULTURAL TUSA",268,"Alegeri Prezidentiale",1,555,217,199,18,0,216,1,600,383,155,61
33,SĂLAJ,"SÂNMIHAIU ALMAŞULUI",142676,"SÂNMIHAIU ALMAŞULUI","SEDIUL CONSILIU LOCAL SÎNMIHAIU ALMAŞULUI",269,"Alegeri Prezidentiale",1,861,450,343,106,1,445,5,900,450,247,198
33,SĂLAJ,"SÂNMIHAIU ALMAŞULUI",142676,BERCEA,"IMOBIL PROPRIETATE PRIVATA",270,"Alegeri Prezidentiale",1,133,67,52,15,0,67,0,200,133,38,29
33,SĂLAJ,"SÂNMIHAIU ALMAŞULUI",142676,"SÂNTĂ MĂRIA","ŞCOALA CU CLASELE I - IV SÎNTĂ MĂRIA",271,"Alegeri Prezidentiale",1,315,167,135,32,0,167,0,350,183,117,50
33,SĂLAJ,SOMEŞ-ODORHEI,142710,SOMEŞ-ODORHEI,"CĂMINUL CULTURAL SOMEȘ-ODORHEI",272,"Alegeri Prezidentiale",1,1108,596,519,71,6,586,10,1200,604,429,157
33,SĂLAJ,SOMEŞ-ODORHEI,142710,INĂU,"CĂMINUL CULTURAL INĂU",273,"Alegeri Prezidentiale",1,491,322,262,41,19,316,6,500,178,193,123
33,SĂLAJ,SOMEŞ-ODORHEI,142710,ŞOIMUŞ,"CĂMINUL CULTURAL ȘOIMUȘ",274,"Alegeri Prezidentiale",1,261,158,105,53,0,154,4,300,142,56,98
33,SĂLAJ,SOMEŞ-ODORHEI,142710,BÂRSA,"ȘCOALA PRIMARĂ BÎRSA",275,"Alegeri Prezidentiale",1,84,47,30,17,0,47,0,150,103,30,17
33,SĂLAJ,SOMEŞ-ODORHEI,142710,DOMNIN,"ȘCOALA PRIMARĂ DOMNIN",276,"Alegeri Prezidentiale",1,255,168,114,46,8,167,1,300,132,94,73
33,SĂLAJ,SURDUC,142774,SURDUC,"CĂMINUL CULTURAL SURDUC",277,"Alegeri Prezidentiale",1,1075,670,572,96,2,659,11,1100,430,421,238
33,SĂLAJ,SURDUC,142774,BRÂGLEZ,"CĂMINUL CULTURAL BRÎGLEZ",278,"Alegeri Prezidentiale",1,223,170,118,50,2,168,2,300,130,108,60
33,SĂLAJ,SURDUC,142774,CRISTOLŢEL,"ȘCOALA PRIMARĂ CLASELE I-IV CRISTOLȚEL",279,"Alegeri Prezidentiale",1,358,178,158,20,0,178,0,400,222,130,48
33,SĂLAJ,SURDUC,142774,SOLONA,"CĂMINUL CULTURAL SOLONA",280,"Alegeri Prezidentiale",1,188,127,94,33,0,127,0,250,123,72,55
33,SĂLAJ,SURDUC,142774,TEŞTIOARA,"CĂMINUL CULTURAL TEȘTIOARA",281,"Alegeri Prezidentiale",1,67,53,31,22,0,53,0,100,47,25,28
33,SĂLAJ,SURDUC,142774,TIHĂU,"CĂMINUL CULTURAL TIHĂU",282,"Alegeri Prezidentiale",1,888,607,501,91,15,605,2,1000,393,391,214
33,SĂLAJ,SURDUC,142774,TURBUŢA,"ȘCOALA PRIMARĂ CLASELE I-IV TURBUȚA",283,"Alegeri Prezidentiale",1,239,105,84,21,0,104,1,300,195,71,33
33,SĂLAJ,ŞAMŞUD,142854,ŞAMŞUD,"PRIMĂRIA COMUNEI ŞAMŞUD",284,"Alegeri Prezidentiale",1,918,254,238,16,0,247,7,1000,746,164,83
33,SĂLAJ,ŞAMŞUD,142854,"VALEA POMILOR","CENTRUL DE INFORMARE ŞI PROMOVARE TURISTICĂ VALEA POMILOR",285,"Alegeri Prezidentiale",1,477,144,128,16,0,141,3,500,356,115,26
33,SĂLAJ,ŞĂRMĂŞAG,142881,ŞĂRMĂŞAG,"CENTRUL CULTURAL COMUNITAR ȘĂRMĂȘAG",286,"Alegeri Prezidentiale",1,953,243,230,13,0,234,9,1100,857,181,53
33,SĂLAJ,ŞĂRMĂŞAG,142881,ŞĂRMĂŞAG,"LICEUL TEHNOLOGIC NR.1 ȘĂRMĂȘAG",287,"Alegeri Prezidentiale",1,825,233,222,11,0,231,2,900,667,171,60
33,SĂLAJ,ŞĂRMĂŞAG,142881,ŞĂRMĂŞAG,"GRĂDINIȚA DE COPII NR.3 ȘĂRMĂȘAG",288,"Alegeri Prezidentiale",1,885,213,205,8,0,212,1,1000,787,168,44
33,SĂLAJ,ŞĂRMĂŞAG,142881,ŞĂRMĂŞAG,"ȘCOALA GENERALĂ NR.2 ȘĂRMĂȘAG",289,"Alegeri Prezidentiale",1,1218,347,336,11,0,345,2,1300,953,256,89
33,SĂLAJ,ŞĂRMĂŞAG,142881,ILIŞUA,"ȘCOALA GENERALĂ ”SELYMES PETER” ILIȘUA",290,"Alegeri Prezidentiale",1,567,166,139,27,0,162,4,600,434,149,13
33,SĂLAJ,ŞĂRMĂŞAG,142881,LOMPIRT,"ȘCOALA GENERALĂ ”ADY ENDRE” LOMPIRT",291,"Alegeri Prezidentiale",1,701,200,176,24,0,197,3,800,600,154,43
33,SĂLAJ,ŞĂRMĂŞAG,142881,MOIAD,"CĂMINUL CULTURAL MOIAD",292,"Alegeri Prezidentiale",1,177,93,71,22,0,93,0,200,107,66,27
33,SĂLAJ,ŞIMIŞNA,179695,ŞIMIŞNA,"ȘCOALA GIMNAZIALĂ ȘIMIȘNA",293,"Alegeri Prezidentiale",1,703,324,264,60,0,321,3,800,476,157,164
33,SĂLAJ,ŞIMIŞNA,179695,HĂŞMAŞ,"CĂMINUL CULTURAL HĂȘMAȘ",294,"Alegeri Prezidentiale",1,225,131,104,27,0,129,2,250,119,65,64
33,SĂLAJ,TREZNEA,179631,TREZNEA,"ȘCOALA GIMNAZIALĂ TREZNEA",295,"Alegeri Prezidentiale",1,648,451,369,82,0,447,4,700,249,232,215
33,SĂLAJ,TREZNEA,179631,BOZNA,"ȘCOALA GENERALĂ BOZNA",296,"Alegeri Prezidentiale",1,196,136,104,32,0,134,2,250,114,100,34
33,SĂLAJ,"VALCĂU DE JOS",142952,"VALCĂU DE JOS","ȘCOALA GIMNAZIALĂ CU CLASELE I-VIII",297,"Alegeri Prezidentiale",1,732,349,323,26,0,343,6,800,451,279,64
33,SĂLAJ,"VALCĂU DE JOS",142952,"VALCĂU DE SUS","ȘCOALA GIMNAZIALĂ",298,"Alegeri Prezidentiale",1,712,441,421,20,0,437,4,800,359,225,212
33,SĂLAJ,"VALCĂU DE JOS",142952,PREOTEASA,"ȘCOALA GIMNAZIALĂ",299,"Alegeri Prezidentiale",1,517,252,237,15,0,250,2,600,348,205,45
33,SĂLAJ,"VALCĂU DE JOS",142952,LAZURI,GRĂDINIȚA,300,"Alegeri Prezidentiale",1,199,125,116,9,0,123,2,250,125,88,35
33,SĂLAJ,"VALCĂU DE JOS",142952,"SUB CETATE","ȘCOALA CU CLASELE I-IV",301,"Alegeri Prezidentiale",1,289,176,159,17,0,172,4,350,174,135,37
33,SĂLAJ,VÂRŞOLŢ,143021,VÂRŞOLŢ,"PRIMĂRIA COMUNEI VÎRȘOLȚ",302,"Alegeri Prezidentiale",1,1408,338,317,21,0,334,4,1500,1162,265,69
33,SĂLAJ,VÂRŞOLŢ,143021,RECEA,"CĂMINUL CULTURAL RECEA",303,"Alegeri Prezidentiale",1,471,220,170,50,0,219,1,500,280,144,75
33,SĂLAJ,ZALHA,143067,ZALHA,"ȘCOALA GIMNAZIALĂ NR.1 ZALHA",304,"Alegeri Prezidentiale",1,219,122,89,33,0,120,2,250,128,58,62
33,SĂLAJ,ZALHA,143067,CEACA,"ȘCOALA CU CLASELE I-IV CEACA",305,"Alegeri Prezidentiale",1,165,101,78,23,0,101,0,200,99,63,38
33,SĂLAJ,ZALHA,143067,"VALEA HRANEI","ȘCOALA CU CLASELE I-IV VALEA HRANEI",306,"Alegeri Prezidentiale",1,65,65,39,26,0,65,0,100,35,53,12
33,SĂLAJ,ZALHA,143067,CIURENI,"ȘCOALA CU CLASELE I-IV CIURENI",307,"Alegeri Prezidentiale",1,113,72,55,17,0,71,1,200,128,44,27
33,SĂLAJ,ZALHA,143067,"VALEA LUNGĂ","ȘCOALA CU CLASELE I-IV VALEA LUNGĂ",308,"Alegeri Prezidentiale",1,119,55,45,10,0,54,1,200,145,44,10
33,SĂLAJ,ZIMBOR,143147,DOLU,"CĂMINUL CULTURAL DOLU",309,"Alegeri Prezidentiale",1,47,55,20,35,0,54,1,100,45,43,11
33,SĂLAJ,ZIMBOR,143147,SUTORU,"CĂMINUL CULTURAL SUTORU",310,"Alegeri Prezidentiale",1,104,98,52,46,0,98,0,200,102,83,15
33,SĂLAJ,ZIMBOR,143147,ZIMBOR,"PRIMĂRIA COMUNEI ZIMBOR",311,"Alegeri Prezidentiale",1,516,309,252,57,0,309,0,600,291,240,69
33,SĂLAJ,ZIMBOR,143147,"SÂNCRAIU ALMAŞULUI","CĂMINUL CULTURAL SÂNCRAIU ALMAȘULUI",312,"Alegeri Prezidentiale",1,145,126,62,64,0,124,2,200,74,85,39
34,SIBIU,"MUNICIPIUL SIBIU",143450,SIBIU,"ŞCOALA GIMNAZIALĂ NR. 10 CU STRUCTURA GRADINIŢA CU PROGRAM PRELUNGIT NR. 20",1,"Alegeri Prezidentiale",1,1695,939,872,67,0,932,7,1750,811,829,103
34,SIBIU,"MUNICIPIUL SIBIU",143450,SIBIU,"ŞCOALA GIMNAZIALĂ NR. 10 CU STRUCTURA GRADINIŢA CU PROGRAM PRELUNGIT NR. 20",2,"Alegeri Prezidentiale",1,1639,884,839,45,0,873,11,1750,866,767,106
34,SIBIU,"MUNICIPIUL SIBIU",143450,SIBIU,"ŞCOALA GIMNAZIALĂ NR.10",3,"Alegeri Prezidentiale",1,1454,911,800,111,0,897,14,1600,689,784,113
34,SIBIU,"MUNICIPIUL SIBIU",143450,SIBIU,"ŞCOALA GIMNAZIALĂ NR.10",4,"Alegeri Prezidentiale",1,1356,1001,747,254,0,985,16,1500,499,849,136
34,SIBIU,"MUNICIPIUL SIBIU",143450,SIBIU,"ŞCOALA GIMNAZIALĂ NR.10",5,"Alegeri Prezidentiale",1,1664,1145,943,202,0,1132,13,1800,655,982,150
34,SIBIU,"MUNICIPIUL SIBIU",143450,SIBIU,"ŞCOALA GIMNAZIALĂ NR. 13 CU STRUCTURA ŞCOALA GIMNAZIALĂ NR. 12",6,"Alegeri Prezidentiale",2,1692,996,886,110,0,981,15,1800,804,843,138
34,SIBIU,"MUNICIPIUL SIBIU",143450,SIBIU,"ŞCOALA GIMNAZIALĂ NR. 13 CU STRUCTURA ŞCOALA GIMNAZIALĂ NR. 12",7,"Alegeri Prezidentiale",1,1303,847,745,102,0,834,13,1400,553,703,131
34,SIBIU,"MUNICIPIUL SIBIU",143450,SIBIU,"ŞCOALA GIMNAZIALĂ NR. 13 CU STRUCTURA ŞCOALA GIMNAZIALĂ NR. 12",8,"Alegeri Prezidentiale",2,1511,973,895,77,1,959,14,1500,527,816,143
34,SIBIU,"MUNICIPIUL SIBIU",143450,SIBIU,"LICEUL TEHNOLOGIC CONSTRUCȚII ŞI ARHITECTURĂ CAROL I SIBIU",9,"Alegeri Prezidentiale",1,1922,1418,1134,225,59,1400,18,2100,682,1246,154
34,SIBIU,"MUNICIPIUL SIBIU",143450,SIBIU,"ŞCOALA GIMNAZIALĂ NR.13",10,"Alegeri Prezidentiale",2,1038,733,624,109,0,723,10,1050,317,632,91
34,SIBIU,"MUNICIPIUL SIBIU",143450,SIBIU,"ŞCOALA GIMNAZIALĂ NR.13",11,"Alegeri Prezidentiale",1,1212,837,697,139,1,829,8,1250,413,746,83
34,SIBIU,"MUNICIPIUL SIBIU",143450,SIBIU,"ŞCOALA GIMNAZIALĂ NR.13",12,"Alegeri Prezidentiale",1,1253,846,710,136,0,836,10,1400,554,723,113
34,SIBIU,"MUNICIPIUL SIBIU",143450,SIBIU,"ŞCOALA GIMNAZIALĂ NR.23",13,"Alegeri Prezidentiale",2,1907,1257,1196,61,0,1243,14,2100,843,1110,133
34,SIBIU,"MUNICIPIUL SIBIU",143450,SIBIU,"ŞCOALA GIMNAZIALĂ NR.23",14,"Alegeri Prezidentiale",1,1414,789,712,77,0,775,14,1500,711,691,84
34,SIBIU,"MUNICIPIUL SIBIU",143450,SIBIU,"ŞCOALA GIMNAZIALĂ NR.23",15,"Alegeri Prezidentiale",1,1155,648,594,54,0,644,4,1300,652,573,71
34,SIBIU,"MUNICIPIUL SIBIU",143450,SIBIU,"COLEGIUL TEHNIC INDEPENDENŢA",16,"Alegeri Prezidentiale",2,1341,878,717,161,0,866,12,1450,572,747,119
34,SIBIU,"MUNICIPIUL SIBIU",143450,SIBIU,"COLEGIUL TEHNIC DE INDUSTRIE ALIMENTARĂ TEREZIANUM SIBIU",17,"Alegeri Prezidentiale",1,1522,1073,905,108,60,1065,8,1700,627,919,146
34,SIBIU,"MUNICIPIUL SIBIU",143450,SIBIU,"COLEGIUL TEHNIC DE INDUSTRIE ALIMENTARĂ TEREZIANUM SIBIU",18,"Alegeri Prezidentiale",1,1469,988,870,54,64,975,13,1600,612,840,135
34,SIBIU,"MUNICIPIUL SIBIU",143450,SIBIU,"ŞCOALA GIMNAZIALĂ NR.18",19,"Alegeri Prezidentiale",1,1760,1198,1052,146,0,1188,10,1800,602,1043,145
34,SIBIU,"MUNICIPIUL SIBIU",143450,SIBIU,"ŞCOALA GIMNAZIALĂ NR.18",20,"Alegeri Prezidentiale",1,1660,1135,982,140,13,1118,17,1670,535,1003,115
34,SIBIU,"MUNICIPIUL SIBIU",143450,SIBIU,"ŞCOALA GIMNAZIALĂ IOAN SLAVICI CU STRUCTURA ŞCOALA GIMNAZIALĂ NR. 11",21,"Alegeri Prezidentiale",1,1586,806,755,50,1,794,12,1600,794,682,112
34,SIBIU,"MUNICIPIUL SIBIU",143450,SIBIU,"ŞCOALA GIMNAZIALĂ IOAN SLAVICI CU STRUCTURA ŞCOALA GIMNAZIALĂ NR. 11",22,"Alegeri Prezidentiale",1,1629,948,871,77,0,935,13,1630,682,797,138
34,SIBIU,"MUNICIPIUL SIBIU",143450,SIBIU,"ŞCOALA GIMNAZIALĂ IOAN SLAVICI",23,"Alegeri Prezidentiale",1,1667,1167,1030,135,2,1148,19,1670,503,974,174
34,SIBIU,"MUNICIPIUL SIBIU",143450,SIBIU,"ŞCOALA GIMNAZIALĂ IOAN SLAVICI",24,"Alegeri Prezidentiale",1,1476,1020,863,156,1,1000,20,1480,460,831,169
34,SIBIU,"MUNICIPIUL SIBIU",143450,SIBIU,"LICEUL TEHNOLOGIC HENRI COANDĂ",25,"Alegeri Prezidentiale",2,1108,726,583,143,0,721,5,1200,474,625,96
34,SIBIU,"MUNICIPIUL SIBIU",143450,SIBIU,"LICEUL TEHNOLOGIC HENRI COANDĂ",26,"Alegeri Prezidentiale",1,984,698,608,90,0,686,12,1100,402,593,93
34,SIBIU,"MUNICIPIUL SIBIU",143450,SIBIU,"LICEUL TEHNOLOGIC HENRI COANDĂ",27,"Alegeri Prezidentiale",1,1677,938,886,52,0,932,6,1900,962,826,106
34,SIBIU,"MUNICIPIUL SIBIU",143450,SIBIU,"ŞCOALA GIMNAZIALĂ NR. 8",28,"Alegeri Prezidentiale",2,1163,705,660,45,0,696,9,1300,595,602,94
34,SIBIU,"MUNICIPIUL SIBIU",143450,SIBIU,"ŞCOALA GIMNAZIALĂ NR. 8",29,"Alegeri Prezidentiale",2,1390,914,838,75,1,901,13,1500,586,775,126
34,SIBIU,"MUNICIPIUL SIBIU",143450,SIBIU,"ŞCOALA GIMNAZIALĂ NR. 8",30,"Alegeri Prezidentiale",1,1258,828,742,86,0,817,11,1400,572,663,154
34,SIBIU,"MUNICIPIUL SIBIU",143450,SIBIU,"ŞCOALA GIMNAZIALĂ NR. 8",31,"Alegeri Prezidentiale",1,1631,1046,968,77,1,1035,11,1800,754,886,149
34,SIBIU,"MUNICIPIUL SIBIU",143450,SIBIU,"GRĂDINIŢA CU PROGRAM PRELUNGIT NR. 17",32,"Alegeri Prezidentiale",1,1041,572,469,103,0,562,10,1100,528,470,92
34,SIBIU,"MUNICIPIUL SIBIU",143450,SIBIU,"GRĂDINIŢA CU PROGRAM PRELUNGIT NR. 37",33,"Alegeri Prezidentiale",1,1326,824,643,181,0,809,15,1500,676,675,134
34,SIBIU,"MUNICIPIUL SIBIU",143450,SIBIU,"ȘCOALA GIMNAZIALĂ NR.2 SIBIU",34,"Alegeri Prezidentiale",1,1308,1083,665,339,79,1073,10,1400,317,910,163
34,SIBIU,"MUNICIPIUL SIBIU",143450,SIBIU,"ȘCOALA GIMNAZIALĂ NR.2 SIBIU",35,"Alegeri Prezidentiale",1,1085,1046,620,378,48,1036,10,1150,104,869,167
34,SIBIU,"MUNICIPIUL SIBIU",143450,SIBIU,"ŞCOALA GIMNAZIALĂ NR.2",36,"Alegeri Prezidentiale",1,1122,853,522,263,68,837,16,1200,347,695,142
34,SIBIU,"MUNICIPIUL SIBIU",143450,SIBIU,"COLEGIUL NAŢIONAL GHEORGHE LAZĂR SIBIU",37,"Alegeri Prezidentiale",1,1176,1691,560,1061,70,1656,35,1948,257,1422,234
34,SIBIU,"MUNICIPIUL SIBIU",143450,SIBIU,"LICEUL DE ARTĂ SIBIU",38,"Alegeri Prezidentiale",1,794,861,353,475,33,835,26,900,39,717,118
34,SIBIU,"MUNICIPIUL SIBIU",143450,SIBIU,"LICEUL DE ARTĂ SIBIU",39,"Alegeri Prezidentiale",1,926,1087,409,609,69,1068,19,1550,463,895,173
34,SIBIU,"MUNICIPIUL SIBIU",143450,SIBIU,"COLEGIUL TEHNIC INDEPENDENŢA SIBIU",40,"Alegeri Prezidentiale",1,1193,882,575,306,1,862,20,1300,418,725,137
34,SIBIU,"MUNICIPIUL SIBIU",143450,SIBIU,"COLEGIUL NAŢIONAL OCTAVIAN GOGA SIBIU",41,"Alegeri Prezidentiale",1,981,924,470,454,0,903,21,1100,176,733,170
34,SIBIU,"MUNICIPIUL SIBIU",143450,SIBIU,"COLEGIUL NAŢIONAL OCTAVIAN GOGA CU STRUCTURĂ ŞCOALA CU CLASELE I-VIII NR. 15",42,"Alegeri Prezidentiale",1,1165,924,608,316,0,902,22,1300,376,759,143
34,SIBIU,"MUNICIPIUL SIBIU",143450,SIBIU,"ŞCOALA GIMNAZIALĂ REGINA MARIA",43,"Alegeri Prezidentiale",2,1175,978,707,270,1,963,15,1300,322,815,148
34,SIBIU,"MUNICIPIUL SIBIU",143450,SIBIU,"ŞCOALA GIMNAZIALĂ REGINA MARIA",44,"Alegeri Prezidentiale",1,1073,813,592,220,1,801,12,1200,387,639,162
34,SIBIU,"MUNICIPIUL SIBIU",143450,SIBIU,"COLEGIUL AGRICOL DANIIL POPOVICI BARCIANU SIBIU",45,"Alegeri Prezidentiale",1,1091,925,553,318,54,904,21,1200,275,774,130
34,SIBIU,"MUNICIPIUL SIBIU",143450,SIBIU,"CASA CORPULUI DIDACTIC",46,"Alegeri Prezidentiale",1,1439,953,838,114,1,935,18,1600,647,785,150
34,SIBIU,"MUNICIPIUL SIBIU",143450,SIBIU,"LICEUL TEORETIC ONISIFOR GHIBU",47,"Alegeri Prezidentiale",1,1222,1028,731,297,0,1010,18,1400,372,858,152
34,SIBIU,"MUNICIPIUL SIBIU",143450,SIBIU,"ŞCOALA GIMNAZIALĂ NR. 1",48,"Alegeri Prezidentiale",1,1489,1157,880,275,2,1138,19,1600,443,970,168
34,SIBIU,"MUNICIPIUL SIBIU",143450,SIBIU,"ŞCOALA GIMNAZIALĂ NR. 1",49,"Alegeri Prezidentiale",1,1498,1006,913,92,1,997,9,1700,694,840,157
34,SIBIU,"MUNICIPIUL SIBIU",143450,SIBIU,"ŞCOALA GIMNAZIALĂ NR. 1",50,"Alegeri Prezidentiale",2,1564,1057,909,146,2,1038,19,1700,643,890,148
34,SIBIU,"MUNICIPIUL SIBIU",143450,SIBIU,"ŞCOALA GIMNAZIALĂ NR. 1",51,"Alegeri Prezidentiale",1,1645,1024,962,61,1,1013,11,1800,776,867,146
34,SIBIU,"MUNICIPIUL SIBIU",143450,SIBIU,"GRĂDINIŢA CU PROGRAM PRELUNGIT NR. 22",52,"Alegeri Prezidentiale",1,1468,955,900,54,1,939,16,1600,645,790,149
34,SIBIU,"MUNICIPIUL SIBIU",143450,SIBIU,"GRĂDINIŢA CU PROGRAM PRELUNGIT NR. 22",53,"Alegeri Prezidentiale",1,1431,990,905,85,0,977,13,1592,602,821,156
34,SIBIU,"MUNICIPIUL SIBIU",143450,SIBIU,"GRĂDINIŢA CU PROGRAM PRELUNGIT NR. 22",54,"Alegeri Prezidentiale",2,1716,1169,1094,75,0,1149,20,1900,731,1011,138
34,SIBIU,"MUNICIPIUL SIBIU",143450,SIBIU,"GRĂDINIŢA CU PROGRAM PRELUNGIT NR. 22",55,"Alegeri Prezidentiale",1,1093,851,632,219,0,838,13,1200,349,724,114
34,SIBIU,"MUNICIPIUL SIBIU",143450,SIBIU,"ŞCOALA GIMNAZIALĂ NR. 25",56,"Alegeri Prezidentiale",1,1243,849,721,128,0,833,16,1400,551,717,116
34,SIBIU,"MUNICIPIUL SIBIU",143450,SIBIU,"ŞCOALA GIMNAZIALĂ NR. 25",57,"Alegeri Prezidentiale",3,1335,923,794,128,1,909,14,1500,577,771,138
34,SIBIU,"MUNICIPIUL SIBIU",143450,SIBIU,"ŞCOALA GIMNAZIALĂ NR. 25",58,"Alegeri Prezidentiale",2,1313,899,813,86,0,891,8,1400,501,767,124
34,SIBIU,"MUNICIPIUL SIBIU",143450,SIBIU,"ŞCOALA GIMNAZIALĂ NR. 25",59,"Alegeri Prezidentiale",1,1599,1026,960,66,0,1008,18,1800,774,875,133
34,SIBIU,"MUNICIPIUL SIBIU",143450,SIBIU,"ŞCOALA GIMNAZIALĂ ION LUCA CARAGIALE",60,"Alegeri Prezidentiale",1,1387,1007,894,112,1,991,16,1500,493,836,155
34,SIBIU,"MUNICIPIUL SIBIU",143450,SIBIU,"ŞCOALA GIMNAZIALĂ ION LUCA CARAGIALE",61,"Alegeri Prezidentiale",1,1178,767,704,63,0,756,11,1300,533,638,118
34,SIBIU,"MUNICIPIUL SIBIU",143450,SIBIU,"ŞCOALA GIMNAZIALĂ ION LUCA CARAGIALE",62,"Alegeri Prezidentiale",1,1131,754,695,56,3,746,8,1200,446,626,120
34,SIBIU,"MUNICIPIUL SIBIU",143450,SIBIU,"FACULTATEA DE INGINERIE",63,"Alegeri Prezidentiale",3,1187,1279,628,650,1,1249,30,1500,221,1043,206
34,SIBIU,"MUNICIPIUL SIBIU",143450,SIBIU,"COLEGIU ECONOMIC GEORGE BARIŢIU",64,"Alegeri Prezidentiale",1,1212,870,677,193,0,861,9,1300,430,717,144
34,SIBIU,"MUNICIPIUL SIBIU",143450,SIBIU,"COLEGIU ECONOMIC GEORGE BARIŢIU",65,"Alegeri Prezidentiale",1,1321,987,738,249,0,974,13,1400,413,794,180
34,SIBIU,"MUNICIPIUL SIBIU",143450,SIBIU,"COLEGIUL ECONOMIC GEORGE BARIŢIU, SIBIU",66,"Alegeri Prezidentiale",2,1257,963,750,213,0,946,17,1400,437,771,175
34,SIBIU,"MUNICIPIUL SIBIU",143450,SIBIU,"ȘCOALA GIMNAZIALĂ NR.4 SIBIU",67,"Alegeri Prezidentiale",1,1321,880,759,90,31,860,20,1500,620,675,185
34,SIBIU,"MUNICIPIUL SIBIU",143450,SIBIU,"ŞCOALA GIMNAZIALĂ NR.4",68,"Alegeri Prezidentiale",1,1352,916,769,147,0,899,17,1500,584,761,138
34,SIBIU,"MUNICIPIUL SIBIU",143450,SIBIU,"ŞCOALA GIMNAZIALĂ NR.4",69,"Alegeri Prezidentiale",1,1153,770,680,90,0,757,13,1300,530,627,130
34,SIBIU,"MUNICIPIUL SIBIU",143450,SIBIU,"ŞCOALA GIMNAZIALĂ NR.4",70,"Alegeri Prezidentiale",2,1413,971,850,120,1,953,18,1600,629,817,136
34,SIBIU,"MUNICIPIUL SIBIU",143450,SIBIU,"COLEGIUL TEHNIC ENERGETIC",71,"Alegeri Prezidentiale",1,1318,1069,809,259,1,1059,10,1500,431,921,138
34,SIBIU,"MUNICIPIUL SIBIU",143450,SIBIU,"COLEGIUL TEHNIC ENERGETIC",72,"Alegeri Prezidentiale",1,1281,906,657,249,0,899,7,1400,494,786,113
34,SIBIU,"MUNICIPIUL SIBIU",143450,SIBIU,"COLEGIUL TEHNIC ENERGETIC",73,"Alegeri Prezidentiale",1,1491,963,841,122,0,949,14,1600,637,804,145
34,SIBIU,"MUNICIPIUL SIBIU",143450,SIBIU,"COLEGIUL TEHNIC ENERGETIC",74,"Alegeri Prezidentiale",1,1407,931,793,138,0,922,9,1600,669,788,134
34,SIBIU,"MUNICIPIUL SIBIU",143450,SIBIU,"ŞCOALA GIMNAZIALĂ REGELE FERDINAND",75,"Alegeri Prezidentiale",1,1263,807,636,171,0,799,8,1350,543,694,105
34,SIBIU,"MUNICIPIUL SIBIU",143450,SIBIU,"ŞCOALA GIMNAZIALĂ REGELE FERDINAND",76,"Alegeri Prezidentiale",1,1381,802,698,103,1,793,9,1500,698,684,109
34,SIBIU,"MUNICIPIUL SIBIU",143450,SIBIU,"ŞCOALA GIMNAZIALĂ REGELE FERDINAND",77,"Alegeri Prezidentiale",1,1330,878,785,93,0,865,13,1500,622,724,141
34,SIBIU,"MUNICIPIUL SIBIU",143450,SIBIU,"ŞCOALA GIMNAZIALĂ REGELE FERDINAND",78,"Alegeri Prezidentiale",2,1306,810,741,69,0,798,12,1400,590,679,119
34,SIBIU,"MUNICIPIUL SIBIU",143450,SIBIU,"ŞCOALA GIMNAZIALĂ REGELE FERDINAND",79,"Alegeri Prezidentiale",1,1013,611,564,46,1,608,3,1100,489,514,94
34,SIBIU,"MUNICIPIUL SIBIU",143450,SIBIU,"ŞCOALA GIMNAZIALĂ REGELE FERDINAND",80,"Alegeri Prezidentiale",1,1204,730,702,28,0,725,5,1300,570,619,106
34,SIBIU,"MUNICIPIUL SIBIU",143450,SIBIU,"ŞCOALA GIMNAZIALĂ REGELE FERDINAND",81,"Alegeri Prezidentiale",1,1228,656,620,36,0,651,5,1200,544,563,88
34,SIBIU,"MUNICIPIUL SIBIU",143450,SIBIU,"GRĂDINIŢA CU PROGRAM PRELUNGIT NR.29",82,"Alegeri Prezidentiale",1,1173,979,696,283,0,974,5,1300,321,842,132
34,SIBIU,"MUNICIPIUL SIBIU",143450,SIBIU,"ŞCOALA GIMNAZIALĂ RADU SELEJAN",83,"Alegeri Prezidentiale",1,1190,849,641,208,0,843,6,1300,451,741,102
34,SIBIU,"MUNICIPIUL SIBIU",143450,SIBIU,"ŞCOALA GIMNAZIALĂ RADU SELEJAN",84,"Alegeri Prezidentiale",1,968,678,511,166,1,666,12,1100,422,567,99
34,SIBIU,"MUNICIPIUL SIBIU",143450,SIBIU,"GRĂDINIŢA CU PROGRAM PRELUNGIT NR.33",85,"Alegeri Prezidentiale",1,1180,805,652,153,0,791,14,1300,495,650,141
34,SIBIU,"MUNICIPIUL SIBIU",143450,SIBIU,"ŞCOALA GIMNAZIALĂ NR. 21",86,"Alegeri Prezidentiale",1,1321,912,774,136,2,894,18,1500,588,739,155
34,SIBIU,"MUNICIPIUL SIBIU",143450,SIBIU,"ŞCOALA GIMNAZIALĂ NR. 21",87,"Alegeri Prezidentiale",1,925,673,516,156,1,670,3,1000,327,562,108
34,SIBIU,"MUNICIPIUL SIBIU",143450,SIBIU,"ŞCOALA GIMNAZIALĂ NR. 21",88,"Alegeri Prezidentiale",1,1005,776,587,189,0,770,6,1100,324,631,139
34,SIBIU,"MUNICIPIUL SIBIU",143450,SIBIU,"ŞCOALA GIMNAZIALĂ NR. 21",89,"Alegeri Prezidentiale",1,1215,782,673,109,0,765,17,1300,518,599,166
34,SIBIU,"MUNICIPIUL SIBIU",143450,SIBIU,"ŞCOALA GIMNAZIALĂ NICOLAE IORGA",90,"Alegeri Prezidentiale",1,1342,899,755,143,1,887,12,1400,501,760,127
34,SIBIU,"MUNICIPIUL SIBIU",143450,SIBIU,"ŞCOALA GIMNAZIALĂ NICOLAE IORGA",91,"Alegeri Prezidentiale",1,1360,1020,782,236,2,1011,9,1400,380,830,181
34,SIBIU,"MUNICIPIUL SIBIU",143450,SIBIU,"ŞCOALA GIMNAZIALĂ NICOLAE IORGA",92,"Alegeri Prezidentiale",2,1294,873,695,177,1,863,10,1200,327,746,117
34,SIBIU,"MUNICIPIUL SIBIU",143450,SIBIU,"ŞCOALA GIMNAZIALĂ NICOLAE IORGA",93,"Alegeri Prezidentiale",1,1063,705,578,127,0,695,10,1200,495,592,103
34,SIBIU,"MUNICIPIUL SIBIU",143450,SIBIU,"LICEUL TEORETIC CONSTANTIN NOICA",94,"Alegeri Prezidentiale",1,1214,963,694,268,1,945,18,1300,337,786,159
34,SIBIU,"MUNICIPIUL SIBIU",143450,SIBIU,"LICEUL TEORETIC CONSTANTIN NOICA",95,"Alegeri Prezidentiale",1,1338,1002,771,231,0,982,20,1500,498,830,152
34,SIBIU,"MUNICIPIUL SIBIU",143450,SIBIU,"LICEUL TEORETIC CONSTANTIN NOICA",96,"Alegeri Prezidentiale",2,1382,925,797,128,0,916,9,1500,575,773,143
34,SIBIU,"MUNICIPIUL SIBIU",143450,SIBIU,"GRĂDINIŢA CU PROGRAM PRELUNGIT ELEFĂNŢELUL CURIOS",97,"Alegeri Prezidentiale",1,1429,915,768,147,0,904,11,1600,685,775,129
34,SIBIU,"MUNICIPIUL SIBIU",143450,SIBIU,"COLEGIUL NAŢIONAL PEDAGOGIC ANDREI ŞAGUNA",98,"Alegeri Prezidentiale",1,1279,1013,746,265,2,1004,9,1400,387,810,194
34,SIBIU,"MUNICIPIUL SIBIU",143450,SIBIU,"COLEGIUL NAŢIONAL PEDAGOGIC ANDREI ŞAGUNA",99,"Alegeri Prezidentiale",1,1183,885,723,160,2,878,7,1300,415,705,173
34,SIBIU,"MUNICIPIUL SIBIU",143450,SIBIU,"GRĂDINIŢA CU PROGRAM PRELUNGIT NR. 42",100,"Alegeri Prezidentiale",1,1285,965,765,200,0,946,19,1400,435,772,174
34,SIBIU,"MUNICIPIUL SIBIU",143450,SIBIU,"GRĂDINIŢA CU PROGRAM PRELUNGIT NR. 43",101,"Alegeri Prezidentiale",1,1567,1288,963,325,0,1273,15,1716,428,1103,170
34,SIBIU,"MUNICIPIUL SIBIU",143450,SIBIU,"GRĂDINIŢA CU PROGRAM PRELUNGIT NR. 43",102,"Alegeri Prezidentiale",1,1416,1535,782,753,0,1523,12,1600,65,1380,143
34,SIBIU,"MUNICIPIUL SIBIU",143450,SIBIU,"GRĂDINIŢA CU PROGRAM PRELUNGIT NR. 5",103,"Alegeri Prezidentiale",2,1615,1092,917,175,0,1074,18,1800,708,898,176
34,SIBIU,"MUNICIPIUL SIBIU",143450,SIBIU,"GRĂDINIŢA CU PROGRAM PRELUNGIT NR. 5",104,"Alegeri Prezidentiale",1,1563,1126,904,221,1,1111,15,1700,574,932,179
34,SIBIU,"MUNICIPIUL SIBIU",143450,PĂLTINIŞ,PĂLTINIŞ,105,"Alegeri Prezidentiale",1,26,169,2,167,0,166,3,310,141,143,23
34,SIBIU,"MUNICIPIUL SIBIU",143450,SIBIU,"SCOALA GIMNAZIALA NR.10 SIBIU",106,"Alegeri Prezidentiale",1,1303,960,788,172,0,950,10,1400,440,861,89
34,SIBIU,"MUNICIPIUL MEDIAŞ",143619,MEDIAŞ,"ŞCOALA GIMNAZIALĂ HERMANN OBERTH",107,"Alegeri Prezidentiale",1,1121,565,423,65,77,557,8,1200,635,471,86
34,SIBIU,"MUNICIPIUL MEDIAŞ",143619,MEDIAŞ,"GRĂDINIŢA CU PROGRAM PRELUNGIT NR.12",108,"Alegeri Prezidentiale",1,1051,481,444,23,14,473,8,1200,719,390,83
34,SIBIU,"MUNICIPIUL MEDIAŞ",143619,MEDIAŞ,"ŞCOALA GIMNAZIALĂ MIHAI EMINESCU",109,"Alegeri Prezidentiale",1,1278,588,554,34,0,580,8,1400,812,480,100
34,SIBIU,"MUNICIPIUL MEDIAŞ",143619,MEDIAŞ,"GRĂDINIŢA CU PROGRAM PRELUNGIT BUCURIA COPIILOR",110,"Alegeri Prezidentiale",1,1171,599,557,42,0,593,6,1300,701,505,88
34,SIBIU,"MUNICIPIUL MEDIAŞ",143619,MEDIAŞ,"VESTIAR SPARTA",111,"Alegeri Prezidentiale",2,745,394,356,38,0,390,4,800,406,342,48
34,SIBIU,"MUNICIPIUL MEDIAŞ",143619,MEDIAŞ,"STADIONUL MUNICIPAL GAZ METAN",112,"Alegeri Prezidentiale",1,833,474,422,52,0,464,10,900,426,382,82
34,SIBIU,"MUNICIPIUL MEDIAŞ",143619,MEDIAŞ,"SC HULA VECHE SRL",113,"Alegeri Prezidentiale",1,1241,637,603,34,0,629,8,1400,763,511,118
34,SIBIU,"MUNICIPIUL MEDIAŞ",143619,MEDIAŞ,"CLUBUL COPIILOR",114,"Alegeri Prezidentiale",1,1012,507,466,39,2,504,3,1100,593,413,91
34,SIBIU,"MUNICIPIUL MEDIAŞ",143619,MEDIAŞ,"CENTRU ŞCOLAR DE EDUCAŢIE INCLUZIVĂ MEDIAŞ",115,"Alegeri Prezidentiale",1,1123,580,550,30,0,576,4,1200,620,487,89
34,SIBIU,"MUNICIPIUL MEDIAŞ",143619,MEDIAŞ,"ŞCOALA GIMNAZIALĂ NR.7",116,"Alegeri Prezidentiale",1,1339,690,643,47,0,680,10,1500,810,575,105
34,SIBIU,"MUNICIPIUL MEDIAŞ",143619,MEDIAŞ,"ŞCOALA GIMNAZIALĂ NR.7",117,"Alegeri Prezidentiale",1,981,442,423,19,0,439,3,1100,658,373,66
34,SIBIU,"MUNICIPIUL MEDIAŞ",143619,MEDIAŞ,"ŞCOALA GIMNAZIALĂ NR.7",118,"Alegeri Prezidentiale",1,1117,550,529,21,0,540,10,1200,650,448,92
34,SIBIU,"MUNICIPIUL MEDIAŞ",143619,MEDIAŞ,"ŞCOALA GIMNAZIALĂ NR.7",119,"Alegeri Prezidentiale",1,970,414,396,18,0,412,2,1100,686,329,83
34,SIBIU,"MUNICIPIUL MEDIAŞ",143619,MEDIAŞ,"GRĂDINIŢA CU PROGRAM PRELUNGIT RAZĂ DE SOARE",120,"Alegeri Prezidentiale",1,1248,588,559,29,0,584,4,1400,812,468,116
34,SIBIU,"MUNICIPIUL MEDIAŞ",143619,MEDIAŞ,"ŞCOALA GIMNAZIALĂ NR.7 CORP A",121,"Alegeri Prezidentiale",1,992,469,445,23,1,466,3,1100,631,371,95
34,SIBIU,"MUNICIPIUL MEDIAŞ",143619,MEDIAŞ,"ŞCOALA GIMNAZIALĂ NR.7 CORP A",122,"Alegeri Prezidentiale",1,1206,449,420,29,0,442,7,1300,851,374,68
34,SIBIU,"MUNICIPIUL MEDIAŞ",143619,MEDIAŞ,"ŞCOALA GIMNAZIALĂ NR.7 CORP A",123,"Alegeri Prezidentiale",1,1114,451,430,19,2,440,11,1200,749,352,88
34,SIBIU,"MUNICIPIUL MEDIAŞ",143619,MEDIAŞ,"GRĂDINIŢA CU PROGRAM PRELUNGIT PITICOT",124,"Alegeri Prezidentiale",1,1313,597,530,65,2,578,19,1400,803,488,90
34,SIBIU,"MUNICIPIUL MEDIAŞ",143619,MEDIAŞ,"ŞCOALA GIMNAZIALĂ NR.4",125,"Alegeri Prezidentiale",1,1231,619,543,76,0,607,12,1400,781,455,152
34,SIBIU,"MUNICIPIUL MEDIAŞ",143619,MEDIAŞ,"ŞCOALA GIMNAZIALĂ NR.4",126,"Alegeri Prezidentiale",1,1008,527,500,27,0,519,8,1100,573,417,102
34,SIBIU,"MUNICIPIUL MEDIAŞ",143619,MEDIAŞ,"ŞCOALA GIMNAZIALĂ NR.4",127,"Alegeri Prezidentiale",1,1019,509,488,21,0,505,4,1100,591,428,77
34,SIBIU,"MUNICIPIUL MEDIAŞ",143619,MEDIAŞ,"SPAŢIU CU ALTĂ DETINAŢIE",128,"Alegeri Prezidentiale",1,1163,559,526,32,1,548,11,1300,741,453,95
34,SIBIU,"MUNICIPIUL MEDIAŞ",143619,MEDIAŞ,"SC AUTOMECANICA SA",129,"Alegeri Prezidentiale",1,587,326,298,28,0,322,4,600,274,272,50
34,SIBIU,"MUNICIPIUL MEDIAŞ",143619,MEDIAŞ,"ŞCOALA GIMNAZIALĂ GEORGE POPA",130,"Alegeri Prezidentiale",1,1215,559,543,16,0,553,6,1300,741,487,66
34,SIBIU,"MUNICIPIUL MEDIAŞ",143619,MEDIAŞ,"ŞCOALA GIMNAZIALĂ GEORGE POPA",131,"Alegeri Prezidentiale",1,1000,486,465,21,0,480,6,1100,614,422,58
34,SIBIU,"MUNICIPIUL MEDIAŞ",143619,MEDIAŞ,"ŞCOALA GIMNAZIALĂ GEORGE POPA",132,"Alegeri Prezidentiale",1,1440,710,662,48,0,704,6,1600,890,606,98
34,SIBIU,"MUNICIPIUL MEDIAŞ",143619,MEDIAŞ,"ŞCOALA GIMNAZIALĂ GEORGE POPA",133,"Alegeri Prezidentiale",1,1194,621,580,40,1,609,12,1300,679,494,115
34,SIBIU,"MUNICIPIUL MEDIAŞ",143619,MEDIAŞ,"COMPLEX COMERCIAL",134,"Alegeri Prezidentiale",1,1302,663,631,31,1,658,5,1400,737,564,94
34,SIBIU,"MUNICIPIUL MEDIAŞ",143619,MEDIAŞ,"COLEGIUL ”ŞCOALA NAŢIONALĂ DE GAZ”",135,"Alegeri Prezidentiale",1,1171,563,534,29,0,559,4,1300,737,486,73
34,SIBIU,"MUNICIPIUL MEDIAŞ",143619,MEDIAŞ,"CASA DE OASPETI",136,"Alegeri Prezidentiale",1,753,370,350,19,1,367,3,800,430,313,54
34,SIBIU,"MUNICIPIUL MEDIAŞ",143619,MEDIAŞ,"COLEGIUL TEHNIC MEDIENSIS",137,"Alegeri Prezidentiale",1,1354,636,601,35,0,623,13,1500,864,530,93
34,SIBIU,"MUNICIPIUL MEDIAŞ",143619,MEDIAŞ,"ŞCOALA GIMNAZIALĂ CIREŞARII",138,"Alegeri Prezidentiale",1,1350,670,638,29,3,660,10,1500,830,552,108
34,SIBIU,"MUNICIPIUL MEDIAŞ",143619,MEDIAŞ,"GRĂDINIŢA CU PROGRAM PRELUNGIT PINOCCHIO",139,"Alegeri Prezidentiale",2,1227,535,516,19,0,531,4,1200,665,452,79
34,SIBIU,"MUNICIPIUL MEDIAŞ",143619,MEDIAŞ,"ŞCOALA GIMNAZIALĂ CONSTANTIN IOAN MOTAŞ",140,"Alegeri Prezidentiale",1,1207,535,499,36,0,532,3,1300,765,466,66
34,SIBIU,"MUNICIPIUL MEDIAŞ",143619,MEDIAŞ,"ŞCOALA GIMNAZIALĂ CONSTANTIN IOAN MOTAŞ",141,"Alegeri Prezidentiale",2,1324,602,578,23,1,595,7,1500,898,472,123
34,SIBIU,"MUNICIPIUL MEDIAŞ",143619,MEDIAŞ,"ŞCOALA GIMNAZIALĂ CONSTANTIN IOAN MOTAŞ",142,"Alegeri Prezidentiale",1,1333,574,552,21,1,570,4,1500,926,487,83
34,SIBIU,"MUNICIPIUL MEDIAŞ",143619,MEDIAŞ,"ŞCOALA GIMNAZIALĂ CONSTANTIN IOAN MOTAŞ",143,"Alegeri Prezidentiale",1,1192,534,508,26,0,531,3,1300,766,475,56
34,SIBIU,"MUNICIPIUL MEDIAŞ",143619,MEDIAŞ,"ŞCOALA GIMNAZIALĂ CONSTANTIN IOAN MOTAŞ",144,"Alegeri Prezidentiale",1,1315,605,587,18,0,595,10,1500,895,500,95
34,SIBIU,"MUNICIPIUL MEDIAŞ",143619,MEDIAŞ,"ŞCOALA GIMNAZIALĂ CONSTANTIN IOAN MOTAŞ",145,"Alegeri Prezidentiale",1,1090,507,495,11,1,501,6,1200,693,422,79
34,SIBIU,"MUNICIPIUL MEDIAŞ",143619,MEDIAŞ,"UNIVERSITATEA LUCIAN BLAGA",146,"Alegeri Prezidentiale",1,1128,550,518,32,0,546,4,1200,650,464,82
34,SIBIU,"MUNICIPIUL MEDIAŞ",143619,MEDIAŞ,"UNIVERSITATEA LUCIAN BLAGA",147,"Alegeri Prezidentiale",1,1381,633,610,23,0,623,10,1500,867,535,88
34,SIBIU,"MUNICIPIUL MEDIAŞ",143619,"IGHIŞU NOU","ŞCOALA GIMNAZIALĂ",148,"Alegeri Prezidentiale",1,1341,559,518,40,1,550,9,1500,941,484,66
34,SIBIU,"ORAŞ AGNITA",143682,AGNITA,"ŞCOALA GIMNAZIALĂ G.D.TEUTSCH",149,"Alegeri Prezidentiale",2,1211,423,396,27,0,421,2,1300,877,361,60
34,SIBIU,"ORAŞ AGNITA",143682,AGNITA,"ŞCOALA GIMNAZIALĂ G.D.TEUTSCH",150,"Alegeri Prezidentiale",1,1106,534,505,29,0,530,4,1200,666,425,105
34,SIBIU,"ORAŞ AGNITA",143682,AGNITA,"GRĂDINIŢA CU PROGRAM PRELUNGIT",151,"Alegeri Prezidentiale",1,1073,419,405,14,0,413,6,1150,731,344,69
34,SIBIU,"ORAŞ AGNITA",143682,AGNITA,"CASA SENIORILOR",152,"Alegeri Prezidentiale",1,1401,551,512,38,1,542,9,1500,949,452,90
34,SIBIU,"ORAŞ AGNITA",143682,AGNITA,"COLEGIUL TEHNIC A.T. LAUREAN",153,"Alegeri Prezidentiale",1,1063,417,396,21,0,414,3,1200,783,352,62
34,SIBIU,"ORAŞ AGNITA",143682,AGNITA,"CASA DE CULTURĂ ”ILARION COCIȘIU”",154,"Alegeri Prezidentiale",1,1213,447,419,28,0,445,2,1300,853,384,61
34,SIBIU,"ORAŞ AGNITA",143682,AGNITA,"GRĂDINIŢA CU PROGRAM PRELUNGIT NR.2",155,"Alegeri Prezidentiale",2,1140,486,458,28,0,479,7,1300,814,394,85
34,SIBIU,"ORAŞ AGNITA",143682,COVEŞ,"ŞCOALA GIMNAZIALĂ COVEŞ",156,"Alegeri Prezidentiale",1,505,249,235,14,0,245,4,550,301,219,26
34,SIBIU,"ORAŞ AGNITA",143682,RUJA,"ŞCOALA GIMNAZIALĂ RUJA",157,"Alegeri Prezidentiale",2,961,379,365,14,0,378,1,1100,721,350,28
34,SIBIU,"ORAŞ AVRIG",144054,AVRIG,"GRADINITA NR.3 PROGRAM PRELUNGIT",158,"Alegeri Prezidentiale",1,1389,708,617,91,0,701,7,1500,792,617,84
34,SIBIU,"ORAŞ AVRIG",144054,AVRIG,"SCOALA GIMNAZIALA AVRIG",159,"Alegeri Prezidentiale",1,1369,825,699,126,0,814,11,1500,675,664,150
34,SIBIU,"ORAŞ AVRIG",144054,AVRIG,"ŞCOALA GIMNAZIALA AVRIG",160,"Alegeri Prezidentiale",1,1218,763,683,80,0,751,12,1300,537,671,80
34,SIBIU,"ORAŞ AVRIG",144054,AVRIG,"GRADINITA NR,1 PROGRAM NORMAL",161,"Alegeri Prezidentiale",1,1536,801,766,35,0,796,5,1700,899,713,83
34,SIBIU,"ORAŞ AVRIG",144054,AVRIG,"LICEUL ”GHEORGHE LAZĂR”, AVRIG",162,"Alegeri Prezidentiale",1,1280,721,629,91,1,716,5,1400,679,639,77
34,SIBIU,"ORAŞ AVRIG",144054,AVRIG,"LICEUL ”GHEORGHE LAZĂR”, AVRIG",163,"Alegeri Prezidentiale",1,1333,765,721,44,0,758,7,1500,735,645,113
34,SIBIU,"ORAŞ AVRIG",144054,MÂRŞA,"ŞCOALA GIMNAZIALA MÎRŞA",164,"Alegeri Prezidentiale",1,1295,734,683,51,0,732,2,1400,666,659,73
34,SIBIU,"ORAŞ AVRIG",144054,MÂRŞA,"LICEUL ”TEHNOLOGIC MÎRŞA",165,"Alegeri Prezidentiale",1,1332,680,638,42,0,678,2,1500,820,594,84
34,SIBIU,"ORAŞ AVRIG",144054,BRADU,"ŞCOLA GIMNAZIALĂ BRADU",166,"Alegeri Prezidentiale",1,890,516,455,61,0,514,2,1000,484,468,46
34,SIBIU,"ORAŞ AVRIG",144054,SĂCĂDATE,"ŞCOLA PRIMARĂ SĂCĂDATE",167,"Alegeri Prezidentiale",1,507,316,278,38,0,314,2,600,284,283,31
34,SIBIU,"ORAŞ AVRIG",144054,GLÂMBOACA,"ŞCOALA PRIMARĂ GLÎMBOACA",168,"Alegeri Prezidentiale",1,183,145,113,32,0,142,3,200,55,133,9
34,SIBIU,"ORAŞ CISNĂDIE",143735,CISNĂDIOARA,"GRĂDINIŢA CU PROGRAM NORMAL CISNĂDIOARA",169,"Alegeri Prezidentiale",1,667,337,224,113,0,331,6,700,363,282,49
34,SIBIU,"ORAŞ CISNĂDIE",143735,CISNĂDIE,"GRĂDINIŢA CU PROGRAM PRELUNGIT NR.7",170,"Alegeri Prezidentiale",1,1573,777,706,70,1,768,9,1650,873,651,117
34,SIBIU,"ORAŞ CISNĂDIE",143735,CISNĂDIE,"CLUBUL COPIILOR CISNĂDIE",171,"Alegeri Prezidentiale",1,1425,668,640,28,0,660,8,1600,932,552,108
34,SIBIU,"ORAŞ CISNĂDIE",143735,CISNĂDIE,"GRĂDINIŢA CU PROGRAM PRELUNGIT NR.6",172,"Alegeri Prezidentiale",1,1412,689,638,51,0,680,9,1500,811,580,100
34,SIBIU,"ORAŞ CISNĂDIE",143735,CISNĂDIE,"ŞCOALA GIMNAZIALĂ NR.3 CISNĂDIE",173,"Alegeri Prezidentiale",1,1528,764,692,71,1,758,6,1650,886,651,107
34,SIBIU,"ORAŞ CISNĂDIE",143735,CISNĂDIE,"LICEUL TEORETIC ”GUSTAV GUNDISCH” CISNĂDIE",174,"Alegeri Prezidentiale",2,1579,796,715,81,0,787,9,1700,904,650,137
34,SIBIU,"ORAŞ CISNĂDIE",143735,CISNĂDIE,"LICEUL TEHNOLOGIC",175,"Alegeri Prezidentiale",2,1485,727,671,55,1,723,4,1600,873,625,98
34,SIBIU,"ORAŞ CISNĂDIE",143735,CISNĂDIE,"ŞCOALA GIMNAZIALĂ NR. 2 CISNĂDIE",176,"Alegeri Prezidentiale",2,1679,877,809,68,0,872,5,1800,923,746,126
34,SIBIU,"ORAŞ CISNĂDIE",143735,CISNĂDIE,"LICEUL TEHNOLOGIC CISNĂDIE",177,"Alegeri Prezidentiale",1,1112,577,557,20,0,570,7,1200,623,492,78
34,SIBIU,"ORAŞ CISNĂDIE",143735,CISNĂDIE,"LICEUL TEHNOLOGIC CISNĂDIE",178,"Alegeri Prezidentiale",1,1079,529,491,38,0,525,4,1150,621,446,79
34,SIBIU,"ORAŞ CISNĂDIE",143735,CISNĂDIE,"GRĂDINIŢA CU PROGRAM NORMAL NR.1",179,"Alegeri Prezidentiale",1,1724,803,695,108,0,793,10,1900,1097,731,62
34,SIBIU,"ORAŞ CISNĂDIE",143735,CISNĂDIE,"GRĂDINIŢA CU PROGRAM NORMAL NR.1",180,"Alegeri Prezidentiale",2,1875,993,912,81,0,980,13,2100,1107,837,143
34,SIBIU,"ORAŞ CISNĂDIE",143735,CISNĂDIE,"GRĂDINIȚA CU PROGRAM NORMAL NR. 1",181,"Alegeri Prezidentiale",1,1830,713,601,112,0,702,11,1850,1137,643,59
34,SIBIU,"ORAŞ COPŞA MICĂ",143771,"COPŞA MICĂ","ŞCOALA GIMNAZIALĂ COPŞA MICĂ, STRADA COLONIA LABORATOR, NR.45",182,"Alegeri Prezidentiale",1,1440,525,495,28,2,522,3,1600,1075,432,90
34,SIBIU,"ORAŞ COPŞA MICĂ",143771,"COPŞA MICĂ","LICEUL TEHNOLOGIC ”NICOLAE TECLU” COPŞA MICĂ, STRADA ŞOSEAUA SIBIULUI, NR.61",183,"Alegeri Prezidentiale",1,1483,604,557,45,2,596,8,1600,996,507,89
34,SIBIU,"ORAŞ COPŞA MICĂ",143771,"COPŞA MICĂ","ŞCOALA GIMNAZIALĂ NR.1 COPŞA MICĂ,STRADA ŞOSEAUA MEDIAŞULUI, NR.93",184,"Alegeri Prezidentiale",1,1263,454,418,36,0,448,6,1400,946,380,68
34,SIBIU,"ORAŞ COPŞA MICĂ",143771,"COPŞA MICĂ","ŞCOALA PRIMARĂ NR. 2 COPŞA MICĂ, STRADA TÂRNĂVIOARA, NR.76",185,"Alegeri Prezidentiale",1,443,173,155,18,0,171,2,500,327,150,21
34,SIBIU,"ORAŞ DUMBRĂVENI",143806,DUMBRĂVENI,"PRIMĂRIA ORAȘULUI DUMBRĂVENI",186,"Alegeri Prezidentiale",1,1232,574,528,45,1,573,1,1400,826,484,89
34,SIBIU,"ORAŞ DUMBRĂVENI",143806,DUMBRĂVENI,"LICEUL ”TIMOTEI CIPARIU” DUMBRĂVENI",187,"Alegeri Prezidentiale",1,1092,552,515,36,1,545,7,1200,648,430,115
34,SIBIU,"ORAŞ DUMBRĂVENI",143806,DUMBRĂVENI,"LICEUL ”TIMOTEI CIPARIU” DUMBRĂVENI",188,"Alegeri Prezidentiale",1,1220,464,442,20,2,462,2,1200,736,317,145
34,SIBIU,"ORAŞ DUMBRĂVENI",143806,DUMBRĂVENI,"CENTRUL ŞCOLAR PENTRU EDUCAŢIE INCLUZIVĂ DUMBRĂVENI",189,"Alegeri Prezidentiale",1,1279,514,478,29,7,514,0,1400,886,447,67
34,SIBIU,"ORAŞ DUMBRĂVENI",143806,"ŞAROŞ PE TÂRNAVE","ŞCOALA GIMNAZIALĂ ŞAROŞ PE TÎRNAVE",190,"Alegeri Prezidentiale",1,1431,600,566,32,2,590,10,1600,1000,430,160
34,SIBIU,"ORAŞ DUMBRĂVENI",143806,ERNEA,"ŞCOALA PRIMARĂ ERNEA",191,"Alegeri Prezidentiale",1,394,239,213,24,2,239,0,400,161,202,37
34,SIBIU,"ORAŞ MIERCUREA SIBIULUI",144928,"MIERCUREA SIBIULUI","PRIMĂRIA ORAŞULUI MIERCUREA SIBIULUI",192,"Alegeri Prezidentiale",1,782,433,395,37,1,426,7,900,467,359,67
34,SIBIU,"ORAŞ MIERCUREA SIBIULUI",144928,"MIERCUREA SIBIULUI","PRIMĂRIA ORAŞULUI MIERCUREA SIBIULUI",193,"Alegeri Prezidentiale",1,931,438,395,43,0,432,6,1000,562,385,47
34,SIBIU,"ORAŞ MIERCUREA SIBIULUI",144928,"APOLDU DE SUS","CAMIN CULTURAL",194,"Alegeri Prezidentiale",1,1465,411,346,65,0,410,1,1600,1189,335,75
34,SIBIU,"ORAŞ MIERCUREA SIBIULUI",144928,DOBÂRCA,"CAMIN CULTURAL",195,"Alegeri Prezidentiale",1,669,218,189,29,0,217,1,700,482,182,35
34,SIBIU,"ORAŞ OCNA SIBIULUI",143851,"OCNA SIBIULUI","ŞCOALA GIMNAZIALA OCNA SIBIULUI",196,"Alegeri Prezidentiale",1,954,579,530,49,0,573,6,1000,421,493,80
34,SIBIU,"ORAŞ OCNA SIBIULUI",143851,"OCNA SIBIULUI","ŞCOALA GIMNAZIALĂ OCNA SIBIULUI",197,"Alegeri Prezidentiale",1,978,535,491,43,1,530,5,1100,565,464,66
34,SIBIU,"ORAŞ OCNA SIBIULUI",143851,"OCNA SIBIULUI","CLĂDIREA PAROHIALĂ ORTODOXĂ NR.1 OCNA SIBIULUI",198,"Alegeri Prezidentiale",1,1418,779,739,39,1,771,8,1600,821,688,83
34,SIBIU,"ORAŞ OCNA SIBIULUI",143851,TOPÂRCEA,"CLADIRE (FOST SEDIU PRIMARIE),TOPÎRCEA",199,"Alegeri Prezidentiale",1,118,97,50,47,0,96,1,130,33,68,28
34,SIBIU,"ORAŞ SĂLIŞTE",145499,SĂLIŞTE,"LICEUL TEHNOLOGIC ”IOAN LUPAȘ”",200,"Alegeri Prezidentiale",1,1221,650,578,72,0,646,4,1292,642,540,106
34,SIBIU,"ORAŞ SĂLIŞTE",145499,SĂLIŞTE,"LICEUL TEHNOLOGIC ”IOAN LUPAȘ”",201,"Alegeri Prezidentiale",1,1158,764,598,118,48,762,2,1300,536,662,100
34,SIBIU,"ORAŞ SĂLIŞTE",145499,GALEŞ,"MUZEUL ETNOGRAFIC ”MARIA COSTACHESCU",202,"Alegeri Prezidentiale",1,267,167,146,21,0,165,2,300,133,138,27
34,SIBIU,"ORAŞ SĂLIŞTE",145499,VALE,"CLĂDIREA FOSTEI PRIMĂRII",203,"Alegeri Prezidentiale",1,302,173,121,46,6,173,0,330,157,130,43
34,SIBIU,"ORAŞ SĂLIŞTE",145499,SIBIEL,"CENTRU DE DOCUMENTARE ȘI INFORMARE SIBIEL",204,"Alegeri Prezidentiale",1,331,297,180,117,0,291,6,400,103,251,40
34,SIBIU,"ORAŞ SĂLIŞTE",145499,FÂNTÂNELE,"CĂMIN CULTURAL FÂNTÂNELE",205,"Alegeri Prezidentiale",1,154,111,76,35,0,111,0,200,89,95,16
34,SIBIU,"ORAŞ SĂLIŞTE",145499,SĂCEL,"ŞCOALA GENERALĂ SĂCEL",206,"Alegeri Prezidentiale",1,429,299,239,60,0,295,4,500,201,271,24
34,SIBIU,"ORAŞ SĂLIŞTE",145499,MAG,"ŞCOALA PRIMARĂ MAG",207,"Alegeri Prezidentiale",1,369,235,170,65,0,234,1,400,165,194,40
34,SIBIU,"ORAŞ SĂLIŞTE",145499,AMNAŞ,"ŞCOALA PRIMARĂ AMNAŞ",208,"Alegeri Prezidentiale",1,346,151,121,30,0,150,1,400,249,134,16
34,SIBIU,"ORAŞ SĂLIŞTE",145499,ACILIU,"CĂMIN CULTURAL ACILIU",209,"Alegeri Prezidentiale",1,162,125,80,45,0,124,1,200,75,100,24
34,SIBIU,"ORAŞ TĂLMACIU",145827,TĂLMACIU,"PRIMARIA ORASULUI TALMACIU",210,"Alegeri Prezidentiale",1,1547,720,636,84,0,713,7,1700,980,605,108
34,SIBIU,"ORAŞ TĂLMACIU",145827,TĂLMACIU,"LICEUL TEHNOLOGIC / ȘCOALA GIMNAZIALĂ TĂLMACIU",211,"Alegeri Prezidentiale",1,1074,630,569,61,0,627,3,1200,570,534,93
34,SIBIU,"ORAŞ TĂLMACIU",145827,TĂLMACIU,"LICEUL TEHNOLOGIC TĂLMACIU CORP A",212,"Alegeri Prezidentiale",1,1207,695,645,50,0,688,7,1300,605,561,127
34,SIBIU,"ORAŞ TĂLMACIU",145827,TĂLMACIU,"LICEUL TEHNOLOGIC TĂLMACIU CORP B",213,"Alegeri Prezidentiale",1,1605,848,812,36,0,836,12,1800,952,718,118
34,SIBIU,"ORAŞ TĂLMACIU",145827,"COLONIA TĂLMACIU","LICEUL TEHNOLOGIC/SCOALA COLONIE TALMACIU II",214,"Alegeri Prezidentiale",1,225,118,107,11,0,117,1,230,112,107,10
34,SIBIU,"ORAŞ TĂLMACIU",145827,TĂLMĂCEL,"LICEUL TEHNOLOGIC TALMACIU/SCOALA GIMNAZIALA TALMACEL",215,"Alegeri Prezidentiale",1,925,589,540,49,0,584,5,1000,411,522,62
34,SIBIU,ALMA,146012,ALMA,"CĂMINUL CULTURAL ALMA",216,"Alegeri Prezidentiale",1,658,407,357,49,1,403,4,700,293,330,73
34,SIBIU,ALMA,146012,GIACĂŞ,"ŞCOALA PRIMARĂ GIACĂŞ",217,"Alegeri Prezidentiale",1,196,132,102,30,0,127,5,200,68,77,50
34,SIBIU,ALMA,146012,ŞMIG,"CĂMINUL CULTURAL ŞMIG",218,"Alegeri Prezidentiale",1,724,498,443,54,1,493,5,800,302,422,71
34,SIBIU,ALŢINA,143888,ALŢINA,"SEDIU PRIMARIA",219,"Alegeri Prezidentiale",2,1083,548,485,42,21,548,0,1200,652,335,213
34,SIBIU,ALŢINA,143888,BENEŞTI,"FOST SEDIU CAP",220,"Alegeri Prezidentiale",1,223,100,75,25,0,100,0,230,130,61,39
34,SIBIU,ALŢINA,143888,"GHIJASA DE SUS","FOST SEDIU CAP",221,"Alegeri Prezidentiale",1,117,102,72,29,1,101,1,130,28,67,34
34,SIBIU,"APOLDU DE JOS",143922,"APOLDU DE JOS","ȘCOALA GIMNAZIALĂ APOLDU DE JOS",222,"Alegeri Prezidentiale",1,841,483,409,74,0,481,2,908,425,398,83
34,SIBIU,"APOLDU DE JOS",143922,SÂNGĂTIN,"ȘCOALA PRIMARĂ - SÎNGĂTIN",223,"Alegeri Prezidentiale",1,211,151,116,35,0,150,1,220,69,129,21
34,SIBIU,"ARPAŞU DE JOS",143959,"ARPAŞU DE JOS","PRIMĂRIA COMUNEI ARPASU DE JOS",224,"Alegeri Prezidentiale",1,908,442,390,52,0,438,4,1000,558,365,73
34,SIBIU,"ARPAŞU DE JOS",143959,"ARPAŞU DE SUS","SCOALA GIMNAZIALA ” AUREL POPA”",225,"Alegeri Prezidentiale",1,1023,617,533,84,0,616,1,1100,483,547,69
34,SIBIU,"ARPAŞU DE JOS",143959,"NOU ROMÂN","GRADINITA, NOU ROMAN",226,"Alegeri Prezidentiale",1,307,188,139,49,0,188,0,320,132,155,33
34,SIBIU,AŢEL,143995,AŢEL,"PRIMARIA ATEL",227,"Alegeri Prezidentiale",1,1141,475,434,41,0,475,0,1300,825,425,50
34,SIBIU,AŢEL,143995,DUPUŞ,"CLADIREA PRIMARIEI (FOSTA SCOALA), DUPUS NR. 107.",228,"Alegeri Prezidentiale",1,210,99,73,26,0,97,2,220,121,87,10
34,SIBIU,"AXENTE SEVER",144116,AGÂRBICIU,"CĂMIN CULTURAL",229,"Alegeri Prezidentiale",1,1184,537,499,38,0,532,5,1300,763,456,76
34,SIBIU,"AXENTE SEVER",144116,ŞOALA,"CĂMIN CULTURAL",230,"Alegeri Prezidentiale",1,277,155,124,31,0,153,2,300,145,122,31
34,SIBIU,"AXENTE SEVER",144116,"AXENTE SEVER","ȘCOALA GIMNAZIALĂ AXENTE SEVER",231,"Alegeri Prezidentiale",1,991,451,415,36,0,446,5,1100,649,355,91
34,SIBIU,"AXENTE SEVER",144116,"AXENTE SEVER","SALA DE FESTIVITĂȚI",232,"Alegeri Prezidentiale",1,1032,426,397,29,0,418,8,1100,674,356,62
34,SIBIU,BAZNA,144152,BAZNA,"PRIMARIA BAZNA",233,"Alegeri Prezidentiale",1,1434,562,490,71,1,554,8,1600,1038,475,79
34,SIBIU,BAZNA,144152,BOIAN,"SCOALA GIMNAZIALA BOIAN",234,"Alegeri Prezidentiale",1,1167,593,534,59,0,587,6,1300,707,499,88
34,SIBIU,BAZNA,144152,VELŢ,"SCOALA PRIMARĂ VELȚ",235,"Alegeri Prezidentiale",1,459,198,174,24,0,195,3,500,302,140,55
34,SIBIU,BÂRGHIŞ,144232,"IGHIŞU VECHI","CĂMIN CULTURAL IGHIŞU VECHI",236,"Alegeri Prezidentiale",1,189,108,90,18,0,106,2,200,92,80,26
34,SIBIU,BÂRGHIŞ,144232,BÂRGHIŞ,"GRĂDINIȚA CU PROGRAM NORMAL BÎRGHIȘ",237,"Alegeri Prezidentiale",1,636,335,295,40,0,334,1,700,365,297,37
34,SIBIU,BÂRGHIŞ,144232,APOŞ,"ŞCOALA PRIMARĂ APOȘ",238,"Alegeri Prezidentiale",1,272,126,114,12,0,126,0,300,174,103,23
34,SIBIU,BÂRGHIŞ,144232,PELIŞOR,"ŞCOALA PRIMARĂ PELIȘOR",239,"Alegeri Prezidentiale",1,406,192,162,30,0,191,1,420,228,162,29
34,SIBIU,BÂRGHIŞ,144232,ZLAGNA,"ŞCOALA PRIMARĂ ZLAGNA",240,"Alegeri Prezidentiale",1,138,87,60,27,0,86,1,200,113,70,16
34,SIBIU,BÂRGHIŞ,144232,VECERD,"DISPENSAR UMAN VECERD",241,"Alegeri Prezidentiale",1,90,62,40,22,0,61,1,100,38,33,28
34,SIBIU,BIERTAN,144198,BIERTAN,"PRIMARIA COMUNEI BIERTAN",242,"Alegeri Prezidentiale",1,1361,548,475,59,14,547,1,1500,952,453,94
34,SIBIU,BIERTAN,144198,RICHIŞ,"SCOALA PRIMARA RICHIS",243,"Alegeri Prezidentiale",1,648,301,274,26,1,298,3,700,399,266,32
34,SIBIU,BIERTAN,144198,"COPŞA MARE","SCOALA PRIMARA COPSA MARE",244,"Alegeri Prezidentiale",1,400,176,151,25,0,172,4,420,244,108,64
34,SIBIU,BLĂJEL,144303,PĂUCEA,"ŞCOALA GIMNAZIALĂ",245,"Alegeri Prezidentiale",1,351,215,197,18,0,213,2,400,185,187,26
34,SIBIU,BLĂJEL,144303,ROMANEŞTI,"FOSTA ŞCOALĂ GENERALĂ",246,"Alegeri Prezidentiale",1,59,57,31,26,0,57,0,100,43,41,16
34,SIBIU,BLĂJEL,144303,BLĂJEL,"CĂMIN CULTURAL",247,"Alegeri Prezidentiale",1,1478,721,664,45,12,710,11,1600,879,602,108
34,SIBIU,BOIŢA,146021,BOIŢA,"PRIMĂRIA COMUNEI BOIŢA",248,"Alegeri Prezidentiale",1,1276,719,665,54,0,714,5,1400,681,624,90
34,SIBIU,BRATEIU,144349,BRATEIU,"CĂMINUL CULTURAL BRATEIU",249,"Alegeri Prezidentiale",1,1132,471,453,18,0,466,5,1200,729,432,34
34,SIBIU,BRATEIU,144349,BRATEIU,"ŞCOALA GIMNAZIALĂ BRATEIU",250,"Alegeri Prezidentiale",1,837,359,342,17,0,358,1,900,541,315,43
34,SIBIU,BRATEIU,144349,BUZD,"ŞCOALA GIMNAZIALĂ BUZD",251,"Alegeri Prezidentiale",1,970,408,391,17,0,407,1,1100,692,359,48
34,SIBIU,BRĂDENI,144376,BRĂDENI,"SALA MARE-PRIMĂRIE",252,"Alegeri Prezidentiale",1,745,402,340,62,0,402,0,800,398,350,52
34,SIBIU,BRĂDENI,144376,RETIŞ,"SALA MARE FOSTĂ PRIMĂRIE",253,"Alegeri Prezidentiale",1,378,185,147,37,1,184,1,400,215,150,34
34,SIBIU,BRĂDENI,144376,ŢELINE,"FOSTA ŞCOALĂ ŢELINE",254,"Alegeri Prezidentiale",1,90,76,45,31,0,76,0,100,24,66,10
34,SIBIU,BRUIU,144410,BRUIU,"PRIMĂRIA BRUIU",255,"Alegeri Prezidentiale",1,409,154,128,26,0,150,4,500,346,119,31
34,SIBIU,BRUIU,144410,ŞOMARTIN,"ȘCOALA PRIMARĂ ȘOMARTIN",256,"Alegeri Prezidentiale",1,320,102,80,22,0,100,2,400,298,79,21
34,SIBIU,CÂRŢA,144508,CÂRŢA,"PRIMARIA CIRTA",257,"Alegeri Prezidentiale",1,944,394,329,65,0,387,7,1000,606,311,76
34,SIBIU,CÂRŢIŞOARA,144535,CÂRŢIŞOARA,"PRIMĂRIA COMUNEI CÎRȚIȘOARA",258,"Alegeri Prezidentiale",1,1089,723,549,174,0,708,15,1200,477,506,202
34,SIBIU,CHIRPĂR,144456,CHIRPĂR,"ŞCOALA GIMNAZIALĂ CHIRPĂR",259,"Alegeri Prezidentiale",1,987,244,226,18,0,242,2,1100,856,188,54
34,SIBIU,CHIRPĂR,144456,VĂRD,"CĂMINUL CULTURAL VĂRD",260,"Alegeri Prezidentiale",1,284,155,132,23,0,155,0,300,145,147,8
34,SIBIU,CHIRPĂR,144456,VESEUD,"ŞCOALA PRIMARĂ VESEUD",261,"Alegeri Prezidentiale",1,151,79,48,31,0,78,1,200,121,65,13
34,SIBIU,CHIRPĂR,144456,SĂSĂUŞ,"CĂMINUL CULTURAL SĂSĂUŞ",262,"Alegeri Prezidentiale",1,105,81,49,32,0,79,2,120,39,52,27
34,SIBIU,CRISTIAN,143487,CRISTIAN,"PRIMARIA COMUNEI CRISTIAN",263,"Alegeri Prezidentiale",1,1148,613,497,116,0,604,9,1300,687,550,54
34,SIBIU,CRISTIAN,143487,CRISTIAN,"GRADINITA CU PROGRAM PRELUNGIT CRISTIAN",264,"Alegeri Prezidentiale",1,1209,762,675,87,0,748,14,1300,538,682,66
34,SIBIU,CRISTIAN,143487,CRISTIAN,"SCOALA GIMNAZIALA , CRISTIAN",265,"Alegeri Prezidentiale",1,1102,643,572,71,0,636,7,1200,557,579,57
34,SIBIU,DÂRLOS,144553,DÂRLOS,"GRADINITA CU PROGRAM NORMAL DARLOS",266,"Alegeri Prezidentiale",1,864,359,331,28,0,357,2,1000,641,303,54
34,SIBIU,DÂRLOS,144553,DÂRLOS,"ŞCOALA GIMNAZIALĂ ”IOAN MORARU” DÎRLOS",267,"Alegeri Prezidentiale",1,1040,429,386,43,0,428,1,1100,671,367,61
34,SIBIU,DÂRLOS,144553,CURCIU,"ŞCOALA GIMNAZIALĂ CURCIU",268,"Alegeri Prezidentiale",1,733,288,268,20,0,283,5,800,512,261,22
34,SIBIU,DÂRLOS,144553,"VALEA LUNGĂ","CĂMIN CULTURAL VALEA LUNGĂ",269,"Alegeri Prezidentiale",2,206,116,100,16,0,113,3,210,94,103,10
34,SIBIU,"GURA RÂULUI",144599,"GURA RÂULUI","ŞCOALA GIMNAZIALĂ ”AUREL DECEI” GURA RÂULUI",270,"Alegeri Prezidentiale",1,1414,1000,871,125,4,991,9,1500,500,896,95
34,SIBIU,"GURA RÂULUI",144599,"GURA RÂULUI","GRĂDINIŢA CU PROGRAM NORMAL NR.2 GURA RÂULUI",271,"Alegeri Prezidentiale",1,1519,975,883,88,4,966,9,1700,725,885,81
34,SIBIU,HOGHILAG,144615,HOGHILAG,"PRIMĂRIA HOGHILAG",272,"Alegeri Prezidentiale",1,998,423,404,19,0,416,7,1100,677,275,141
34,SIBIU,HOGHILAG,144615,PROD,"SCOALA PRIMARĂ PROD",273,"Alegeri Prezidentiale",1,205,154,108,46,0,154,0,210,56,119,35
34,SIBIU,HOGHILAG,144615,VALCHID,"ȘCOALĂ GIMNAZIALĂ VALCHID",274,"Alegeri Prezidentiale",1,625,352,325,27,0,347,5,700,348,173,174
34,SIBIU,IACOBENI,144651,IACOBENI,"PRIMĂRIA IACOBENI",275,"Alegeri Prezidentiale",1,846,323,302,21,0,320,3,900,577,270,50
34,SIBIU,IACOBENI,144651,STEJĂRIŞU,"ȘCOALA PRIMARĂ STEJĂRIȘU",276,"Alegeri Prezidentiale",1,425,151,140,11,0,149,2,500,349,120,29
34,SIBIU,IACOBENI,144651,NETUŞ,"ȘCOALA PRIMARĂ NETUȘ",277,"Alegeri Prezidentiale",1,399,168,148,20,0,165,3,410,242,139,26
34,SIBIU,IACOBENI,144651,NOIŞTAT,"ȘCOALA GIMNAZIALĂ NOIȘTAT",278,"Alegeri Prezidentiale",1,459,151,137,14,0,145,6,500,349,109,36
34,SIBIU,IACOBENI,144651,MOVILE,"ȘCOALA PRIMARĂ MOVILE",279,"Alegeri Prezidentiale",1,288,136,120,16,0,136,0,300,164,121,15
34,SIBIU,JINA,144713,JINA,"PRIMĂRIA COMUNEI JINA",280,"Alegeri Prezidentiale",1,1498,650,585,54,11,648,2,1700,1050,595,53
34,SIBIU,JINA,144713,JINA,"ŞCOALA GIMNAZIALĂ JINA BĂIEŞI",281,"Alegeri Prezidentiale",1,1222,521,458,63,0,511,10,1300,779,459,52
34,SIBIU,LASLEA,144731,LASLEA,"CĂMIN CULTURAL LASLEA",282,"Alegeri Prezidentiale",1,1276,490,449,40,1,486,4,1400,910,346,140
34,SIBIU,LASLEA,144731,MĂLÂNCRAV,"CĂMIN CULTURAL MĂLÎNCRAV",283,"Alegeri Prezidentiale",1,1004,389,354,35,0,388,1,1100,711,288,100
34,SIBIU,LASLEA,144731,FLOREŞTI,"CĂMIN CULTURAL FLOREŞTI",284,"Alegeri Prezidentiale",1,104,61,40,21,0,60,1,110,49,35,25
34,SIBIU,LASLEA,144731,ROANDOLA,"ȘCOALA PRIMARĂ ROANDOLA",285,"Alegeri Prezidentiale",2,254,68,45,23,0,68,0,300,232,57,11
34,SIBIU,LASLEA,144731,"NOU SĂSESC","ȘCOALA PRIMARĂ NOU SĂSESC",286,"Alegeri Prezidentiale",2,606,153,135,18,0,150,3,700,547,127,23
34,SIBIU,LOAMNEŞ,144795,LOAMNEŞ,"CĂMIN CULTURAL LOAMNEŞ",287,"Alegeri Prezidentiale",1,502,331,279,52,0,328,3,600,269,260,68
34,SIBIU,LOAMNEŞ,144795,MÂNDRA,"CĂMIN CULTURAL MÎNDRA",288,"Alegeri Prezidentiale",1,279,216,177,39,0,215,1,300,84,160,55
34,SIBIU,LOAMNEŞ,144795,ALĂMOR,"CĂMIN CULTURAL ALĂMOR",289,"Alegeri Prezidentiale",1,618,336,296,40,0,333,3,700,364,250,83
34,SIBIU,LOAMNEŞ,144795,ARMENI,"ŞCOALA PRIMARĂ ARMENI",290,"Alegeri Prezidentiale",1,417,189,154,35,0,188,1,500,311,164,24
34,SIBIU,LOAMNEŞ,144795,HAŞAG,"ŞCOALA PRIMARĂ HAŞAG",291,"Alegeri Prezidentiale",1,538,321,267,54,0,321,0,600,279,272,49
34,SIBIU,LUDOŞ,144866,LUDOŞ,"PRIMĂRIA COMUNEI LUDOȘ",292,"Alegeri Prezidentiale",1,572,254,196,58,0,254,0,600,346,204,50
34,SIBIU,MARPOD,144893,MARPOD,"PRIMĂRIA MARPOD",293,"Alegeri Prezidentiale",1,542,308,252,56,0,308,0,600,292,271,37
34,SIBIU,MARPOD,144893,ILIMBAV,"FOSTĂ ŞCOALĂ GENERALĂ ILIMBAV",294,"Alegeri Prezidentiale",1,164,128,85,43,0,126,2,200,72,106,20
34,SIBIU,MERGHINDEAL,144964,MERGHINDEAL,"CLĂDIRE REMIZĂ MERGHINDEAL, NUMARUL 60",295,"Alegeri Prezidentiale",1,693,332,282,29,21,330,2,800,468,259,71
34,SIBIU,MERGHINDEAL,144964,"DEALU FRUMOS","ȘCOALA PRIMARĂ DEALU FRUMOS",296,"Alegeri Prezidentiale",2,555,269,241,22,6,267,2,600,331,157,110
34,SIBIU,MICĂSASA,144991,MICĂSASA,"ȘCOALA GIMNAZIALĂ ”CORNELIU PĂCURARIU” MICĂSASA",297,"Alegeri Prezidentiale",1,1115,598,553,45,0,592,6,1200,602,476,116
34,SIBIU,MICĂSASA,144991,ŢAPU,"ȘCOALA PRIMARĂ ŢAPU",298,"Alegeri Prezidentiale",1,632,262,242,20,0,260,2,700,438,204,56
34,SIBIU,MICĂSASA,144991,CHESLER,"DISPENSARUL MEDICAL CHESLER",299,"Alegeri Prezidentiale",1,54,45,29,16,0,45,0,100,55,30,15
34,SIBIU,MIHĂILENI,145042,MIHĂILENI,"PRIMĂRIA COMUNEI MIHĂILENI",300,"Alegeri Prezidentiale",1,242,111,88,23,0,110,1,300,189,89,21
34,SIBIU,MIHĂILENI,145042,METIŞ,"ȘCOALA PRIMARĂ METIȘ",301,"Alegeri Prezidentiale",1,241,80,61,19,0,79,1,300,220,64,15
34,SIBIU,MIHĂILENI,145042,RĂVĂŞEL,"CĂMINUL CULTURAL RĂVĂȘEL",302,"Alegeri Prezidentiale",2,273,92,72,20,0,87,5,300,208,68,19
34,SIBIU,MOŞNA,145104,MOŞNA,"ȘCOALA GIMNAZIALĂ MOȘNA",303,"Alegeri Prezidentiale",1,1121,405,382,23,0,400,5,1200,795,352,48
34,SIBIU,MOŞNA,145104,MOŞNA,"ȘCOALA GIMNAZIALĂ MOȘNA",304,"Alegeri Prezidentiale",1,955,499,461,38,0,490,9,1100,601,401,89
34,SIBIU,MOŞNA,145104,"ALMA VII","GRĂDINIȚA CU PROGRAM NORMAL ALMA VII",305,"Alegeri Prezidentiale",1,330,129,117,12,0,127,2,400,271,104,23
34,SIBIU,MOŞNA,145104,NEMŞA,"ȘCOALA GIMNAZIALĂ NEMȘA",306,"Alegeri Prezidentiale",1,471,247,217,30,0,245,2,500,253,182,63
34,SIBIU,NOCRICH,145140,NOCRICH,"CAMINUL CULTURAL NOCRICH",307,"Alegeri Prezidentiale",2,1115,540,506,34,0,537,3,1200,660,490,47
34,SIBIU,NOCRICH,145140,HOSMAN,"SCOALA GIMNAZIALA HOSMAN",308,"Alegeri Prezidentiale",1,715,301,252,49,0,301,0,800,499,269,32
34,SIBIU,NOCRICH,145140,FOFELDEA,"SCOALA PRIMARA FOFELDEA",309,"Alegeri Prezidentiale",1,308,180,154,26,0,175,5,320,140,144,31
34,SIBIU,NOCRICH,145140,"GHIJASA DE JOS","FOSTA SCOALA GHIJASA DE JOS",310,"Alegeri Prezidentiale",1,78,47,31,16,0,47,0,100,53,41,6
34,SIBIU,NOCRICH,145140,ŢICHINDEAL,"SCOALA PRIMARA ŢICHINDEAL",311,"Alegeri Prezidentiale",1,129,78,54,19,5,75,3,140,62,63,12
34,SIBIU,ORLAT,145202,ORLAT,"GRĂDINIŢA CU PROGRAM NORMAL ORLAT",312,"Alegeri Prezidentiale",1,1290,686,632,54,0,682,4,1400,714,640,42
34,SIBIU,ORLAT,145202,ORLAT,"GRĂDINIŢA CU PROGRAM NORMAL ORLAT",313,"Alegeri Prezidentiale",1,1333,827,731,96,0,821,6,1500,673,766,55
34,SIBIU,PĂUCA,145220,PĂUCA,"PRIMARIA COMUNEI PĂUCA",314,"Alegeri Prezidentiale",1,651,293,256,37,0,292,1,700,407,257,35
34,SIBIU,PĂUCA,145220,"BOGATU ROMÂN","ŞCOALA GIMNAZIALA BOGATU-ROMÂN",315,"Alegeri Prezidentiale",1,363,253,219,34,0,253,0,400,147,228,25
34,SIBIU,PĂUCA,145220,BROŞTENI,"ŞCOALA PRIMARA BROŞTENI",316,"Alegeri Prezidentiale",1,272,202,178,24,0,200,2,300,98,170,30
34,SIBIU,PĂUCA,145220,PRESACA,"ŞCOALA PRIMARA PRESACA",317,"Alegeri Prezidentiale",2,303,228,206,22,0,227,1,310,82,199,28
34,SIBIU,"POIANA SIBIULUI",145275,"POIANA SIBIULUI","CĂMINUL CULTURAL POIANA SIBIULUI",318,"Alegeri Prezidentiale",1,888,470,330,140,0,466,4,1000,530,399,67
34,SIBIU,"POIANA SIBIULUI",145275,"POIANA SIBIULUI","ȘCOALA GIMNAZIALĂ ”IOAN BAN - DASCĂLU”, POIANA SIBIULUI, NR. 1332",319,"Alegeri Prezidentiale",1,903,356,298,58,0,355,1,1000,644,308,47
34,SIBIU,POPLACA,143502,POPLACA,"CĂMINUL CULTURAL POPLACA",320,"Alegeri Prezidentiale",1,1426,905,809,96,0,903,2,1600,695,786,117
34,SIBIU,"PORUMBACU DE JOS",145293,"PORUMBACU DE JOS","PRIMĂRIA PORUMBACU DE JOS",321,"Alegeri Prezidentiale",1,887,449,356,93,0,442,7,1000,551,364,78
34,SIBIU,"PORUMBACU DE JOS",145293,"PORUMBACU DE SUS","CĂMINUL CULTURAL PORUMBACU DE SUS",322,"Alegeri Prezidentiale",1,697,466,338,128,0,465,1,800,334,385,80
34,SIBIU,"PORUMBACU DE JOS",145293,SCOREIU,"CĂMINUL CULTURAL SCOREIU",323,"Alegeri Prezidentiale",2,555,322,226,96,0,317,5,600,278,270,47
34,SIBIU,"PORUMBACU DE JOS",145293,SĂRATA,"CĂMINUL CULTURAL SARATA",324,"Alegeri Prezidentiale",1,283,174,119,55,0,171,3,300,126,142,29
34,SIBIU,"PORUMBACU DE JOS",145293,COLUN,"CĂMINUL CULTURAL COLUN",325,"Alegeri Prezidentiale",1,141,90,70,20,0,90,0,200,110,70,20
34,SIBIU,RACOVIŢA,145355,"SEBEŞU DE SUS","CĂMINUL CULTURAL SEBEȘU DE SUS",326,"Alegeri Prezidentiale",1,595,394,312,82,0,391,3,700,306,344,47
34,SIBIU,RACOVIŢA,145355,RACOVIŢA,"CĂMINUL CULTURAL RACOVIŢA",327,"Alegeri Prezidentiale",1,1729,1049,974,75,0,1039,10,1900,851,950,89
34,SIBIU,RĂŞINARI,143520,RĂŞINARI,"ŞCOALA GIMNAZIALĂ OCTAVIAN GOGA RĂŞINARI",328,"Alegeri Prezidentiale",1,1516,779,727,52,0,776,3,1700,921,688,88
34,SIBIU,RĂŞINARI,143520,RĂŞINARI,"ŞCOALA GIMNAZIALĂ SAVA POPOVICI BARCIANU RĂŞINARI",329,"Alegeri Prezidentiale",1,1469,830,707,123,0,825,5,1600,770,761,64
34,SIBIU,RĂŞINARI,143520,RĂŞINARI,"CĂMINUL CULTURAL RĂȘINARI",330,"Alegeri Prezidentiale",1,1430,852,764,88,0,844,8,1600,748,755,89
34,SIBIU,"RÂU SADULUI",145382,"RÂU SADULUI",PRIMĂRIA,331,"Alegeri Prezidentiale",1,472,302,250,52,0,294,8,500,198,256,38
34,SIBIU,ROŞIA,145408,ROŞIA,"PRIMARIA ROSIA",332,"Alegeri Prezidentiale",1,1222,536,495,41,0,534,2,1300,764,499,35
34,SIBIU,ROŞIA,145408,NOU,"SCOALA GIMNAZIALA NOU",333,"Alegeri Prezidentiale",1,1327,603,577,26,0,601,2,1500,897,555,46
34,SIBIU,ROŞIA,145408,DAIA,"SCOALA GIMAZIALA DAIA",334,"Alegeri Prezidentiale",1,763,448,376,72,0,445,3,800,352,408,37
34,SIBIU,ROŞIA,145408,CAŞOLŢ,"SCOALA GIMNAZIALA CAŞOLŢ",335,"Alegeri Prezidentiale",1,629,295,252,43,0,293,2,700,405,252,41
34,SIBIU,ROŞIA,145408,CORNĂŢEL,"SEDIUL ADMINISTRATIV DISPENSAR",336,"Alegeri Prezidentiale",1,415,269,198,71,0,263,6,500,231,216,47
34,SIBIU,SADU,145471,SADU,"CĂMINUL CULTURAL AL COMUNEI SADU",337,"Alegeri Prezidentiale",1,935,663,591,71,1,659,4,1000,337,596,63
34,SIBIU,SADU,145471,SADU,"CĂMINUL CULTURAL AL COMUNEI SADU",338,"Alegeri Prezidentiale",1,1162,763,683,80,0,749,14,1300,537,661,88
34,SIBIU,SLIMNIC,145603,SLIMNIC,"ŞCOALA GIMNAZIALĂ SLIMNIC",339,"Alegeri Prezidentiale",1,1299,659,579,79,1,658,1,1400,741,609,49
34,SIBIU,SLIMNIC,145603,SLIMNIC,"ŞCOALA GIMNAZIALĂ SLIMNIC",340,"Alegeri Prezidentiale",1,1021,523,472,51,0,522,1,1100,577,479,43
34,SIBIU,SLIMNIC,145603,RUŞI,"ŞCOALA GIMNAZIALĂ RUŞI",341,"Alegeri Prezidentiale",2,721,378,329,49,0,374,4,800,422,327,47
34,SIBIU,SLIMNIC,145603,VESEUD,"ŞCOALA GIMNAZIALA VESEUD",342,"Alegeri Prezidentiale",1,165,107,70,37,0,107,0,200,93,94,13
34,SIBIU,"ŞEICA MARE",145667,"ŞEICA MARE","SCOALA GIMNAZIALA SEICA MARE",343,"Alegeri Prezidentiale",2,955,491,426,65,0,485,6,1100,609,436,49
34,SIBIU,"ŞEICA MARE",145667,"ŞEICA MARE","SCOALA GIMNAZIALA SEICA MARE",344,"Alegeri Prezidentiale",2,864,420,366,54,0,415,5,900,480,357,58
34,SIBIU,"ŞEICA MARE",145667,"ŞEICA MARE","SCOALA PRIMARA SEICA MARE",345,"Alegeri Prezidentiale",1,879,494,436,58,0,490,4,970,476,438,52
34,SIBIU,"ŞEICA MARE",145667,BOARTA,"SCOALA PRIMARA BOARTA",346,"Alegeri Prezidentiale",1,337,182,159,23,0,180,2,400,218,150,30
34,SIBIU,"ŞEICA MARE",145667,BUIA,"SCOALA PRIMARA BUIA",347,"Alegeri Prezidentiale",1,474,233,197,36,0,232,1,500,267,209,23
34,SIBIU,"ŞEICA MARE",145667,ŞTENEA,"ŞCOALA PRIMARA ŞTENEA",348,"Alegeri Prezidentiale",1,125,80,55,25,0,79,1,142,62,54,25
34,SIBIU,"ŞEICA MARE",145667,PETIŞ,"CASA PAROHIALA CULT ORTODOX",349,"Alegeri Prezidentiale",1,47,38,16,22,0,36,2,100,62,30,6
34,SIBIU,"ŞEICA MICĂ",145738,"ŞEICA MICĂ",PRIMARIA,350,"Alegeri Prezidentiale",2,1029,431,382,49,0,425,6,1100,669,340,85
34,SIBIU,"ŞEICA MICĂ",145738,SOROŞTIN,"FOSTUL SEDIU CAP SOROŞTIN",351,"Alegeri Prezidentiale",1,443,229,198,31,0,227,2,500,271,124,103
34,SIBIU,ŞELIMBĂR,143557,ŞELIMBĂR,"CĂMIN CULTURAL ŞELIMBĂR",352,"Alegeri Prezidentiale",1,1582,1020,874,146,0,1011,9,1700,680,903,108
34,SIBIU,ŞELIMBĂR,143557,ŞELIMBĂR,"ŞCOALA GIMNAZIALĂ `MIHAI VITEAZU~ ŞELIMBĂR",353,"Alegeri Prezidentiale",2,1417,1102,873,229,0,1093,9,1500,398,952,141
34,SIBIU,ŞELIMBĂR,143557,ŞELIMBĂR,"GRĂDINIȚA CU PROGRAM PRELUNGIT",354,"Alegeri Prezidentiale",1,1635,1150,944,204,2,1136,14,1800,650,1049,87
34,SIBIU,ŞELIMBĂR,143557,VEŞTEM,"CĂMIN CULTURAL VEȘTEM",355,"Alegeri Prezidentiale",1,1410,837,760,76,1,833,4,1600,763,708,125
34,SIBIU,ŞELIMBĂR,143557,MOHU,"CĂMIN CULTURAL MOHU",356,"Alegeri Prezidentiale",1,609,339,293,46,0,339,0,700,361,299,40
34,SIBIU,ŞELIMBĂR,143557,BUNGARD,"CĂMIN CULTURAL BUNGRAD",357,"Alegeri Prezidentiale",1,496,300,247,53,0,299,1,500,200,268,31
34,SIBIU,ŞELIMBĂR,143557,ŞELIMBĂR,"GRĂDINIȚA CU PROGRAM PRELUNGIT ȘELIMBĂR, CORP NOU, PARTER",358,"Alegeri Prezidentiale",1,1545,1204,954,250,0,1187,17,1700,496,1072,115
34,SIBIU,ŞELIMBĂR,143557,ŞELIMBĂR,"CARTIER DOAMNA STANCA ȘCOALA DE BALET PENTRU COPII",359,"Alegeri Prezidentiale",1,1348,1053,735,318,0,1044,9,1400,347,967,77
34,SIBIU,ŞELIMBĂR,143557,ŞELIMBĂR,"CARTIER AVANTGARDEN 3 SEDIUL SECUNDAR ȘI PUNCT DE LUCRU FIRMĂ",360,"Alegeri Prezidentiale",1,439,594,234,360,0,585,9,700,106,526,59
34,SIBIU,"ŞURA MARE",145765,"ŞURA MARE","SALĂ SPORT",361,"Alegeri Prezidentiale",1,1323,774,675,99,0,766,8,1300,526,643,123
34,SIBIU,"ŞURA MARE",145765,"ŞURA MARE","SALĂ SPORT",362,"Alegeri Prezidentiale",1,1760,948,848,100,0,942,6,1900,952,854,88
34,SIBIU,"ŞURA MARE",145765,HAMBA,"REMIZĂ PSI HAMBA",363,"Alegeri Prezidentiale",1,716,388,339,49,0,386,2,800,412,342,44
34,SIBIU,"ŞURA MICĂ",145792,"ŞURA MICĂ","SCOALA GIMNAZIALA SURA MICA",364,"Alegeri Prezidentiale",1,1443,806,648,157,1,801,5,1600,794,732,69
34,SIBIU,"ŞURA MICĂ",145792,RUSCIORI,"SCOALA PRIMARA RUSCIORI",365,"Alegeri Prezidentiale",2,603,263,222,41,0,257,6,700,437,229,28
34,SIBIU,"ŞURA MICĂ",145792,"ŞURA MICĂ","ȘCOALA GIMNAZIALĂ CLASELE I-IV ȘURA MICĂ",366,"Alegeri Prezidentiale",1,544,424,295,129,0,421,3,600,176,367,54
34,SIBIU,TÂRNAVA,143646,TÂRNAVA,"GRĂDINIŢA CU ORAR NORMAL TÎRNAVA",367,"Alegeri Prezidentiale",2,1294,552,523,29,0,550,2,1400,848,474,76
34,SIBIU,TÂRNAVA,143646,TÂRNAVA,"GRĂDINIŢA CU ORAR NORMAL TÎRNAVA",368,"Alegeri Prezidentiale",1,1212,533,511,22,0,528,5,1300,767,454,74
34,SIBIU,TILIŞCA,145907,TILIŞCA,"PRIMĂRIA TILIŞCA",369,"Alegeri Prezidentiale",1,850,521,457,64,0,515,6,900,379,416,99
34,SIBIU,TILIŞCA,145907,ROD,"ŞCOALA PRIMARĂ ROD",370,"Alegeri Prezidentiale",1,323,205,170,35,0,204,1,400,195,183,21
34,SIBIU,"TURNU ROŞU",145934,"TURNU ROŞU",CLUB,371,"Alegeri Prezidentiale",1,1481,907,785,122,0,899,8,1600,693,796,103
34,SIBIU,"TURNU ROŞU",145934,"SEBEŞU DE JOS",DISPENSAR,372,"Alegeri Prezidentiale",1,450,325,255,70,0,320,5,500,175,267,53
34,SIBIU,"VALEA VIILOR",145961,"VALEA VIILOR","CĂMIN VALEA VIILOR",373,"Alegeri Prezidentiale",1,1250,584,503,43,38,575,9,1400,816,422,153
34,SIBIU,"VALEA VIILOR",145961,MOTIŞ,"CĂMIN MOTIȘ",374,"Alegeri Prezidentiale",1,549,212,176,32,4,211,1,600,388,178,33
34,SIBIU,VURPĂR,145998,VURPĂR,"SALA SPORT",375,"Alegeri Prezidentiale",2,1224,461,438,23,0,455,6,1300,839,402,53
34,SIBIU,VURPĂR,145998,VURPĂR,"ŞCOALA GIMNAZIALĂ",376,"Alegeri Prezidentiale",1,857,354,328,26,0,354,0,900,546,317,37
35,SUCEAVA,"MUNICIPIUL SUCEAVA",146263,SUCEAVA,"PRIMĂRIA MUNICIPIULUI SUCEAVA",1,"Alegeri Prezidentiale",1,1636,899,810,82,7,871,28,1800,901,529,342
35,SUCEAVA,"MUNICIPIUL SUCEAVA",146263,SUCEAVA,"COLEGIUL NAŢIONAL ”PETRU RAREŞ” SALA A",2,"Alegeri Prezidentiale",1,1677,876,779,96,1,855,21,1800,924,546,309
35,SUCEAVA,"MUNICIPIUL SUCEAVA",146263,SUCEAVA,"COLEGIUL NAŢIONAL ”PETRU RAREŞ” SALA B",3,"Alegeri Prezidentiale",1,1698,868,768,100,0,838,30,1900,1032,474,364
35,SUCEAVA,"MUNICIPIUL SUCEAVA",146263,SUCEAVA,"COLEGIUL NAŢIONAL ”ŞTEFAN CEL MARE”",4,"Alegeri Prezidentiale",1,1665,815,736,79,0,793,22,1800,985,526,267
35,SUCEAVA,"MUNICIPIUL SUCEAVA",146263,SUCEAVA,"COLEGIUL NAȚIONAL ”ȘTEFAN CEL MARE”",5,"Alegeri Prezidentiale",1,876,422,322,100,0,408,14,1000,578,240,168
35,SUCEAVA,"MUNICIPIUL SUCEAVA",146263,SUCEAVA,"CENTRUL CULTURAL BUCOVINA",6,"Alegeri Prezidentiale",1,1651,861,761,99,1,833,28,1800,939,505,328
35,SUCEAVA,"MUNICIPIUL SUCEAVA",146263,SUCEAVA,"ŞCOALA GIMNAZIALĂ NR .1",7,"Alegeri Prezidentiale",1,1332,743,665,78,0,716,27,1500,757,423,293
35,SUCEAVA,"MUNICIPIUL SUCEAVA",146263,SUCEAVA,"COLEGIUL TEHNIC ”SAMUIL ISOPESCU”",8,"Alegeri Prezidentiale",1,1212,750,654,96,0,740,10,1300,550,453,287
35,SUCEAVA,"MUNICIPIUL SUCEAVA",146263,SUCEAVA,"COLEGIUL DE ARTĂ „CIPRIAN PORUMBESCU” SALA A",9,"Alegeri Prezidentiale",1,1360,425,349,76,0,415,10,1500,1075,255,160
35,SUCEAVA,"MUNICIPIUL SUCEAVA",146263,SUCEAVA,"COLEGIUL DE ARTĂ „CIPRIAN PORUMBESCU” SALA B",10,"Alegeri Prezidentiale",1,1232,593,563,29,1,578,15,1400,807,381,197
35,SUCEAVA,"MUNICIPIUL SUCEAVA",146263,SUCEAVA,"ŞCOALA GIMNAZIALĂ NR.3 SALA A",11,"Alegeri Prezidentiale",1,1034,574,519,54,1,554,20,1100,526,344,210
35,SUCEAVA,"MUNICIPIUL SUCEAVA",146263,SUCEAVA,"ŞCOALA GIMNAZIALĂ NR.3 SALA B",12,"Alegeri Prezidentiale",1,1168,707,601,106,0,687,20,1300,593,392,295
35,SUCEAVA,"MUNICIPIUL SUCEAVA",146263,SUCEAVA,"COLEGIUL ECONOMIC ” DIMITRIE CANTEMIR”",13,"Alegeri Prezidentiale",1,1129,601,537,64,0,585,16,1200,599,358,227
35,SUCEAVA,"MUNICIPIUL SUCEAVA",146263,SUCEAVA,"CENTRUL PENTRU SUSŢINEREA TRADIŢIILOR BUCOVINENE",14,"Alegeri Prezidentiale",1,1518,756,679,74,3,741,15,1700,944,456,285
35,SUCEAVA,"MUNICIPIUL SUCEAVA",146263,SUCEAVA,"UNIVERSITATEA ”ŞTEFAN CEL MARE”",15,"Alegeri Prezidentiale",1,845,880,412,468,0,853,27,1400,520,650,203
35,SUCEAVA,"MUNICIPIUL SUCEAVA",146263,SUCEAVA,"DIRECŢIA SILVICĂ SUCEAVA",16,"Alegeri Prezidentiale",1,1076,564,480,67,17,552,12,1400,836,327,225
35,SUCEAVA,"MUNICIPIUL SUCEAVA",146263,SUCEAVA,"COLEGIUL NAŢIONAL DE INFORMATICĂ ”SPIRU HARET”, SALA A",17,"Alegeri Prezidentiale",1,1129,802,531,80,191,786,16,1400,598,475,311
35,SUCEAVA,"MUNICIPIUL SUCEAVA",146263,SUCEAVA,"COLEGIUL NAŢIONAL DE INFORMATICĂ ” SPIRU HARET”, SALA B",18,"Alegeri Prezidentiale",1,971,708,510,45,153,696,12,1400,692,408,288
35,SUCEAVA,"MUNICIPIUL SUCEAVA",146263,SUCEAVA,"GRĂDINIŢA CU PROGRAM PRELUNGIT NR.7 ”ABC ”",19,"Alegeri Prezidentiale",1,1614,698,639,59,0,682,16,1800,1102,386,296
35,SUCEAVA,"MUNICIPIUL SUCEAVA",146263,SUCEAVA,"ŞCOALA GIMNAZIALĂ NR. 4 SALA A",20,"Alegeri Prezidentiale",1,1492,796,739,56,1,775,21,1600,804,442,333
35,SUCEAVA,"MUNICIPIUL SUCEAVA",146263,SUCEAVA,"ŞCOALA GIMNAZIALĂ NR. 4, SALA B",21,"Alegeri Prezidentiale",1,1345,718,664,53,1,702,16,1500,782,420,282
35,SUCEAVA,"MUNICIPIUL SUCEAVA",146263,SUCEAVA,"ŞCOALA GIMNAZIALĂ NR. 8",22,"Alegeri Prezidentiale",1,1970,981,890,90,1,966,15,2100,1119,598,368
35,SUCEAVA,"MUNICIPIUL SUCEAVA",146263,SUCEAVA,"GRADINIŢA CU PROGRAM NORMAL NR. 5",23,"Alegeri Prezidentiale",1,1815,836,795,41,0,812,24,2000,1164,489,323
35,SUCEAVA,"MUNICIPIUL SUCEAVA",146263,SUCEAVA,"GRADINIŢA CU PROGRAM PRELUNGIT NR.1 ”GULIVER”",24,"Alegeri Prezidentiale",1,1287,679,602,77,0,669,10,1400,721,395,274
35,SUCEAVA,"MUNICIPIUL SUCEAVA",146263,SUCEAVA,"LICEUL CU PROGRAM SPORTIV SALA A",25,"Alegeri Prezidentiale",1,1595,755,694,61,0,733,22,1800,1045,435,298
35,SUCEAVA,"MUNICIPIUL SUCEAVA",146263,SUCEAVA,"LICEUL CU PROGRAM SPORTIV SALA B",26,"Alegeri Prezidentiale",1,1793,784,744,39,1,763,21,1900,1116,452,311
35,SUCEAVA,"MUNICIPIUL SUCEAVA",146263,SUCEAVA,"COLEGIUL NAŢIONAL ”MIHAI EMINESCU”",27,"Alegeri Prezidentiale",1,1889,487,314,173,0,479,8,2000,1513,340,139
35,SUCEAVA,"MUNICIPIUL SUCEAVA",146263,SUCEAVA,"COLEGIUL NAŢIONAL ”MIHAI EMINESCU”",28,"Alegeri Prezidentiale",1,1652,815,789,25,1,794,21,1800,985,482,312
35,SUCEAVA,"MUNICIPIUL SUCEAVA",146263,SUCEAVA,"COLEGIUL NAŢIONAL ”MIHAI EMINESCU”",29,"Alegeri Prezidentiale",1,1950,868,839,29,0,842,26,2100,1232,511,331
35,SUCEAVA,"MUNICIPIUL SUCEAVA",146263,SUCEAVA,"COLEGIUL NAȚIONAL ”MIHAI EMINESCU”",30,"Alegeri Prezidentiale",1,1473,740,665,75,0,720,20,1600,860,439,281
35,SUCEAVA,"MUNICIPIUL SUCEAVA",146263,SUCEAVA,"COLEGIUL TEHNIC DE INDUSTRIE ALIMENTARĂ, SALA A",31,"Alegeri Prezidentiale",1,1825,939,860,79,0,916,23,2000,1061,618,298
35,SUCEAVA,"MUNICIPIUL SUCEAVA",146263,SUCEAVA,"COLEGIUL TEHNIC DE INDUSTRIE ALIMENTARĂ, SALA B",32,"Alegeri Prezidentiale",1,1897,915,841,73,1,901,14,2100,1185,560,341
35,SUCEAVA,"MUNICIPIUL SUCEAVA",146263,SUCEAVA,"COLEGIUL TEHNIC „PETRU MUŞAT”",33,"Alegeri Prezidentiale",1,1091,300,271,29,0,293,7,1200,900,196,97
35,SUCEAVA,"MUNICIPIUL SUCEAVA",146263,SUCEAVA,"S.C. ROMTELECOM S.A.",34,"Alegeri Prezidentiale",1,1950,884,806,78,0,858,26,2100,1216,603,255
35,SUCEAVA,"MUNICIPIUL SUCEAVA",146263,SUCEAVA,"INSPECTORATUL TERITORIAL DE MUNCĂ",35,"Alegeri Prezidentiale",3,1974,863,796,66,1,843,20,2100,1237,577,266
35,SUCEAVA,"MUNICIPIUL SUCEAVA",146263,SUCEAVA,"AGENŢIA PENTRU PROTECŢIA MEDIULUI",36,"Alegeri Prezidentiale",1,1990,1132,1001,131,0,1096,36,2100,968,761,335
35,SUCEAVA,"MUNICIPIUL SUCEAVA",146263,SUCEAVA,"ŞCOALA GIMNAZIALĂ NR. 9 ”ION CREANGĂ” SALA A",37,"Alegeri Prezidentiale",1,1840,950,862,88,0,906,44,2000,1050,605,301
35,SUCEAVA,"MUNICIPIUL SUCEAVA",146263,SUCEAVA,"ŞCOALA GIMNAZIALĂ NR. 9 ”ION CREANGĂ” SALA B",38,"Alegeri Prezidentiale",1,1896,1021,911,110,0,988,33,2100,1079,696,292
35,SUCEAVA,"MUNICIPIUL SUCEAVA",146263,SUCEAVA,"ŞCOALA GIMNAZIALĂ NR. 9 ”ION CREANGĂ”, SALA C",39,"Alegeri Prezidentiale",1,1689,863,769,93,1,847,16,1800,937,588,259
35,SUCEAVA,"MUNICIPIUL SUCEAVA",146263,SUCEAVA,"SCOALA GIMNAZIALĂ NR. 9 ”ION CREANGA”, SALA D",40,"Alegeri Prezidentiale",1,1900,982,902,80,0,958,24,2100,1118,649,309
35,SUCEAVA,"MUNICIPIUL SUCEAVA",146263,SUCEAVA,"GRĂDINIŢA CU PROGRAM NORMAL NR. 9 ”NOROCEL” SALA A",41,"Alegeri Prezidentiale",1,2000,549,468,81,0,532,17,2100,1551,383,149
35,SUCEAVA,"MUNICIPIUL SUCEAVA",146263,SUCEAVA,"GRĂDINIŢA CU PROGRAM NORMAL NR.9 ”NOROCEL” SALA B",42,"Alegeri Prezidentiale",1,2091,783,749,34,0,757,26,2200,1417,584,173
35,SUCEAVA,"MUNICIPIUL SUCEAVA",146263,SUCEAVA,"ATELIER ZONĂ CFR",43,"Alegeri Prezidentiale",1,1526,456,429,27,0,445,11,1600,1144,279,166
35,SUCEAVA,"MUNICIPIUL SUCEAVA",146263,SUCEAVA,"GARA BURDUJENI",44,"Alegeri Prezidentiale",1,2021,378,283,95,0,372,6,2200,1822,238,134
35,SUCEAVA,"MUNICIPIUL SUCEAVA",146263,SUCEAVA,"GARA BURDUJENI",45,"Alegeri Prezidentiale",1,2035,799,585,214,0,772,27,2200,1401,522,250
35,SUCEAVA,"MUNICIPIUL SUCEAVA",146263,SUCEAVA,"ŞCOALA GIMNAZIALĂ NR. 10, SALA A",46,"Alegeri Prezidentiale",1,1965,940,860,80,0,924,16,2100,1160,609,315
35,SUCEAVA,"MUNICIPIUL SUCEAVA",146263,SUCEAVA,"ŞCOALA GIMNAZIALĂ NR. 10, SALA B",47,"Alegeri Prezidentiale",1,1983,912,878,34,0,902,10,2100,1188,598,304
35,SUCEAVA,"MUNICIPIUL SUCEAVA",146263,SUCEAVA,"COLEGIUL TEHNIC ”A.I.CUZA” SALA A, CALEA UNIRII, NR.49",48,"Alegeri Prezidentiale",1,1890,725,671,54,0,709,16,2000,1275,483,226
35,SUCEAVA,"MUNICIPIUL SUCEAVA",146263,SUCEAVA,"COLEGIUL TEHNIC ”A.I.CUZA” SALA B, CALEA UNIRII, NR.49",49,"Alegeri Prezidentiale",1,1566,770,722,48,0,753,17,1700,930,530,223
35,SUCEAVA,"MUNICIPIUL SUCEAVA",146263,SUCEAVA,"COLEGIUL TEHNIC ”AL. I. CUZA” SALA C",50,"Alegeri Prezidentiale",1,1307,614,576,38,0,604,10,1400,786,405,199
35,SUCEAVA,"MUNICIPIUL SUCEAVA",146263,SUCEAVA,"ŞCOALA GIMNAZIALĂ NR. 5 ”JEAN BART”",51,"Alegeri Prezidentiale",1,1586,660,628,32,0,643,17,1700,1040,420,223
35,SUCEAVA,"MUNICIPIUL SUCEAVA",146263,SUCEAVA,"CENTRUL ŞCOLAR PENTRU EDUCAŢIE INCLUZIVĂ SUCEAVA, CORP A",52,"Alegeri Prezidentiale",2,1911,852,804,48,0,827,25,2100,1248,603,224
35,SUCEAVA,"MUNICIPIUL SUCEAVA",146263,SUCEAVA,"CENTRUL ŞCOLAR PENTRU EDUCAŢIE INCLUZIVĂ SUCEAVA- CORP B",53,"Alegeri Prezidentiale",1,1765,675,657,18,0,659,16,1900,1225,442,217
35,SUCEAVA,"MUNICIPIUL SUCEAVA",146263,SUCEAVA,"GRĂDINIŢA CU PROGRAM NORMAL NR. 12 ”ŢĂNDĂRICĂ”",54,"Alegeri Prezidentiale",1,1779,838,785,53,0,820,18,1900,1062,564,256
35,SUCEAVA,"MUNICIPIUL SUCEAVA",146263,SUCEAVA,"ŞCOALA GIMNAZIALĂ NR.11, ”MIRON COSTIN”, SALA A",55,"Alegeri Prezidentiale",1,1815,880,747,133,0,863,17,2000,1120,614,249
35,SUCEAVA,"MUNICIPIUL SUCEAVA",146263,SUCEAVA,"ŞCOALA GIMNAZIALĂ NR.11, ”MIRON COSTIN”, SALA B",56,"Alegeri Prezidentiale",1,1825,746,719,27,0,727,19,2000,1254,511,216
35,SUCEAVA,"MUNICIPIUL SUCEAVA",146263,SUCEAVA,"ŞCOALA GIMNAZIALĂ NR.11, ”MIRON COSTIN”, SALA C",57,"Alegeri Prezidentiale",1,1734,758,728,30,0,732,26,1900,1142,482,250
35,SUCEAVA,"MUNICIPIUL SUCEAVA",146263,SUCEAVA,"ŞCOALA GIMNAZIALĂ NR.11, ”MIRON COSTIN”, SALA D",58,"Alegeri Prezidentiale",1,1751,771,737,34,0,757,14,1900,1129,528,229
35,SUCEAVA,"MUNICIPIUL SUCEAVA",146263,SUCEAVA,"SCOALA GIMNAZIALA NR.11 ”MIRON COSTIN”, SALA E",59,"Alegeri Prezidentiale",1,1655,642,619,23,0,624,18,1800,1158,423,201
35,SUCEAVA,"MUNICIPIUL SUCEAVA",146263,SUCEAVA,"PRIMĂRIA BURDUJENI",60,"Alegeri Prezidentiale",1,1365,619,564,46,9,598,21,1500,881,426,172
35,SUCEAVA,"MUNICIPIUL SUCEAVA",146263,SUCEAVA,"ŞCOALA GIMNAZIALĂ NR. 6, SALA A",61,"Alegeri Prezidentiale",1,1377,557,531,26,0,546,11,1500,943,368,178
35,SUCEAVA,"MUNICIPIUL SUCEAVA",146263,SUCEAVA,"SCOALA GIMNAZIALA NR.6 SALA B",62,"Alegeri Prezidentiale",1,1085,484,471,13,0,471,13,1200,716,353,118
35,SUCEAVA,"MUNICIPIUL SUCEAVA",146263,SUCEAVA,"GRĂDINIŢA CU PROGRAM NORMAL NR.7",63,"Alegeri Prezidentiale",5,1398,628,561,67,0,613,15,1500,872,363,250
35,SUCEAVA,"MUNICIPIUL SUCEAVA",146263,SUCEAVA,"GRĂDINIŢA CU PROGRAM NORMAL NR.8",64,"Alegeri Prezidentiale",2,1741,674,650,24,0,652,22,1900,1226,418,234
35,SUCEAVA,"MUNICIPIUL SUCEAVA",146263,SUCEAVA,"ŞCOALA GENERALĂ NR. 7 ”GRIGORE GHICA VOIEVOD”",65,"Alegeri Prezidentiale",1,1785,813,760,52,1,791,22,1900,1087,502,289
35,SUCEAVA,"MUNICIPIUL CÂMPULUNG MOLDOVENESC",146502,"CÂMPULUNG MOLDOVENESC","ŞCOALA GIMNAZIALĂ „THEODOR DARIE”",66,"Alegeri Prezidentiale",1,1535,754,719,35,0,739,15,1700,946,494,245
35,SUCEAVA,"MUNICIPIUL CÂMPULUNG MOLDOVENESC",146502,"CÂMPULUNG MOLDOVENESC","LICEUL TEHNOLOGIC NR. 1",67,"Alegeri Prezidentiale",1,827,460,374,45,41,446,14,900,440,277,169
35,SUCEAVA,"MUNICIPIUL CÂMPULUNG MOLDOVENESC",146502,"CÂMPULUNG MOLDOVENESC","CIRCUMSCRIPŢIA SANITAR-VETERINARĂ",68,"Alegeri Prezidentiale",1,1874,700,663,36,1,687,13,1900,1200,436,251
35,SUCEAVA,"MUNICIPIUL CÂMPULUNG MOLDOVENESC",146502,"CÂMPULUNG MOLDOVENESC","ŞCOALA GIMNAZIALĂ „TEODOR ŞTEFANELLI”",69,"Alegeri Prezidentiale",1,842,375,336,39,0,364,11,900,525,213,151
35,SUCEAVA,"MUNICIPIUL CÂMPULUNG MOLDOVENESC",146502,"CÂMPULUNG MOLDOVENESC","COLEGIUL NAŢIONAL ”DRAGOŞ VODĂ”",70,"Alegeri Prezidentiale",1,1129,561,497,64,0,546,15,1200,639,358,188
35,SUCEAVA,"MUNICIPIUL CÂMPULUNG MOLDOVENESC",146502,"CÂMPULUNG MOLDOVENESC","CLUBUL COPIILOR ŞI ELEVILOR",71,"Alegeri Prezidentiale",1,1316,652,597,55,0,633,19,1500,848,417,216
35,SUCEAVA,"MUNICIPIUL CÂMPULUNG MOLDOVENESC",146502,"CÂMPULUNG MOLDOVENESC","ŞCOALA GIMNAZIALĂ ”BOGDAN VODĂ”",72,"Alegeri Prezidentiale",1,1405,817,654,163,0,802,15,1600,783,535,267
35,SUCEAVA,"MUNICIPIUL CÂMPULUNG MOLDOVENESC",146502,"CÂMPULUNG MOLDOVENESC","CLUBUL COPIILOR ŞI ELEVILOR – SATUL DE VACANŢĂ",73,"Alegeri Prezidentiale",1,643,319,297,22,0,313,6,700,381,218,95
35,SUCEAVA,"MUNICIPIUL CÂMPULUNG MOLDOVENESC",146502,"CÂMPULUNG MOLDOVENESC","COLEGIUL SILVIC ”BUCOVINA” (CORP A)",74,"Alegeri Prezidentiale",2,1406,664,619,45,0,647,17,1600,936,435,212
35,SUCEAVA,"MUNICIPIUL CÂMPULUNG MOLDOVENESC",146502,"CÂMPULUNG MOLDOVENESC","COLEGIUL SILVIC ”BUCOVINA” (CORP B)",75,"Alegeri Prezidentiale",1,1342,632,603,29,0,616,16,1500,868,422,194
35,SUCEAVA,"MUNICIPIUL CÂMPULUNG MOLDOVENESC",146502,"CÂMPULUNG MOLDOVENESC","COLEGIUL SILVIC ”BUCOVINA” (CORP C)",76,"Alegeri Prezidentiale",1,1435,687,664,23,0,670,17,1600,913,458,212
35,SUCEAVA,"MUNICIPIUL CÂMPULUNG MOLDOVENESC",146502,"CÂMPULUNG MOLDOVENESC","GRĂDINIŢA NR. 4 „VALEA SEACĂ”",77,"Alegeri Prezidentiale",1,1158,607,582,25,0,601,6,1300,693,415,186
35,SUCEAVA,"MUNICIPIUL CÂMPULUNG MOLDOVENESC",146502,"CÂMPULUNG MOLDOVENESC","ŞCOALA GIMNAZIALĂ „GEORGE VOEVIDCA” - CORP A",78,"Alegeri Prezidentiale",1,1030,550,509,40,1,542,8,1100,550,392,150
35,SUCEAVA,"MUNICIPIUL CÂMPULUNG MOLDOVENESC",146502,"CÂMPULUNG MOLDOVENESC","ŞCOALA GIMNAZIALĂ „GEORGE VOEVIDCA” - CORP B",79,"Alegeri Prezidentiale",1,1090,608,547,61,0,596,12,1200,592,407,189
35,SUCEAVA,"MUNICIPIUL FĂLTICENI",146539,FĂLTICENI,"COLEGIUL TEHNIC ”MIHAI BĂCESCU”",80,"Alegeri Prezidentiale",1,1415,828,702,60,66,801,27,1592,764,445,356
35,SUCEAVA,"MUNICIPIUL FĂLTICENI",146539,FĂLTICENI,"ŞCOALA GIMNAZIALĂ ”ALEXANDRU IOAN CUZA”",81,"Alegeri Prezidentiale",1,1477,680,618,60,2,659,21,1600,920,335,324
35,SUCEAVA,"MUNICIPIUL FĂLTICENI",146539,FĂLTICENI,"COLEGIUL NAŢIONAL ”NICU GANE”",82,"Alegeri Prezidentiale",1,1493,726,643,83,0,713,13,1600,874,405,308
35,SUCEAVA,"MUNICIPIUL FĂLTICENI",146539,FĂLTICENI,"COLEGIUL NAŢIONAL ”NICU GANE”",83,"Alegeri Prezidentiale",1,1568,760,684,76,0,736,24,1700,940,394,342
35,SUCEAVA,"MUNICIPIUL FĂLTICENI",146539,FĂLTICENI,"ŞCOALA GIMNAZIALĂ ”IOAN CIUREA”",84,"Alegeri Prezidentiale",1,1436,629,572,57,0,616,13,1600,971,314,302
35,SUCEAVA,"MUNICIPIUL FĂLTICENI",146539,FĂLTICENI,"ŞCOALA GIMNAZIALĂ ”IOAN CIUREA”",85,"Alegeri Prezidentiale",1,817,436,393,43,0,426,10,900,464,203,223
35,SUCEAVA,"MUNICIPIUL FĂLTICENI",146539,FĂLTICENI,"ŞCOALA GIMNAZIALĂ ”IOAN CIUREA”",86,"Alegeri Prezidentiale",1,1181,537,511,26,0,521,16,1300,763,278,243
35,SUCEAVA,"MUNICIPIUL FĂLTICENI",146539,FĂLTICENI,"ŞCOALA GIMNAZIALĂ ”MIHAIL SADOVEANU”",87,"Alegeri Prezidentiale",1,1679,834,755,78,1,818,16,1800,966,465,353
35,SUCEAVA,"MUNICIPIUL FĂLTICENI",146539,FĂLTICENI,"ŞCOALA GIMNAZIALĂ ”MIHAIL SADOVEANU”",88,"Alegeri Prezidentiale",1,1266,601,530,71,0,586,15,1400,799,291,295
35,SUCEAVA,"MUNICIPIUL FĂLTICENI",146539,FĂLTICENI,"ŞCOALA GIMNAZIALĂ ”MIHAIL SADOVEANU”",89,"Alegeri Prezidentiale",1,1181,624,590,32,2,603,21,1300,676,297,306
35,SUCEAVA,"MUNICIPIUL FĂLTICENI",146539,FĂLTICENI,"ŞCOALA GIMNAZIALĂ ”ION IRIMIESCU”",90,"Alegeri Prezidentiale",1,1230,591,550,38,3,574,17,1400,809,310,264
35,SUCEAVA,"MUNICIPIUL FĂLTICENI",146539,FĂLTICENI,"ŞCOALA GIMNAZIALĂ ”ION IRIMIESCU”",91,"Alegeri Prezidentiale",1,1151,500,478,22,0,490,10,1300,800,270,220
35,SUCEAVA,"MUNICIPIUL FĂLTICENI",146539,FĂLTICENI,"GRĂDINIŢA CU PROGRAM PRELUNGIT ”DUMBRAVA MINUNATĂ”",92,"Alegeri Prezidentiale",1,1069,429,400,29,0,419,10,1200,771,223,196
35,SUCEAVA,"MUNICIPIUL FĂLTICENI",146539,FĂLTICENI,"GRĂDINIŢA CU PROGRAM PRELUNGIT ”DUMBRAVA MINUNATĂ”",93,"Alegeri Prezidentiale",1,1122,478,451,27,0,467,11,1200,722,236,231
35,SUCEAVA,"MUNICIPIUL FĂLTICENI",146539,FĂLTICENI,"GRĂDINIŢA CU PROGRAM PRELUNGIT ”DUMBRAVA MINUNATĂ”",94,"Alegeri Prezidentiale",1,921,495,430,55,10,490,5,1000,505,250,240
35,SUCEAVA,"MUNICIPIUL FĂLTICENI",146539,FĂLTICENI,"COLEGIUL ”VASILE LOVINESCU”",95,"Alegeri Prezidentiale",1,1456,719,667,33,19,702,17,1600,881,321,381
35,SUCEAVA,"MUNICIPIUL FĂLTICENI",146539,FĂLTICENI,"COLEGIUL ”VASILE LOVINESCU”",96,"Alegeri Prezidentiale",1,1437,664,636,28,0,647,17,1600,936,316,331
35,SUCEAVA,"MUNICIPIUL FĂLTICENI",146539,FĂLTICENI,"COLEGIUL ”VASILE LOVINESCU”",97,"Alegeri Prezidentiale",2,1491,785,725,54,6,768,17,1600,815,476,292
35,SUCEAVA,"MUNICIPIUL FĂLTICENI",146539,FĂLTICENI,"ŞCOALA GIMNAZIALĂ ”IOAN CIUREA”- CLĂDIRE GHEORGHE GAFENCU",98,"Alegeri Prezidentiale",1,1561,713,682,31,0,695,18,1700,987,368,327
35,SUCEAVA,"MUNICIPIUL FĂLTICENI",146539,FĂLTICENI,"GRĂDINIŢA CU PROGRAM NORMAL ŢARNA MARE",99,"Alegeri Prezidentiale",1,798,401,388,13,0,394,7,900,499,249,145
35,SUCEAVA,"MUNICIPIUL RĂDĂUŢI",146628,RĂDĂUŢI,"PRIMARIA RADAUTI",100,"Alegeri Prezidentiale",1,1965,741,689,52,0,726,15,2100,1359,462,264
35,SUCEAVA,"MUNICIPIUL RĂDĂUŢI",146628,RĂDĂUŢI,"CASA DE CULTURA",101,"Alegeri Prezidentiale",1,1792,823,718,104,1,803,20,1900,1077,440,363
35,SUCEAVA,"MUNICIPIUL RĂDĂUŢI",146628,RĂDĂUŢI,"GALERIILE DE ARTA",102,"Alegeri Prezidentiale",1,1581,715,632,82,1,686,29,1700,985,417,269
35,SUCEAVA,"MUNICIPIUL RĂDĂUŢI",146628,RĂDĂUŢI,"SCOALA GIMNAZIALA REGINA ELISABETA NR.4",103,"Alegeri Prezidentiale",1,1907,792,733,58,1,769,23,2100,1308,502,267
35,SUCEAVA,"MUNICIPIUL RĂDĂUŢI",146628,RĂDĂUŢI,"COLEGIUL TEHNIC",104,"Alegeri Prezidentiale",2,1913,771,713,56,2,752,19,2100,1329,464,288
35,SUCEAVA,"MUNICIPIUL RĂDĂUŢI",146628,RĂDĂUŢI,"COLEGIUL EUDOXIU HURMUZACHI",105,"Alegeri Prezidentiale",1,1645,757,670,87,0,727,30,1800,1043,431,296
35,SUCEAVA,"MUNICIPIUL RĂDĂUŢI",146628,RĂDĂUŢI,"SCOALA GIMNAZIALA NR.5 BOGDAN VODA",106,"Alegeri Prezidentiale",1,1733,670,634,36,0,658,12,1900,1230,381,277
35,SUCEAVA,"MUNICIPIUL RĂDĂUŢI",146628,RĂDĂUŢI,"GRADINITA NR.8",107,"Alegeri Prezidentiale",1,1921,782,734,48,0,757,25,2100,1318,514,243
35,SUCEAVA,"MUNICIPIUL RĂDĂUŢI",146628,RĂDĂUŢI,"DIRECȚIA DE ASISTENȚĂ SOCIALĂ",108,"Alegeri Prezidentiale",1,1813,710,640,32,38,683,27,2000,1290,423,260
35,SUCEAVA,"MUNICIPIUL RĂDĂUŢI",146628,RĂDĂUŢI,POLICLINICA,109,"Alegeri Prezidentiale",2,1829,882,719,64,99,847,35,2000,1118,486,361
35,SUCEAVA,"MUNICIPIUL RĂDĂUŢI",146628,RĂDĂUŢI,"SCOALA GIMNAZIALA NR.3 MIHAI EMINESCU",110,"Alegeri Prezidentiale",1,1984,764,718,46,0,745,19,2100,1336,424,321
35,SUCEAVA,"MUNICIPIUL RĂDĂUŢI",146628,RĂDĂUŢI,"CRESA HIPODROM",111,"Alegeri Prezidentiale",2,1897,773,719,54,0,754,19,2000,1227,468,286
35,SUCEAVA,"MUNICIPIUL RĂDĂUŢI",146628,RĂDĂUŢI,"SCOALA GIMNAZIALA NR.2",112,"Alegeri Prezidentiale",1,1596,628,594,34,0,609,19,1700,1072,374,235
35,SUCEAVA,"MUNICIPIUL RĂDĂUŢI",146628,RĂDĂUŢI,"SCOALA GIMNAZIALA GHEORGHE POPADIUC NR.1",113,"Alegeri Prezidentiale",1,1826,659,619,40,0,647,12,2000,1341,442,205
35,SUCEAVA,"MUNICIPIUL RĂDĂUŢI",146628,RĂDĂUŢI,"GRADINITA CU PROGRAM PRELUNGIT PINOCHIO",114,"Alegeri Prezidentiale",1,1753,647,616,31,0,622,25,1900,1253,387,235
35,SUCEAVA,"MUNICIPIUL RĂDĂUŢI",146628,RĂDĂUŢI,"COLEGIUL ANDRONIC MOTRESCU",115,"Alegeri Prezidentiale",1,1325,559,519,40,0,541,18,1500,941,382,159
35,SUCEAVA,"MUNICIPIUL VATRA DORNEI",146744,"VATRA DORNEI","CASA DE CULTURA ” PLATON PARDAU”",116,"Alegeri Prezidentiale",1,1316,743,594,122,27,716,27,1500,757,451,265
35,SUCEAVA,"MUNICIPIUL VATRA DORNEI",146744,"VATRA DORNEI","HOTEL BRADUL",117,"Alegeri Prezidentiale",1,855,757,390,367,0,742,15,900,143,422,320
35,SUCEAVA,"MUNICIPIUL VATRA DORNEI",146744,"VATRA DORNEI","HOTEL INTUS",118,"Alegeri Prezidentiale",1,925,673,484,188,1,662,11,1000,327,377,285
35,SUCEAVA,"MUNICIPIUL VATRA DORNEI",146744,"VATRA DORNEI","ŞCOALA GIMNAZIALĂ NR.1",119,"Alegeri Prezidentiale",1,1018,608,502,106,0,597,11,1100,492,434,163
35,SUCEAVA,"MUNICIPIUL VATRA DORNEI",146744,"VATRA DORNEI","ŞCOALA GIMNAZIALĂ NR.1",120,"Alegeri Prezidentiale",1,1515,829,766,63,0,815,14,1700,871,591,224
35,SUCEAVA,"MUNICIPIUL VATRA DORNEI",146744,"VATRA DORNEI","CENTRUL DE PRIMIRE, ASISTARE ŞI ÎNGRIJIRE A PERSOANELOR VÂRSTNICE",121,"Alegeri Prezidentiale",1,519,274,251,23,0,264,10,600,326,181,83
35,SUCEAVA,"MUNICIPIUL VATRA DORNEI",146744,"VATRA DORNEI","ŞCOALA GIMNAZIALĂ NR.2",122,"Alegeri Prezidentiale",1,855,439,411,28,0,427,12,900,461,245,182
35,SUCEAVA,"MUNICIPIUL VATRA DORNEI",146744,"VATRA DORNEI","ȘCOALA GIMNAZIALĂ NR.2",123,"Alegeri Prezidentiale",1,1212,618,603,15,0,599,19,1300,682,345,254
35,SUCEAVA,"MUNICIPIUL VATRA DORNEI",146744,"VATRA DORNEI","GRĂDINIȚA CU PROGRAM PRELUNGIT NR.3 ”SCUFIȚA ROȘIE”",124,"Alegeri Prezidentiale",1,1047,633,501,129,3,608,25,1200,567,341,267
35,SUCEAVA,"MUNICIPIUL VATRA DORNEI",146744,"VATRA DORNEI","GRADINITA CU PROGRAM NORMAL NR.5",125,"Alegeri Prezidentiale",1,1077,559,506,53,0,552,7,1200,641,379,173
35,SUCEAVA,"MUNICIPIUL VATRA DORNEI",146744,"VATRA DORNEI","ȘCOALA PRIMARĂ NR.3",126,"Alegeri Prezidentiale",1,1031,552,516,36,0,539,13,1100,548,354,185
35,SUCEAVA,"MUNICIPIUL VATRA DORNEI",146744,"VATRA DORNEI","ȘCOALA PRIMARĂ NR.3",127,"Alegeri Prezidentiale",1,861,419,402,17,0,405,14,900,481,234,171
35,SUCEAVA,"MUNICIPIUL VATRA DORNEI",146744,"VATRA DORNEI","COMPLEX CFR GARA MARE",128,"Alegeri Prezidentiale",1,1094,544,489,55,0,533,11,1200,656,364,169
35,SUCEAVA,"MUNICIPIUL VATRA DORNEI",146744,"VATRA DORNEI","SCOALA GENERALA ARGESTRU",129,"Alegeri Prezidentiale",1,501,282,255,26,1,275,7,600,318,179,96
35,SUCEAVA,"ORAŞ BROŞTENI",147358,HOLDA,"CĂMIN CULTURAL HOLDA",130,"Alegeri Prezidentiale",1,1024,514,492,22,0,510,4,1100,586,301,209
35,SUCEAVA,"ORAŞ BROŞTENI",147358,BROŞTENI,"PRIMĂRIA BROŞTENI",131,"Alegeri Prezidentiale",2,822,390,348,41,1,376,14,900,510,206,170
35,SUCEAVA,"ORAŞ BROŞTENI",147358,BROŞTENI,"LICEUL TEHNOLOGIC ”NICOLAI NANU” BROŞTENI",132,"Alegeri Prezidentiale",1,1473,597,553,44,0,581,16,1600,1003,293,288
35,SUCEAVA,"ORAŞ BROŞTENI",147358,BROŞTENI,"SPITAL MEDICO SOCIAL CARMEN SYLVA",133,"Alegeri Prezidentiale",1,440,171,157,14,0,167,4,500,329,85,82
35,SUCEAVA,"ORAŞ BROŞTENI",147358,COTÂRGAŞI,"ŞCOALA COTÎRGAŞI NR.1",134,"Alegeri Prezidentiale",1,1053,501,476,25,0,495,6,1200,699,297,198
35,SUCEAVA,"ORAŞ BROŞTENI",147358,FRASIN,"GRADINITA SAT FRASIN, BROSTENI",135,"Alegeri Prezidentiale",1,412,231,197,34,0,227,4,500,269,119,108
35,SUCEAVA,"ORAŞ BROŞTENI",147358,DÂRMOXA,"ŞCOALA GENERALĂ DÎRMOXA",136,"Alegeri Prezidentiale",3,121,89,72,17,0,88,1,200,111,57,31
35,SUCEAVA,"ORAŞ CAJVANA",147633,CAJVANA,"CĂMIN CULTURAL CAJVANA",137,"Alegeri Prezidentiale",1,1791,605,563,42,0,604,1,1900,1295,428,176
35,SUCEAVA,"ORAŞ CAJVANA",147633,CAJVANA,"LICEUL TEHNOLOGIC CAJVANA",138,"Alegeri Prezidentiale",1,1895,476,468,8,0,472,4,2000,1524,355,117
35,SUCEAVA,"ORAŞ CAJVANA",147633,CAJVANA,"LICEUL TEHNOLOGIC CAJVANA",139,"Alegeri Prezidentiale",1,1738,468,452,16,0,464,4,1900,1432,387,77
35,SUCEAVA,"ORAŞ CAJVANA",147633,CAJVANA,"GRADINITA CU PROGRAM NORMAL CAJVANA",140,"Alegeri Prezidentiale",1,1490,381,364,17,0,379,2,1600,1219,304,75
35,SUCEAVA,"ORAŞ DOLHASCA",148006,DOLHASCA,"LICEUL TEHNOLOGIC ”OLTEA DOAMNA”",141,"Alegeri Prezidentiale",1,1207,537,473,64,0,527,10,1300,763,294,233
35,SUCEAVA,"ORAŞ DOLHASCA",148006,DOLHASCA,"ŞCOALA PRIMARĂ DOLHASCA",142,"Alegeri Prezidentiale",1,981,459,404,55,0,454,5,1100,641,238,216
35,SUCEAVA,"ORAŞ DOLHASCA",148006,DOLHASCA,"ŞCOALA PRIMARĂ SÂNDENI",143,"Alegeri Prezidentiale",1,730,342,328,14,0,337,5,800,458,202,135
35,SUCEAVA,"ORAŞ DOLHASCA",148006,POIANA,"ŞCOALA PRIMARĂ POIANA",144,"Alegeri Prezidentiale",1,369,162,144,18,0,162,0,400,238,121,41
35,SUCEAVA,"ORAŞ DOLHASCA",148006,GULIA,"CENTRU COMUNITAR PENTRU SERVICII MEDICALE INTEGRATE",145,"Alegeri Prezidentiale",1,1798,804,782,22,0,790,14,1900,1096,456,334
35,SUCEAVA,"ORAŞ DOLHASCA",148006,PROBOTA,"ŞCOALA GIMNAZIALĂ PROBOTA",146,"Alegeri Prezidentiale",1,1447,681,611,70,0,673,8,1600,919,379,294
35,SUCEAVA,"ORAŞ DOLHASCA",148006,POIENARI,"ŞCOALA PRIMARĂ POIENARI",147,"Alegeri Prezidentiale",1,232,130,119,11,0,129,1,300,170,71,58
35,SUCEAVA,"ORAŞ DOLHASCA",148006,"SILIŞTEA NOUĂ","ŞCOALA PRIMARĂ SILIŞTEA",148,"Alegeri Prezidentiale",1,601,287,269,18,0,282,5,700,413,151,131
35,SUCEAVA,"ORAŞ DOLHASCA",148006,BUDENI,"CĂMINUL CULTURAL BUDENI",149,"Alegeri Prezidentiale",1,1118,426,396,30,0,421,5,1200,774,213,208
35,SUCEAVA,"ORAŞ DOLHASCA",148006,"VALEA POIENEI","ŞCOALA PRIMARĂ VALEA POIENII",150,"Alegeri Prezidentiale",1,408,231,202,29,0,227,4,500,269,169,58
35,SUCEAVA,"ORAŞ FRASIN",148612,FRASIN,"PRIMĂRIA ORAŞULUI FRASIN",151,"Alegeri Prezidentiale",1,1323,544,487,57,0,536,8,1500,956,326,210
35,SUCEAVA,"ORAŞ FRASIN",148612,FRASIN,"ŞCOALA GIMNAZIALĂ FRASIN",152,"Alegeri Prezidentiale",1,1082,440,425,15,0,436,4,1200,760,286,150
35,SUCEAVA,"ORAŞ FRASIN",148612,BUCŞOAIA,"ŞCOALA GIMNAZIALĂ BUCŞOAIA",153,"Alegeri Prezidentiale",1,1286,610,562,48,0,593,17,1400,790,369,224
35,SUCEAVA,"ORAŞ FRASIN",148612,DOROTEIA,"ŞCOALA GIMNAZIALĂ DOROTEIA",154,"Alegeri Prezidentiale",1,726,289,269,20,0,286,3,800,511,205,81
35,SUCEAVA,"ORAŞ FRASIN",148612,PLUTONIŢA,"CĂMIN CULTURAL PLUTONIŢA",155,"Alegeri Prezidentiale",1,937,382,353,29,0,382,0,1000,618,272,110
35,SUCEAVA,"ORAŞ GURA HUMORULUI",146584,"GURA HUMORULUI","MUZEUL OBICEIURILOR POPULARE GURA HUMORULUI",156,"Alegeri Prezidentiale",1,1868,941,817,123,1,922,19,2000,1059,613,309
35,SUCEAVA,"ORAŞ GURA HUMORULUI",146584,"GURA HUMORULUI","GRADINITA CU PROGRAM NORMAL ”PINOCHIO”",157,"Alegeri Prezidentiale",1,1555,657,600,57,0,642,15,1700,1043,434,208
35,SUCEAVA,"ORAŞ GURA HUMORULUI",146584,"GURA HUMORULUI","COLEGIUL ”ALEXANDRU CEL BUN” CORPUL B",158,"Alegeri Prezidentiale",1,1908,872,788,56,28,851,21,2200,1328,552,299
35,SUCEAVA,"ORAŞ GURA HUMORULUI",146584,"GURA HUMORULUI","SCOALA GIMNAZIALA NR.1",159,"Alegeri Prezidentiale",1,1922,857,754,102,1,839,18,2100,1243,558,281
35,SUCEAVA,"ORAŞ GURA HUMORULUI",146584,"GURA HUMORULUI","SCOALA GIMNAZIALA ”PETRU COMARNESCU”",160,"Alegeri Prezidentiale",1,1793,816,748,68,0,796,20,1900,1084,495,301
35,SUCEAVA,"ORAŞ GURA HUMORULUI",146584,"GURA HUMORULUI","COLEGIUL” ALEXANDRU CEL BUN” CORPUL A",161,"Alegeri Prezidentiale",1,1824,798,724,74,0,781,17,2000,1202,483,298
35,SUCEAVA,"ORAŞ GURA HUMORULUI",146584,"GURA HUMORULUI","SCOALA GIMNAZIALA ”TEODOR BALAN”",162,"Alegeri Prezidentiale",1,1768,833,767,57,9,817,16,2000,1167,533,284
35,SUCEAVA,"ORAŞ GURA HUMORULUI",146584,"GURA HUMORULUI","SCOALA PRIMARA BOURENI",163,"Alegeri Prezidentiale",1,906,340,314,26,0,332,8,1000,660,218,114
35,SUCEAVA,"ORAŞ GURA HUMORULUI",146584,VORONEŢ,"GRADINITA CU PROGRAM NORMAL VORONET",164,"Alegeri Prezidentiale",1,717,445,341,104,0,435,10,800,355,325,110
35,SUCEAVA,"ORAŞ LITENI",149227,LITENI,"CASA DE CULTURĂ LITENI",165,"Alegeri Prezidentiale",1,1714,762,724,36,2,744,18,1900,1138,503,241
35,SUCEAVA,"ORAŞ LITENI",149227,LITENI,"CORPUL III LICEUL TEHNOLOGIC IORGU VÂRNAV LITEANU LITENI",166,"Alegeri Prezidentiale",1,1286,573,548,25,0,563,10,1400,827,370,193
35,SUCEAVA,"ORAŞ LITENI",149227,LITENI,"CORPUL A LICEUL TEHNOLOGIC IORGU VÂRNAV LITEANU LITENI",167,"Alegeri Prezidentiale",1,949,382,355,27,0,378,4,1000,618,284,94
35,SUCEAVA,"ORAŞ LITENI",149227,ROTUNDA,"ŞCOALA GIMNAZIALĂ NR. 1 ROTUNDA",168,"Alegeri Prezidentiale",1,1163,452,436,16,0,449,3,1300,848,316,133
35,SUCEAVA,"ORAŞ LITENI",149227,ROTUNDA,"ŞCOALA PRIMARĂ NR. 2 ROTUNDA",169,"Alegeri Prezidentiale",1,714,294,284,10,0,291,3,800,506,194,97
35,SUCEAVA,"ORAŞ LITENI",149227,ROŞCANI,"ŞCOALA GIMNAZIALĂ ROŞCANI",170,"Alegeri Prezidentiale",1,982,440,401,39,0,435,5,1100,660,297,138
35,SUCEAVA,"ORAŞ LITENI",149227,CORNI,"ŞCOALA GIMNAZIALĂ CORNI",171,"Alegeri Prezidentiale",3,644,281,249,32,0,276,5,685,404,172,104
35,SUCEAVA,"ORAŞ LITENI",149227,SILIŞTEA,"ŞCOALA GIMNAZIALĂ SILIŞTEA",172,"Alegeri Prezidentiale",1,651,229,208,21,0,225,4,700,471,158,67
35,SUCEAVA,"ORAŞ MILIŞĂUŢI",146931,MILIŞĂUŢI,"SEDIUL PRIMĂRIEI MILIȘĂUȚI",173,"Alegeri Prezidentiale",1,1540,614,594,20,0,605,9,1700,1086,449,156
35,SUCEAVA,"ORAŞ MILIŞĂUŢI",146931,MILIŞĂUŢI,"CĂMINUL CULTURAL MILIŞĂUŢI",174,"Alegeri Prezidentiale",1,1646,626,604,20,2,613,13,1800,1174,443,170
35,SUCEAVA,"ORAŞ MILIŞĂUŢI",146931,BĂDEUŢI,"GRĂDINIȚA CU PROGRAM NORMAL BĂDEUȚI",175,"Alegeri Prezidentiale",2,1249,478,457,21,0,469,9,1400,922,277,192
35,SUCEAVA,"ORAŞ SALCEA",146370,SALCEA,"CĂMINUL CULTURAL SALCEA",176,"Alegeri Prezidentiale",2,1198,474,453,21,0,460,14,1300,826,284,176
35,SUCEAVA,"ORAŞ SALCEA",146370,SALCEA,"CĂMINUL CULTURAL SALCEA",177,"Alegeri Prezidentiale",1,1373,605,573,32,0,588,17,1500,895,400,188
35,SUCEAVA,"ORAŞ SALCEA",146370,PLOPENI,"CAMIN CULTURAL PLOPENI",178,"Alegeri Prezidentiale",1,1926,854,806,48,0,844,10,2100,1246,573,271
35,SUCEAVA,"ORAŞ SALCEA",146370,MERENI,"ȘCOALA MERENI",179,"Alegeri Prezidentiale",1,1151,479,451,28,0,464,15,1300,821,306,158
35,SUCEAVA,"ORAŞ SALCEA",146370,VĂRATEC,"CĂMIN CULTURAL VĂRATEC",180,"Alegeri Prezidentiale",1,1240,545,514,31,0,529,16,1400,855,326,203
35,SUCEAVA,"ORAŞ SALCEA",146370,PRELIPCA,"CĂMINUL CULTURAL - PRELIPCA",181,"Alegeri Prezidentiale",3,1073,459,423,36,0,448,11,1200,741,295,153
35,SUCEAVA,"ORAŞ SIRET",146655,SIRET,"CENTRUL CULTURAL ”MIHAI TELIMAN”",182,"Alegeri Prezidentiale",1,1290,579,539,33,7,554,25,1400,821,298,256
35,SUCEAVA,"ORAŞ SIRET",146655,SIRET,"COLEGIUL LATCU VODA",183,"Alegeri Prezidentiale",1,1437,607,585,22,0,587,20,1600,993,364,223
35,SUCEAVA,"ORAŞ SIRET",146655,SIRET,"ȘCOALA GIMNAZIALA PETRU MUȘAT GRĂDINIȚA",184,"Alegeri Prezidentiale",1,1295,476,455,21,0,465,11,1400,924,266,199
35,SUCEAVA,"ORAŞ SIRET",146655,SIRET,"COLEGIUL LAȚCU VODĂ ȘCOALA PROFESIONALĂ",185,"Alegeri Prezidentiale",1,752,354,299,17,38,346,8,800,446,201,145
35,SUCEAVA,"ORAŞ SIRET",146655,SIRET,"ȘCOALA GIMNAZIALĂ PETRU MUȘAT CORP II",186,"Alegeri Prezidentiale",1,1066,461,425,36,0,452,9,1200,739,271,181
35,SUCEAVA,"ORAŞ SIRET",146655,SIRET,"ȘCOALA GIMNAZIALĂ PETRU MUȘAT CORP I",187,"Alegeri Prezidentiale",1,1343,613,533,28,52,599,14,1500,887,361,238
35,SUCEAVA,"ORAŞ SIRET",146655,SIRET,"ȘCOALA GIMNAZIALĂ PĂDURENI",188,"Alegeri Prezidentiale",1,463,226,215,11,0,220,6,500,274,120,100
35,SUCEAVA,"ORAŞ SIRET",146655,SIRET,"ȘCOALA GIMNAZIALĂ MANASTIOARA",189,"Alegeri Prezidentiale",1,455,209,192,17,0,207,2,500,291,121,86
35,SUCEAVA,"ORAŞ SOLCA",146708,SOLCA,"PRIMĂRIA ORAŞULUI SOLCA",190,"Alegeri Prezidentiale",1,1041,419,381,38,0,412,7,1100,681,204,208
35,SUCEAVA,"ORAŞ SOLCA",146708,SOLCA,"LICEUL TEHNOLOGIC TOMŞA VODĂ SOLCA",191,"Alegeri Prezidentiale",1,1042,482,445,37,0,477,5,1100,618,240,237
35,SUCEAVA,"ORAŞ VICOVU DE SUS",151095,"VICOVU DE SUS","CĂMINUL CULTURAL VICOVU DE SUS-EST",192,"Alegeri Prezidentiale",1,1243,460,432,28,0,454,6,1400,940,266,188
35,SUCEAVA,"ORAŞ VICOVU DE SUS",151095,"VICOVU DE SUS","GRĂDINIŢA CU PROGRAM NORMAL NR. 1-EST",193,"Alegeri Prezidentiale",1,1378,403,386,16,1,390,13,1500,1097,197,193
35,SUCEAVA,"ORAŞ VICOVU DE SUS",151095,"VICOVU DE SUS","LICEUL TEHHNOLOGIC ”ION NISTOR” VICOVU DE SUS-CORPUL 4",194,"Alegeri Prezidentiale",3,1105,389,367,22,0,385,4,1200,811,223,162
35,SUCEAVA,"ORAŞ VICOVU DE SUS",151095,"VICOVU DE SUS","ŞCOALA GIMNAZIALĂ NR. 3 VICOVU DE SUS",195,"Alegeri Prezidentiale",1,1465,462,449,13,0,456,6,1600,1138,269,187
35,SUCEAVA,"ORAŞ VICOVU DE SUS",151095,"VICOVU DE SUS","ŞCOALA GIMNAZIALĂ NR. 2 VICOVU DE SUS",196,"Alegeri Prezidentiale",1,1423,519,499,20,0,514,5,1600,1081,239,275
35,SUCEAVA,"ORAŞ VICOVU DE SUS",151095,"VICOVU DE SUS","CASA DE CULTURĂ VICOVU DE SUS - LAURA",197,"Alegeri Prezidentiale",1,1724,568,556,12,0,565,3,1900,1332,245,320
35,SUCEAVA,"ORAŞ VICOVU DE SUS",151095,BIVOLĂRIA,"ŞCOALA GIMNAZIALĂ BIVOLĂRIA",198,"Alegeri Prezidentiale",1,1690,609,584,25,0,568,41,1800,1191,361,207
35,SUCEAVA,"ORAŞ VICOVU DE SUS",151095,BIVOLĂRIA,"GRĂDINIŢA NOUĂ BIVOLĂRIE",199,"Alegeri Prezidentiale",1,853,271,258,13,0,264,7,900,629,185,79
35,SUCEAVA,"ORAŞ VICOVU DE SUS",151095,"VICOVU DE SUS","GRĂDINIŢA CU PROGRAM NORMAL ”LUMEA COPIILOR”",200,"Alegeri Prezidentiale",1,1192,422,390,31,1,417,5,1300,878,221,196
35,SUCEAVA,ADÂNCATA,146799,ADÂNCATA,"SCOALA GIMNAZIALĂ IOAN BĂNCESCU ADÂNCATA - CORPUL CU CLASELE I-IV",201,"Alegeri Prezidentiale",1,1429,705,651,54,0,690,15,1600,895,505,185
35,SUCEAVA,ADÂNCATA,146799,ADÂNCATA,"SCOALA GIMNAZIALĂ IOAN BĂNCESCU ADÂNCATA - CORPUL CU CLASELE V-VIII",202,"Alegeri Prezidentiale",2,1011,603,538,65,0,591,12,1100,497,433,158
35,SUCEAVA,ADÂNCATA,146799,CĂLUGĂRENI,"ŞCOALA PRIMARĂ CĂLUGĂRENI",203,"Alegeri Prezidentiale",1,641,310,259,51,0,305,5,700,390,209,96
35,SUCEAVA,ADÂNCATA,146799,FETEŞTI,"ŞCOALA GIMNAZIALĂ FETEŞTI",204,"Alegeri Prezidentiale",1,459,238,214,24,0,230,8,500,262,162,68
35,SUCEAVA,ARBORE,146860,ARBORE,"SCOALA GIMNAZIALA NR. 1 ”LUCA ARBURE”, CORP B",205,"Alegeri Prezidentiale",1,1746,711,661,50,0,700,11,1900,1189,487,213
35,SUCEAVA,ARBORE,146860,ARBORE,"SCOALA GIMNAZIALA NR.2 ARBORE",206,"Alegeri Prezidentiale",1,1690,648,625,23,0,638,10,1800,1152,362,276
35,SUCEAVA,ARBORE,146860,ARBORE,"SCOALA GIMNAZIALA NR.3 ARBORE",207,"Alegeri Prezidentiale",1,1075,439,420,19,0,435,4,1200,761,261,174
35,SUCEAVA,ARBORE,146860,CLIT,"SALĂ DE FESTIVITĂŢI CLIT",208,"Alegeri Prezidentiale",1,1043,484,447,37,0,473,11,1200,716,266,207
35,SUCEAVA,ARBORE,146860,BODNĂRENI,"ŞCOALA PRIMARĂ BODNĂRENI",209,"Alegeri Prezidentiale",1,260,89,76,13,0,87,2,300,211,41,46
35,SUCEAVA,BAIA,146904,BAIA,"SEDIUL PRIMARIEI BAIA",210,"Alegeri Prezidentiale",1,1720,651,617,34,0,645,6,1900,1249,290,355
35,SUCEAVA,BAIA,146904,BAIA,"ŞCOALA NR. 2 BAIA",211,"Alegeri Prezidentiale",1,1205,516,492,24,0,511,5,1300,784,296,215
35,SUCEAVA,BAIA,146904,BAIA,"ŞCOALA NR. 3 BAIA",212,"Alegeri Prezidentiale",1,1746,676,645,31,0,670,6,1900,1224,323,347
35,SUCEAVA,BAIA,146904,BOGATA,"ŞCOALA GIMNAZIALĂ BOGATA",213,"Alegeri Prezidentiale",2,1090,455,428,27,0,452,3,1200,745,133,319
35,SUCEAVA,BĂLĂCEANA,151530,BĂLĂCEANA,"ŞCOALA GIMNAZIALĂ BĂLĂCEANA",214,"Alegeri Prezidentiale",1,1211,474,416,58,0,471,3,1300,826,197,274
35,SUCEAVA,BĂLCĂUŢI,146995,BĂLCĂUŢI,"SEDIUL PRIMĂRIEI COMUNEI BĂLCĂUŢI",215,"Alegeri Prezidentiale",1,1212,387,355,32,0,379,8,1294,907,219,160
35,SUCEAVA,BĂLCĂUŢI,146995,NEGOSTINA,"ŞCOALA GIMNAZIALA NEGOSTINA",216,"Alegeri Prezidentiale",1,1114,473,437,36,0,462,11,1200,727,282,180
35,SUCEAVA,BĂLCĂUŢI,146995,GROPENI,"ŞCOALA PRIMARA GROPENI",217,"Alegeri Prezidentiale",1,302,135,112,23,0,129,6,400,265,81,48
35,SUCEAVA,BERCHIŞEŞTI,151576,BERCHIŞEŞTI,"ȘCOALA GIMNAZIALĂ BERCHIȘEȘTI",218,"Alegeri Prezidentiale",1,2009,1123,953,134,36,1102,21,2200,1077,527,575
35,SUCEAVA,BERCHIŞEŞTI,151576,CORLATA,"SCOALA PRIMARA CORLATA",219,"Alegeri Prezidentiale",1,409,248,208,24,16,243,5,500,252,86,157
35,SUCEAVA,BILCA,147036,BILCA,PRIMARIA,220,"Alegeri Prezidentiale",1,1140,412,386,26,0,410,2,1300,888,238,172
35,SUCEAVA,BILCA,147036,BILCA,"SCOALA GIMNAZIALA NR. 2",221,"Alegeri Prezidentiale",1,997,440,403,27,10,429,11,1084,644,275,154
35,SUCEAVA,BILCA,147036,BILCA,"SCOALA PRIMARA NR. 3",222,"Alegeri Prezidentiale",1,960,358,345,13,0,347,11,1100,742,224,123
35,SUCEAVA,BOGDĂNEŞTI,147054,BOGDĂNEŞTI,"ȘCOALA GIMNAZIALĂ NUMĂRUL 1 BOGDĂNEȘTI, LOCAL VECHI",223,"Alegeri Prezidentiale",1,1878,705,636,69,0,693,12,2000,1295,351,342
35,SUCEAVA,BOGDĂNEŞTI,147054,BOGDĂNEŞTI,"ȘCOALA GIMNAZIALĂ NR. 2 BOGDĂNEȘTI, LOCAL NOU",224,"Alegeri Prezidentiale",1,1407,557,531,25,1,549,8,1500,943,313,236
35,SUCEAVA,BOROAIA,147072,BOROAIA,"CĂMIN CULTURAL MIHAI BOLEAC",225,"Alegeri Prezidentiale",1,838,404,332,72,0,394,10,900,496,227,167
35,SUCEAVA,BOROAIA,147072,BOROAIA,"ŞCOALA PRIMARĂ NR.2 BOROAIA",226,"Alegeri Prezidentiale",1,721,290,267,23,0,285,5,800,510,161,124
35,SUCEAVA,BOROAIA,147072,GIULEŞTI,"CĂMIN CULTURAL GIULEŞTI",227,"Alegeri Prezidentiale",1,461,208,182,26,0,204,4,500,292,120,84
35,SUCEAVA,BOROAIA,147072,BĂRĂŞTI,"GRĂDINIŢA CU PROGRAM NORMAL BĂRĂŞTI",228,"Alegeri Prezidentiale",1,810,349,326,23,0,344,5,900,551,131,213
35,SUCEAVA,BOROAIA,147072,SĂCUŢA,"ŞCOALA PRIMARĂ SĂCUŢA",229,"Alegeri Prezidentiale",1,455,180,153,26,1,179,1,500,320,75,104
35,SUCEAVA,BOROAIA,147072,MOIŞA,"ŞCOALA GIMNAZIALĂ MOIŞA",230,"Alegeri Prezidentiale",1,554,245,218,27,0,242,3,600,355,111,131
35,SUCEAVA,BOSANCI,147134,BOSANCI,"CAMINUL CULTURAL BOSANCI",231,"Alegeri Prezidentiale",1,1210,414,386,28,0,410,4,1295,881,295,115
35,SUCEAVA,BOSANCI,147134,BOSANCI,"CĂMINUL CULTURAL BOSANCI",232,"Alegeri Prezidentiale",1,1210,463,438,25,0,455,8,1300,837,305,150
35,SUCEAVA,BOSANCI,147134,BOSANCI,"ŞCOALA GIMNAZIALĂ BOSANCI",233,"Alegeri Prezidentiale",1,1249,398,382,16,0,383,15,1400,1002,278,105
35,SUCEAVA,BOSANCI,147134,BOSANCI,"ŞCOALA PRIMARĂ BOSANCI",234,"Alegeri Prezidentiale",1,1829,619,595,24,0,605,14,2000,1381,446,159
35,SUCEAVA,BOSANCI,147134,CUMPĂRĂTURA,"ŞCOALA PRIMARĂ CUMPĂRĂTURA",235,"Alegeri Prezidentiale",1,307,148,125,23,0,145,3,397,249,98,47
35,SUCEAVA,BOTOŞANA,147161,BOTOŞANA,"SCOALA GIMNAZIALA CU CLASELE I-VIII BOTOSANA",236,"Alegeri Prezidentiale",1,1031,461,447,14,0,461,0,1100,639,331,130
35,SUCEAVA,BOTOŞANA,147161,BOTOŞANA,"CĂMIN CULTURAL BOTOŞANA",237,"Alegeri Prezidentiale",1,1070,517,478,37,2,515,2,1200,683,353,162
35,SUCEAVA,BREAZA,147205,BREAZA,"CAMINUL CULTURAL SAT BREAZA",238,"Alegeri Prezidentiale",1,1289,560,522,38,0,555,5,1400,840,319,236
35,SUCEAVA,BRODINA,147241,BRODINA,"SEDIUL NOU AL PRIMARIEI COMUNEI BRODINA",239,"Alegeri Prezidentiale",1,1274,501,473,28,0,489,12,1400,899,292,197
35,SUCEAVA,BRODINA,147241,"BRODINA DE JOS","CENTRU DE ASISTENTA DUPA PROGRAMUL SCOLAR TIP AFTER SCHOOL",240,"Alegeri Prezidentiale",1,651,197,178,19,0,193,4,700,503,148,45
35,SUCEAVA,BRODINA,147241,FALCĂU,"GRADINITA CU PROGRAM NORMAL FALCAU",241,"Alegeri Prezidentiale",1,1089,496,428,68,0,487,9,1200,704,330,157
35,SUCEAVA,BUNEŞTI,147465,BUNEŞTI,"PRIMARIA COMUNEI BUNESTI",242,"Alegeri Prezidentiale",1,551,281,240,41,0,275,6,600,319,162,113
35,SUCEAVA,BUNEŞTI,147465,PODENI,"GRADINITA CU PROGRAM NORMAL PODENI",243,"Alegeri Prezidentiale",1,477,220,201,19,0,213,7,500,280,106,107
35,SUCEAVA,BUNEŞTI,147465,PETIA,"SCOALA GIMNAZIALA PETIA",244,"Alegeri Prezidentiale",2,621,252,225,27,0,252,0,700,448,154,98
35,SUCEAVA,BUNEŞTI,147465,UNCEŞTI,"SCOALA UNCESTI",245,"Alegeri Prezidentiale",1,544,258,214,44,0,254,4,600,342,121,133
35,SUCEAVA,BURLA,151521,BURLA,"CAMINUL CULTURAL BURLA - SALA MARE",246,"Alegeri Prezidentiale",1,1665,597,560,37,0,588,9,1800,1203,376,212
35,SUCEAVA,CACICA,147526,"PÂRTEŞTII DE SUS","CENTRUL DE AFACERI MULTICULTURAL CACICA",247,"Alegeri Prezidentiale",1,1555,666,620,46,0,647,19,1700,1034,431,216
35,SUCEAVA,CACICA,147526,CACICA,"ȘCOALA CACICA",248,"Alegeri Prezidentiale",1,1091,433,384,49,0,426,7,1200,767,268,158
35,SUCEAVA,CACICA,147526,"SOLONEŢU NOU","ŞCOALA SOLONEŢU NOU",249,"Alegeri Prezidentiale",1,685,310,285,25,0,308,2,800,490,271,37
35,SUCEAVA,CACICA,147526,RUNCU,"ŞCOALA RUNCU",250,"Alegeri Prezidentiale",1,162,108,52,56,0,107,1,200,92,59,48
35,SUCEAVA,CALAFINDEŞTI,147580,CALAFINDEŞTI,"SALA DE SPORT CALAFINDESTI SALA A",251,"Alegeri Prezidentiale",1,1005,450,433,13,4,441,9,1100,650,246,195
35,SUCEAVA,CALAFINDEŞTI,147580,CALAFINDEŞTI,"SALA DE SPORT CALAFINDESTI- SALA B",252,"Alegeri Prezidentiale",1,982,492,471,16,5,483,9,1100,608,259,224
35,SUCEAVA,CALAFINDEŞTI,147580,"BOTOŞANIŢA MARE","SCOALA PRIMARA BOTOŞANIŢA MARE",253,"Alegeri Prezidentiale",1,292,163,143,20,0,157,6,300,137,49,108
35,SUCEAVA,"CAPU CÂMPULUI",151503,"CAPU CÂMPULUI","GRĂDINIŢA CU PROGRAM NORMAL NR.1 CAPU CÂMPULUI",254,"Alegeri Prezidentiale",1,1923,1314,1124,129,61,1301,13,2100,786,1091,210
35,SUCEAVA,CÂRLIBABA,147713,"CÂRLIBABA NOUĂ","LOCAL AFTER SCHOOL",255,"Alegeri Prezidentiale",1,1577,735,673,62,0,729,6,1700,965,536,193
35,SUCEAVA,CIOCĂNEŞTI,151451,CIOCĂNEŞTI,"GRĂDINIȚA CIOCĂNEȘTI",256,"Alegeri Prezidentiale",1,897,539,489,50,0,536,3,1000,461,353,183
35,SUCEAVA,CIOCĂNEŞTI,151451,BOTOŞ,"ȘCOALA BOTOȘ",257,"Alegeri Prezidentiale",1,337,206,178,28,0,201,5,400,194,142,59
35,SUCEAVA,"CIPRIAN PORUMBESCU",151567,"CIPRIAN PORUMBESCU","PRIMARIA COMUNEI CIPRIAN PORUMBESCU",258,"Alegeri Prezidentiale",1,1618,609,565,44,0,600,9,1800,1191,204,396
35,SUCEAVA,COMĂNEŞTI,151433,COMĂNEŞTI,"SCOALA GIMNAZIALA CU CLASELE I-VIII COMANESTI",259,"Alegeri Prezidentiale",1,966,484,441,42,1,477,7,1100,616,310,167
35,SUCEAVA,COMĂNEŞTI,151433,HUMORENI,"SCOALA GIMNAZIALA CU CLASELE I-VIII HUMORENI",260,"Alegeri Prezidentiale",1,914,415,386,29,0,409,6,1000,585,283,126
35,SUCEAVA,"CORNU LUNCII",147786,"CORNU LUNCII","SCOALA GIMNAZIALA CORNU LUNCII",261,"Alegeri Prezidentiale",1,1041,518,474,38,6,503,15,1200,682,228,275
35,SUCEAVA,"CORNU LUNCII",147786,BĂIŞEŞTI,"SCOALA GIMNAZIALA BAISESTI",262,"Alegeri Prezidentiale",1,1200,617,570,38,9,609,8,1300,683,332,277
35,SUCEAVA,"CORNU LUNCII",147786,BRĂIEŞTI,"SCOALA GIMNAZIALA BRAIESTI",263,"Alegeri Prezidentiale",1,1005,533,507,26,0,523,10,1100,567,339,184
35,SUCEAVA,"CORNU LUNCII",147786,DUMBRAVA,"SCOALA PRIMARA DUMBRAVA",264,"Alegeri Prezidentiale",1,444,207,189,15,3,204,3,500,293,107,97
35,SUCEAVA,"CORNU LUNCII",147786,"SASCA NOUĂ","SCOALA SASCA NOUA",265,"Alegeri Prezidentiale",1,185,117,91,26,0,115,2,200,83,42,73
35,SUCEAVA,"CORNU LUNCII",147786,"SASCA MICĂ","SCOALA PRIMARA SASCA MICA",266,"Alegeri Prezidentiale",1,603,276,252,24,0,265,11,700,424,82,183
35,SUCEAVA,"CORNU LUNCII",147786,ŞINCA,"SCOALA SINCA",267,"Alegeri Prezidentiale",1,145,97,77,15,5,97,0,200,103,27,70
35,SUCEAVA,"CORNU LUNCII",147786,"SASCA MARE","SCOALA SASCA MARE",268,"Alegeri Prezidentiale",1,550,284,249,29,6,279,5,600,316,95,184
35,SUCEAVA,"CORNU LUNCII",147786,PĂISENI,"SCOALA PAISENI",269,"Alegeri Prezidentiale",2,632,317,293,19,5,311,6,700,383,118,193
35,SUCEAVA,COŞNA,151497,COŞNA,"CĂMIN CULTURAL COȘNA",270,"Alegeri Prezidentiale",1,1234,720,665,54,1,713,7,1400,680,509,204
35,SUCEAVA,CRUCEA,147884,CRUCEA,"PRIMĂRIA COMUNEI CRUCEA SALĂ FESTIVITĂȚI",271,"Alegeri Prezidentiale",1,1238,602,567,35,0,594,8,1400,798,283,311
35,SUCEAVA,CRUCEA,147884,COJOCI,"ȘCOALA COJOCI",272,"Alegeri Prezidentiale",1,449,242,218,24,0,238,4,500,258,105,133
35,SUCEAVA,DĂRMĂNEŞTI,147937,DĂRMĂNEŞTI,"GRĂDINIŢA CU PROGRAM NORMAL NR.1 DĂRMĂNEŞTI",273,"Alegeri Prezidentiale",1,970,451,408,43,0,445,6,1100,649,320,125
35,SUCEAVA,DĂRMĂNEŞTI,147937,DĂRMĂNEŞTI,"ŞCOALA DĂRMĂNEŞTI NR.2",274,"Alegeri Prezidentiale",1,822,402,363,39,0,393,9,900,498,273,120
35,SUCEAVA,DĂRMĂNEŞTI,147937,MĂRIŢEI,"ŞCOALA GIMNAZIALĂ MĂRIŢEI",275,"Alegeri Prezidentiale",1,1448,747,699,48,0,731,16,1600,853,538,193
35,SUCEAVA,DĂRMĂNEŞTI,147937,CĂLINEŞTI,"ŞCOALA GIMNAZIALĂ CĂLINEŞTI ENACHE",276,"Alegeri Prezidentiale",1,520,256,207,49,0,255,1,600,344,177,78
35,SUCEAVA,DĂRMĂNEŞTI,147937,CĂLINEŞTI-VASILACHE,"ŞCOALA CĂLINEŞTI-VASILACHE",277,"Alegeri Prezidentiale",1,163,92,74,18,0,91,1,200,108,78,13
35,SUCEAVA,DĂRMĂNEŞTI,147937,DĂNILA,"ŞCOALA GIMNAZIALĂ DĂNILA",278,"Alegeri Prezidentiale",1,881,388,352,36,0,375,13,1000,612,268,107
35,SUCEAVA,DOLHEŞTI,148097,"DOLHEŞTII MARI","PRIMĂRIA DOLHEŞTI",279,"Alegeri Prezidentiale",1,1428,685,641,44,0,672,13,1600,915,224,448
35,SUCEAVA,DOLHEŞTI,148097,"DOLHEŞTII MICI","ŞCOALA GIMNAZIALĂ DOLHEŞTII MICI",280,"Alegeri Prezidentiale",1,974,487,438,49,0,481,6,1100,613,216,265
35,SUCEAVA,DOLHEŞTI,148097,"VALEA BOUREI","ŞCOALA PRIMARĂ VALEA BOUREI",281,"Alegeri Prezidentiale",1,626,308,263,45,0,305,3,700,392,121,184
35,SUCEAVA,"DORNA CANDRENILOR",148202,"DORNA CANDRENILOR","PRIMĂRIA COMUNEI DORNA CANDRENILOR",282,"Alegeri Prezidentiale",1,1726,952,842,109,1,944,8,1909,957,583,361
35,SUCEAVA,"DORNA CANDRENILOR",148202,"POIANA NEGRII","CĂMINUL CULTURAL POIANA NEGRII",283,"Alegeri Prezidentiale",1,789,464,409,55,0,461,3,900,436,311,150
35,SUCEAVA,DORNA-ARINI,148131,DORNA-ARINI,"SEDIU ASOCIAŢIE ”OBŞTEA GURA NEGRII” DORNA ARINI",284,"Alegeri Prezidentiale",1,557,318,291,27,0,314,4,600,282,220,94
35,SUCEAVA,DORNA-ARINI,148131,COZĂNEŞTI,"CĂMIN CULTURAL COZĂNEŞTI",285,"Alegeri Prezidentiale",1,1258,700,666,34,0,684,16,1400,700,438,246
35,SUCEAVA,DORNA-ARINI,148131,RUSCA,"GRĂDINIŢA CU PROGRAM NORMAL RUSCA, SAT RUSCA, NR. 59A",286,"Alegeri Prezidentiale",1,683,379,348,30,1,368,11,800,421,259,109
35,SUCEAVA,DORNEŞTI,148293,DORNEŞTI,"SCOALA GIMNAZIALA DORNESTI",287,"Alegeri Prezidentiale",1,1777,564,540,22,2,551,13,1900,1336,367,184
35,SUCEAVA,DORNEŞTI,148293,DORNEŞTI,"PRIMĂRIA COMUNEI DORNEȘTI",288,"Alegeri Prezidentiale",1,1795,693,655,37,1,683,10,1900,1207,408,275
35,SUCEAVA,DORNEŞTI,148293,IAZ,"SCOALA PRIMARA IAZ",289,"Alegeri Prezidentiale",1,229,89,79,10,0,89,0,300,211,68,21
35,SUCEAVA,DRĂGOIEŞTI,148328,MĂZĂNĂEŞTI,"PRIMARIA COMUNEI DRĂGOIEŞTI",290,"Alegeri Prezidentiale",1,487,223,202,21,0,222,1,500,277,109,113
35,SUCEAVA,DRĂGOIEŞTI,148328,DRĂGOIEŞTI,"CĂMIN CULTURAL DRĂGOIEȘTI",291,"Alegeri Prezidentiale",3,1461,594,541,53,0,583,11,1600,1006,262,321
35,SUCEAVA,DRĂGOIEŞTI,148328,LUCĂCEŞTI,"CĂMIN CULTURAL LUCĂCEȘTI",292,"Alegeri Prezidentiale",1,216,149,124,25,0,145,4,300,151,96,49
35,SUCEAVA,DRĂGUŞENI,148382,DRĂGUŞENI,"PRIMĂRIA COMUNEI DRĂGUŞENI",293,"Alegeri Prezidentiale",1,1807,742,610,100,32,734,8,2000,1258,293,441
35,SUCEAVA,DRĂGUŞENI,148382,BROŞTENI,"GRĂDINIŢA CU PROGRAM NORMAL BROŞTENI",294,"Alegeri Prezidentiale",1,275,134,108,26,0,132,2,300,166,48,84
35,SUCEAVA,DUMBRĂVENI,148426,DUMBRĂVENI,"ATENEU DUMBRAVENI",295,"Alegeri Prezidentiale",1,1605,709,640,69,0,693,16,1700,991,368,325
35,SUCEAVA,DUMBRĂVENI,148426,DUMBRĂVENI,"LICEUL TEHNOLOGIC MIHAI EMINESCU DUMBRAVENI",296,"Alegeri Prezidentiale",1,1802,799,742,57,0,781,18,2000,1201,447,334
35,SUCEAVA,DUMBRĂVENI,148426,DUMBRĂVENI,"SCOALA TOLOACA",297,"Alegeri Prezidentiale",1,1848,761,722,39,0,743,18,2000,1239,427,316
35,SUCEAVA,DUMBRĂVENI,148426,DUMBRĂVENI,"SCOALA DEAL",298,"Alegeri Prezidentiale",1,1546,680,639,41,0,672,8,1700,1020,389,283
35,SUCEAVA,DUMBRĂVENI,148426,SĂLĂGENI,"SCOALA SALAGENI",299,"Alegeri Prezidentiale",1,409,212,178,34,0,209,3,500,288,104,105
35,SUCEAVA,"FÂNTÂNA MARE",151488,"FÂNTÂNA MARE","SCOALA CU CLASELE I-IV FANTANA MARE",300,"Alegeri Prezidentiale",1,867,372,347,25,0,358,14,1000,628,206,152
35,SUCEAVA,"FÂNTÂNA MARE",151488,"COTU BĂII","SCOALA CU CLASELE I-IV COTU BAII",301,"Alegeri Prezidentiale",1,790,334,295,39,0,327,7,900,566,170,157
35,SUCEAVA,"FÂNTÂNA MARE",151488,PRAXIA,"SCOALA CU CLASELE I-IV PRAXIA",302,"Alegeri Prezidentiale",1,130,72,53,19,0,71,1,200,128,38,33
35,SUCEAVA,"FÂNTÂNA MARE",151488,SPĂTĂREŞTI,"SCOALA CU CLASELE I-IV SPĂTĂREȘTI",303,"Alegeri Prezidentiale",1,363,164,144,20,0,162,2,400,236,85,77
35,SUCEAVA,FÂNTÂNELE,148453,FÂNTÂNELE,"CĂMINUL CULTURAL FÎNTÎNELE",304,"Alegeri Prezidentiale",1,898,326,298,28,0,320,6,1000,674,190,130
35,SUCEAVA,FÂNTÂNELE,148453,SLOBOZIA,"SCOALA DIN SATUL SLOBOZIA",305,"Alegeri Prezidentiale",1,170,90,77,13,0,90,0,200,110,41,49
35,SUCEAVA,FÂNTÂNELE,148453,BĂNEŞTI,"CĂMINUL CULTURAL BĂNEŞTI",306,"Alegeri Prezidentiale",1,942,411,374,37,0,404,7,1000,589,214,190
35,SUCEAVA,FÂNTÂNELE,148453,STAMATE,"CĂMINUL CULTURAL STAMATE",307,"Alegeri Prezidentiale",1,1543,684,634,50,0,677,7,1700,1016,405,272
35,SUCEAVA,FÂNTÂNELE,148453,"COTU DOBEI","SCOALA DIN SATUL COTU DOBEI",308,"Alegeri Prezidentiale",1,147,86,65,21,0,82,4,200,114,36,46
35,SUCEAVA,FORĂŞTI,148514,FORĂŞTI,"SEDIUL PRIMARIEI FORASTI",309,"Alegeri Prezidentiale",2,487,228,204,20,4,224,4,500,272,114,110
35,SUCEAVA,FORĂŞTI,148514,ANTOCENI,"SCOALA ANTOCENI",310,"Alegeri Prezidentiale",1,261,145,117,22,6,144,1,300,155,69,75
35,SUCEAVA,FORĂŞTI,148514,ONICENI,"SCOALA GIMNAZIALA ONICENI",311,"Alegeri Prezidentiale",1,791,359,311,39,9,352,7,900,541,156,196
35,SUCEAVA,FORĂŞTI,148514,ROŞIORI,"SCOALA ROSIORI",312,"Alegeri Prezidentiale",1,300,191,136,55,0,188,3,298,107,77,111
35,SUCEAVA,FORĂŞTI,148514,RUŞI,"SCOALA PRIMARA RUSI",313,"Alegeri Prezidentiale",1,320,171,145,23,3,168,3,400,229,76,92
35,SUCEAVA,FORĂŞTI,148514,ŢOLEŞTI,"SCOALA TOLESTI",314,"Alegeri Prezidentiale",2,331,130,113,17,0,129,1,400,270,35,94
35,SUCEAVA,FORĂŞTI,148514,BOURA,"SCOALA PRIMARA BOURA",315,"Alegeri Prezidentiale",1,451,202,182,20,0,199,3,500,298,77,122
35,SUCEAVA,FORĂŞTI,148514,MANOLEA,"SEDIUL FOSTEI PRIMARII MANOLEA",316,"Alegeri Prezidentiale",1,406,222,183,39,0,217,5,500,278,89,128
35,SUCEAVA,FORĂŞTI,148514,UIDEŞTI,"SCOALA PRIMARA UIDESTI",317,"Alegeri Prezidentiale",1,134,74,61,13,0,72,2,200,126,17,55
35,SUCEAVA,FORĂŞTI,148514,MANOLEA,"SCOALA VIISOARA, CATUN VIISOARA",318,"Alegeri Prezidentiale",1,182,96,87,9,0,93,3,200,104,45,48
35,SUCEAVA,"FRĂTĂUŢII NOI",148667,"FRĂTĂUŢII NOI","ȘCOALA GIMNAZIALĂ ”IRACLIE PORUMBESCU” FRĂTĂUȚII NOI",319,"Alegeri Prezidentiale",1,1212,514,479,35,0,501,13,1300,786,298,203
35,SUCEAVA,"FRĂTĂUŢII NOI",148667,"FRĂTĂUŢII NOI","ŞCOALA GIMNAZIALĂ NR 2 FRĂTĂUŢII NOI",320,"Alegeri Prezidentiale",1,1585,392,376,16,0,386,6,1700,1308,265,121
35,SUCEAVA,"FRĂTĂUŢII NOI",148667,"FRĂTĂUŢII NOI","GRADINITA CU PROGRAM NORMAL NR 3 FRĂTĂUŢII NOI",321,"Alegeri Prezidentiale",1,399,165,156,9,0,162,3,400,235,105,57
35,SUCEAVA,"FRĂTĂUŢII NOI",148667,COSTIŞA,"CĂMIN CULTURAL COSTIŞA",322,"Alegeri Prezidentiale",1,791,273,250,23,0,271,2,900,627,179,92
35,SUCEAVA,"FRĂTĂUŢII NOI",148667,COSTIŞA,"GRĂDINIŢA CU PROGRAM NORMAL NR 2 COSTIŞA",323,"Alegeri Prezidentiale",1,504,208,188,20,0,204,4,600,392,94,110
35,SUCEAVA,"FRĂTĂUŢII VECHI",148694,"FRĂTĂUŢII VECHI","CAMIN CULTURAL FRATAUTII VECHI",324,"Alegeri Prezidentiale",1,1520,443,417,26,0,438,5,1700,1257,283,155
35,SUCEAVA,"FRĂTĂUŢII VECHI",148694,"FRĂTĂUŢII VECHI","ŞCOALA PRIMARĂ LIVIU V. IONESI FRĂTĂUŢII-VECHI",325,"Alegeri Prezidentiale",1,1196,345,328,17,0,342,3,1300,955,220,122
35,SUCEAVA,"FRĂTĂUŢII VECHI",148694,MĂNEUŢI,"CAMIN CULTURAL MĂNEUŢI",326,"Alegeri Prezidentiale",1,1764,484,459,25,0,476,8,1900,1416,295,181
35,SUCEAVA,FRUMOSU,148729,FRUMOSU,"PRIMARIA FRUMOSU",327,"Alegeri Prezidentiale",1,1834,902,860,28,14,898,4,2000,1098,540,358
35,SUCEAVA,FRUMOSU,148729,DEIA,"SCOALA GENERALA CU CLASELE I-IV DEIA",328,"Alegeri Prezidentiale",1,661,349,328,18,3,344,5,700,351,237,107
35,SUCEAVA,FRUMOSU,148729,DRAGOŞA,"SCOALA DRAGOSA",329,"Alegeri Prezidentiale",1,356,192,180,12,0,189,3,400,208,114,75
35,SUCEAVA,"FUNDU MOLDOVEI",148765,"FUNDU MOLDOVEI","ŞCOALA GIMNAZIALĂ”DIMITRIE GUSTI”",330,"Alegeri Prezidentiale",1,1569,893,827,65,1,878,15,1700,807,633,245
35,SUCEAVA,"FUNDU MOLDOVEI",148765,COLACU,"ȘCOALA GIMNAZIALĂ ”TRAIAN POPOVICI” COLACU",331,"Alegeri Prezidentiale",1,823,448,420,27,1,445,3,900,452,305,140
35,SUCEAVA,"FUNDU MOLDOVEI",148765,BOTUŞ,"CĂMINUL CULTURAL BOTUȘ",332,"Alegeri Prezidentiale",1,957,473,435,38,0,471,2,1100,627,342,129
35,SUCEAVA,GĂLĂNEŞTI,148872,GĂLĂNEŞTI,"ŞCOALA PRIMARĂ DIN SATUL GĂLĂNEŞTI",333,"Alegeri Prezidentiale",1,1497,439,417,22,0,434,5,1600,1161,240,194
35,SUCEAVA,GĂLĂNEŞTI,148872,GĂLĂNEŞTI,"CĂMIN CULTURAL GĂLĂNEŞTI",334,"Alegeri Prezidentiale",1,893,278,259,18,1,277,1,1000,722,164,113
35,SUCEAVA,GRĂMEŞTI,148916,GRĂMEŞTI,"CĂMIN CULTURAL GRĂMEŞTI",335,"Alegeri Prezidentiale",1,1649,635,592,43,0,632,3,1800,1165,329,303
35,SUCEAVA,GRĂMEŞTI,148916,BĂLINEŞTI,"ŞCOALA PRIMARĂ BĂLINEŞTI",336,"Alegeri Prezidentiale",1,576,199,180,19,0,195,4,600,401,92,103
35,SUCEAVA,GRĂMEŞTI,148916,"BOTOŞANIŢA MICĂ","ŞCOALA CU CLASELE I-IV BOTOŞANIŢA MICĂ",337,"Alegeri Prezidentiale",1,199,97,81,16,0,95,2,200,103,29,66
35,SUCEAVA,GRĂNICEŞTI,148970,GRĂNICEŞTI,"ŞCOALA GIMNAZIALĂ ”MIHAIL SADOVEANU” GRĂNICEŞTI",338,"Alegeri Prezidentiale",1,1010,318,295,23,0,313,5,1100,782,168,145
35,SUCEAVA,GRĂNICEŞTI,148970,GRĂNICEŞTI,"SCOALA GIMNAZIALA MIHAIL SADOVEANU GRANICESTI",339,"Alegeri Prezidentiale",1,937,226,216,10,0,223,3,1000,774,134,89
35,SUCEAVA,GRĂNICEŞTI,148970,DUMBRAVA,"ȘCOALA PRIMARĂ DUMBRAVA",340,"Alegeri Prezidentiale",1,339,126,99,27,0,126,0,398,272,83,43
35,SUCEAVA,GRĂNICEŞTI,148970,"GURA SOLCII","ŞCOALA GIMNAZIALĂ GURA SOLCII",341,"Alegeri Prezidentiale",1,597,238,229,9,0,238,0,700,462,63,175
35,SUCEAVA,GRĂNICEŞTI,148970,IACOBEŞTI,"ŞCOALA PRIMARĂ IACOBEŞTI",342,"Alegeri Prezidentiale",1,453,200,172,28,0,199,1,500,300,128,71
35,SUCEAVA,GRĂNICEŞTI,148970,ROMÂNEŞTI,"ŞCOALA GIMNAZIALĂ ROMÂNEŞTI",343,"Alegeri Prezidentiale",1,576,250,216,34,0,239,11,600,350,116,123
35,SUCEAVA,GRĂNICEŞTI,148970,"SLOBOZIA SUCEVEI","ŞCOALA PRIMARĂ SLOBOZIA SUCEVEI",344,"Alegeri Prezidentiale",1,560,213,191,22,0,212,1,604,391,128,84
35,SUCEAVA,HĂNŢEŞTI,151512,HĂNŢEŞTI,"SCOALA GIMNAZIALA ”MIHAI HALUNGA” HANTESTI",345,"Alegeri Prezidentiale",1,1435,678,635,40,3,662,16,1600,922,312,350
35,SUCEAVA,HĂNŢEŞTI,151512,HĂNŢEŞTI,"ȘCOALA PRIMARĂ NR. 2 HĂNȚEȘTI VALE",346,"Alegeri Prezidentiale",1,1197,538,503,31,4,530,8,1300,762,236,294
35,SUCEAVA,HĂNŢEŞTI,151512,ARŢARI,"ȘCOALA PRIMARĂ BEREȘTI",347,"Alegeri Prezidentiale",1,506,247,218,26,3,244,3,600,353,132,112
35,SUCEAVA,HÂRTOP,151549,HÂRTOP,"CLĂDIRE ADMINISTRATIVĂ",348,"Alegeri Prezidentiale",1,1150,538,518,20,0,529,9,1300,762,315,214
35,SUCEAVA,HÂRTOP,151549,HÂRTOP,"CLĂDIRE ADMINISTRATIVĂ",349,"Alegeri Prezidentiale",1,880,372,356,16,0,368,4,1000,628,176,192
35,SUCEAVA,"HORODNIC DE JOS",149101,"HORODNIC DE JOS","CĂMINUL CULTURAL HORODNIC DE JOS",350,"Alegeri Prezidentiale",1,1367,595,567,28,0,586,9,1500,905,354,232
35,SUCEAVA,"HORODNIC DE JOS",149101,"HORODNIC DE JOS","SCOALA PRIMARĂ VASILE ŢIGĂNESCU",351,"Alegeri Prezidentiale",1,630,262,247,15,0,251,11,700,438,171,80
35,SUCEAVA,"HORODNIC DE SUS",151479,"HORODNIC DE SUS","SCOALA GIMNAZIALA NR.2",352,"Alegeri Prezidentiale",1,1183,461,431,30,0,450,11,1300,839,349,101
35,SUCEAVA,"HORODNIC DE SUS",151479,"HORODNIC DE SUS","SALA DE SPORT",353,"Alegeri Prezidentiale",1,1738,785,734,51,0,778,7,1900,1115,616,162
35,SUCEAVA,"HORODNIC DE SUS",151479,"HORODNIC DE SUS","SCOALA GIMNAZIALA NR.3",354,"Alegeri Prezidentiale",1,1072,395,373,22,0,385,10,1200,805,220,165
35,SUCEAVA,HORODNICENI,149049,HORODNICENI,"PRIMĂRIA COMUNEI HORODNICENI",355,"Alegeri Prezidentiale",2,894,509,437,66,6,502,7,1000,491,289,213
35,SUCEAVA,HORODNICENI,149049,BOTEŞTI,"ȘCOALA CU CL.I-IV BOTEȘTI",356,"Alegeri Prezidentiale",1,372,212,170,30,12,209,3,400,188,138,71
35,SUCEAVA,HORODNICENI,149049,BRĂDĂŢEL,"ȘCOALA CU CL.I-IV BRĂDĂȚEL",357,"Alegeri Prezidentiale",1,457,226,181,45,0,226,0,500,274,141,85
35,SUCEAVA,HORODNICENI,149049,MIHĂIEŞTI,"ȘCOALA CU CL.I-VIII MIHĂIEȘTI",358,"Alegeri Prezidentiale",1,645,450,358,62,30,446,4,700,250,290,156
35,SUCEAVA,HORODNICENI,149049,ROTOPĂNEŞTI,"PUNCT DOCUMENTAR NICOALE ISTRATI",359,"Alegeri Prezidentiale",1,478,198,174,19,5,195,3,500,302,117,78
35,SUCEAVA,IACOBENI,149138,IACOBENI,"CASA NAȚIONALĂ IACOBENI",360,"Alegeri Prezidentiale",1,917,459,425,34,0,450,9,1000,541,247,203
35,SUCEAVA,IACOBENI,149138,MESTECĂNIŞ,"CLUBUL FERMIERILOR MESTECANIS STR FERMIERILOR NR 14 SAT MESTECANIS COMUNA IACOBENI JUDETUL SUCEAVA",361,"Alegeri Prezidentiale",1,267,170,151,19,0,166,4,300,130,86,80
35,SUCEAVA,IACOBENI,149138,IACOBENI,"LICEUL TEHNOLOGIC LIVIU SUHAR IACOBENI CORP A STR. MINELOR NR 17 COMUNA IACOBENI JUDETUL SUCEAVA",362,"Alegeri Prezidentiale",1,586,263,246,17,0,257,6,600,337,123,134
35,SUCEAVA,IASLOVĂŢ,151442,IASLOVĂŢ,"SALA MICĂ A CĂMINULUI CULTURAL IASLOVĂŢ",363,"Alegeri Prezidentiale",1,1576,551,523,28,0,541,10,1700,1149,258,283
35,SUCEAVA,IASLOVĂŢ,151442,IASLOVĂŢ,"ŞCOALA GIMNAZIALA NR. 2 IASLOVAT",364,"Alegeri Prezidentiale",1,1556,527,513,14,0,518,9,1700,1173,252,266
35,SUCEAVA,ILIŞEŞTI,147660,ILIŞEŞTI,"PRIMARIA ILISESTI",365,"Alegeri Prezidentiale",1,1941,805,728,77,0,796,9,2091,1286,497,299
35,SUCEAVA,ILIŞEŞTI,147660,BRAŞCA,"CAMIN CULTURAL BRASCA",366,"Alegeri Prezidentiale",1,312,162,140,22,0,162,0,400,238,116,46
35,SUCEAVA,IPOTEŞTI,146281,IPOTEŞTI,"ȘCOALA GIMNAZIALĂ IPOTEȘTI",367,"Alegeri Prezidentiale",1,1575,886,770,116,0,867,19,1700,814,680,187
35,SUCEAVA,IPOTEŞTI,146281,IPOTEŞTI,"GRĂDINIȚA CU PROGRAM NORMAL IPOTEȘTI",368,"Alegeri Prezidentiale",1,1633,785,732,53,0,766,19,1800,1015,603,163
35,SUCEAVA,IPOTEŞTI,146281,IPOTEŞTI,"ȘCOALA PRIMARĂ IPOTEȘTI",369,"Alegeri Prezidentiale",2,1148,519,479,40,0,513,6,1300,781,430,83
35,SUCEAVA,IPOTEŞTI,146281,TISĂUŢI,"ŞCOALA PRIMARĂ TIŞĂUŢI",370,"Alegeri Prezidentiale",1,1043,609,552,57,0,585,24,1100,491,409,176
35,SUCEAVA,IPOTEŞTI,146281,LISAURA,"ŞCOALA PRIMARĂ LISAURA",371,"Alegeri Prezidentiale",2,986,617,560,57,0,594,23,1100,483,406,188
35,SUCEAVA,"IZVOARELE SUCEVEI",149183,"IZVOARELE SUCEVEI","PRIMARIA IZVOARELE SUCEVEI",372,"Alegeri Prezidentiale",2,707,276,262,14,0,272,4,800,524,164,108
35,SUCEAVA,"IZVOARELE SUCEVEI",149183,BOBEICA,"CENTRUL SOCIAL DE ZI PENTRU PERSOANE VÂRSTNICE, SAT BOBEICA",373,"Alegeri Prezidentiale",1,348,174,149,25,0,174,0,399,225,138,36
35,SUCEAVA,"IZVOARELE SUCEVEI",149183,BRODINA,"SCOALA GIMNAZIALĂ BRODINA - IZVOARELE SUCEVEI",374,"Alegeri Prezidentiale",1,582,235,198,37,0,234,1,602,367,179,55
35,SUCEAVA,MARGINEA,149290,MARGINEA,"SCOALA CU CLASELE I-VIII NR. 2 MARGINEA",375,"Alegeri Prezidentiale",2,1628,589,567,22,0,575,14,1800,1211,425,150
35,SUCEAVA,MARGINEA,149290,MARGINEA,"LICEUL TEHNOLOGIC VASILE GHERASIM MARGINEA",376,"Alegeri Prezidentiale",1,1689,601,585,16,0,585,16,1800,1199,402,183
35,SUCEAVA,MARGINEA,149290,MARGINEA,"LICEUL TEHNOLOGIC VASILE GHERASIM MARGINEA",377,"Alegeri Prezidentiale",1,1610,610,585,25,0,599,11,1800,1190,426,173
35,SUCEAVA,MARGINEA,149290,MARGINEA,"LICEUL TEHNOLOGIC VASILE GHERASIM MARGINEA",378,"Alegeri Prezidentiale",1,1698,639,620,18,1,626,13,1800,1161,427,199
35,SUCEAVA,MARGINEA,149290,MARGINEA,"SCOALA CU CLASELE I-VIII NR. 3 MARGINEA",379,"Alegeri Prezidentiale",1,1836,689,660,29,0,671,18,2000,1311,456,215
35,SUCEAVA,MĂLINI,149316,MĂLINI,"PRIMARIA MALINI",380,"Alegeri Prezidentiale",2,1293,628,582,46,0,612,16,1400,772,384,228
35,SUCEAVA,MĂLINI,149316,MĂLINI,"SCOALA GIMNAZIALA SUHA",381,"Alegeri Prezidentiale",1,1516,610,577,33,0,595,15,1700,1090,329,266
35,SUCEAVA,MĂLINI,149316,PÂRAIE,"SCOALA GIMNAZIALA PIRAIE",382,"Alegeri Prezidentiale",1,1557,640,615,25,0,627,13,1700,1060,463,164
35,SUCEAVA,MĂLINI,149316,"POIANA MĂRULUI","SCOALA GIMNAZIALA POIANA MARULUI",383,"Alegeri Prezidentiale",1,1017,435,402,33,0,427,8,1100,665,257,170
35,SUCEAVA,MĂLINI,149316,VĂLENI-STÂNIŞOARA,"SCOALA GIMNAZIALA VALENI-STANISOARA",384,"Alegeri Prezidentiale",1,653,344,311,33,0,340,4,700,356,229,111
35,SUCEAVA,"MĂNĂSTIREA HUMORULUI",149370,"MĂNĂSTIREA HUMORULUI","ŞCOALA GIMNAZIALĂ MĂNĂSTIREA HUMORULUI",385,"Alegeri Prezidentiale",1,1010,462,438,22,2,459,3,1100,638,358,101
35,SUCEAVA,"MĂNĂSTIREA HUMORULUI",149370,"MĂNĂSTIREA HUMORULUI","ŞCOALA GIMNAZIALĂ MĂNĂSTIREA HUMORULUI",386,"Alegeri Prezidentiale",1,1060,493,413,78,2,483,10,1200,707,383,100
35,SUCEAVA,"MĂNĂSTIREA HUMORULUI",149370,PLEŞA,"CASA POLONĂ ”DOM POLSKI”",387,"Alegeri Prezidentiale",1,166,74,55,19,0,73,1,200,126,64,9
35,SUCEAVA,"MĂNĂSTIREA HUMORULUI",149370,"POIANA MICULUI","ŞCOALA GIMNAZIALĂ ”KRYSTINA BOCHENEK” POIANA MICULUI",388,"Alegeri Prezidentiale",2,494,236,214,22,0,234,2,500,264,215,19
35,SUCEAVA,"MĂNĂSTIREA HUMORULUI",149370,"POIANA MICULUI","FOSTA ”ŞCOALĂ PRIMARĂ NR. .1 POIANA MICULUI”",389,"Alegeri Prezidentiale",1,337,152,133,19,0,152,0,400,248,120,32
35,SUCEAVA,"MITOCU DRAGOMIRNEI",146325,"MITOCU DRAGOMIRNEI","CAMINUL CULTURAL AL COMUNEI MITOCU DRAGOMIRNEI",390,"Alegeri Prezidentiale",1,1399,664,589,75,0,640,24,1500,836,416,224
35,SUCEAVA,"MITOCU DRAGOMIRNEI",146325,"MITOCU DRAGOMIRNEI","GRĂDINIŢA CU PROGRAM NORMAL NR. 1",391,"Alegeri Prezidentiale",2,1523,824,744,80,0,790,34,1700,876,482,308
35,SUCEAVA,"MITOCU DRAGOMIRNEI",146325,MITOCAŞI,"ŞCOALA PRIMARĂ ”ION CREANGĂ” MITOCAŞI",392,"Alegeri Prezidentiale",1,721,347,318,29,0,342,5,800,453,209,133
35,SUCEAVA,"MITOCU DRAGOMIRNEI",146325,LIPOVENI,"ŞCOALA PRIMARĂ LIPOVENI",393,"Alegeri Prezidentiale",1,389,199,165,34,0,196,3,400,201,126,70
35,SUCEAVA,MOARA,149414,"MOARA NICA",PRIMARIE,394,"Alegeri Prezidentiale",1,1522,669,623,46,0,654,15,1700,1031,476,178
35,SUCEAVA,MOARA,149414,"MOARA NICA","SCOALA GENERALA MOARA NICA",395,"Alegeri Prezidentiale",1,1183,573,514,59,0,564,9,1300,727,416,148
35,SUCEAVA,MOARA,149414,"MOARA CARP","SCOALA GENERALA MOARA CARP",396,"Alegeri Prezidentiale",1,716,296,265,31,0,294,2,800,504,177,117
35,SUCEAVA,MOARA,149414,FRUMOASA,"SCOALA GENERALA FRUMOASA",397,"Alegeri Prezidentiale",1,205,104,74,30,0,101,3,300,196,66,35
35,SUCEAVA,MOARA,149414,LITENI,"SCOALA GENERALA LITENI",398,"Alegeri Prezidentiale",1,741,362,321,41,0,356,6,800,438,234,122
35,SUCEAVA,MOARA,149414,"VORNICENII MARI","SCOALA GENERALA VORNICENII MARI",399,"Alegeri Prezidentiale",1,214,104,85,19,0,103,1,300,196,53,50
35,SUCEAVA,MOLDOVA-SULIŢA,149502,MOLDOVA-SULIŢA,"PRIMĂRIA COM MOLDOVA SULIȚA",400,"Alegeri Prezidentiale",1,1035,362,331,31,0,351,11,1100,738,218,133
35,SUCEAVA,MOLDOVA-SULIŢA,149502,BENIA,"ȘCOALA PRIMARĂ BENIA",401,"Alegeri Prezidentiale",1,522,245,228,17,0,241,4,600,355,183,58
35,SUCEAVA,MOLDOVIŢA,149539,MOLDOVIŢA,"SALA DE SPECTACOLE",402,"Alegeri Prezidentiale",1,1891,896,823,73,0,884,12,2000,1104,657,227
35,SUCEAVA,MOLDOVIŢA,149539,ARGEL,"ŞCOALA GIMNAZIALĂ ARGEL",403,"Alegeri Prezidentiale",1,834,306,294,12,0,305,1,900,594,239,66
35,SUCEAVA,MOLDOVIŢA,149539,DEMACUŞA,"GRĂDINIŢA CU PROGRAM NORMAL DEMACUŞA",404,"Alegeri Prezidentiale",1,799,381,372,9,0,376,5,900,519,270,106
35,SUCEAVA,MOLDOVIŢA,149539,RAŞCA,"GRĂDINIŢA CU PROGRAM NORMAL RAŞCA",405,"Alegeri Prezidentiale",1,654,362,340,22,0,361,1,700,338,293,68
35,SUCEAVA,MUŞENIŢA,149584,BAINEŢ,"CĂMINUL CULTURAL BAINEŢ",406,"Alegeri Prezidentiale",1,242,112,95,17,0,110,2,300,188,64,46
35,SUCEAVA,MUŞENIŢA,149584,CLIMĂUŢI,"CĂMINUL CULTURAL CLIMĂUŢI",407,"Alegeri Prezidentiale",1,303,112,94,18,0,111,1,400,288,77,34
35,SUCEAVA,MUŞENIŢA,149584,VICŞANI,"CLĂDIREA ”DOM POLSKI” VICŞANI",408,"Alegeri Prezidentiale",1,185,98,85,13,0,95,3,200,102,67,28
35,SUCEAVA,MUŞENIŢA,149584,MUŞENIŢA,"ŞCOALA CU CL.I-IV MUŞENIŢA",409,"Alegeri Prezidentiale",1,302,141,128,13,0,138,3,400,259,80,58
35,SUCEAVA,MUŞENIŢA,149584,VĂŞCĂUŢI,"CĂMINUL CULTURAL VĂŞCĂUŢI",410,"Alegeri Prezidentiale",1,511,206,191,14,1,202,4,600,394,145,57
35,SUCEAVA,OSTRA,149655,OSTRA,"CĂMINUL CULTURAL NOU",411,"Alegeri Prezidentiale",2,1777,652,625,27,0,640,12,1900,1248,307,333
35,SUCEAVA,OSTRA,149655,OSTRA,"CASA DE TIP FAMILIAL ”CIREŞARII”",412,"Alegeri Prezidentiale",1,994,381,369,11,1,375,6,1100,719,186,189
35,SUCEAVA,PANACI,149682,PANACI,"ȘCOALA GIMNAZIALĂ PANACI",413,"Alegeri Prezidentiale",1,671,401,351,50,0,396,5,700,299,240,156
35,SUCEAVA,PANACI,149682,COVERCA,"SCOALA CU CLASELE I-IV COVERCA",414,"Alegeri Prezidentiale",1,679,344,324,20,0,342,2,700,356,244,98
35,SUCEAVA,PANACI,149682,PĂLTINIŞ,"ȘCOALA CU CLASELE I-IV PĂLTINIȘ",415,"Alegeri Prezidentiale",1,282,178,154,24,0,177,1,300,122,131,46
35,SUCEAVA,PANACI,149682,GLODU,"CAMIN CULTURAL GLODU",416,"Alegeri Prezidentiale",1,271,123,107,16,0,122,1,310,187,71,51
35,SUCEAVA,PĂLTINOASA,149753,PĂLTINOASA,"CĂMINUL CULTURAL PĂLTINOASA",417,"Alegeri Prezidentiale",1,1245,670,610,60,0,666,4,1400,730,498,168
35,SUCEAVA,PĂLTINOASA,149753,PĂLTINOASA,"ŞCOALA GIMNAZIALĂ PĂLTINOASA",418,"Alegeri Prezidentiale",1,1374,769,685,84,0,762,7,1500,731,615,147
35,SUCEAVA,PĂLTINOASA,149753,"CAPU CODRULUI","CĂMINUL CULTURAL CAPU CODRULUI",419,"Alegeri Prezidentiale",1,913,476,417,59,0,472,4,1000,524,311,161
35,SUCEAVA,PĂLTINOASA,149753,"CAPU CODRULUI","ŞCOALA GIMNAZIALĂ BOGDAN VODĂ CAPU CODRULUI",420,"Alegeri Prezidentiale",1,1227,555,527,28,0,541,14,1400,845,412,129
35,SUCEAVA,PĂTRĂUŢI,149833,PĂTRĂUŢI,"PRIMARIA COMUNEI PATRAUTI",421,"Alegeri Prezidentiale",1,1985,791,737,54,0,782,9,2100,1309,524,258
35,SUCEAVA,PĂTRĂUŢI,149833,PĂTRĂUŢI,"CAMINUL CULTURAL VECHI PATRAUTI",422,"Alegeri Prezidentiale",2,1936,863,812,51,0,854,9,2100,1237,420,434
35,SUCEAVA,"PÂRTEŞTII DE JOS",149780,"PÂRTEŞTII DE JOS","LICEUL TEHNOLOGIC ”NICANOR MOROȘAN” PÎRTEȘTII DE JOS",423,"Alegeri Prezidentiale",1,1587,677,616,60,1,663,14,1700,1023,398,265
35,SUCEAVA,"PÂRTEŞTII DE JOS",149780,DELENI,"ŞCOALA DELENI",424,"Alegeri Prezidentiale",1,572,274,236,38,0,273,1,600,326,164,109
35,SUCEAVA,"PÂRTEŞTII DE JOS",149780,"VÂRFU DEALULUI","ŞCOALA VÂRFU DEALULUI",425,"Alegeri Prezidentiale",1,137,95,65,30,0,95,0,200,105,64,31
35,SUCEAVA,"POIANA STAMPEI",149851,"POIANA STAMPEI","PRIMĂRIA POIANA STAMPEI",426,"Alegeri Prezidentiale",1,1577,920,869,51,0,910,10,1700,780,523,387
35,SUCEAVA,"POIANA STAMPEI",149851,DORNIŞOARA,"COMPLEX SOCIAL DORNISOARA",427,"Alegeri Prezidentiale",1,260,162,139,23,0,161,1,300,138,39,122
35,SUCEAVA,POIENI-SOLCA,151585,POIENI-SOLCA,"PRIMĂRIA POIENI-SOLCA",428,"Alegeri Prezidentiale",1,1717,567,523,44,0,560,7,1900,1333,293,267
35,SUCEAVA,POJORÂTA,149931,POJORÂTA,"ŞCOALA CU CLASELE I-IV POJORÎTA",429,"Alegeri Prezidentiale",1,800,477,415,54,8,473,4,900,423,324,149
35,SUCEAVA,POJORÂTA,149931,POJORÂTA,"CĂMINUL CULTURAL POJORÂTA",430,"Alegeri Prezidentiale",1,1392,777,692,85,0,767,10,1500,723,483,284
35,SUCEAVA,POJORÂTA,149931,"VALEA PUTNEI","ȘCOALA CU CLASELE I - IV VALEA PUTNEI",431,"Alegeri Prezidentiale",1,294,195,146,49,0,189,6,300,105,153,36
35,SUCEAVA,PREUTEŞTI,149968,ARGHIRA,"ŞCOALA GIMNAZIALĂ ARGHIRA",432,"Alegeri Prezidentiale",1,926,451,405,46,0,440,11,1000,549,205,235
35,SUCEAVA,PREUTEŞTI,149968,BASARABI,"ŞCOALA GIMNAZIALĂ BASARABI",433,"Alegeri Prezidentiale",1,1418,643,606,37,0,636,7,1600,957,339,297
35,SUCEAVA,PREUTEŞTI,149968,"BAHNA ARIN","ŞCOALA PRIMARĂ BAHNA ARIN",434,"Alegeri Prezidentiale",1,177,101,85,16,0,99,2,199,98,45,54
35,SUCEAVA,PREUTEŞTI,149968,PREUTEŞTI,"CĂMINUL CULTURAL PREUTEŞTI",435,"Alegeri Prezidentiale",1,1528,741,696,45,0,725,16,1700,959,292,433
35,SUCEAVA,PREUTEŞTI,149968,HUŞI,"ŞCOALA PRIMARĂ HUŞI",436,"Alegeri Prezidentiale",1,557,283,259,24,0,278,5,600,317,122,156
35,SUCEAVA,PREUTEŞTI,149968,LEUCUŞEŞTI,"ŞCOALA GIMNAZIALĂ LEUCUŞEŞTI",437,"Alegeri Prezidentiale",1,914,440,410,30,0,436,4,1000,560,242,194
35,SUCEAVA,PUTNA,150043,PUTNA,"CĂMINUL CULTURAL PUTNA- SALA CĂSĂTORIILOR",438,"Alegeri Prezidentiale",2,1271,674,633,34,7,664,10,1400,726,360,304
35,SUCEAVA,PUTNA,150043,PUTNA,"CĂMINUL CULTURAL PUTNA- SALA DE ŞEDINŢE",439,"Alegeri Prezidentiale",1,814,469,390,76,3,463,6,900,431,270,193
35,SUCEAVA,PUTNA,150043,"GURA PUTNEI","CĂMINUL CULTURAL GURA PUTNEI",440,"Alegeri Prezidentiale",1,1096,504,478,18,8,494,10,1200,696,358,136
35,SUCEAVA,RĂDĂŞENI,150070,RĂDĂŞENI,"PRIMĂRIA COMUNEI RĂDĂŞENI",441,"Alegeri Prezidentiale",1,1056,444,406,38,0,436,8,1200,756,330,106
35,SUCEAVA,RĂDĂŞENI,150070,RĂDĂŞENI,"PRIMĂRIA COMUNEI RĂDĂŞENI",442,"Alegeri Prezidentiale",1,1167,486,450,36,0,477,9,1300,814,375,102
35,SUCEAVA,RĂDĂŞENI,150070,LĂMĂŞENI,"ȘCOALA MIHAI NICULĂIASA, SAT LĂMĂȘENI",443,"Alegeri Prezidentiale",1,1038,460,430,30,0,458,2,1100,640,345,113
35,SUCEAVA,RĂDĂŞENI,150070,POCOLENI,"ȘCOALA POCOLENI",444,"Alegeri Prezidentiale",1,159,61,46,15,0,61,0,200,139,31,30
35,SUCEAVA,RÂŞCA,150114,RÂŞCA,"CĂMIN CULTURAL RÎŞCA",445,"Alegeri Prezidentiale",1,1511,641,602,39,0,627,14,1700,1059,310,317
35,SUCEAVA,RÂŞCA,150114,RÂŞCA,"ŞCOALA GENERALĂ RÎŞCA 3",446,"Alegeri Prezidentiale",1,728,321,297,24,0,316,5,800,479,163,153
35,SUCEAVA,RÂŞCA,150114,JAHALIA,"PRAZNICAR (PAROHIA ORTODOXĂ JAHALIA)",447,"Alegeri Prezidentiale",1,264,119,105,14,0,118,1,300,181,67,51
35,SUCEAVA,RÂŞCA,150114,BUDA,"ȘCOALA PRIMARĂ NR. 2 RÎȘCA",448,"Alegeri Prezidentiale",1,602,262,239,23,0,253,9,700,438,116,137
35,SUCEAVA,RÂŞCA,150114,DUMBRĂVENI,"ȘCOALA DUMBRĂVENI",449,"Alegeri Prezidentiale",1,316,170,152,18,0,168,2,400,230,69,99
35,SUCEAVA,RÂŞCA,150114,SLĂTIOARA,"ȘCOALA SLĂTIOARA",450,"Alegeri Prezidentiale",1,638,274,251,23,0,268,6,700,426,90,178
35,SUCEAVA,SADOVA,150178,SADOVA,"CĂMINUL CULTURAL SADOVA",451,"Alegeri Prezidentiale",1,1147,716,622,94,0,699,17,1300,584,551,148
35,SUCEAVA,SADOVA,150178,SADOVA,"ŞCOALA GENERALĂ FUNDU SADOVEI",452,"Alegeri Prezidentiale",1,925,521,501,20,0,514,7,1000,479,389,125
35,SUCEAVA,"SATU MARE",150196,"SATU MARE","CAMIN CULTURAL",453,"Alegeri Prezidentiale",1,1164,397,376,21,0,392,5,1300,903,235,157
35,SUCEAVA,"SATU MARE",150196,"SATU MARE","SCOALA GIMNAZIALA SATU MARE",454,"Alegeri Prezidentiale",1,1223,446,435,11,0,441,5,1282,836,249,192
35,SUCEAVA,"SATU MARE",150196,ŢIBENI,"SCOALA GIMNAZIALA SAT TIBENI",455,"Alegeri Prezidentiale",1,1158,420,397,23,0,416,4,1300,880,208,208
35,SUCEAVA,SIMINICEA,150221,SIMINICEA,"CĂMINUL CULTURAL SIMINICEA",456,"Alegeri Prezidentiale",1,1251,504,467,37,0,492,12,1400,896,280,212
35,SUCEAVA,SIMINICEA,150221,SIMINICEA,"SCOALA GIMNAZIALA SIMINICEA",457,"Alegeri Prezidentiale",1,848,343,314,29,0,341,2,900,557,160,181
35,SUCEAVA,SIMINICEA,150221,GRIGOREŞTI,"SCOALA PRIMARA GRIGORESTI",458,"Alegeri Prezidentiale",1,256,157,115,42,0,154,3,300,143,86,68
35,SUCEAVA,SLATINA,150258,SLATINA,"PRIMARIA COMUNEI SLATINA",459,"Alegeri Prezidentiale",2,1567,693,636,30,27,674,19,1700,1007,342,332
35,SUCEAVA,SLATINA,150258,HERLA,"CĂMINUL CULTURAL HERLA",460,"Alegeri Prezidentiale",1,1116,598,551,28,19,591,7,1200,602,352,239
35,SUCEAVA,SLATINA,150258,GĂINEŞTI,"ȘCOALA GIMNAZIALĂ GĂINEȘTI",461,"Alegeri Prezidentiale",1,1635,867,800,36,31,864,3,1800,933,268,596
35,SUCEAVA,STRAJA,150294,STRAJA,"GRĂDINIŢA DE COPII NR. 1 STRAJA",462,"Alegeri Prezidentiale",1,1253,502,488,14,0,494,8,1400,898,314,180
35,SUCEAVA,STRAJA,150294,STRAJA,"GRĂDINIŢA DE COPII NR. 3 STRAJA",463,"Alegeri Prezidentiale",1,1113,490,464,26,0,480,10,1200,710,346,134
35,SUCEAVA,STRAJA,150294,STRAJA,"PRIMĂRIA COMUNEI STRAJA",464,"Alegeri Prezidentiale",1,1175,479,458,21,0,467,12,1300,821,328,139
35,SUCEAVA,STRAJA,150294,STRAJA,"GRĂDINIŢA DE COPII NR. 2 STRAJA",465,"Alegeri Prezidentiale",1,987,365,342,23,0,352,13,1100,735,236,116
35,SUCEAVA,STROIEŞTI,150310,STROIEŞTI,"ŞCOALA GIMNAZIALĂ STROIEŞTI, SALA DE SPORT",466,"Alegeri Prezidentiale",1,1138,548,519,28,1,534,14,1300,752,316,218
35,SUCEAVA,STROIEŞTI,150310,STROIEŞTI,"ŞCOALA GIMNAZIALĂ STROIEŞTI, SALA DE CLASĂ",467,"Alegeri Prezidentiale",1,991,448,420,28,0,447,1,1100,652,276,171
35,SUCEAVA,STROIEŞTI,150310,ZAHAREŞTI,"SCOALA CU CLASELE I - IV ” ILIE GRAMADA”",468,"Alegeri Prezidentiale",1,614,322,274,48,0,319,3,700,378,162,157
35,SUCEAVA,STULPICANI,150356,STULPICANI,"CASA TINERETULUI",469,"Alegeri Prezidentiale",1,1152,517,487,29,1,514,3,1300,783,260,254
35,SUCEAVA,STULPICANI,150356,STULPICANI,"GRĂDINIŢA CU PROGRAM NORMAL STULPICANI",470,"Alegeri Prezidentiale",1,1175,505,484,21,0,500,5,1300,795,249,251
35,SUCEAVA,STULPICANI,150356,NEGRILEASA,"CĂMINUL CULTURAL NEGRILESA",471,"Alegeri Prezidentiale",1,833,352,331,21,0,348,4,900,548,203,145
35,SUCEAVA,STULPICANI,150356,"VADU NEGRILESEI","ŞCOALA PRIMARĂ VADU NEGRILESEI",472,"Alegeri Prezidentiale",1,461,232,221,11,0,230,2,500,268,140,90
35,SUCEAVA,STULPICANI,150356,GEMENEA,"ŞCOALA GIMNAZIALĂ GEMENEA",473,"Alegeri Prezidentiale",1,639,292,272,20,0,292,0,700,408,174,118
35,SUCEAVA,STULPICANI,150356,SLĂTIOARA,"ŞCOALA GIMNAZIALĂ SLĂTIOARA",474,"Alegeri Prezidentiale",1,489,223,216,7,0,222,1,500,277,124,98
35,SUCEAVA,SUCEVIŢA,150418,SUCEVIŢA,"SCOALA GIMNAZIALĂ DIMITRIE VATAMANIUC",475,"Alegeri Prezidentiale",1,1403,650,562,88,0,639,11,1500,850,389,250
35,SUCEAVA,SUCEVIŢA,150418,VOIEVODEASA,"CĂMINUL CULTURAL VOIEVODEASA",476,"Alegeri Prezidentiale",1,1054,466,438,28,0,452,14,1200,734,309,143
35,SUCEAVA,"ŞARU DORNEI",150445,"NEAGRA ŞARULUI","SCOALA GIMNAZIALA NEAGRA SARULUI",477,"Alegeri Prezidentiale",1,1592,844,776,65,3,839,5,1700,856,548,291
35,SUCEAVA,"ŞARU DORNEI",150445,"ŞARU DORNEI","SCOALA CU CLASELE I-VIII SARU DORNEI",478,"Alegeri Prezidentiale",1,952,483,453,30,0,474,9,1000,517,293,181
35,SUCEAVA,"ŞARU DORNEI",150445,"GURA HAITII","SCOALA CU CLASELE I-IV GURA HAITII",479,"Alegeri Prezidentiale",1,484,225,221,4,0,225,0,500,275,155,70
35,SUCEAVA,"ŞARU DORNEI",150445,"SĂRIŞORU MARE","SCOALA CU CLASELE I-IV SARISORU MARE",480,"Alegeri Prezidentiale",1,446,228,217,11,0,227,1,500,272,151,76
35,SUCEAVA,ŞCHEIA,146432,"SFÂNTU ILIE","CĂMIN CULTURAL",481,"Alegeri Prezidentiale",1,828,410,389,21,0,403,7,900,490,302,101
35,SUCEAVA,ŞCHEIA,146432,"SFÂNTU ILIE","CĂMIN CULTURAL",482,"Alegeri Prezidentiale",1,1404,664,632,32,0,649,15,1600,936,434,215
35,SUCEAVA,ŞCHEIA,146432,"SFÂNTU ILIE","CĂMIN CULTURAL",483,"Alegeri Prezidentiale",1,1867,863,821,42,0,843,20,2000,1137,549,294
35,SUCEAVA,ŞCHEIA,146432,FLORINTA,"CAMIN CULTURAL",484,"Alegeri Prezidentiale",1,171,83,69,14,0,82,1,200,117,59,23
35,SUCEAVA,ŞCHEIA,146432,ŞCHEIA,"ȘCOALA GIMNAZIALĂ ”DIMITRIE PĂCURARIU” ȘCHEIA",485,"Alegeri Prezidentiale",1,1720,959,882,77,0,936,23,1900,941,667,269
35,SUCEAVA,ŞCHEIA,146432,ŞCHEIA,"ȘCOALA GIMNAZIALĂ ”DIMITRIE PĂCURARIU” ȘCHEIA",486,"Alegeri Prezidentiale",2,1564,796,759,37,0,785,11,1700,904,495,290
35,SUCEAVA,ŞCHEIA,146432,MIHOVENI,"ŞCOALA GIMNAZIALĂ",487,"Alegeri Prezidentiale",1,1808,904,816,88,0,880,24,2000,1096,581,299
35,SUCEAVA,ŞERBĂUŢI,151460,ŞERBĂUŢI,"CAMIN CULTURAL SERBAUTI",488,"Alegeri Prezidentiale",1,1617,506,468,38,0,500,6,1800,1294,351,149
35,SUCEAVA,ŞERBĂUŢI,151460,CĂLINEŞTI,"ȘCOALA GIMNAZIALĂ CĂLINEȘTI",489,"Alegeri Prezidentiale",1,980,402,373,29,0,394,8,1100,698,249,145
35,SUCEAVA,TODIREŞTI,150524,TODIREŞTI,"SCOALA GIMNAZIALĂ TODIREŞTI",490,"Alegeri Prezidentiale",1,1202,576,521,55,0,569,7,1300,724,312,257
35,SUCEAVA,TODIREŞTI,150524,COSTÂNA,"SCOALA GIMNAZIALĂ ”VASILE BUMBAC” COSTÎNA",491,"Alegeri Prezidentiale",1,930,460,408,52,0,455,5,1000,540,291,164
35,SUCEAVA,TODIREŞTI,150524,PĂRHĂUŢI,"SCOALA GIMNAZIALĂ PĂRHĂUŢI",492,"Alegeri Prezidentiale",1,995,472,428,44,0,465,7,1100,628,314,151
35,SUCEAVA,TODIREŞTI,150524,SOLONEŢ,"SCOALA GIMNAZIALĂ ”I.V.RACHIERU” SOLONEŢ",493,"Alegeri Prezidentiale",1,1301,479,441,38,0,472,7,1400,921,313,159
35,SUCEAVA,UDEŞTI,150588,UDEŞTI,"PRIMĂRIA COMUNEI UDEŞTI",494,"Alegeri Prezidentiale",1,1969,826,729,97,0,817,9,2100,1274,518,299
35,SUCEAVA,UDEŞTI,150588,POIENI-SUCEAVA,"CĂMINUL CULTURAL POIENI - SUCEAVA",495,"Alegeri Prezidentiale",1,483,262,222,40,0,258,4,500,238,146,112
35,SUCEAVA,UDEŞTI,150588,CHILIŞENI,"CĂMINUL CULTURAL CHILIŞENI",496,"Alegeri Prezidentiale",1,631,374,344,30,0,370,4,700,326,180,190
35,SUCEAVA,UDEŞTI,150588,ŞTIRBĂŢ,"CĂMINUL CULTURAL ŞTIRBĂŢ",497,"Alegeri Prezidentiale",1,450,250,211,39,0,249,1,500,250,141,108
35,SUCEAVA,UDEŞTI,150588,RACOVA,"CĂMINUL CULTURAL RACOVA",498,"Alegeri Prezidentiale",1,240,126,107,19,0,125,1,300,174,57,68
35,SUCEAVA,UDEŞTI,150588,RUŞII-MĂNĂSTIOARA,"ŞCOALA PRIMARĂ RUŞII - MĂNĂSTIOARA",499,"Alegeri Prezidentiale",1,428,229,193,36,0,224,5,500,271,137,87
35,SUCEAVA,UDEŞTI,150588,LUNCUŞOARA,"ŞCOALA PRIMARĂ LUNCUŞOARA",500,"Alegeri Prezidentiale",1,523,262,227,35,0,258,4,600,338,148,110
35,SUCEAVA,UDEŞTI,150588,REUSENI,"CASA TRADIȚIILOR",501,"Alegeri Prezidentiale",1,519,275,242,33,0,269,6,600,325,129,140
35,SUCEAVA,UDEŞTI,150588,PLĂVĂLARI,"GRĂDINIŢA CU PROGRAM NORMAL PLĂVĂLARI",502,"Alegeri Prezidentiale",1,901,345,318,27,0,339,6,1000,655,172,167
35,SUCEAVA,ULMA,150702,ULMA,"ŞCOALA GIMNAZIALA ULMA",503,"Alegeri Prezidentiale",1,547,212,202,10,0,212,0,600,388,143,69
35,SUCEAVA,ULMA,150702,LUPCINA,"ŞCOALA GIMNAZIALĂ LUPCINA",504,"Alegeri Prezidentiale",1,785,367,326,41,0,362,5,900,533,235,127
35,SUCEAVA,ULMA,150702,NISIPITU,"SALA DE ŞEDINŢE A CONSILIULUI LOCAL ULMA",505,"Alegeri Prezidentiale",1,359,172,143,29,0,167,5,400,228,89,78
35,SUCEAVA,"VADU MOLDOVEI",150766,"VADU MOLDOVEI","ȘCOALA GIMNAZIALĂ NR 1 VADU MOLDOVEI",506,"Alegeri Prezidentiale",1,869,476,409,42,25,472,4,1000,524,258,214
35,SUCEAVA,"VADU MOLDOVEI",150766,DUMBRĂVIŢA,"ȘCOALA PRIMARĂ DUMBRĂVIȚA",507,"Alegeri Prezidentiale",1,824,386,344,42,0,381,5,900,514,206,175
35,SUCEAVA,"VADU MOLDOVEI",150766,NIGOTEŞTI,"ȘCOALA GIMNAZIALĂ NIGOTEȘTI",508,"Alegeri Prezidentiale",1,357,182,155,27,0,179,3,400,218,87,92
35,SUCEAVA,"VADU MOLDOVEI",150766,MOVILENI,"ȘCOALA PRIMARĂ MOVILENI",509,"Alegeri Prezidentiale",1,223,94,77,16,1,92,2,300,206,49,43
35,SUCEAVA,"VADU MOLDOVEI",150766,MESTECENI,"ȘCOALA PRIMARĂ MESTECENI",510,"Alegeri Prezidentiale",1,159,72,61,11,0,71,1,200,128,50,21
35,SUCEAVA,"VADU MOLDOVEI",150766,IONEASA,"ȘCOALA PRIMARĂ IONEASA",511,"Alegeri Prezidentiale",1,285,137,116,20,1,137,0,300,163,62,75
35,SUCEAVA,"VADU MOLDOVEI",150766,CIUMULEŞTI,"CĂMINUL CULTURAL CIUMULEȘTI",512,"Alegeri Prezidentiale",1,702,350,326,24,0,346,4,800,450,131,215
35,SUCEAVA,"VADU MOLDOVEI",150766,"VADU MOLDOVEI","ȘCOALA GIMNAZIALĂ NR 2 VADU MOLDOVEI",513,"Alegeri Prezidentiale",1,322,191,147,44,0,186,5,399,208,109,77
35,SUCEAVA,"VALEA MOLDOVEI",150891,"VALEA MOLDOVEI","PRIMĂRIA COMUNEI VALEA MOLDOVEI, JUDEȚUL SUCEAVA",514,"Alegeri Prezidentiale",1,1343,618,596,22,0,609,9,1500,882,334,275
35,SUCEAVA,"VALEA MOLDOVEI",150891,MIRONU,"GRĂDINIȚA MIRONU",515,"Alegeri Prezidentiale",1,1612,793,774,19,0,771,22,1800,1007,465,306
35,SUCEAVA,VAMA,150935,VAMA,"CĂMIN CULTURAL VAMA",516,"Alegeri Prezidentiale",1,986,479,435,44,0,469,10,1100,621,318,151
35,SUCEAVA,VAMA,150935,VAMA,"SCOALA GIMNAZIALĂ ”IORGU G. TOMA” LOCALUL NR.2",517,"Alegeri Prezidentiale",1,1720,787,721,54,12,776,11,1900,1113,592,184
35,SUCEAVA,VAMA,150935,STRÂMTURA,"ŞCOALA GIMNAZIALĂ ”IORGU G. TOMA” LOCALUL DIN SATUL STRÂMTURA",518,"Alegeri Prezidentiale",1,1038,476,438,37,1,473,3,1100,624,363,110
35,SUCEAVA,VAMA,150935,MOLID,"ŞCOLA GIMNAZIALĂ ”IORGU G. TOMA” LOCALUL DIN SATUL MOLID",519,"Alegeri Prezidentiale",1,533,275,241,34,0,272,3,600,325,185,87
35,SUCEAVA,VAMA,150935,"PRISACA DORNEI","ŞCOALA GIMNAZIALĂ ”IORGU G. TOMA” LOCALUL DIN SATUL PRISACA DORNEI",520,"Alegeri Prezidentiale",1,683,294,259,35,0,290,4,800,506,193,97
35,SUCEAVA,"VATRA MOLDOVIŢEI",150980,"VATRA MOLDOVIŢEI","CENTRUL LOCAL DE PROMOVARE ȘI INFORMARE TURISTICĂ VATRA MOLDOVIȚEI",521,"Alegeri Prezidentiale",1,1173,574,529,45,0,568,6,1300,726,406,162
35,SUCEAVA,"VATRA MOLDOVIŢEI",150980,"VATRA MOLDOVIŢEI","ȘCOALA PRIMARĂ VALEA STÂNII",522,"Alegeri Prezidentiale",1,649,272,255,17,0,270,2,700,428,214,56
35,SUCEAVA,"VATRA MOLDOVIŢEI",150980,CIUMÂRNA,"SALA POLIVALENTĂ CIUMÂRNA",523,"Alegeri Prezidentiale",1,383,178,155,23,0,174,4,400,222,145,29
35,SUCEAVA,"VATRA MOLDOVIŢEI",150980,PALTINU,"ȘCOALA GIMNAZIALĂ PALTINU",524,"Alegeri Prezidentiale",2,698,302,268,34,0,301,1,800,498,218,83
35,SUCEAVA,"VATRA MOLDOVIŢEI",150980,PALTINU,"ŞCOALA PRIMARĂ SPĂRTURI",525,"Alegeri Prezidentiale",1,678,361,331,30,0,357,4,700,339,246,111
35,SUCEAVA,VEREŞTI,151022,VEREŞTI,"CAMINUL CULTURAL VERESTI",526,"Alegeri Prezidentiale",1,1252,503,469,34,0,482,21,1400,897,265,217
35,SUCEAVA,VEREŞTI,151022,HANCEA,"SALA DE SEDINTE A CONSILIULUI LOCAL VERESTI",527,"Alegeri Prezidentiale",1,912,398,371,27,0,391,7,1000,602,172,219
35,SUCEAVA,VEREŞTI,151022,COROCĂIEŞTI,"SCOALA GIMNAZIALA COROCAIESTI",528,"Alegeri Prezidentiale",1,1038,366,343,23,0,359,7,1100,734,235,124
35,SUCEAVA,VEREŞTI,151022,COROCĂIEŞTI,"CAMINUL CULTURAL COROCAIESTI",529,"Alegeri Prezidentiale",1,1276,437,407,30,0,436,1,1400,963,275,161
35,SUCEAVA,VEREŞTI,151022,BURSUCENI,"SCOALA GIMNAZIALA BURSUCENI",530,"Alegeri Prezidentiale",1,1148,437,402,35,0,433,4,1300,863,281,152
35,SUCEAVA,"VICOVU DE JOS",151077,"VICOVU DE JOS","SCOALA CU CLASELE I-VIII IOAN VICOVEANU",531,"Alegeri Prezidentiale",1,1359,594,545,49,0,582,12,1500,906,277,305
35,SUCEAVA,"VICOVU DE JOS",151077,"VICOVU DE JOS","SCOALA CU CLASELE I-VIII NR.2 REMEZAU",532,"Alegeri Prezidentiale",1,1984,724,707,17,0,717,7,2100,1376,328,389
35,SUCEAVA,"VICOVU DE JOS",151077,"VICOVU DE JOS","SCOALA CU CLASELE I-IV MARGINE",533,"Alegeri Prezidentiale",1,792,311,296,15,0,301,10,900,589,120,181
35,SUCEAVA,"VICOVU DE JOS",151077,"VICOVU DE JOS","GRĂDINIŢA ”POD DABÎCA”",534,"Alegeri Prezidentiale",1,1039,418,400,18,0,410,8,1100,682,227,183
35,SUCEAVA,VOITINEL,151558,VOITINEL,"CĂMINUL CULTURAL VOITINEL",535,"Alegeri Prezidentiale",1,1759,808,729,49,30,799,9,1900,1092,255,544
35,SUCEAVA,VOITINEL,151558,VOITINEL,"SCOALA CU CLASELE I-VIII VOITINEL",536,"Alegeri Prezidentiale",1,1582,743,703,22,18,720,23,1700,957,293,427
35,SUCEAVA,VOLOVĂŢ,151120,VOLOVĂŢ,"CĂMINUL CULTURAL",537,"Alegeri Prezidentiale",1,1672,643,620,22,1,630,13,1800,1157,358,272
35,SUCEAVA,VOLOVĂŢ,151120,VOLOVĂŢ,"CĂMINUL CULTURAL",538,"Alegeri Prezidentiale",1,1695,625,611,10,4,617,8,1800,1175,339,278
35,SUCEAVA,VOLOVĂŢ,151120,VOLOVĂŢ,"PRIMĂRIA COMUNEI VOLOVĂŢ",539,"Alegeri Prezidentiale",1,853,328,312,15,1,325,3,900,572,188,137
35,SUCEAVA,VULTUREŞTI,151157,PLEŞEŞTI,"ŞCOALA GIMNAZIALĂ ”CONSTANTIN TOMESCU” PLEŞEŞTI",540,"Alegeri Prezidentiale",1,506,200,171,29,0,195,5,600,400,100,95
35,SUCEAVA,VULTUREŞTI,151157,"VALEA GLODULUI","ŞCOALA GIMNAZIALĂ VALEA GLODULUI",541,"Alegeri Prezidentiale",1,736,289,274,15,0,284,5,800,511,142,142
35,SUCEAVA,VULTUREŞTI,151157,GIURGEŞTI,"SCOALA GIMNAZIALĂ GIURGEŞTI",542,"Alegeri Prezidentiale",1,580,237,213,24,0,235,2,600,363,141,94
35,SUCEAVA,VULTUREŞTI,151157,HREAŢCA,"LOCALUL FOSTEI ŞCOLI HREAŢCA (IMOBIL PROPRIETATEA SOCIETĂŢII COOPERATIVE ”VULTURUL PLEŞUV” VULTUREŞTI)",543,"Alegeri Prezidentiale",1,333,164,134,30,0,160,4,400,236,83,77
35,SUCEAVA,VULTUREŞTI,151157,MEREŞTI,"ŞCOALA CU CLASELE I - IV",544,"Alegeri Prezidentiale",2,198,110,83,27,0,110,0,200,90,36,74
35,SUCEAVA,VULTUREŞTI,151157,JACOTA,"LOCALUL FOSTEI ŞCOLI JACOTA",545,"Alegeri Prezidentiale",1,115,57,42,15,0,57,0,200,143,35,22
35,SUCEAVA,VULTUREŞTI,151157,OSOI,"SCOALA PRIMARĂ OSOI",546,"Alegeri Prezidentiale",1,278,149,117,32,0,147,2,300,151,56,91
35,SUCEAVA,ZAMOSTEA,151246,ZAMOSTEA,"CĂMINUL CULTURAL ZAMOSTEA",547,"Alegeri Prezidentiale",1,1214,575,506,56,13,565,10,1300,725,188,377
35,SUCEAVA,ZAMOSTEA,151246,CIOMÂRTAN,"ȘCOALA PRIMARĂ CIOMÎRTAN",548,"Alegeri Prezidentiale",1,453,246,205,29,12,245,1,500,254,76,169
35,SUCEAVA,ZAMOSTEA,151246,LUNCA,"ȘCOALA PRIMARĂ LUNCA",549,"Alegeri Prezidentiale",1,208,114,98,16,0,111,3,300,186,32,79
35,SUCEAVA,ZAMOSTEA,151246,NICANI,"ȘCOALA PRIMARĂ NICANI",550,"Alegeri Prezidentiale",1,412,185,162,16,7,181,4,500,315,78,103
35,SUCEAVA,ZAMOSTEA,151246,TĂUTEŞTI,"ȘCOALA PRIMARĂ TĂUTEȘTI",551,"Alegeri Prezidentiale",1,152,93,76,16,1,93,0,200,107,46,47
35,SUCEAVA,ZVORIŞTEA,151344,ZVORIŞTEA,"ŞCOALA GENERALĂ ZVORIŞTEA",552,"Alegeri Prezidentiale",1,758,391,295,43,53,388,3,800,409,180,208
35,SUCEAVA,ZVORIŞTEA,151344,DEALU,"ŞCOALA GENERALĂ BUDA",553,"Alegeri Prezidentiale",1,661,233,209,24,0,228,5,700,467,97,131
35,SUCEAVA,ZVORIŞTEA,151344,BUDA,"ŞCOALA GENERALĂ BUDA",554,"Alegeri Prezidentiale",1,943,370,343,27,0,363,7,1000,630,168,195
35,SUCEAVA,ZVORIŞTEA,151344,STÂNCA,"ŞCOALA PRIMARĂ STÂNCA",555,"Alegeri Prezidentiale",1,482,209,187,22,0,208,1,500,291,89,119
35,SUCEAVA,ZVORIŞTEA,151344,STÂNCUŢA,"ŞCOALA GENERALĂ STÎNCUŢA",556,"Alegeri Prezidentiale",1,137,76,58,18,0,75,1,200,124,33,42
35,SUCEAVA,ZVORIŞTEA,151344,POIANA,"CASA DE PRĂZNUIRE A PAROHIEI ORTODOXE POIANA",557,"Alegeri Prezidentiale",1,462,211,32,179,0,210,1,500,289,112,98
35,SUCEAVA,ZVORIŞTEA,151344,ŞERBĂNEŞTI,"ŞCOALA GENERALĂ ŞERBĂNEŞTI",558,"Alegeri Prezidentiale",1,920,323,291,32,0,320,3,1000,677,190,130
35,SUCEAVA,ZVORIŞTEA,151344,SLOBOZIA,"ŞCOALA PRIMARĂ SLOBOZIA",559,"Alegeri Prezidentiale",1,491,235,209,26,0,229,6,557,322,148,81
36,TELEORMAN,"MUNICIPIUL ALEXANDRIA",151790,ALEXANDRIA,"ȘCOALA AJUTĂTOARE ALEXANDRIA",1,"Alegeri Prezidentiale",1,1518,805,662,49,94,789,16,1665,860,359,430
36,TELEORMAN,"MUNICIPIUL ALEXANDRIA",151790,ALEXANDRIA,"ȘCOALA GIMNAZIALĂ NR.7",2,"Alegeri Prezidentiale",1,1219,540,517,23,0,517,23,1340,800,233,284
36,TELEORMAN,"MUNICIPIUL ALEXANDRIA",151790,ALEXANDRIA,"ȘCOALA GIMNAZIALĂ NR.7",3,"Alegeri Prezidentiale",1,1238,564,521,43,0,553,11,1360,796,256,297
36,TELEORMAN,"MUNICIPIUL ALEXANDRIA",151790,ALEXANDRIA,"ȘCOALA GIMNAZIALĂ NR.7",4,"Alegeri Prezidentiale",1,1363,594,577,17,0,577,17,1495,901,231,346
36,TELEORMAN,"MUNICIPIUL ALEXANDRIA",151790,ALEXANDRIA,"ȘCOALA GIMNAZIALĂ NR.7",5,"Alegeri Prezidentiale",1,1309,642,610,32,0,632,10,1435,793,291,341
36,TELEORMAN,"MUNICIPIUL ALEXANDRIA",151790,ALEXANDRIA,"LICEUL TEHNOLOGIC ”NICOLAE BĂLCESCU”",6,"Alegeri Prezidentiale",1,1445,732,701,31,0,712,20,1585,853,269,443
36,TELEORMAN,"MUNICIPIUL ALEXANDRIA",151790,ALEXANDRIA,"LICEUL TEHNOLOGIC ”NICOLAE BĂLCESCU”",7,"Alegeri Prezidentiale",1,1135,548,511,37,0,534,14,1245,697,247,287
36,TELEORMAN,"MUNICIPIUL ALEXANDRIA",151790,ALEXANDRIA,"COLEGIUL NAȚIONAL ”AL. D. GHICA”",8,"Alegeri Prezidentiale",1,1500,747,722,25,0,733,14,1637,890,357,376
36,TELEORMAN,"MUNICIPIUL ALEXANDRIA",151790,ALEXANDRIA,"COLEGIUL NAȚIONAL ”AL. D. GHICA”",9,"Alegeri Prezidentiale",1,1287,685,648,37,0,672,13,1415,730,322,350
36,TELEORMAN,"MUNICIPIUL ALEXANDRIA",151790,ALEXANDRIA,"LICEUL TEORETIC ”C. NOICA”",10,"Alegeri Prezidentiale",1,1343,704,661,43,0,690,14,1475,771,315,375
36,TELEORMAN,"MUNICIPIUL ALEXANDRIA",151790,ALEXANDRIA,"LICEUL TEORETIC ”C. NOICA”",11,"Alegeri Prezidentiale",1,1018,541,500,40,1,530,11,1115,574,221,309
36,TELEORMAN,"MUNICIPIUL ALEXANDRIA",151790,ALEXANDRIA,"LICEUL PEDAGOGIC ”MIRCEA SCARLAT”",12,"Alegeri Prezidentiale",1,1224,607,575,32,0,593,14,1345,738,258,335
36,TELEORMAN,"MUNICIPIUL ALEXANDRIA",151790,ALEXANDRIA,"ȘCOALA GIMNAZIALĂ NR.5",13,"Alegeri Prezidentiale",1,968,565,477,77,11,551,14,1060,495,242,309
36,TELEORMAN,"MUNICIPIUL ALEXANDRIA",151790,ALEXANDRIA,"GRĂDINIȚA CU PROGRAM PRELUNGIT NR.7",14,"Alegeri Prezidentiale",1,1118,544,519,24,1,536,8,1225,681,243,293
36,TELEORMAN,"MUNICIPIUL ALEXANDRIA",151790,ALEXANDRIA,"GRĂDINIȚA CU PROGRAM PRELUNGIT NR.7",15,"Alegeri Prezidentiale",1,1037,577,538,39,0,567,10,1140,563,239,328
36,TELEORMAN,"MUNICIPIUL ALEXANDRIA",151790,ALEXANDRIA,"SALA POLIVALENTĂ",16,"Alegeri Prezidentiale",1,1483,671,601,63,7,664,7,1630,959,256,408
36,TELEORMAN,"MUNICIPIUL ALEXANDRIA",151790,ALEXANDRIA,"SALA POLIVALENTĂ",17,"Alegeri Prezidentiale",1,1166,594,535,58,1,581,13,1280,686,242,339
36,TELEORMAN,"MUNICIPIUL ALEXANDRIA",151790,ALEXANDRIA,"ȘCOALA GIMNAZIALĂ ”ȘTEFAN CEL MARE”",18,"Alegeri Prezidentiale",1,853,483,378,80,25,475,8,935,452,227,248
36,TELEORMAN,"MUNICIPIUL ALEXANDRIA",151790,ALEXANDRIA,"ȘCOALA GIMNAZIALĂ ”ȘTEFAN CEL MARE”",19,"Alegeri Prezidentiale",1,996,500,470,30,0,488,12,1095,595,229,259
36,TELEORMAN,"MUNICIPIUL ALEXANDRIA",151790,ALEXANDRIA,"ȘCOALA GIMNAZIALĂ ”MIHAI VITEAZUL”",20,"Alegeri Prezidentiale",1,1364,637,574,63,0,623,14,1500,863,321,302
36,TELEORMAN,"MUNICIPIUL ALEXANDRIA",151790,ALEXANDRIA,"ȘCOALA GIMNAZIALĂ ”MIHAI VITEAZUL”",21,"Alegeri Prezidentiale",1,1082,530,494,34,2,518,12,1190,660,240,278
36,TELEORMAN,"MUNICIPIUL ALEXANDRIA",151790,ALEXANDRIA,"ȘCOALA GIMNAZIALĂ NR.6",22,"Alegeri Prezidentiale",1,968,376,353,23,0,367,9,1070,694,136,231
36,TELEORMAN,"MUNICIPIUL ALEXANDRIA",151790,ALEXANDRIA,"ȘCOALA GIMNAZIALĂ NR.6",23,"Alegeri Prezidentiale",1,1059,430,401,28,1,423,7,1160,730,186,237
36,TELEORMAN,"MUNICIPIUL ALEXANDRIA",151790,ALEXANDRIA,"COLEGIUL NAȚIONAL ”AL. I. CUZA”",24,"Alegeri Prezidentiale",1,1078,491,463,26,2,484,7,1185,694,225,259
36,TELEORMAN,"MUNICIPIUL ALEXANDRIA",151790,ALEXANDRIA,"COLEGIUL NAȚIONAL ”AL. I. CUZA”",25,"Alegeri Prezidentiale",1,1076,528,490,37,1,519,9,1180,652,235,284
36,TELEORMAN,"MUNICIPIUL ALEXANDRIA",151790,ALEXANDRIA,"COLEGIUL NAȚIONAL ”AL. I. CUZA”",26,"Alegeri Prezidentiale",1,996,472,436,36,0,470,2,1095,623,220,250
36,TELEORMAN,"MUNICIPIUL ALEXANDRIA",151790,ALEXANDRIA,"ȘCOALA GIMNAZIALĂ ”ALEXANDRU COLFESCU”",27,"Alegeri Prezidentiale",1,1371,631,581,50,0,623,8,1505,874,288,335
36,TELEORMAN,"MUNICIPIUL ALEXANDRIA",151790,ALEXANDRIA,"ȘCOALA GIMNAZIALĂ ”ALEXANDRU COLFESCU”",28,"Alegeri Prezidentiale",1,1416,634,594,39,1,614,20,1555,921,232,382
36,TELEORMAN,"MUNICIPIUL ALEXANDRIA",151790,ALEXANDRIA,"ȘCOALA GIMNAZIALĂ ”ALEXANDRU COLFESCU”",29,"Alegeri Prezidentiale",1,1355,614,574,40,0,596,18,1490,876,264,332
36,TELEORMAN,"MUNICIPIUL ALEXANDRIA",151790,ALEXANDRIA,"ȘCOALA GIMNAZIALĂ ”ALEXANDRU COLFESCU”",30,"Alegeri Prezidentiale",1,1436,676,651,25,0,659,17,1564,888,303,356
36,TELEORMAN,"MUNICIPIUL ALEXANDRIA",151790,ALEXANDRIA,"GRĂDINIȚA CU PROGRAM PRELUNGIT NR.4",31,"Alegeri Prezidentiale",1,1366,509,469,40,0,496,13,1500,991,205,291
36,TELEORMAN,"MUNICIPIUL ALEXANDRIA",151790,ALEXANDRIA,"GRĂDINIȚA CU PROGRAM PRELUNGIT NR.4",32,"Alegeri Prezidentiale",1,1512,548,524,24,0,535,13,1660,1112,207,328
36,TELEORMAN,"MUNICIPIUL ALEXANDRIA",151790,ALEXANDRIA,"ȘCOALA DE ȘOFERI AMATORI",33,"Alegeri Prezidentiale",1,1477,603,583,20,0,588,15,1620,1017,181,407
36,TELEORMAN,"MUNICIPIUL ALEXANDRIA",151790,ALEXANDRIA,"GRĂDINIȚA CU PROGRAM PRELUNGIT NR.8",34,"Alegeri Prezidentiale",1,1235,312,294,18,0,297,15,1355,1043,96,201
36,TELEORMAN,"MUNICIPIUL ROŞIORI DE VEDE",151870,"ROŞIORI DE VEDE","ŞCOALA GIMNAZIALĂ ”ZAHARIA STANCU”",35,"Alegeri Prezidentiale",1,1191,543,500,43,0,530,13,1310,767,240,290
36,TELEORMAN,"MUNICIPIUL ROŞIORI DE VEDE",151870,"ROŞIORI DE VEDE","ŞCOALA GIMNAZIALĂ ”ZAHARIA STANCU”",36,"Alegeri Prezidentiale",1,1104,469,442,26,1,459,10,1210,741,185,274
36,TELEORMAN,"MUNICIPIUL ROŞIORI DE VEDE",151870,"ROŞIORI DE VEDE","ȘCOALA GIMNAZIALĂ ”DAN BERINDEI”",37,"Alegeri Prezidentiale",1,1185,494,398,38,58,483,11,1300,806,173,310
36,TELEORMAN,"MUNICIPIUL ROŞIORI DE VEDE",151870,"ROŞIORI DE VEDE","COLEGIUL TEHNIC ”ANGHEL SALIGNY”",38,"Alegeri Prezidentiale",1,1081,531,492,39,0,518,13,1185,654,231,287
36,TELEORMAN,"MUNICIPIUL ROŞIORI DE VEDE",151870,"ROŞIORI DE VEDE","GRĂDINIŢA CU PROGRAM PRELUNGIT NR.1",39,"Alegeri Prezidentiale",1,1069,446,408,37,1,438,8,1175,729,206,232
36,TELEORMAN,"MUNICIPIUL ROŞIORI DE VEDE",151870,"ROŞIORI DE VEDE","CENTRUL CULTURAL",40,"Alegeri Prezidentiale",1,1092,494,457,35,2,488,6,1200,706,206,282
36,TELEORMAN,"MUNICIPIUL ROŞIORI DE VEDE",151870,"ROŞIORI DE VEDE","ŞCOALA GIMNAZIALĂ ”GALA GALACTION”",41,"Alegeri Prezidentiale",1,1097,453,430,23,0,443,10,1205,752,165,278
36,TELEORMAN,"MUNICIPIUL ROŞIORI DE VEDE",151870,"ROŞIORI DE VEDE","ŞCOALA GIMNAZIALĂ ”GALA GALACTION”",42,"Alegeri Prezidentiale",1,1166,392,360,29,3,386,6,1280,888,176,210
36,TELEORMAN,"MUNICIPIUL ROŞIORI DE VEDE",151870,"ROŞIORI DE VEDE","MUZEUL DE ISTORIE",43,"Alegeri Prezidentiale",1,1079,462,424,38,0,450,12,1185,723,221,229
36,TELEORMAN,"MUNICIPIUL ROŞIORI DE VEDE",151870,"ROŞIORI DE VEDE","CLUBUL COPIILOR",44,"Alegeri Prezidentiale",1,1379,720,601,36,83,708,12,1515,795,304,404
36,TELEORMAN,"MUNICIPIUL ROŞIORI DE VEDE",151870,"ROŞIORI DE VEDE","ŞCOALA GIMNAZIALĂ ”ALEXANDRU DEPĂRĂŢEANU”",45,"Alegeri Prezidentiale",1,1351,511,485,19,7,496,15,1485,974,192,304
36,TELEORMAN,"MUNICIPIUL ROŞIORI DE VEDE",151870,"ROŞIORI DE VEDE","ŞCOALA GIMNAZIALĂ ”ALEXANDRU DEPĂRĂŢEANU”",46,"Alegeri Prezidentiale",1,1398,415,390,25,0,407,8,1535,1120,143,264
36,TELEORMAN,"MUNICIPIUL ROŞIORI DE VEDE",151870,"ROŞIORI DE VEDE","ŞCOALA GIMNAZIALĂ ”ALEXANDRU DEPĂRĂŢEANU”",47,"Alegeri Prezidentiale",1,1086,517,472,43,2,506,11,1190,673,235,271
36,TELEORMAN,"MUNICIPIUL ROŞIORI DE VEDE",151870,"ROŞIORI DE VEDE","ŞCOALA PRIMARĂ NR. 5",48,"Alegeri Prezidentiale",1,1458,591,563,27,1,582,9,1600,1009,246,336
36,TELEORMAN,"MUNICIPIUL ROŞIORI DE VEDE",151870,"ROŞIORI DE VEDE","ŞCOALA PRIMARĂ NR. 5",49,"Alegeri Prezidentiale",1,1101,491,466,25,0,488,3,1210,719,163,325
36,TELEORMAN,"MUNICIPIUL ROŞIORI DE VEDE",151870,"ROŞIORI DE VEDE","LICEUL TEHNOLOGIC ”EMIL RACOVIŢĂ”",50,"Alegeri Prezidentiale",1,1321,588,538,50,0,575,13,1450,862,240,335
36,TELEORMAN,"MUNICIPIUL ROŞIORI DE VEDE",151870,"ROŞIORI DE VEDE","CASA DE CULTURĂ",51,"Alegeri Prezidentiale",2,1081,483,447,36,0,479,4,1185,702,203,276
36,TELEORMAN,"MUNICIPIUL ROŞIORI DE VEDE",151870,"ROŞIORI DE VEDE","COLEGIUL NAŢIONAL ”ANASTASESCU”",52,"Alegeri Prezidentiale",1,1401,627,586,41,0,621,6,1540,913,269,352
36,TELEORMAN,"MUNICIPIUL ROŞIORI DE VEDE",151870,"ROŞIORI DE VEDE","GRĂDINIŢA CU PROGRAM NORMAL NR. 3",53,"Alegeri Prezidentiale",1,1318,561,527,33,1,552,9,1445,884,219,333
36,TELEORMAN,"MUNICIPIUL ROŞIORI DE VEDE",151870,"ROŞIORI DE VEDE","LICEUL TEHNOLOGIC ”VIRGIL MADGEARU”",54,"Alegeri Prezidentiale",1,1209,497,449,48,0,491,6,1325,828,216,275
36,TELEORMAN,"MUNICIPIUL ROŞIORI DE VEDE",151870,"ROŞIORI DE VEDE","GRĂDINIŢA CU PROGRAM NORMAL NR. 6",55,"Alegeri Prezidentiale",1,1084,484,452,32,0,474,10,1190,706,191,283
36,TELEORMAN,"MUNICIPIUL TURNU MĂGURELE",151683,"TURNU MĂGURELE","GRĂDINIŢA CU PROGRAM NORMAL NR.3",56,"Alegeri Prezidentiale",1,1335,594,566,24,4,582,12,1465,871,280,302
36,TELEORMAN,"MUNICIPIUL TURNU MĂGURELE",151683,"TURNU MĂGURELE","ŞCOALA GENERALĂ NR.3",57,"Alegeri Prezidentiale",2,1072,495,464,29,2,489,6,1175,680,232,257
36,TELEORMAN,"MUNICIPIUL TURNU MĂGURELE",151683,"TURNU MĂGURELE","ŞCOALA GIMNAZIALĂ NR.4",58,"Alegeri Prezidentiale",1,1834,670,630,40,0,658,12,2015,1345,332,326
36,TELEORMAN,"MUNICIPIUL TURNU MĂGURELE",151683,"TURNU MĂGURELE","GRĂDINIŢA CU PROGRAM PRELUNGIT NR.7",59,"Alegeri Prezidentiale",1,1768,730,691,36,3,713,17,1940,1210,357,356
36,TELEORMAN,"MUNICIPIUL TURNU MĂGURELE",151683,"TURNU MĂGURELE","LICEUL TEHNOLOGIC ”GENERAL DAVID PRAPORGESCU”",60,"Alegeri Prezidentiale",1,1427,615,585,30,0,609,6,1565,950,277,332
36,TELEORMAN,"MUNICIPIUL TURNU MĂGURELE",151683,"TURNU MĂGURELE","LICEUL TEHNOLOGIC ”GENERAL DAVID PRAPORGESCU”",61,"Alegeri Prezidentiale",1,1097,405,374,31,0,393,12,1205,800,180,213
36,TELEORMAN,"MUNICIPIUL TURNU MĂGURELE",151683,"TURNU MĂGURELE","GRĂDINIŢA CU PROGRAM NORMAL NR.4",62,"Alegeri Prezidentiale",1,871,318,294,24,0,315,3,955,637,129,186
36,TELEORMAN,"MUNICIPIUL TURNU MĂGURELE",151683,"TURNU MĂGURELE","GRĂDINIȚA CU PROGRAM PRELUNGIT NR.1",63,"Alegeri Prezidentiale",1,1173,337,314,20,3,325,12,1290,953,130,195
36,TELEORMAN,"MUNICIPIUL TURNU MĂGURELE",151683,"TURNU MĂGURELE","COLEGIUL NAŢIONAL ”UNIREA”",64,"Alegeri Prezidentiale",1,1122,527,460,32,35,516,11,1230,703,254,262
36,TELEORMAN,"MUNICIPIUL TURNU MĂGURELE",151683,"TURNU MĂGURELE","COLEGIUL NAŢIONAL ”UNIREA”",65,"Alegeri Prezidentiale",1,1212,582,528,48,6,562,20,1330,748,283,279
36,TELEORMAN,"MUNICIPIUL TURNU MĂGURELE",151683,"TURNU MĂGURELE","ŞCOALA GIMNAZIALĂ ”MIRCEA CEL BĂTRÂN”",66,"Alegeri Prezidentiale",1,1151,502,458,38,6,489,13,1265,763,259,230
36,TELEORMAN,"MUNICIPIUL TURNU MĂGURELE",151683,"TURNU MĂGURELE","ŞCOALA GIMNAZIALĂ ”MIRCEA CEL BĂTRÂN”",67,"Alegeri Prezidentiale",1,1572,762,719,40,3,750,12,1725,963,350,400
36,TELEORMAN,"MUNICIPIUL TURNU MĂGURELE",151683,"TURNU MĂGURELE","LICEUL TEHNOLOGIC ”SF. HARALAMBIE”",68,"Alegeri Prezidentiale",1,1683,802,737,63,2,783,19,1850,1048,404,379
36,TELEORMAN,"MUNICIPIUL TURNU MĂGURELE",151683,"TURNU MĂGURELE","LICEUL TEORETIC ”MARIN PREDA”",69,"Alegeri Prezidentiale",1,1189,526,492,30,4,517,9,1305,779,236,281
36,TELEORMAN,"MUNICIPIUL TURNU MĂGURELE",151683,"TURNU MĂGURELE","GRĂDINIŢA CU PROGRAM PRELUNGIT NR.5",70,"Alegeri Prezidentiale",1,1073,499,465,34,0,486,13,1180,681,223,263
36,TELEORMAN,"MUNICIPIUL TURNU MĂGURELE",151683,"TURNU MĂGURELE","GRĂDINIŢA CU PROGRAM NORMAL NR.2",71,"Alegeri Prezidentiale",1,1301,471,454,17,0,464,7,1430,959,185,279
36,TELEORMAN,"MUNICIPIUL TURNU MĂGURELE",151683,"TURNU MĂGURELE","ŞCOALA GIMNAZIALĂ NR.2",72,"Alegeri Prezidentiale",1,1411,522,493,25,4,511,11,1550,1028,205,306
36,TELEORMAN,"MUNICIPIUL TURNU MĂGURELE",151683,"TURNU MĂGURELE","DISPENSARUL UMAN MĂGURELE",73,"Alegeri Prezidentiale",1,1316,606,574,32,0,594,12,1445,839,288,306
36,TELEORMAN,"ORAŞ VIDELE",151905,VIDELE,"ȘCOALA GIMNAZIALĂ CU CLASELE I-VIII, NR. 2",74,"Alegeri Prezidentiale",1,1742,981,889,92,0,962,19,1915,934,404,558
36,TELEORMAN,"ORAŞ VIDELE",151905,VIDELE,"LICEUL TEORETIC",75,"Alegeri Prezidentiale",1,1502,829,726,103,0,808,21,1650,821,308,500
36,TELEORMAN,"ORAŞ VIDELE",151905,VIDELE,"CASA DE CULTURĂ A ORAȘULUI VIDELE",76,"Alegeri Prezidentiale",1,1478,840,728,111,1,824,16,1625,785,370,454
36,TELEORMAN,"ORAŞ VIDELE",151905,VIDELE,"GRĂDINIȚA CU PROGRAM NORMAL NR. 4, FOTĂCHEȘTI",77,"Alegeri Prezidentiale",1,927,437,355,29,53,430,7,1015,578,122,308
36,TELEORMAN,"ORAŞ VIDELE",151905,VIDELE,"GRĂDINIȚA CU PROGRAM NORMAL NR. 3, FURCULEȘTI",78,"Alegeri Prezidentiale",1,1313,718,669,49,0,702,16,1440,722,248,454
36,TELEORMAN,"ORAŞ VIDELE",151905,VIDELE,"GRĂDINIȚA CU PROGRAM NORMAL NR. 5, CARTOJANCA",79,"Alegeri Prezidentiale",1,666,335,307,28,0,327,8,735,400,100,227
36,TELEORMAN,"ORAŞ VIDELE",151905,VIDELE,"GRĂDINIȚA CU PROGRAM NORMAL NR. 2, TĂMĂȘEȘTI",80,"Alegeri Prezidentiale",1,722,370,343,27,0,362,8,795,425,136,226
36,TELEORMAN,"ORAŞ VIDELE",151905,VIDELE,"GRĂDINIȚA CU PROGRAM NORMAL NR. 6, PARISEȘTI",81,"Alegeri Prezidentiale",1,469,260,227,33,0,253,7,520,260,108,145
36,TELEORMAN,"ORAŞ VIDELE",151905,COŞOAIA,"GRĂDINIȚA CU PROGRAM NORMAL NR. 7, COȘOAIA",82,"Alegeri Prezidentiale",1,271,149,110,39,0,149,0,300,151,60,89
36,TELEORMAN,"ORAŞ ZIMNICEA",151978,ZIMNICEA,"ȘCOALA PRIMARĂ NR.4",83,"Alegeri Prezidentiale",1,1366,634,620,12,2,629,5,1500,866,238,391
36,TELEORMAN,"ORAŞ ZIMNICEA",151978,ZIMNICEA,"ȘCOALA PRIMARĂ NR.4",84,"Alegeri Prezidentiale",1,1466,730,697,31,2,722,8,1610,880,262,460
36,TELEORMAN,"ORAŞ ZIMNICEA",151978,ZIMNICEA,"S.C. URBANA SERV S.R.L.",85,"Alegeri Prezidentiale",1,1437,721,658,24,39,710,11,1580,859,232,478
36,TELEORMAN,"ORAŞ ZIMNICEA",151978,ZIMNICEA,"ȘCOALA GIMNAZIALĂ NR.3",86,"Alegeri Prezidentiale",1,1531,595,556,39,0,582,13,1680,1085,262,320
36,TELEORMAN,"ORAŞ ZIMNICEA",151978,ZIMNICEA,"ȘCOALA GIMNAZIALĂ ”MIRON RADU PARASCHIVESCU”",87,"Alegeri Prezidentiale",1,1497,591,562,29,0,582,9,1645,1054,303,279
36,TELEORMAN,"ORAŞ ZIMNICEA",151978,ZIMNICEA,"GRĂDINIȚA CU PROGRAM PRELUNGIT NR.5, NIVEL ȘCOLARIZARE PRE PP",88,"Alegeri Prezidentiale",1,1315,552,503,37,12,542,10,1437,885,263,279
36,TELEORMAN,"ORAŞ ZIMNICEA",151978,ZIMNICEA,"GRĂDINIȚA CU PROGRAM PRELUNGIT NR.5, NIVEL ȘCOLARIZARE PRE PP",89,"Alegeri Prezidentiale",1,1159,590,562,25,3,585,5,1270,680,263,322
36,TELEORMAN,"ORAŞ ZIMNICEA",151978,ZIMNICEA,"ȘCOALA GIMNAZIALĂ NR.2",90,"Alegeri Prezidentiale",1,1286,623,592,26,5,616,7,1410,784,247,369
36,TELEORMAN,"ORAŞ ZIMNICEA",151978,ZIMNICEA,"ȘCOALA GIMNAZIALĂ NR.2",91,"Alegeri Prezidentiale",1,1290,659,633,20,6,654,5,1415,756,273,381
36,TELEORMAN,BALACI,151996,BALACI,"CĂMINUL CULTURAL BALCI",92,"Alegeri Prezidentiale",1,780,470,317,113,40,459,11,860,390,151,308
36,TELEORMAN,BALACI,151996,TECUCI,"CĂMINUL CULTURAL TECUCI",93,"Alegeri Prezidentiale",2,536,384,254,118,12,382,2,590,206,108,274
36,TELEORMAN,BĂBĂIŢA,152038,BĂBĂIŢA,"ŞCOALA GIMNAZIALĂ BĂBĂIŢA",94,"Alegeri Prezidentiale",1,1502,728,668,38,22,725,3,1650,922,202,523
36,TELEORMAN,BĂBĂIŢA,152038,BĂBĂIŢA,"ŞCOALA GIMNAZIALĂ MERIŞANI",95,"Alegeri Prezidentiale",1,867,577,482,71,24,572,5,950,373,74,498
36,TELEORMAN,BECIU,155083,BECIU,"GRĂDINIŢA DE COPII CU PROGRAM NORMAL NR. 1 BECIU",96,"Alegeri Prezidentiale",1,796,481,410,71,0,475,6,880,399,193,282
36,TELEORMAN,BECIU,155083,SMÂRDAN,"GRĂDINIŢA DE COPII CU PROGRAM NORMAL NR.2 SMÂRDAN",97,"Alegeri Prezidentiale",1,447,273,233,40,0,271,2,495,222,127,144
36,TELEORMAN,BEUCA,155092,BEUCA,"GRĂDINIȚA CU PROGRAM NORMAL",98,"Alegeri Prezidentiale",1,891,667,492,82,93,659,8,980,313,235,424
36,TELEORMAN,BEUCA,155092,PLOPI,"CĂMINUL CULTURAL PLOPI",99,"Alegeri Prezidentiale",1,155,114,82,23,9,113,1,175,61,52,61
36,TELEORMAN,BLEJEŞTI,152083,BLEJEŞTI,"ŞCOALA GIMNAZIALA NR.1 BLEJEŞTI",100,"Alegeri Prezidentiale",1,998,651,546,103,2,637,14,1095,444,155,482
36,TELEORMAN,BLEJEŞTI,152083,BLEJEŞTI,"GRĂDINIŢA CU PROGRAM NORMAL NR.2 BLEJEŞTI",101,"Alegeri Prezidentiale",1,853,555,485,65,5,548,7,935,380,90,458
36,TELEORMAN,BLEJEŞTI,152083,BACIU,"ŞCOALA GIMNAZIALĂ NR.2 BACIU COMUNA BLEJEŞTI",102,"Alegeri Prezidentiale",1,869,506,428,74,4,506,0,955,449,116,390
36,TELEORMAN,BLEJEŞTI,152083,SERICU,"GRĂDINIŢA DE COPII CU PROGRAM NORMAL SERICU COMUNA BLEJEŞTI",103,"Alegeri Prezidentiale",1,332,259,225,34,0,254,5,370,111,70,184
36,TELEORMAN,BOGDANA,152127,BOGDANA,"ŞCOALA GIMNAZIALĂ BOGDANA",104,"Alegeri Prezidentiale",1,720,507,382,99,26,502,5,795,288,100,402
36,TELEORMAN,BOGDANA,152127,ULMENI,"GRĂDINIŢA DE COPII CU PROGRAM NORMAL NR.2 ULMENI",105,"Alegeri Prezidentiale",1,536,378,302,57,19,363,15,590,212,121,242
36,TELEORMAN,BOGDANA,152127,URLUIU,"DISPENSAR UMAN (HOL)",106,"Alegeri Prezidentiale",1,498,480,296,143,41,477,3,552,72,105,372
36,TELEORMAN,BOTOROAGA,152172,BOTOROAGA,"LICEUL TEHNOLOGIC ”ANDREI ŞAGUNA”",107,"Alegeri Prezidentiale",1,1034,710,514,157,39,701,9,1135,425,344,357
36,TELEORMAN,BOTOROAGA,152172,CĂLUGĂRU,"ŞCOALA GIMNAZIALĂ NR. 1 CĂLUGĂRU",108,"Alegeri Prezidentiale",1,674,396,327,37,32,392,4,745,349,192,200
36,TELEORMAN,BOTOROAGA,152172,TÂRNAVA,"GRĂDINIŢA CU PROGRAM NORMAL NR.2",109,"Alegeri Prezidentiale",1,1003,719,529,148,42,710,9,1100,381,341,369
36,TELEORMAN,BOTOROAGA,152172,TUNARI,"ŞCOALA CU CLASELE I-IV TUNARI",110,"Alegeri Prezidentiale",3,150,99,75,24,0,99,0,165,66,50,49
36,TELEORMAN,BOTOROAGA,152172,"VALEA CIREŞULUI","ŞCOALA GIMNAZIALĂ NR. 2",111,"Alegeri Prezidentiale",1,1157,772,597,115,60,766,6,1270,498,512,254
36,TELEORMAN,BRAGADIRU,152234,BRAGADIRU,"PRIMĂRIA VECHE",112,"Alegeri Prezidentiale",1,1041,546,451,81,14,542,4,1145,599,270,272
36,TELEORMAN,BRAGADIRU,152234,BRAGADIRU,"CĂMINUL CULTURAL",113,"Alegeri Prezidentiale",1,966,505,419,75,11,505,0,1060,555,284,221
36,TELEORMAN,BRAGADIRU,152234,BRAGADIRU,"GRĂDINIŢA CU PROGRAM NORMAL BRAGADIRU",114,"Alegeri Prezidentiale",1,1111,527,458,55,14,524,3,1220,693,266,258
36,TELEORMAN,BRÂNCENI,152252,BRÂNCENI,"ȘCOALA GIMNAZIALĂ BRÎNCENI",115,"Alegeri Prezidentiale",1,656,438,365,47,26,432,6,725,287,155,277
36,TELEORMAN,BRÂNCENI,152252,BRÂNCENI,"CLĂDIRE ADMINISTRATIVĂ BRÎNCENI",116,"Alegeri Prezidentiale",1,1605,898,824,46,28,882,16,1765,867,332,550
36,TELEORMAN,BUJORENI,152270,BUJORENI,"CĂMINUL CULTURAL BUJORENI",117,"Alegeri Prezidentiale",1,422,326,194,131,1,323,3,465,139,119,204
36,TELEORMAN,BUJORENI,152270,PRUNARU,"ŞCOALA CU CLASELE I-IV PRUNARU",118,"Alegeri Prezidentiale",1,344,195,128,63,4,189,6,380,185,51,138
36,TELEORMAN,BUJORU,152314,BUJORU,"GRĂDINIȚA CU PROGRAM NORMAL",119,"Alegeri Prezidentiale",1,754,377,324,53,0,374,3,830,453,212,162
36,TELEORMAN,BUJORU,152314,BUJORU,"CĂMINUL CULTURAL",120,"Alegeri Prezidentiale",1,705,402,336,64,2,395,7,780,378,228,167
36,TELEORMAN,BUZESCU,152332,BUZESCU,"CĂMIN CULTURAL",121,"Alegeri Prezidentiale",1,1143,610,506,64,40,596,14,1255,645,390,206
36,TELEORMAN,BUZESCU,152332,BUZESCU,"GRĂDINIŢA CU PROGRAM NORMAL",122,"Alegeri Prezidentiale",1,1169,495,424,50,21,490,5,1285,790,332,158
36,TELEORMAN,BUZESCU,152332,BUZESCU,"ŞCOALA GIMNAZIALĂ BUZESCU",123,"Alegeri Prezidentiale",1,1134,648,508,96,44,644,4,1245,597,360,284
36,TELEORMAN,CĂLINEŞTI,152350,CĂLINEŞTI,"ȘCOALA GIMNAZIALĂ CĂLINEȘTI",124,"Alegeri Prezidentiale",1,1147,676,523,73,80,672,4,1260,584,140,532
36,TELEORMAN,CĂLINEŞTI,152350,LICURICIU,"ȘCOALA GIMNAZIALĂ LICURICIU",125,"Alegeri Prezidentiale",1,387,231,152,57,22,231,0,430,199,58,173
36,TELEORMAN,CĂLINEŞTI,152350,COPĂCEANCA,"ȘCOALA GIMNAZIALĂ COPĂCEANCA",126,"Alegeri Prezidentiale",1,715,422,291,87,44,419,3,790,368,128,291
36,TELEORMAN,CĂLINEŞTI,152350,ANTONEŞTI,"ȘCOALA GIMNAZIALĂ ANTONEŞTI",127,"Alegeri Prezidentiale",1,236,148,108,29,11,145,3,260,112,38,107
36,TELEORMAN,CĂLMĂŢUIU,152412,CĂLMĂŢUIU,"ŞCOALA GIMNAZIALĂ CĂLMĂŢUIU (FOST LOCAL AL ȘCOLII CU CLASELE I-IV)",128,"Alegeri Prezidentiale",1,542,355,306,49,0,352,3,600,245,120,232
36,TELEORMAN,CĂLMĂŢUIU,152412,CARAVANEŢI,"ŞCOLALA GIMNAZIALĂ CĂLMĂȚUIU (FOST LOCAL AL ȘCOLII CU CLASELE I-IV)",129,"Alegeri Prezidentiale",1,203,131,100,31,0,130,1,225,94,29,101
36,TELEORMAN,CĂLMĂŢUIU,152412,BUJORU,"ŞCOALA GIMNAZIALĂ CĂLMĂȚUIU ( FOST LOCAL AL ȘCOLII CU CLASELE I-IV )",130,"Alegeri Prezidentiale",1,212,171,130,41,0,166,5,235,64,58,108
36,TELEORMAN,CĂLMĂŢUIU,152412,"NICOLAE BĂLCESCU","ŞCOALA GIMNAZIALĂ CĂLMĂȚUIU ( FOST LOCAL AL ȘCOLII NICOLAE BĂLCESCU )",131,"Alegeri Prezidentiale",1,521,334,268,66,0,328,6,575,241,116,212
36,TELEORMAN,"CĂLMĂŢUIU DE SUS",152467,"CĂLMĂŢUIU DE SUS","GRĂDINIȚA DE COPII CU PROGRAM NORMAL NR.1 CĂLMĂȚUIU DE SUS",132,"Alegeri Prezidentiale",1,640,322,259,47,16,318,4,705,383,104,214
36,TELEORMAN,"CĂLMĂŢUIU DE SUS",152467,IONAŞCU,"GRĂDINIȚA DE COPII CU PROGRAM NORMAL NR. 3 IONAȘCU",133,"Alegeri Prezidentiale",1,283,130,103,23,4,129,1,315,185,53,76
36,TELEORMAN,"CĂLMĂŢUIU DE SUS",152467,BĂCĂLEŞTI,"CLĂDIRE PRIMĂRIE -FOST SEDIU CAP BĂCĂLEȘTI",134,"Alegeri Prezidentiale",1,764,432,330,59,43,425,7,845,413,119,306
36,TELEORMAN,CERVENIA,152500,CERVENIA,"ȘCOALA GIMNAZIALĂ CERVENIA",135,"Alegeri Prezidentiale",1,1311,576,488,78,10,570,6,1440,864,146,424
36,TELEORMAN,CERVENIA,152500,CERVENIA,"ȘCOALA GIMNAZIALĂ CERVENIA",136,"Alegeri Prezidentiale",1,1113,499,448,48,3,488,11,1220,721,182,306
36,TELEORMAN,CIOLĂNEŞTI,152528,"CIOLĂNEŞTII DIN DEAL","ŞCOALA GIMNAZIALĂ NR. 1 CIOLĂNEŞTII DIN DEAL",137,"Alegeri Prezidentiale",1,785,360,297,63,0,359,1,865,505,121,238
36,TELEORMAN,CIOLĂNEŞTI,152528,"CIOLĂNEŞTII DIN DEAL","ŞCOALA GIMNAZIALĂ NR. 2 CIOLĂNEŞTII DIN DEAL",138,"Alegeri Prezidentiale",1,498,240,203,37,0,239,1,550,310,74,165
36,TELEORMAN,CIOLĂNEŞTI,152528,"CIOLĂNEŞTII DIN VALE","ŞCOALA GENERALA NR. 3 CIOLĂNEŞTII DIN VALE",139,"Alegeri Prezidentiale",1,458,221,182,39,0,219,2,505,284,50,169
36,TELEORMAN,CIOLĂNEŞTI,152528,BALDOVINEŞTI,"ŞCOALA BALDOVINEŞTI",140,"Alegeri Prezidentiale",1,344,167,147,20,0,167,0,380,213,58,109
36,TELEORMAN,CIUPERCENI,151709,CIUPERCENI,"ȘCOALA GIMNAZIALĂ CIUPERCENI",141,"Alegeri Prezidentiale",1,810,501,388,90,23,500,1,895,394,192,308
36,TELEORMAN,CIUPERCENI,151709,POIANA,"ȘCOALA GENERALĂ POIANA",142,"Alegeri Prezidentiale",1,495,424,311,88,25,414,10,545,121,223,191
36,TELEORMAN,CONŢEŞTI,152564,CONŢEŞTI,"GRĂDINIŢA CU PROGRAM NORMAL CONŢEŞTI",143,"Alegeri Prezidentiale",1,1398,715,614,46,55,706,9,1535,820,104,602
36,TELEORMAN,CONŢEŞTI,152564,CONŢEŞTI,"GRĂDINIŢA CU PROGRAM NORMAL CONŢEŞTI",144,"Alegeri Prezidentiale",1,1263,763,607,90,66,758,5,1385,622,140,618
36,TELEORMAN,COSMEŞTI,152582,COSMEŞTI,"ȘCOALA GIMNAZIALĂ NR.2 COSMEȘTI",145,"Alegeri Prezidentiale",1,846,555,470,53,32,548,7,930,375,356,192
36,TELEORMAN,COSMEŞTI,152582,CIUPERCENI,"ŞCOLA GIMNAZIALĂ NR. 1 CIUPERCENI",146,"Alegeri Prezidentiale",1,1168,599,510,65,24,586,13,1280,681,363,223
36,TELEORMAN,CRÂNGENI,152617,CRÂNGENI,"CĂMINULUI CULTURAL CRINGENI",147,"Alegeri Prezidentiale",1,1182,585,480,71,34,577,8,1300,715,203,374
36,TELEORMAN,CRÂNGENI,152617,"BALTA SĂRATĂ","CLĂDIRE PRIMĂRIE -FOSTA ŞCOALĂ CU CLASELE I-VIII BALTA SĂRATĂ",148,"Alegeri Prezidentiale",1,599,331,250,57,24,328,3,660,329,90,238
36,TELEORMAN,CRÂNGENI,152617,DOROBANŢU,"CLĂDIRE PRIMĂRIE FOSTA ŞCOALĂ CU CLASELE I-IV DOROBANŢU",149,"Alegeri Prezidentiale",1,213,122,87,35,0,119,3,235,113,33,86
36,TELEORMAN,CRÂNGENI,152617,STEJARU,"CLĂDIRE PRIMĂRIE FOSTA ŞCOALĂ CU CLASELE I-IV STEJARU",150,"Alegeri Prezidentiale",2,155,106,78,28,0,105,1,175,69,41,64
36,TELEORMAN,CRÂNGU,152662,CRÂNGU,"CĂMINUL CULTURAL DIN SATUL CRÂNGU",151,"Alegeri Prezidentiale",1,830,601,365,207,29,596,5,910,309,267,329
36,TELEORMAN,CRÂNGU,152662,SECARA,"SEDIUL ADMINISTRATIV DIN SATUL SECARA",152,"Alegeri Prezidentiale",1,280,245,152,63,30,240,5,303,58,63,177
36,TELEORMAN,CREVENICU,151932,CREVENICU,"GRĂDINIŢA CU PROGRAM NORMAL NR. 1 CREVENICU",153,"Alegeri Prezidentiale",1,703,451,363,60,28,447,4,775,324,152,295
36,TELEORMAN,CREVENICU,151932,RĂDULEŞTI,"CĂMINUL CULTURAL RĂDULEŞTI",154,"Alegeri Prezidentiale",1,425,234,200,34,0,232,2,470,236,64,168
36,TELEORMAN,DIDEŞTI,152724,DIDEŞTI,"CĂMINUL CULTURAL DIDEȘTI",155,"Alegeri Prezidentiale",1,941,500,433,67,0,494,6,1035,535,254,240
36,TELEORMAN,DOBROTEŞTI,152760,DOBROTEŞTI,"ȘCOALA GIMNAZIALĂ NR.1",156,"Alegeri Prezidentiale",1,1291,580,497,83,0,570,10,1420,840,220,350
36,TELEORMAN,DOBROTEŞTI,152760,DOBROTEŞTI,"CENTRUL DE ÎNGRIJIRE DE ZI PENTRU COPIII ÎN SITUAȚII DE RISC ÎN COMUNA DOBROTEȘTI",157,"Alegeri Prezidentiale",1,1308,471,434,37,0,465,6,1435,964,232,233
36,TELEORMAN,DOBROTEŞTI,152760,MERIŞANI,"ȘCOALA GIMNAZIALĂ NR. 2",158,"Alegeri Prezidentiale",2,942,488,370,74,44,478,10,1035,547,156,322
36,TELEORMAN,DRACEA,155109,DRACEA,"GRĂDINIŢA CU PROGRAM NORMAL DRACEA",159,"Alegeri Prezidentiale",1,1028,658,435,186,37,651,7,1130,472,453,198
36,TELEORMAN,DRACEA,155109,ZLATA,"ŞCOALA GENERALĂ ZLATA",160,"Alegeri Prezidentiale",1,60,69,33,36,0,69,0,100,31,41,28
36,TELEORMAN,DRACEA,155109,FLORICA,"CĂMINUL CULTURAL FLORICA",161,"Alegeri Prezidentiale",1,173,171,97,63,11,170,1,195,24,94,76
36,TELEORMAN,DRĂCŞENEI,152797,DRĂCŞENEI,"ŞCOALA CU CLASELE I-IV DRĂCŞENEI",162,"Alegeri Prezidentiale",1,582,363,294,34,35,356,7,645,282,122,234
36,TELEORMAN,DRĂCŞENEI,152797,DRĂCŞANI,"ŞCOALA GIMNAZIALĂ DRĂCŞANI",163,"Alegeri Prezidentiale",1,317,204,155,26,23,201,3,350,146,34,167
36,TELEORMAN,DRĂCŞENEI,152797,ODOBEASCA,"ŞCOALA CU CLASELE I-IV ODOBEASCA",164,"Alegeri Prezidentiale",1,420,239,201,28,10,237,2,465,226,79,158
36,TELEORMAN,"DRĂGĂNEŞTI DE VEDE",152868,"DRĂGĂNEŞTI DE VEDE","ŞCOALA GİMNAZİALĂ DRĂGĂNEŞTİ DE VEDE",165,"Alegeri Prezidentiale",1,1154,598,508,56,34,590,8,1265,667,260,330
36,TELEORMAN,"DRĂGĂNEŞTI DE VEDE",152868,VĂCĂREŞTI,"GRĂDİNİŢA CU PROGRAM NORMAL NR.2",166,"Alegeri Prezidentiale",1,534,252,225,15,12,246,6,590,338,107,139
36,TELEORMAN,DRĂGĂNEŞTI-VLAŞCA,152902,DRĂGĂNEŞTI-VLAŞCA,"LICEUL TEHNOLOGIC DRĂGĂNEŞTI VLAŞCA",167,"Alegeri Prezidentiale",1,1670,930,826,104,0,925,5,1835,905,605,320
36,TELEORMAN,DRĂGĂNEŞTI-VLAŞCA,152902,DRĂGĂNEŞTI-VLAŞCA,"ŞCOALA GIMNAZIALĂ DRĂGĂNEŞTI VLAŞCA",168,"Alegeri Prezidentiale",1,1052,623,420,200,3,619,4,1155,532,345,274
36,TELEORMAN,DRĂGĂNEŞTI-VLAŞCA,152902,VĂCENI,"ȘCOALA CU CLASELE I - IV VĂCENI",169,"Alegeri Prezidentiale",1,202,131,84,47,0,131,0,225,94,61,70
36,TELEORMAN,DRĂGĂNEŞTI-VLAŞCA,152902,COMOARA,"ȘCOALA CU CLASELE I-IV COMOARA",170,"Alegeri Prezidentiale",1,351,239,184,55,0,232,7,390,151,112,120
36,TELEORMAN,FÂNTÂNELE,155118,FÂNTÂNELE,"ŞCOALA GIMNAZIALĂ FÂNTÂNELE",171,"Alegeri Prezidentiale",1,1301,898,722,132,44,889,9,1430,532,344,545
36,TELEORMAN,FRĂSINET,155127,FRĂSINET,"LOCALUL ŞCOLII GIMNAZIALE FRĂSINET",172,"Alegeri Prezidentiale",1,1467,611,529,82,0,605,6,1610,999,269,336
36,TELEORMAN,FRĂSINET,155127,CLĂNIŢA,"LOCALUL GRĂDINIŢEI CLĂNIŢA",173,"Alegeri Prezidentiale",1,546,279,245,34,0,277,2,605,326,111,166
36,TELEORMAN,FRUMOASA,152993,FRUMOASA,"CĂMINUL CULTURAL FRUMOASA",174,"Alegeri Prezidentiale",1,766,434,350,77,7,428,6,845,411,135,293
36,TELEORMAN,FRUMOASA,152993,FRUMOASA,"GRĂDINIȚA CU PROGRAM NORMAL NR. 2 FRUMOASA",175,"Alegeri Prezidentiale",1,465,272,229,40,3,268,4,515,243,62,206
36,TELEORMAN,FRUMOASA,152993,PĂULEASCA,"GRĂDINIȚA CU PROGRAM NORMAL NR. 2 PĂULEASCA",176,"Alegeri Prezidentiale",1,408,223,172,51,0,220,3,450,227,90,130
36,TELEORMAN,FURCULEŞTI,152948,FURCULEŞTI,"ŞCOALA GIMNAZIALĂ FURCULEŞTI",177,"Alegeri Prezidentiale",1,1405,654,506,130,18,643,11,1545,891,327,316
36,TELEORMAN,FURCULEŞTI,152948,SPĂTĂREI,"ŞCOALA CU CLASELE I - VIII SPĂTĂREI",178,"Alegeri Prezidentiale",1,804,473,371,102,0,468,5,885,412,222,246
36,TELEORMAN,FURCULEŞTI,152948,VOIEVODA,"GRĂDINIŢA CU PROGRAM NORMAL VOIEVODA",179,"Alegeri Prezidentiale",1,518,286,239,47,0,284,2,570,284,155,129
36,TELEORMAN,GĂLĂTENI,153026,GĂLĂTENI,"ŞCOALA PRIMARĂ GĂLĂTENI",180,"Alegeri Prezidentiale",1,1211,751,588,121,42,741,10,1330,579,172,569
36,TELEORMAN,GĂLĂTENI,153026,BÂSCOVENI,"ŞCOALA GIMNAZIALĂ GĂLĂTENI",181,"Alegeri Prezidentiale",1,821,490,367,82,41,483,7,905,415,138,345
36,TELEORMAN,GRATIA,153062,GRATIA,"GRĂDINIȚA CU PROGRAM NORMAL NR. 1",182,"Alegeri Prezidentiale",1,946,615,521,85,9,608,7,1040,425,116,492
36,TELEORMAN,GRATIA,153062,CIURARI-DEAL,"ȘCOALA GIMNAZIALĂ GRATIA",183,"Alegeri Prezidentiale",1,1140,725,603,117,5,717,8,1250,525,106,611
36,TELEORMAN,ISLAZ,151736,ISLAZ,"CĂMINUL CULTURAL",184,"Alegeri Prezidentiale",1,1167,662,551,90,21,656,6,1280,618,283,373
36,TELEORMAN,ISLAZ,151736,ISLAZ,"GRĂDINIȚA CU PROGRAM NORMAL NR. 2",185,"Alegeri Prezidentiale",1,1554,796,709,68,19,777,19,1705,909,338,439
36,TELEORMAN,ISLAZ,151736,ISLAZ,"ŞCOALA GIMNAZIALĂ NR. 1 ISLAZ",186,"Alegeri Prezidentiale",1,732,395,338,49,8,387,8,810,415,140,247
36,TELEORMAN,ISLAZ,151736,MOLDOVENI,"ŞCOALA GENERALĂ MOLDOVENI",187,"Alegeri Prezidentiale",1,756,476,395,67,14,473,3,835,359,178,295
36,TELEORMAN,IZVOARELE,153106,IZVOARELE,"GRĂDINIŢA DE COPII IZVOARELE",188,"Alegeri Prezidentiale",1,1117,589,528,49,12,584,5,1225,636,248,336
36,TELEORMAN,IZVOARELE,153106,IZVOARELE,"GRĂDINIŢA DE COPII IZVOARELE",189,"Alegeri Prezidentiale",1,931,526,472,47,7,507,19,1020,494,239,268
36,TELEORMAN,LISA,153124,LISA,"PRIMĂRIA LISA",190,"Alegeri Prezidentiale",1,1259,615,493,67,55,611,4,1380,765,385,226
36,TELEORMAN,LISA,153124,VÂNĂTORI,"GRĂDINIŢA VÂNĂTORI",191,"Alegeri Prezidentiale",1,523,288,230,38,20,284,4,580,292,134,150
36,TELEORMAN,LIŢA,151763,LIŢA,"ȘCOALA GIMNAZIALĂ LIȚA",192,"Alegeri Prezidentiale",1,1073,550,483,67,0,544,6,1181,631,230,314
36,TELEORMAN,LIŢA,151763,LIŢA,"GRĂDINIȚA CU PROGRAM NORMAL NR. 2",193,"Alegeri Prezidentiale",1,1097,524,477,47,0,516,8,1205,681,189,327
36,TELEORMAN,LUNCA,153151,LUNCA,"ȘCOALA GIMNAZIALĂ NUMĂRUL 1 LUNCA",194,"Alegeri Prezidentiale",1,922,468,388,78,2,464,4,1010,542,244,220
36,TELEORMAN,LUNCA,153151,LUNCA,"GRĂDINIȚA CU PROGRAM NORMAL NUMĂRUL 1 LUNCA",195,"Alegeri Prezidentiale",1,569,345,286,59,0,341,4,630,285,150,191
36,TELEORMAN,LUNCA,153151,PRUNDU,"ȘCOALA GIMNAZIALĂ NUMĂRUL 2 PRUNDU",196,"Alegeri Prezidentiale",1,1171,371,359,12,0,365,6,1285,914,79,286
36,TELEORMAN,MAVRODIN,153204,MAVRODIN,"ŞCOALA GIMNAZIALĂ MAVRODIN",197,"Alegeri Prezidentiale",1,1060,460,414,46,0,453,7,1165,705,149,304
36,TELEORMAN,MAVRODIN,153204,MAVRODIN,"ŞCOALA GIMNAZIALĂ MAVRODIN",198,"Alegeri Prezidentiale",1,942,456,399,55,2,454,2,1035,579,161,293
36,TELEORMAN,MĂGURA,153240,MĂGURA,"CĂMINUL CULTURAL MĂGURA",199,"Alegeri Prezidentiale",1,1430,919,706,141,72,903,16,1570,651,249,654
36,TELEORMAN,MĂGURA,153240,GURUIENI,"CĂMINUL CULTURAL GURUIENI",200,"Alegeri Prezidentiale",1,772,554,444,69,41,545,9,850,296,120,425
36,TELEORMAN,MĂLDĂENI,153277,MĂLDĂENI,"SCOALA GIMNAZIALA NR.1",201,"Alegeri Prezidentiale",1,1176,639,564,55,20,635,4,1290,651,217,418
36,TELEORMAN,MĂLDĂENI,153277,MĂLDĂENI,"GRADINITA CU PROGRAM NORMAL NR.1",202,"Alegeri Prezidentiale",1,958,499,457,32,10,490,9,1050,551,210,280
36,TELEORMAN,MĂLDĂENI,153277,MĂLDĂENI,"GRADINITA CU PROGRAM NORMAL NR.2",203,"Alegeri Prezidentiale",1,1292,702,622,58,22,693,9,1420,718,293,400
36,TELEORMAN,MÂRZĂNEŞTI,153339,CERNETU,"ŞCOALA GIMNAZIALĂ NR. 2, CERNETU",204,"Alegeri Prezidentiale",1,1080,697,557,140,0,686,11,1185,488,327,359
36,TELEORMAN,MÂRZĂNEŞTI,153339,"VALEA PĂRULUI","GRĂDINIŢA CU PROGRAM NORMAL NR.3 VALEA PĂRULUI",205,"Alegeri Prezidentiale",1,652,438,325,105,8,429,9,721,283,253,176
36,TELEORMAN,MÂRZĂNEŞTI,153339,MÂRZĂNEŞTI,"ŞCOALA GIMNAZIALĂ NR.1 MÎRZĂNEŞTI",206,"Alegeri Prezidentiale",1,496,313,256,57,0,309,4,550,237,181,128
36,TELEORMAN,MÂRZĂNEŞTI,153339,TELEORMANU,"ŞCOALA GIMNAZIALĂ TELEORMANU",207,"Alegeri Prezidentiale",1,724,438,330,95,13,434,4,800,362,173,261
36,TELEORMAN,MERENI,153295,"MERENII DE JOS","SCOALA GIMNAZIALĂ CU CLASELE I-VIII MERENII DE JOS",208,"Alegeri Prezidentiale",1,1288,834,706,128,0,828,6,1415,581,618,210
36,TELEORMAN,MERENI,153295,"MERENII DE SUS","SCOALA GENERALĂ CU CLASELE I-VIII",209,"Alegeri Prezidentiale",1,810,485,415,70,0,483,2,895,410,276,207
36,TELEORMAN,MOŞTENI,153384,MOŞTENI,"ȘCOALA GIMNAZIALĂ MOȘTENI",210,"Alegeri Prezidentiale",1,623,428,312,64,52,426,2,690,262,352,74
36,TELEORMAN,MOŞTENI,153384,MOŞTENI,"ŞCOALA GIMNAZIALĂ MOŞTENI",211,"Alegeri Prezidentiale",1,530,419,310,62,47,417,2,585,166,351,66
36,TELEORMAN,NANOV,151816,NANOV,"ȘCOALA GIMNAZIALĂ NANOV",212,"Alegeri Prezidentiale",1,1672,942,820,122,0,921,21,1835,893,383,538
36,TELEORMAN,NANOV,151816,NANOV,"GRĂDINIŢA CU PROGRAM NORMAL NR. 2 NANOV",213,"Alegeri Prezidentiale",1,1367,720,650,70,0,707,13,1500,780,309,398
36,TELEORMAN,NĂSTURELU,153400,NĂSTURELU,"ȘCOALA GIMNAZIALĂ NĂSTURELU",214,"Alegeri Prezidentiale",1,1259,670,630,40,0,657,13,1380,710,418,239
36,TELEORMAN,NĂSTURELU,153400,ZIMNICELE,"ȘCOALA GIMNAZIALĂ ZIMNICELE",215,"Alegeri Prezidentiale",1,794,365,337,28,0,362,3,875,510,129,233
36,TELEORMAN,NECŞEŞTI,153437,NECŞEŞTI,"LOCALUL ŞCOLII CU CLASELE I-IV NECŞEŞTI",216,"Alegeri Prezidentiale",1,452,313,230,81,2,313,0,500,187,91,222
36,TELEORMAN,NECŞEŞTI,153437,GÂRDEŞTI,"LOCALUL ŞCOLII CU CLASELE I-VIII GÂRDEŞTI",217,"Alegeri Prezidentiale",1,427,243,188,54,1,238,5,470,227,65,173
36,TELEORMAN,NENCIULEŞTI,154996,NENCIULEŞTI,"ȘCOALA GIMNAZIALĂ NENCIULEȘTI",218,"Alegeri Prezidentiale",1,700,315,240,75,0,312,3,770,455,130,182
36,TELEORMAN,NENCIULEŞTI,154996,NENCIULEŞTI,"GRĂDINIȚA CU PROGRAM NORMAL NR. 1 NENCIULEȘTI",219,"Alegeri Prezidentiale",1,780,371,310,61,0,368,3,860,489,121,247
36,TELEORMAN,NENCIULEŞTI,154996,"PĂRU ROTUND","GRĂDINIȚA CU PROGRAM NORMAL NR. 2 PĂRU ROTUND",220,"Alegeri Prezidentiale",1,459,210,175,35,0,208,2,505,295,86,122
36,TELEORMAN,OLTENI,153473,OLTENI,"ŞCOALA GIMNAZIALĂ NR.1 OLTENI",221,"Alegeri Prezidentiale",2,1477,654,577,76,1,633,21,1620,966,247,386
36,TELEORMAN,OLTENI,153473,"PERII BROŞTENI","ŞCOALA GIMNAZIALĂ NR.2 PERII-BROŞTENI",222,"Alegeri Prezidentiale",1,870,361,305,56,0,351,10,955,594,137,214
36,TELEORMAN,ORBEASCA,153507,"ORBEASCA DE JOS","ŞCOALA GIMNAZIALÃ NR. 2 ORBEASCA DE JOS ( CORP A)",223,"Alegeri Prezidentiale",1,915,421,365,51,5,415,6,1005,584,123,292
36,TELEORMAN,ORBEASCA,153507,"ORBEASCA DE JOS","ŞCOALA GIMNAZIALÃ NR. 2 ORBEASCA DE JOS (CORP A)",224,"Alegeri Prezidentiale",1,837,410,331,71,8,408,2,920,510,124,284
36,TELEORMAN,ORBEASCA,153507,"ORBEASCA DE SUS","ŞCOALA GIMNAZIALÃ NR. 1 ORBEASCA DE SUS (CORP B)",225,"Alegeri Prezidentiale",1,1090,550,487,50,13,545,5,1195,645,166,379
36,TELEORMAN,ORBEASCA,153507,"ORBEASCA DE SUS","ŞCOALA GIMNAZIALÃ NR. 1 ORBEASCA DE SUS (CORP B)",226,"Alegeri Prezidentiale",1,1305,662,592,57,13,653,9,1435,773,141,512
36,TELEORMAN,ORBEASCA,153507,LĂCENI,"ŞCOALA GIMNAZIALÃ NR.3 LACENI (CORP A)",227,"Alegeri Prezidentiale",1,871,392,347,39,6,388,4,955,563,120,268
36,TELEORMAN,ORBEASCA,153507,LĂCENI,"ŞCOALA GIMNAZIALÃ NR.3 LACENI (CORP A)",228,"Alegeri Prezidentiale",1,1068,461,406,42,13,458,3,1170,709,146,312
36,TELEORMAN,PERETU,153543,PERETU,"ŞCOALA GIMNAZIALĂ ”GRIGORE DIMITRIE GHICA” PERETU",229,"Alegeri Prezidentiale",1,998,454,427,27,0,444,10,1095,641,226,218
36,TELEORMAN,PERETU,153543,PERETU,"ŞCOALA GIMNAZIALĂ ”GRIGORE DIMITRIE GHICA” PERETU",230,"Alegeri Prezidentiale",1,1156,500,482,18,0,499,1,1270,770,182,317
36,TELEORMAN,PERETU,153543,PERETU,"CĂMINUL CULTURAL PERETU",231,"Alegeri Prezidentiale",1,1320,503,473,30,0,496,7,1450,947,203,293
36,TELEORMAN,PERETU,153543,PERETU,"GRĂDINIŢA CU PROGRAM NORMAL PERETU",232,"Alegeri Prezidentiale",1,1352,575,522,53,0,568,7,1485,910,296,272
36,TELEORMAN,PERETU,153543,PERETU,"GRĂDINIŢA CU PROGRAM NORMAL PERETU",233,"Alegeri Prezidentiale",1,1089,426,397,29,0,423,3,1195,769,176,247
36,TELEORMAN,PIATRA,153561,PIATRA,"ȘCOALA GIMNAZIALĂ PIATRA",234,"Alegeri Prezidentiale",1,894,588,500,88,0,582,6,980,392,328,254
36,TELEORMAN,PIATRA,153561,PIATRA,"GRĂDINIȚA CU PROGRAM NORMAL PIATRA",235,"Alegeri Prezidentiale",1,750,460,364,96,0,454,6,825,365,222,232
36,TELEORMAN,PIATRA,153561,PIATRA,"SALA DE PROTOCOL PRIMĂRIA COMUNEI PIATRA",236,"Alegeri Prezidentiale",1,867,475,392,83,0,472,3,950,475,196,276
36,TELEORMAN,PIETROŞANI,153589,PIETROŞANI,"ŞCOALA GIMNAZIALĂ(ŞCOALA VECHE)",237,"Alegeri Prezidentiale",2,956,499,389,77,33,492,7,1050,551,216,276
36,TELEORMAN,PIETROŞANI,153589,PIETROŞANI,"ŞCOALA GIMNAZIALĂ(ŞCOALA NOUĂ)",238,"Alegeri Prezidentiale",1,1120,616,502,90,24,605,11,1230,614,221,384
36,TELEORMAN,PLOPII-SLĂVITEŞTI,153623,PLOPII-SLĂVITEŞTI,"ŞCOALA GIMNAZIALĂ PLOPII SLĂVITEŞTI",239,"Alegeri Prezidentiale",1,544,430,334,72,24,422,8,600,170,228,194
36,TELEORMAN,PLOPII-SLĂVITEŞTI,153623,BRÂNCOVEANCA,"GRĂDINIŢA CU PROGRAM NORMAL NR.3",240,"Alegeri Prezidentiale",1,795,507,399,64,44,502,5,875,368,245,257
36,TELEORMAN,PLOPII-SLĂVITEŞTI,153623,DUDU,"GRĂDINIŢA CU PROGRAM NORMAL NR.2",241,"Alegeri Prezidentiale",1,605,434,353,50,31,426,8,670,236,248,178
36,TELEORMAN,PLOSCA,153605,PLOSCA,"CĂMINUL CULTURAL",242,"Alegeri Prezidentiale",1,1277,642,567,65,10,630,12,1400,758,295,335
36,TELEORMAN,PLOSCA,153605,PLOSCA,"ŞCOALA RĂSFIRAŢI",243,"Alegeri Prezidentiale",1,1386,809,734,59,16,799,10,1520,711,444,355
36,TELEORMAN,PLOSCA,153605,PLOSCA,"ŞCOALA GIMNAZIALĂ PLOSCA",244,"Alegeri Prezidentiale",1,789,381,332,43,6,379,2,870,489,176,203
36,TELEORMAN,PLOSCA,153605,PLOSCA,"ŞCOALA MICĂ",245,"Alegeri Prezidentiale",1,1245,591,529,53,9,582,9,1365,774,300,282
36,TELEORMAN,POENI,153696,POENI,"ȘCOALA GENERALĂ POENI",246,"Alegeri Prezidentiale",1,1142,594,499,95,0,590,4,1255,661,176,414
36,TELEORMAN,POENI,153696,PREAJBA,"ȘCOALA GENERALĂ PREAJBA",247,"Alegeri Prezidentiale",1,325,214,190,24,0,213,1,360,146,62,151
36,TELEORMAN,POENI,153696,VĂTAŞI,"ȘCOALA GENERALĂ VĂTAȘI",248,"Alegeri Prezidentiale",1,470,215,178,37,0,212,3,520,305,91,121
36,TELEORMAN,POENI,153696,CĂTUNU,"ȘCOALA PRIMARĂ CĂTUNU",249,"Alegeri Prezidentiale",1,361,235,180,55,0,234,1,400,165,48,186
36,TELEORMAN,POROSCHIA,151834,POROSCHIA,"ŞCOALA GIMNAZIALĂ POROSCHIA",250,"Alegeri Prezidentiale",1,1474,738,645,93,0,725,13,1620,882,227,498
36,TELEORMAN,POROSCHIA,151834,POROSCHIA,"ȘCOALA GENERALĂ POROSCHIA",251,"Alegeri Prezidentiale",1,1384,892,728,164,0,883,9,1520,628,341,542
36,TELEORMAN,POROSCHIA,151834,CALOMFIREŞTI,"GRĂDINIȚA CU PROGRAM NORMAL CALOMFIREȘTI",252,"Alegeri Prezidentiale",1,823,572,496,76,0,564,8,905,333,181,383
36,TELEORMAN,PURANI,155136,PURANI,"ŞCOALA GIMNAZIALĂ PURANII DE SUS",253,"Alegeri Prezidentiale",1,1125,752,628,114,10,737,15,1235,483,326,411
36,TELEORMAN,PUTINEIU,153829,PUTINEIU,"GRĂDINIȚA CU PROGRAM NORMAL NR.1 PUTINEIU",254,"Alegeri Prezidentiale",1,1043,654,524,124,6,645,9,1145,491,247,398
36,TELEORMAN,PUTINEIU,153829,BĂDULEASA,"GRĂDINIȚA CU PROGRAM NORMAL NR.2 BĂDULEASA",255,"Alegeri Prezidentiale",1,564,404,294,109,1,397,7,625,221,231,166
36,TELEORMAN,RĂDOIEŞTI,153865,RĂDOIEŞTI-VALE,"CĂMIN CULTURAL",256,"Alegeri Prezidentiale",1,509,318,254,61,3,317,1,560,242,115,202
36,TELEORMAN,RĂDOIEŞTI,153865,RĂDOIEŞTI-DEAL,"ȘCOALA GIMNAZIALĂ RĂDOIEȘTI",257,"Alegeri Prezidentiale",1,807,419,359,56,4,419,0,890,471,135,284
36,TELEORMAN,RĂDOIEŞTI,153865,CETATEA,"ȘCOALA GENERALĂ RĂDOIEȘTI CETATEA",258,"Alegeri Prezidentiale",1,301,209,133,70,6,206,3,335,126,75,131
36,TELEORMAN,RĂSMIREŞTI,153909,RĂSMIREŞTI,"CĂMINUL CULTURAL RĂSMIREŞTI",259,"Alegeri Prezidentiale",1,637,539,360,177,2,537,2,705,166,279,258
36,TELEORMAN,SAELELE,155145,SAELELE,"ŞCOALA GIMNAZIALĂ SAELELE",260,"Alegeri Prezidentiale",1,1226,852,690,106,56,847,5,1345,493,219,628
36,TELEORMAN,SAELELE,155145,PLEAŞOV,"GRĂDINIŢA PLEAŞOV",261,"Alegeri Prezidentiale",1,669,481,351,85,45,475,6,740,259,87,388
36,TELEORMAN,SALCIA,153936,SALCIA,"LOCALUL CĂMINULUI CULTURAL SALCIA",262,"Alegeri Prezidentiale",1,771,323,266,57,0,323,0,850,527,110,213
36,TELEORMAN,SALCIA,153936,BĂNEASA,"LOCALUL CĂMINULUI CULTURAL DIN SATUL BĂNEASA",263,"Alegeri Prezidentiale",1,711,418,351,60,7,408,10,785,367,107,301
36,TELEORMAN,SALCIA,153936,"TUDOR VLADIMIRESCU","LOCALUL CĂMINULUI CULTURAL DIN SATUL TUDOR VLADIMIRESCU",264,"Alegeri Prezidentiale",1,584,346,297,47,2,342,4,645,299,126,216
36,TELEORMAN,SĂCENI,153972,SĂCENI,"ȘCOALA GIMNAZIALĂ SĂCENI",265,"Alegeri Prezidentiale",1,552,373,281,63,29,364,9,610,237,82,282
36,TELEORMAN,SĂCENI,153972,CIURARI,"CLĂDIREA FOSTA ȘCOALĂ GIMNAZIALĂ CIURARI",266,"Alegeri Prezidentiale",1,358,244,186,49,9,240,4,395,151,98,142
36,TELEORMAN,SÂRBENI,154308,UDENI,"GRĂDINIŢA CU PROGRAM NORMAL NR. 3",267,"Alegeri Prezidentiale",2,350,224,169,55,0,223,1,385,161,83,140
36,TELEORMAN,SÂRBENI,154308,SÂRBENI,"GRĂDINIŢA CU PROGRAM NORMAL NR. 2",268,"Alegeri Prezidentiale",1,537,286,236,50,0,280,6,595,309,74,206
36,TELEORMAN,SÂRBENI,154308,"SÂRBENII DE JOS","LOCALUL ŞCOLII GIMNAZIALE SÂRBENII DE JOS",269,"Alegeri Prezidentiale",1,204,135,99,36,0,134,1,225,90,46,88
36,TELEORMAN,SCRIOAŞTEA,154013,SCRIOAŞTEA,"CĂMIN CULTURAL SCRIOAȘTEA",270,"Alegeri Prezidentiale",1,1841,1290,1037,253,0,1273,17,2025,735,723,550
36,TELEORMAN,SCRIOAŞTEA,154013,BREBINA,"GRĂDINIŢA DE COPII",271,"Alegeri Prezidentiale",1,620,392,337,55,0,391,1,686,294,146,245
36,TELEORMAN,SCRIOAŞTEA,154013,CUCUEŢI,"CĂMIN CULTURAL CUCUEŢI",272,"Alegeri Prezidentiale",1,675,450,364,86,0,442,8,745,295,267,175
36,TELEORMAN,"SCURTU MARE",154068,"SCURTU MARE","LOCALUL ŞCOLII GENERALE CU CLASELE I – VIII SCURTU MARE",273,"Alegeri Prezidentiale",1,852,558,396,90,72,555,3,935,377,170,385
36,TELEORMAN,"SCURTU MARE",154068,DRĂCEŞTI,"LOCALUL ŞCOLII CU CLASELE I-IV DRACESTI",274,"Alegeri Prezidentiale",1,270,172,140,26,6,170,2,300,128,21,149
36,TELEORMAN,"SCURTU MARE",154068,ALBENI,"LOCALUL ŞCOLII CU CLASELE I-IV ALBENI",275,"Alegeri Prezidentiale",1,156,94,57,23,14,94,0,175,81,12,82
36,TELEORMAN,SEACA,154139,SEACA,"GRADINITA CU PROGRAM NORMAL ,NR.1 SEACA , SAT SEACA , JUDETUL TELEORMAN , STRADA VICTORIEI , NR.75",276,"Alegeri Prezidentiale",1,1213,602,488,80,34,593,9,1330,728,265,328
36,TELEORMAN,SEACA,154139,NĂVODARI,"GRADINITA CU PROGRAM NORMAL NR.2 NAVODARI , SAT NAVODARI, COMUNA SEACA , JUDETUL TELEORMAN, STRADA DUNARII, NR.107",277,"Alegeri Prezidentiale",1,699,431,345,41,45,426,5,770,339,186,240
36,TELEORMAN,SEGARCEA-VALE,154184,SEGARCEA-VALE,"GRĂDINIŢA DE COPII CU PROGRAM NORMAL NR.1 SEGARCEA-VALE",278,"Alegeri Prezidentiale",1,804,491,403,84,4,480,11,885,394,147,333
36,TELEORMAN,SEGARCEA-VALE,154184,OLTEANCA,"GRĂDINIŢA DE COPII CU PROGRAM NORMAL NR.3 OLTEANCA",279,"Alegeri Prezidentiale",1,711,438,354,79,5,435,3,785,347,150,285
36,TELEORMAN,SEGARCEA-VALE,154184,SEGARCEA-DEAL,"LOCALUL ŞCOLII CU CLASELE I-VIII SEGARCEA DEAL",280,"Alegeri Prezidentiale",1,904,511,428,55,28,504,7,990,479,213,291
36,TELEORMAN,SFINŢEŞTI,154166,SFINŢEŞTI,"LOCALUL CĂMINULUI CULTURAL SFINŢEŞTI",281,"Alegeri Prezidentiale",1,897,430,362,57,11,427,3,985,555,165,262
36,TELEORMAN,SILIŞTEA,154228,SILIŞTEA,"CĂMINUL CULTURAL SILIŞTEA",282,"Alegeri Prezidentiale",1,1064,598,515,81,2,593,5,1170,572,179,414
36,TELEORMAN,SILIŞTEA,154228,BUTEŞTI,"GRĂDINIȚA CU PROGRAM NORMAL NR. 2 BUTEȘTI (FOST LOCAL AL ȘCOLII CU CLASELE I-IV BUTEȘTI)",283,"Alegeri Prezidentiale",1,487,262,211,51,0,260,2,540,278,83,177
36,TELEORMAN,SILIŞTEA,154228,"SILIŞTEA MICĂ","GRĂDINIȚA CU PROGRAM NORMAL NR. 3 SILIȘTEA MICĂ (FOST LOCAL AL ȘCOLII CU CLASELE I-IV SILIȘTEA MICĂ)",284,"Alegeri Prezidentiale",1,260,131,114,17,0,127,4,290,159,46,81
36,TELEORMAN,SILIŞTEA-GUMEŞTI,154282,SILIŞTEA-GUMEŞTI,"CENTRUL MEMORIAL ”MARIN PREDA”",285,"Alegeri Prezidentiale",1,1161,688,550,108,30,686,2,1275,587,380,306
36,TELEORMAN,SILIŞTEA-GUMEŞTI,154282,SILIŞTEA-GUMEŞTI,"ȘCOALA CU CLASELE I-IV ”MĂGURA”",286,"Alegeri Prezidentiale",1,799,436,360,47,29,433,3,880,444,230,203
36,TELEORMAN,"SLOBOZIA MÂNDRA",154344,"SLOBOZIA MÂNDRA","ȘCOALA GIMNAZIALĂ SLOBOZIA MÂNDRA",287,"Alegeri Prezidentiale",1,564,435,305,78,52,432,3,625,190,93,339
36,TELEORMAN,"SLOBOZIA MÂNDRA",154344,"SLOBOZIA MÂNDRA","ȘCOALA GIMNAZIALĂ SLOBOZIA MÂNDRA",288,"Alegeri Prezidentiale",1,767,477,335,59,83,474,3,845,368,124,350
36,TELEORMAN,SMÂRDIOASA,154380,SMÂRDIOASA,"ŞCOALA GIMNAZIALĂ SMÎRDIOASA",289,"Alegeri Prezidentiale",1,1508,802,700,101,1,785,17,1655,853,214,571
36,TELEORMAN,SMÂRDIOASA,154380,ŞOIMU,"ŞCOALA PRIMARĂ ŞOIMU",290,"Alegeri Prezidentiale",1,335,200,157,43,0,198,2,370,170,71,127
36,TELEORMAN,STEJARU,154415,STEJARU,"CĂMIN CULTURAL STEJARU",291,"Alegeri Prezidentiale",1,590,400,321,52,27,399,1,640,240,56,343
36,TELEORMAN,STEJARU,154415,SOCETU,"CLĂDIREA ŞCOLII GENERALE SOCETU",292,"Alegeri Prezidentiale",1,621,491,371,83,37,487,4,685,194,81,406
36,TELEORMAN,STEJARU,154415,BRATCOVU,"SEDIUL FOSTEI PRIMĂRII COMUNALE BRATCOV",293,"Alegeri Prezidentiale",1,104,111,62,43,6,111,0,120,9,18,93
36,TELEORMAN,STEJARU,154415,GRESIA,"CLĂDIREA ŞCOLII ELEMENTARE GRESIA",294,"Alegeri Prezidentiale",1,95,112,67,40,5,111,1,120,8,25,86
36,TELEORMAN,SUHAIA,154460,SUHAIA,"ŞCOALA GIMNAZIALĂ SUHAIA",295,"Alegeri Prezidentiale",1,853,494,397,93,4,484,10,935,441,223,261
36,TELEORMAN,SUHAIA,154460,SUHAIA,"ŞCOALA GIMNAZIALĂ SUHAIA",296,"Alegeri Prezidentiale",1,960,703,463,232,8,690,13,1055,352,435,255
36,TELEORMAN,ŞTOROBĂNEASA,154497,ŞTOROBĂNEASA,"SCOALA GIMNAZIALA ”VASILE RACOTTA”",297,"Alegeri Prezidentiale",1,1376,830,643,130,57,821,9,1510,680,232,589
36,TELEORMAN,ŞTOROBĂNEASA,154497,BEIU,"SCOALA CU CLASELE I-VIII ” BADEA NEGREANU ”",298,"Alegeri Prezidentiale",1,1132,639,510,109,20,625,14,1245,606,192,433
36,TELEORMAN,TALPA,154521,TALPA-OGRĂZILE,"ȘCOALA GIMNAZIALĂ COMUNA TALPA",299,"Alegeri Prezidentiale",1,739,583,364,108,111,571,12,815,232,109,462
36,TELEORMAN,TALPA,154521,TALPA-BÂSCOVENI,"ȘCOALA CU CLASELE I - IV TALPA",300,"Alegeri Prezidentiale",1,689,505,381,65,59,497,8,760,255,169,328
36,TELEORMAN,"TĂTĂRĂŞTII DE JOS",154585,"TĂTĂRĂŞTII DE JOS","ŞCOALA GIMNAZIALĂ TĂTĂRĂŞTII DE JOS",301,"Alegeri Prezidentiale",1,1182,620,509,111,0,612,8,1300,680,181,431
36,TELEORMAN,"TĂTĂRĂŞTII DE JOS",154585,SLĂVEŞTI,"ŞCOALA GIMNAZIALĂ SLĂVEŞTI",302,"Alegeri Prezidentiale",1,752,386,313,73,0,380,6,830,444,120,260
36,TELEORMAN,"TĂTĂRĂŞTII DE JOS",154585,"NEGRENII DE SUS","GRĂDINIŢA NEGRENII DE SUS",303,"Alegeri Prezidentiale",1,685,303,242,61,0,300,3,755,452,85,215
36,TELEORMAN,"TĂTĂRĂŞTII DE SUS",154665,"TĂTĂRĂŞTII DE SUS","ȘCOALA GIMNAZIALĂ TĂTĂRĂȘTII DE SUS",304,"Alegeri Prezidentiale",1,1074,564,457,107,0,558,6,1180,616,286,272
36,TELEORMAN,"TĂTĂRĂŞTII DE SUS",154665,UDUPU,"ȘCOALA GIMNAZIALĂ TĂTĂRĂȘTII DE SUS",305,"Alegeri Prezidentiale",1,1214,681,564,117,0,676,5,1335,654,363,313
36,TELEORMAN,TRAIAN,154736,TRAIAN,"SPAŢII BIROURI, STRADA PRINCIPALĂ NR. 116",306,"Alegeri Prezidentiale",1,659,391,318,53,20,381,10,725,334,140,241
36,TELEORMAN,TRAIAN,154736,TRAIAN,"ŞCOALA GIMNAZIALĂ TRAIAN, STRADA PRINCIPALĂ NR. 188",307,"Alegeri Prezidentiale",1,798,443,366,62,15,434,9,880,437,135,299
36,TELEORMAN,TRIVALEA-MOŞTENI,154754,TRIVALEA-MOŞTENI,"GRᾸDINIṬA TRIVALEA-SAT (FOSTA)",308,"Alegeri Prezidentiale",1,745,359,301,58,0,354,5,820,461,86,268
36,TELEORMAN,TRIVALEA-MOŞTENI,154754,BRĂTĂŞANI,"DISPENSARUL BRᾸTᾸŞANI",309,"Alegeri Prezidentiale",1,504,280,222,58,0,277,3,555,275,67,210
36,TELEORMAN,TRIVALEA-MOŞTENI,154754,DEPARAŢI,"GRᾸDINIṬA CU PROGRAM NORMAL NR.2",310,"Alegeri Prezidentiale",1,829,346,300,46,0,342,4,910,564,91,251
36,TELEORMAN,TROIANUL,154790,TROIANUL,"ȘCOALA GIMNAZIALĂ ”ION PREOTU”",311,"Alegeri Prezidentiale",1,1284,743,624,119,0,738,5,1410,667,322,416
36,TELEORMAN,TROIANUL,154790,TROIANUL,"ȘCOALA GENARALĂ NR. 2",312,"Alegeri Prezidentiale",1,806,458,396,62,0,451,7,890,432,236,215
36,TELEORMAN,TROIANUL,154790,VATRA,"ȘCOALA GENERALĂ",313,"Alegeri Prezidentiale",1,167,114,85,29,0,112,2,185,71,61,51
36,TELEORMAN,TROIANUL,154790,DULCENI,"CĂMINUL CULTURAL",314,"Alegeri Prezidentiale",1,66,68,30,38,0,66,2,95,27,35,31
36,TELEORMAN,ŢIGĂNEŞTI,154834,ŢIGĂNEŞTI,"ȘCOALA CU CLASELE I-IV",315,"Alegeri Prezidentiale",1,1411,736,659,66,11,725,11,1550,814,179,546
36,TELEORMAN,ŢIGĂNEŞTI,154834,ŢIGĂNEŞTI,"GRĂDINIȚA CU PROGRAM NORMAL",316,"Alegeri Prezidentiale",1,1282,723,656,59,8,709,14,1410,687,210,499
36,TELEORMAN,ŢIGĂNEŞTI,154834,ŢIGĂNEŞTI,"ȘCOALA GIMNAZIALĂ ”I.GH.DUCA”",317,"Alegeri Prezidentiale",1,1443,834,753,49,32,821,13,1585,751,213,608
36,TELEORMAN,UDA-CLOCOCIOV,155154,UDA-CLOCOCIOV,"LOCALUL CĂMINULUI CULTURAL UDA CLOCOCIOV",318,"Alegeri Prezidentiale",2,608,465,309,94,62,459,6,670,205,162,297
36,TELEORMAN,UDA-CLOCOCIOV,155154,UDA-PACIUREA,"LOCALUL ŞCOLII CU CLASELE I – VIII UDA PACIUREA",319,"Alegeri Prezidentiale",1,613,413,308,71,34,405,8,673,260,181,224
36,TELEORMAN,VÂRTOAPE,154932,"VÂRTOAPELE DE SUS","CĂMINUL CULTURAL VIRTOAPELE DE SUS",320,"Alegeri Prezidentiale",1,820,531,403,128,0,524,7,905,374,258,266
36,TELEORMAN,VÂRTOAPE,154932,"VÂRTOAPELE DE JOS","CĂMINUL CULTURAL VIRTOAPELE DE JOS",321,"Alegeri Prezidentiale",1,728,598,465,133,0,595,3,805,207,433,162
36,TELEORMAN,VÂRTOAPE,154932,GĂRĂGĂU,"CĂMINUL CULTURAL GĂRĂGĂU",322,"Alegeri Prezidentiale",1,576,440,353,87,0,440,0,635,195,385,55
36,TELEORMAN,VEDEA,154852,VEDEA,"ȘCOALA GIMNAZIALĂ VEDEA",323,"Alegeri Prezidentiale",1,502,323,278,45,0,321,2,555,232,80,241
36,TELEORMAN,VEDEA,154852,ALBEŞTI,"ȘCOALA CU CLASELE I - IV ALBEȘTI",324,"Alegeri Prezidentiale",1,527,402,342,51,9,395,7,580,178,73,322
36,TELEORMAN,VEDEA,154852,COŞOTENI,"ȘCOALA CU CLASELE I -IV COȘOTENI",325,"Alegeri Prezidentiale",1,448,302,251,47,4,300,2,495,193,66,234
36,TELEORMAN,VEDEA,154852,DULCEANCA,"ŞCOALA CU CLASELE I – VIII DULCEANCA",326,"Alegeri Prezidentiale",1,426,302,254,48,0,298,4,470,168,75,223
36,TELEORMAN,VEDEA,154852,MERI,"ŞCOALA CU CLASELE I – IV MERI",327,"Alegeri Prezidentiale",1,388,270,236,33,1,267,3,430,160,48,219
36,TELEORMAN,VIIŞOARA,154914,VIIŞOARA,"ȘCOALA GIMNAZIALĂ VIIȘOARA, NR. 97",328,"Alegeri Prezidentiale",1,699,542,426,83,33,534,8,770,228,326,208
36,TELEORMAN,VIIŞOARA,154914,VIIŞOARA,"GRĂDINIȚA CU PROGRAM NORMAL VIIȘOARA, NR. 519",329,"Alegeri Prezidentiale",1,643,477,390,51,36,470,7,710,233,285,185
36,TELEORMAN,VITĂNEŞTI,153776,PURANI,"CĂMIN CULTURAL SAT PURANI",330,"Alegeri Prezidentiale",1,588,389,278,84,27,381,8,650,261,152,229
36,TELEORMAN,VITĂNEŞTI,153776,SILIŞTEA,"CĂMIN CULTURAL SAT SILIŞTEA",331,"Alegeri Prezidentiale",1,692,466,304,116,46,462,4,765,299,106,356
36,TELEORMAN,VITĂNEŞTI,153776,VITĂNEŞTI,"GRĂDINIȚA CU PROGRAM NORMAL NR. 1 VITĂNEȘTI",332,"Alegeri Prezidentiale",1,945,608,424,115,69,602,6,1035,427,145,457
36,TELEORMAN,ZÂMBREASCA,154978,ZÂMBREASCA,"CĂMINUL CULTURAL",333,"Alegeri Prezidentiale",1,759,397,300,49,48,395,2,835,438,97,298
36,TELEORMAN,ZÂMBREASCA,154978,ZÂMBREASCA,"ŞCOALA PRIMARĂ",334,"Alegeri Prezidentiale",1,397,232,185,23,24,232,0,440,208,31,201
37,TIMIŞ,"MUNICIPIUL TIMIŞOARA",155243,TIMIŞOARA,"UNIVERSITATEA DE MEDICINA ŞI FARMACIE ”VICTOR BABEŞ”",1,"Alegeri Prezidentiale",2,1379,677,423,200,54,649,28,1500,823,472,177
37,TIMIŞ,"MUNICIPIUL TIMIŞOARA",155243,TIMIŞOARA,"UNIVERSITATEA DE MEDICINA ŞI FARMACIE ”VICTOR BABEŞ”",2,"Alegeri Prezidentiale",1,1063,900,466,433,1,884,16,1200,300,712,172
37,TIMIŞ,"MUNICIPIUL TIMIŞOARA",155243,TIMIŞOARA,"LICEUL PEDAGOGIC ” CARMEN SYLVA”",3,"Alegeri Prezidentiale",1,662,507,279,187,41,495,12,700,193,359,136
37,TIMIŞ,"MUNICIPIUL TIMIŞOARA",155243,TIMIŞOARA,"COLEGIUL TEHNIC ”EMANUIL UNGUREANU”",4,"Alegeri Prezidentiale",2,1430,981,614,343,24,962,19,1600,619,750,212
37,TIMIŞ,"MUNICIPIUL TIMIŞOARA",155243,TIMIŞOARA,"LICEUL TEORETIC ”NIKOLAUS LENAU” TIMIȘOARA",5,"Alegeri Prezidentiale",1,769,616,354,207,55,600,16,800,184,461,139
37,TIMIŞ,"MUNICIPIUL TIMIŞOARA",155243,TIMIŞOARA,"LICEUL TEORETIC ”NIKOLAUS LENAU” TIMIȘOARA",6,"Alegeri Prezidentiale",1,857,636,356,242,38,618,18,900,264,501,117
37,TIMIŞ,"MUNICIPIUL TIMIŞOARA",155243,TIMIŞOARA,"LICEUL TEORETIC ”NIKOLAUS LENAU”TIMIȘOARA",7,"Alegeri Prezidentiale",1,637,503,263,161,79,497,6,700,197,379,118
37,TIMIŞ,"MUNICIPIUL TIMIŞOARA",155243,TIMIŞOARA,"COLEGIUL TEHNIC ”HENRI COANDĂ”",8,"Alegeri Prezidentiale",1,854,476,350,126,0,467,9,1000,524,367,100
37,TIMIŞ,"MUNICIPIUL TIMIŞOARA",155243,TIMIŞOARA,"COLEGIUL TEHNIC ”HENRY COANDA”",9,"Alegeri Prezidentiale",1,1208,678,575,103,0,665,13,1100,422,489,176
37,TIMIŞ,"MUNICIPIUL TIMIŞOARA",155243,TIMIŞOARA,"COLEGIUL TEHNIC ”ION MINCU”",10,"Alegeri Prezidentiale",1,619,637,265,227,145,625,12,900,263,408,217
37,TIMIŞ,"MUNICIPIUL TIMIŞOARA",155243,TIMIŞOARA,"INSPECTORATUL JUDETEAN AL POLIŢIEI DE FRONTIERA",11,"Alegeri Prezidentiale",1,1292,684,569,115,0,670,14,1400,716,526,144
37,TIMIŞ,"MUNICIPIUL TIMIŞOARA",155243,TIMIŞOARA,"INSPECTORATUL JUDETEAN AL POLIŢIEI DE FRONTIERA",12,"Alegeri Prezidentiale",1,1360,759,616,143,0,745,14,1500,741,586,159
37,TIMIŞ,"MUNICIPIUL TIMIŞOARA",155243,TIMIŞOARA,"FUNDAŢIA IOAN SLAVICI",13,"Alegeri Prezidentiale",1,1266,860,636,224,0,841,19,1392,532,676,165
37,TIMIŞ,"MUNICIPIUL TIMIŞOARA",155243,TIMIŞOARA,"FUNDAŢIA IOAN SLAVICI",14,"Alegeri Prezidentiale",1,1395,835,701,134,0,830,5,1500,665,672,158
37,TIMIŞ,"MUNICIPIUL TIMIŞOARA",155243,TIMIŞOARA,"ȘCOALA GIMNAZIALĂ NR.7 ”SFÂNTA MARIA” TIMIȘOARA",15,"Alegeri Prezidentiale",1,1092,672,530,142,0,655,17,1200,528,516,139
37,TIMIŞ,"MUNICIPIUL TIMIŞOARA",155243,TIMIŞOARA,"ȘCOALA GIMNAZIALĂ NR.7 ”SFÂNTA MARIA” TIMIȘOARA",16,"Alegeri Prezidentiale",1,1039,562,472,90,0,549,13,1200,638,423,126
37,TIMIŞ,"MUNICIPIUL TIMIŞOARA",155243,TIMIŞOARA,"ȘCOALA GIMNAZIALĂ NR.7 ”SFÂNTA MARIA”TIMIȘOARA",17,"Alegeri Prezidentiale",1,1817,911,852,58,1,889,22,2000,1089,662,227
37,TIMIŞ,"MUNICIPIUL TIMIŞOARA",155243,TIMIŞOARA,"GRĂDINIŢA CU PROGRAM PRELUNGIT NR. 36 (FOSTA GRĂDINIŢĂ NR. 37)",18,"Alegeri Prezidentiale",1,1671,995,817,178,0,974,21,1792,797,773,201
37,TIMIŞ,"MUNICIPIUL TIMIŞOARA",155243,TIMIŞOARA,"GRĂDINIŢA CU PROGRAM PRELUNGIT NR. 36 (FOSTA GRĂDINIŢĂ NR. 37)",19,"Alegeri Prezidentiale",1,1483,949,682,267,0,928,21,1600,651,735,193
37,TIMIŞ,"MUNICIPIUL TIMIŞOARA",155243,TIMIŞOARA,"UNIVERSITATEA DE ȘTIINȚE AGRICOLE ȘI MEDICINĂ VETERINARĂ A BANATULUI( ÎN INCINTA FACULTĂȚII DE TEHNOLOGIA PRODUSELOR AGROALIMENTARE)",20,"Alegeri Prezidentiale",1,1801,1147,936,211,0,1122,25,1700,553,918,204
37,TIMIŞ,"MUNICIPIUL TIMIŞOARA",155243,TIMIŞOARA,"UNIVERSITATEA DE ȘTIINȚE AGRICOLE ȘI MEDICINĂ VETERINARĂ A BANATULUI( ÎN INCINTA FACULTĂȚII DE TEHNOLOGIA PRODUSELOR AGROALIMENTARE)",21,"Alegeri Prezidentiale",1,1812,1157,897,260,0,1132,25,1900,743,914,218
37,TIMIŞ,"MUNICIPIUL TIMIŞOARA",155243,TIMIŞOARA,"UNIVERSITATEA DE ȘTIINȚE AGRICOLE ȘI MEDICINĂ VETERINARĂ A BANATULUI( ÎN INCINTA FACULTĂȚII DE TEHNOLOGIA PRODUSELOR AGROALIMENTARE)",22,"Alegeri Prezidentiale",1,1628,1008,739,257,12,988,20,1800,792,762,226
37,TIMIŞ,"MUNICIPIUL TIMIŞOARA",155243,TIMIŞOARA,"UNIVERSITATEA DE ȘTIINȚE AGRICOLE ȘI MEDICINĂ VETERINARĂ A BANATULUI( ÎN INCINTA FACULTĂȚII DE TEHNOLOGIA PRODUSELOR AGROALIMENTARE)",23,"Alegeri Prezidentiale",1,1759,1112,905,207,0,1090,22,1900,788,879,211
37,TIMIŞ,"MUNICIPIUL TIMIŞOARA",155243,TIMIŞOARA,"UNIVERSITATEA DE ȘTIINȚE AGRICOLE ȘI MEDICINĂ VETERINARĂ A BANATULUI( ÎN INCINTA FACULTĂȚII DE TEHNOLOGIA PRODUSELOR AGROALIMENTARE )",24,"Alegeri Prezidentiale",1,1794,1138,859,279,0,1121,17,1700,562,896,225
37,TIMIŞ,"MUNICIPIUL TIMIŞOARA",155243,TIMIŞOARA,"ŞCOALA GIMNAZIALĂ NR.24 (GRĂDINIŢA CU PROGRAM PRELUNGIT NR.27)",25,"Alegeri Prezidentiale",1,1344,809,662,147,0,795,14,1500,691,592,203
37,TIMIŞ,"MUNICIPIUL TIMIŞOARA",155243,TIMIŞOARA,"ŞCOALA GIMNAZIALĂ NR.24 (GRĂDINIŢA CU PROGRAM PRELUNGIT NR.27)",26,"Alegeri Prezidentiale",1,1310,786,655,131,0,767,19,1400,614,589,178
37,TIMIŞ,"MUNICIPIUL TIMIŞOARA",155243,TIMIŞOARA,"ŞCOALA GIMNAZIALĂ NR.19 (ŞCOALA PRIMARĂ NR.19)",27,"Alegeri Prezidentiale",1,1374,842,730,112,0,826,16,1500,658,617,209
37,TIMIŞ,"MUNICIPIUL TIMIŞOARA",155243,TIMIŞOARA,"ŞCOALA GIMNAZIALĂ NR.19 (ŞCOALA PRIMARĂ NR.19)",28,"Alegeri Prezidentiale",1,1586,899,811,88,0,888,11,1200,301,703,185
37,TIMIŞ,"MUNICIPIUL TIMIŞOARA",155243,TIMIŞOARA,"ŞCOALA GIMNAZIALĂ NR.24",29,"Alegeri Prezidentiale",1,1240,833,588,245,0,820,13,1400,567,636,184
37,TIMIŞ,"MUNICIPIUL TIMIŞOARA",155243,TIMIŞOARA,"ŞCOALA GIMNAZIALĂ NR.24",30,"Alegeri Prezidentiale",1,1445,794,707,86,1,780,14,1600,806,583,197
37,TIMIŞ,"MUNICIPIUL TIMIŞOARA",155243,TIMIŞOARA,"ŞCOALA GIMNAZIALĂ NR.24",31,"Alegeri Prezidentiale",1,812,637,389,248,0,628,9,900,263,501,127
37,TIMIŞ,"MUNICIPIUL TIMIŞOARA",155243,TIMIŞOARA,"ŞCOALA GIMNAZIALĂ NR.24",32,"Alegeri Prezidentiale",1,939,557,484,73,0,539,18,1000,443,413,126
37,TIMIŞ,"MUNICIPIUL TIMIŞOARA",155243,TIMIŞOARA,"ŞCOALA GIMNAZIALĂ NR. 26",33,"Alegeri Prezidentiale",1,1375,728,648,80,0,714,14,1500,772,573,141
37,TIMIŞ,"MUNICIPIUL TIMIŞOARA",155243,TIMIŞOARA,"ŞCOALA GIMNAZIALĂ NR. 26",34,"Alegeri Prezidentiale",1,1132,682,539,143,0,671,11,1200,518,512,159
37,TIMIŞ,"MUNICIPIUL TIMIŞOARA",155243,TIMIŞOARA,"ŞCOALA GIMNAZIALĂ NR. 26",35,"Alegeri Prezidentiale",1,1112,672,556,116,0,658,14,1200,528,537,121
37,TIMIŞ,"MUNICIPIUL TIMIŞOARA",155243,TIMIŞOARA,"ŞCOALA GIMNAZIALĂ NR. 26",36,"Alegeri Prezidentiale",1,1280,746,638,108,0,736,10,1400,654,560,176
37,TIMIŞ,"MUNICIPIUL TIMIŞOARA",155243,TIMIŞOARA,"ŞCOALA GIMNAZIALĂ NR.18",37,"Alegeri Prezidentiale",1,1499,843,692,150,1,826,17,1700,857,624,202
37,TIMIŞ,"MUNICIPIUL TIMIŞOARA",155243,TIMIŞOARA,"ŞCOALA GIMNAZIALĂ NR.18",38,"Alegeri Prezidentiale",1,1571,895,775,120,0,877,18,1700,805,633,244
37,TIMIŞ,"MUNICIPIUL TIMIŞOARA",155243,TIMIŞOARA,"ŞCOALA GIMNAZIALĂ NR.18",39,"Alegeri Prezidentiale",1,1287,675,575,100,0,661,14,1400,725,514,147
37,TIMIŞ,"MUNICIPIUL TIMIŞOARA",155243,TIMIŞOARA,"CLUBUL SPORTIV ŞCOLAR NR.1",40,"Alegeri Prezidentiale",1,928,590,476,114,0,581,9,1000,410,453,128
37,TIMIŞ,"MUNICIPIUL TIMIŞOARA",155243,TIMIŞOARA,"GRĂDINIŢA CU PROGRAM PRELUNGIT NR.36",41,"Alegeri Prezidentiale",1,1264,891,630,261,0,870,21,1400,509,702,168
37,TIMIŞ,"MUNICIPIUL TIMIŞOARA",155243,TIMIŞOARA,"ŞCOALA GIMNAZIALĂ NR.19 ”AVRAM IANCU”",42,"Alegeri Prezidentiale",1,1064,735,547,188,0,723,12,1200,465,574,149
37,TIMIŞ,"MUNICIPIUL TIMIŞOARA",155243,TIMIŞOARA,"ŞCOALA GIMNAZIALĂ NR.19 ”AVRAM IANCU”",43,"Alegeri Prezidentiale",1,1169,722,566,155,1,711,11,1300,578,538,173
37,TIMIŞ,"MUNICIPIUL TIMIŞOARA",155243,TIMIŞOARA,"ŞCOALA GIMNAZIALĂ NR.19 ”AVRAM IANCU”",44,"Alegeri Prezidentiale",1,1225,766,616,150,0,752,14,1400,634,584,168
37,TIMIŞ,"MUNICIPIUL TIMIŞOARA",155243,TIMIŞOARA,"ŞCOALA GIMNAZIALĂ NR.19 ”AVRAM IANCU”",45,"Alegeri Prezidentiale",1,1417,735,628,107,0,724,11,1600,865,570,154
37,TIMIŞ,"MUNICIPIUL TIMIŞOARA",155243,TIMIŞOARA,"GRĂDINIŢA CU PROGRAM PRELUNGIT NR.26",46,"Alegeri Prezidentiale",1,1340,815,644,171,0,793,22,1500,685,604,189
37,TIMIŞ,"MUNICIPIUL TIMIŞOARA",155243,TIMIŞOARA,"GRĂDINIŢA CU PROGRAM PRELUNGIT NR.26",47,"Alegeri Prezidentiale",1,1326,793,655,138,0,783,10,1500,707,583,200
37,TIMIŞ,"MUNICIPIUL TIMIŞOARA",155243,TIMIŞOARA,"GRĂDINIŢA CU PROGRAM PRELUNGIT NR.20 (GRĂDINIŢA CU PROGRAM PRELUNGIT NR.9 ”CARLA PELZ”)",48,"Alegeri Prezidentiale",1,1412,833,758,74,1,821,12,1600,767,628,193
37,TIMIŞ,"MUNICIPIUL TIMIŞOARA",155243,TIMIŞOARA,"GRĂDINIŢA CU PROGRAM PRELUNGIT NR.20 (GRĂDINIŢA CU PROGRAM PRELUNGIT NR.9 ”CARLA PELZ”)",49,"Alegeri Prezidentiale",1,1449,887,787,100,0,875,12,1608,721,690,185
37,TIMIŞ,"MUNICIPIUL TIMIŞOARA",155243,TIMIŞOARA,"BIROUL LOCUINŢE/DIRECŢIA CLĂDIRI, TERENURI ŞI DOTĂRI DIVERSE- PRIMĂRIA MUNICIPIULUI TIMIŞOARA",50,"Alegeri Prezidentiale",1,729,640,333,161,146,625,15,800,160,395,230
37,TIMIŞ,"MUNICIPIUL TIMIŞOARA",155243,TIMIŞOARA,"LICEUL TEHNOLOGIC DE INDUSTRIE ALIMENTARĂ",51,"Alegeri Prezidentiale",1,1072,673,524,149,0,660,13,1200,527,498,162
37,TIMIŞ,"MUNICIPIUL TIMIŞOARA",155243,TIMIŞOARA,"LICEUL TEHNOLOGIC DE INDUSTRIE ALIMENTARĂ",52,"Alegeri Prezidentiale",1,1214,747,650,97,0,730,17,1400,653,562,168
37,TIMIŞ,"MUNICIPIUL TIMIŞOARA",155243,TIMIŞOARA,"LICEUL TEHNOLOGIC UCECOM ”SPIRU HARET”",53,"Alegeri Prezidentiale",1,1293,806,678,128,0,793,13,1400,594,594,199
37,TIMIŞ,"MUNICIPIUL TIMIŞOARA",155243,TIMIŞOARA,"LICEUL TEHNOLOGIC UCECOM ”SPIRU HARET”",54,"Alegeri Prezidentiale",1,1440,908,773,135,0,898,10,1600,692,688,210
37,TIMIŞ,"MUNICIPIUL TIMIŞOARA",155243,TIMIŞOARA,"COLEGIUL TEHNIC ”HENRI COANDĂ” (ŞCOALA PRIMARĂ NR.11)",55,"Alegeri Prezidentiale",1,1734,998,937,61,0,978,20,1900,902,746,232
37,TIMIŞ,"MUNICIPIUL TIMIŞOARA",155243,TIMIŞOARA,"COLEGIUL TEHNIC ”HENRI COANDĂ” (ŞCOALA PRIMARĂ NR.11)",56,"Alegeri Prezidentiale",1,1722,975,891,84,0,951,24,1900,925,739,212
37,TIMIŞ,"MUNICIPIUL TIMIŞOARA",155243,TIMIŞOARA,"COLEGIUL TEHNIC ”HENRI COANDĂ” (ŞCOALA PRIMARĂ NR.11)",57,"Alegeri Prezidentiale",1,1908,1042,957,85,0,1023,19,2100,1058,809,214
37,TIMIŞ,"MUNICIPIUL TIMIŞOARA",155243,TIMIŞOARA,"ŞCOALA GIMNAZIALĂ NR.19 ”AVRAM IANCU” (ŞCOALA PRIMARĂ NR.19)",58,"Alegeri Prezidentiale",1,1770,894,790,104,0,886,8,1900,1006,674,212
37,TIMIŞ,"MUNICIPIUL TIMIŞOARA",155243,TIMIŞOARA,"ŞCOALA GIMNAZIALĂ NR.19 ”AVRAM IANCU” (ŞCOALA PRIMARĂ NR.19)",59,"Alegeri Prezidentiale",1,1702,961,904,56,1,944,17,1900,939,755,189
37,TIMIŞ,"MUNICIPIUL TIMIŞOARA",155243,TIMIŞOARA,"ŞCOALA GIMNAZIALĂ NR.19 ”AVRAM IANCU” (ŞCOALA PRIMARĂ NR.19)",60,"Alegeri Prezidentiale",1,1688,796,704,92,0,779,17,1800,1004,622,157
37,TIMIŞ,"MUNICIPIUL TIMIŞOARA",155243,TIMIŞOARA,"INSPECTORATUL TERITORIAL DE MUNCĂ TIMIŞ",61,"Alegeri Prezidentiale",1,1342,722,539,183,0,703,19,1500,778,554,149
37,TIMIŞ,"MUNICIPIUL TIMIŞOARA",155243,TIMIŞOARA,"S.C. DRUMURI MUNICIPALE TIMIŞOARA S.A.(FOSTA ADMINISTRAREA DOMENIULUI PUBLIC )",62,"Alegeri Prezidentiale",1,1436,750,653,97,0,733,17,1600,850,549,184
37,TIMIŞ,"MUNICIPIUL TIMIŞOARA",155243,TIMIŞOARA,"S.C. DRUMURI MUNICIPALE TIMIŞOARA S.A.(FOSTA ADMINISTRAREA DOMENIULUI PUBLIC )",63,"Alegeri Prezidentiale",1,1384,720,588,125,7,711,9,1500,780,585,126
37,TIMIŞ,"MUNICIPIUL TIMIŞOARA",155243,TIMIŞOARA,"COLEGIUL TEHNIC DE VEST",64,"Alegeri Prezidentiale",1,1260,596,494,77,25,583,13,1400,804,432,151
37,TIMIŞ,"MUNICIPIUL TIMIŞOARA",155243,TIMIŞOARA,"COLEGIUL TEHNIC DE VEST",65,"Alegeri Prezidentiale",1,1068,594,493,101,0,582,12,1200,606,465,117
37,TIMIŞ,"MUNICIPIUL TIMIŞOARA",155243,TIMIŞOARA,"COLEGIUL TEHNIC DE VEST",66,"Alegeri Prezidentiale",1,980,583,435,148,0,562,21,1100,517,462,100
37,TIMIŞ,"MUNICIPIUL TIMIŞOARA",155243,TIMIŞOARA,"ŞCOALA GIMNAZIALĂ NR.12",67,"Alegeri Prezidentiale",1,986,634,448,154,32,623,11,1100,466,478,145
37,TIMIŞ,"MUNICIPIUL TIMIŞOARA",155243,TIMIŞOARA,"ŞCOALA GIMNAZIALĂ NR.12",68,"Alegeri Prezidentiale",1,1258,723,559,163,1,710,13,1400,677,569,141
37,TIMIŞ,"MUNICIPIUL TIMIŞOARA",155243,TIMIŞOARA,"COLEGIUL ECONOMIC ”F.S.NITTI”",69,"Alegeri Prezidentiale",1,1179,646,496,150,0,632,14,1308,662,486,146
37,TIMIŞ,"MUNICIPIUL TIMIŞOARA",155243,TIMIŞOARA,"COLEGIUL ECONOMIC ”F.S.NITTI”",70,"Alegeri Prezidentiale",1,1178,583,506,52,25,573,10,1300,717,455,118
37,TIMIŞ,"MUNICIPIUL TIMIŞOARA",155243,TIMIŞOARA,"COLEGIUL ECONOMIC ”F.S.NITTI”",71,"Alegeri Prezidentiale",1,1340,776,666,44,66,760,16,1500,724,574,186
37,TIMIŞ,"MUNICIPIUL TIMIŞOARA",155243,TIMIŞOARA,"COLEGIUL ECONOMIC ”F.S. NITTI”",72,"Alegeri Prezidentiale",1,1262,663,601,62,0,642,21,1400,737,499,143
37,TIMIŞ,"MUNICIPIUL TIMIŞOARA",155243,TIMIŞOARA,"LICEUL TEORETIC ”GRIGORE MOISIL” (ŞCOALA GIMNAZIALĂ NR.22)",73,"Alegeri Prezidentiale",1,938,602,445,150,7,583,19,1000,398,439,144
37,TIMIŞ,"MUNICIPIUL TIMIŞOARA",155243,TIMIŞOARA,"LICEUL TEORETIC ”GRIGORE MOISIL” (ŞCOALA GIMNAZIALĂ NR.22)",74,"Alegeri Prezidentiale",1,934,601,431,170,0,584,17,1000,399,478,106
37,TIMIŞ,"MUNICIPIUL TIMIŞOARA",155243,TIMIŞOARA,"LICEUL TEORETIC ”GRIGORE MOISIL” (ŞCOALA GIMNAZIALĂ NR.22)",75,"Alegeri Prezidentiale",1,1033,624,483,140,1,612,12,1100,476,470,142
37,TIMIŞ,"MUNICIPIUL TIMIŞOARA",155243,TIMIŞOARA,"LICEUL TEORETIC ”GRIGORE MOISIL” (ŞCOALA GIMNAZIALĂ NR.22)",76,"Alegeri Prezidentiale",1,1046,633,522,111,0,618,15,1100,467,487,131
37,TIMIŞ,"MUNICIPIUL TIMIŞOARA",155243,TIMIŞOARA,"LICEUL ”GRIGORE MOISIL”",77,"Alegeri Prezidentiale",1,1017,593,489,103,1,579,14,1000,407,463,116
37,TIMIŞ,"MUNICIPIUL TIMIŞOARA",155243,TIMIŞOARA,"LICEUL ”GRIGORE MOISIL”",78,"Alegeri Prezidentiale",1,1003,606,490,59,57,595,11,1100,494,420,175
37,TIMIŞ,"MUNICIPIUL TIMIŞOARA",155243,TIMIŞOARA,"ŞCOALA SF. ANTIM IVIREANUL (FOST LICEUL DE ARTE PLASTICE -FOSTA ŞCOALA GENERALĂ NR.9)",79,"Alegeri Prezidentiale",1,1588,895,827,68,0,880,15,1700,805,679,201
37,TIMIŞ,"MUNICIPIUL TIMIŞOARA",155243,TIMIŞOARA,"ŞCOALA SF. ANTIM IVIREANUL (FOST LICEUL DE ARTE PLASTICE -FOSTA ŞCOALA GENERALĂ NR.9)",80,"Alegeri Prezidentiale",1,1575,871,731,140,0,850,21,1700,829,673,177
37,TIMIŞ,"MUNICIPIUL TIMIŞOARA",155243,TIMIŞOARA,"ŞCOALA SF. ANTIM IVIREANUL (FOST LICEUL DE ARTE PLASTICE -FOSTA ŞCOALA GENERALĂ NR.9)",81,"Alegeri Prezidentiale",2,1654,888,807,80,1,876,12,1800,912,694,182
37,TIMIŞ,"MUNICIPIUL TIMIŞOARA",155243,TIMIŞOARA,"ŞCOALA SF. ANTIM IVIREANUL (FOST LICEUL DE ARTE PLASTICE -FOSTA ŞCOALA GENERALĂ NR.9)",82,"Alegeri Prezidentiale",1,1560,778,710,68,0,768,10,1700,922,604,164
37,TIMIŞ,"MUNICIPIUL TIMIŞOARA",155243,TIMIŞOARA,"ŞCOALA GIMNAZIALĂ NR.27 (GRADINIŢA CU PROGRAM PRELUNGIT NR. 3)",83,"Alegeri Prezidentiale",1,1302,726,573,153,0,717,9,1400,674,529,188
37,TIMIŞ,"MUNICIPIUL TIMIŞOARA",155243,TIMIŞOARA,"ŞCOALA GIMNAZIALĂ NR.27 (GRADINIŢA CU PROGRAM PRELUNGIT NR. 3)",84,"Alegeri Prezidentiale",1,1274,708,613,95,0,697,11,1400,692,546,151
37,TIMIŞ,"MUNICIPIUL TIMIŞOARA",155243,TIMIŞOARA,"ŞCOALA GIMNAZIALĂ NR. 27",85,"Alegeri Prezidentiale",1,1737,899,815,84,0,884,15,1900,1001,694,190
37,TIMIŞ,"MUNICIPIUL TIMIŞOARA",155243,TIMIŞOARA,"ŞCOALA GIMNAZIALĂ NR. 27",86,"Alegeri Prezidentiale",1,1673,915,765,150,0,895,20,1800,885,705,190
37,TIMIŞ,"MUNICIPIUL TIMIŞOARA",155243,TIMIŞOARA,"ŞCOALA GIMNAZIALĂ NR. 27",87,"Alegeri Prezidentiale",2,1679,974,826,148,0,952,22,1900,926,769,183
37,TIMIŞ,"MUNICIPIUL TIMIŞOARA",155243,TIMIŞOARA,"ŞCOALA GIMNAZIALĂ NR. 27",88,"Alegeri Prezidentiale",1,1689,891,774,117,0,879,12,1900,1009,665,214
37,TIMIŞ,"MUNICIPIUL TIMIŞOARA",155243,TIMIŞOARA,"ŞCOALA GIMNAZIALĂ NR. 6",89,"Alegeri Prezidentiale",1,1102,635,508,127,0,623,12,1200,565,469,154
37,TIMIŞ,"MUNICIPIUL TIMIŞOARA",155243,TIMIŞOARA,"ŞCOALA GIMNAZIALĂ NR. 6",90,"Alegeri Prezidentiale",1,1258,696,616,80,0,685,11,1400,704,525,160
37,TIMIŞ,"MUNICIPIUL TIMIŞOARA",155243,TIMIŞOARA,"ŞCOALA GIMNAZIALĂ NR. 6",91,"Alegeri Prezidentiale",1,1269,676,612,64,0,663,13,1400,724,541,122
37,TIMIŞ,"MUNICIPIUL TIMIŞOARA",155243,TIMIŞOARA,"ŞCOALA GIMNAZIALĂ NR. 6",92,"Alegeri Prezidentiale",1,1488,749,699,50,0,742,7,1600,851,591,151
37,TIMIŞ,"MUNICIPIUL TIMIŞOARA",155243,TIMIŞOARA,"LICEUL TEHNOLOGIC TRANSPORTURI AUTO",93,"Alegeri Prezidentiale",1,1531,904,793,111,0,894,10,1700,796,722,172
37,TIMIŞ,"MUNICIPIUL TIMIŞOARA",155243,TIMIŞOARA,"LICEUL TEHNOLOGIC TRANSPORTURI AUTO",94,"Alegeri Prezidentiale",1,1636,907,809,98,0,884,23,1300,393,718,166
37,TIMIŞ,"MUNICIPIUL TIMIŞOARA",155243,TIMIŞOARA,"LICEUL TEHNOLOGIC TRANSPORTURI AUTO",95,"Alegeri Prezidentiale",1,1755,921,818,103,0,907,14,1900,979,725,182
37,TIMIŞ,"MUNICIPIUL TIMIŞOARA",155243,TIMIŞOARA,"LICEUL TEHNOLOGIC TRANSPORTURI AUTO (ŞCOALA GIMNAZIALĂ NR. 29)",96,"Alegeri Prezidentiale",1,1416,733,660,73,0,715,18,1600,867,575,140
37,TIMIŞ,"MUNICIPIUL TIMIŞOARA",155243,TIMIŞOARA,"LICEUL TEHNOLOGIC TRANSPORTURI AUTO (ŞCOALA GIMNAZIALĂ NR. 29)",97,"Alegeri Prezidentiale",1,1399,643,581,62,0,632,11,1600,957,509,123
37,TIMIŞ,"MUNICIPIUL TIMIŞOARA",155243,TIMIŞOARA,"LICEUL TEHNOLOGIC TRANSPORTURI AUTO (ŞCOALA GIMNAZIALĂ NR. 29)",98,"Alegeri Prezidentiale",1,1126,547,511,36,0,531,16,1200,653,423,108
37,TIMIŞ,"MUNICIPIUL TIMIŞOARA",155243,TIMIŞOARA,"ŞCOALA GIMNAZIALĂ NR.15 (ŞCOALA PRIMARĂ NR.15)",99,"Alegeri Prezidentiale",1,1614,800,740,60,0,780,20,1808,1008,619,161
37,TIMIŞ,"MUNICIPIUL TIMIŞOARA",155243,TIMIŞOARA,"ŞCOALA GIMNAZIALĂ NR.15 (ŞCOALA PRIMARĂ NR.15)",100,"Alegeri Prezidentiale",1,1496,794,727,67,0,777,17,1700,906,588,189
37,TIMIŞ,"MUNICIPIUL TIMIŞOARA",155243,TIMIŞOARA,"ŞCOALA GIMNAZIALĂ NR.2 (GRĂDINIŢA CU PROGRAM PRELUNGIT NR. 29)",101,"Alegeri Prezidentiale",1,1397,755,641,114,0,740,15,1600,845,591,149
37,TIMIŞ,"MUNICIPIUL TIMIŞOARA",155243,TIMIŞOARA,"ŞCOALA GIMNAZIALĂ NR.2 (GRĂDINIŢA CU PROGRAM PRELUNGIT NR. 29)",102,"Alegeri Prezidentiale",1,1255,808,642,166,0,791,17,1400,592,639,152
37,TIMIŞ,"MUNICIPIUL TIMIŞOARA",155243,TIMIŞOARA,"ŞCOALA GIMNAZIALĂ NR.2",103,"Alegeri Prezidentiale",1,1466,831,658,172,1,809,22,1600,769,632,177
37,TIMIŞ,"MUNICIPIUL TIMIŞOARA",155243,TIMIŞOARA,"ŞCOALA GIMNAZIALĂ NR.2",104,"Alegeri Prezidentiale",1,1413,846,727,119,0,829,17,1592,746,647,182
37,TIMIŞ,"MUNICIPIUL TIMIŞOARA",155243,TIMIŞOARA,"ŞCOALA GIMNAZIALĂ NR.2",105,"Alegeri Prezidentiale",1,1357,732,632,100,0,722,10,1500,768,547,175
37,TIMIŞ,"MUNICIPIUL TIMIŞOARA",155243,TIMIŞOARA,"GRĂDINIŢA CU PROGRAM PRELUNGIT NR.2 (GRĂDINIŢA CU PROGRAM PRELUNGIT NR. 1)",106,"Alegeri Prezidentiale",1,1754,1128,1008,120,0,1102,26,1900,772,872,230
37,TIMIŞ,"MUNICIPIUL TIMIŞOARA",155243,TIMIŞOARA,"GRĂDINIŢA CU PROGRAM PRELUNGIT NR.2 (GRĂDINIŢA CU PROGRAM PRELUNGIT NR. 1)",107,"Alegeri Prezidentiale",1,1834,1056,940,116,0,1037,19,2000,944,815,222
37,TIMIŞ,"MUNICIPIUL TIMIŞOARA",155243,TIMIŞOARA,"LICEUL TEORETIC ”VLAD ŢEPES” (GRĂDINIŢA CU PROGRAM PRELUNGIT NR.28)",108,"Alegeri Prezidentiale",1,1243,810,572,237,1,791,19,1400,590,595,196
37,TIMIŞ,"MUNICIPIUL TIMIŞOARA",155243,TIMIŞOARA,"LICEUL CU PROGRAM SPORTIV ”BANATUL”",109,"Alegeri Prezidentiale",1,1380,885,677,196,12,869,16,1500,615,665,204
37,TIMIŞ,"MUNICIPIUL TIMIŞOARA",155243,TIMIŞOARA,"COLEGIUL NATIONAL DE ARTA ”ION VIDU”",110,"Alegeri Prezidentiale",1,530,1502,263,1239,0,1471,31,2000,498,1321,150
37,TIMIŞ,"MUNICIPIUL TIMIŞOARA",155243,TIMIŞOARA,"FUNDAŢIA JUDEŢEANĂ PENTRU TINERET TIMIŞ (FOSTA CASA TINERETULUI)",111,"Alegeri Prezidentiale",1,1231,797,587,210,0,779,18,1400,603,607,172
37,TIMIŞ,"MUNICIPIUL TIMIŞOARA",155243,TIMIŞOARA,"FUNDAŢIA JUDEŢEANĂ PENTRU TINERET TIMIŞ (FOSTA CASA TINERETULUI)",112,"Alegeri Prezidentiale",1,1551,1035,753,245,37,1016,19,1700,665,833,183
37,TIMIŞ,"MUNICIPIUL TIMIŞOARA",155243,TIMIŞOARA,"FUNDAŢIA JUDEŢEANĂ PENTRU TINERET TIMIŞ (FOSTA CASA TINERETULUI)",113,"Alegeri Prezidentiale",1,1101,735,488,246,1,709,26,1200,465,574,135
37,TIMIŞ,"MUNICIPIUL TIMIŞOARA",155243,TIMIŞOARA,"LICEUL TEORETIC ”JEAN LOUIS CALDERON” (FOSTA ŞCOALA GIMNAZIALĂ NR.28) ” CORP B ”",114,"Alegeri Prezidentiale",1,907,758,415,343,0,734,24,1000,242,611,123
37,TIMIŞ,"MUNICIPIUL TIMIŞOARA",155243,TIMIŞOARA,"ŞCOALA GIMNAZIALĂ NR.30",115,"Alegeri Prezidentiale",1,1841,1160,979,181,0,1143,17,2000,840,944,199
37,TIMIŞ,"MUNICIPIUL TIMIŞOARA",155243,TIMIŞOARA,"ŞCOALA GIMNAZIALĂ NR.30",116,"Alegeri Prezidentiale",1,1335,859,713,146,0,846,13,1500,641,688,158
37,TIMIŞ,"MUNICIPIUL TIMIŞOARA",155243,TIMIŞOARA,"ŞCOALA GIMNAZIALĂ NR.30",117,"Alegeri Prezidentiale",1,1486,1042,755,287,0,1019,23,1700,658,795,224
37,TIMIŞ,"MUNICIPIUL TIMIŞOARA",155243,TIMIŞOARA,"ŞCOALA GIMNAZIALĂ NR.30",118,"Alegeri Prezidentiale",1,1484,963,752,211,0,944,19,1700,737,745,199
37,TIMIŞ,"MUNICIPIUL TIMIŞOARA",155243,TIMIŞOARA,"ŞCOALA GIMNAZIALĂ NR.30",119,"Alegeri Prezidentiale",1,1328,844,683,161,0,832,12,1492,648,671,161
37,TIMIŞ,"MUNICIPIUL TIMIŞOARA",155243,TIMIŞOARA,"UNIVERSITATEA POLITEHNICA TIMIŞOARA - CANTINA STUDENŢEASCĂ",120,"Alegeri Prezidentiale",1,1042,1947,339,1608,0,1906,41,2500,553,1701,205
37,TIMIŞ,"MUNICIPIUL TIMIŞOARA",155243,TIMIŞOARA,"UNIVERSITATEA POLITEHNICA TIMIŞOARA- CANTINA STUDENŢEASCĂ",121,"Alegeri Prezidentiale",1,915,2002,416,1586,0,1957,45,2300,298,1714,243
37,TIMIŞ,"MUNICIPIUL TIMIŞOARA",155243,TIMIŞOARA,"LICEUL TEORETIC ”WILLIAM SHAKESPEARE” (FOSTA ŞCOALA GIMNAZIALĂ NR. 5 )",122,"Alegeri Prezidentiale",1,1240,748,612,134,2,739,9,1400,652,593,146
37,TIMIŞ,"MUNICIPIUL TIMIŞOARA",155243,TIMIŞOARA,"LICEUL TEORETIC ”WILLIAM SHAKESPEARE” ( FOSTA ŞCOALA GIMNAZIALĂ NR. 5 )",123,"Alegeri Prezidentiale",1,1185,692,587,105,0,686,6,1300,608,523,163
37,TIMIŞ,"MUNICIPIUL TIMIŞOARA",155243,TIMIŞOARA,"GRADINIŢA CU PROGRAM PRELUNGIT NR.11",124,"Alegeri Prezidentiale",1,1293,721,591,128,2,700,21,1400,679,563,137
37,TIMIŞ,"MUNICIPIUL TIMIŞOARA",155243,TIMIŞOARA,"GRADINIŢA CU PROGRAM PRELUNGIT NR.11",125,"Alegeri Prezidentiale",1,1065,667,532,135,0,651,16,1200,533,503,148
37,TIMIŞ,"MUNICIPIUL TIMIŞOARA",155243,TIMIŞOARA,"COLEGIUL TEHNIC ”AZUR”",126,"Alegeri Prezidentiale",1,1372,949,652,275,22,936,13,1500,551,713,223
37,TIMIŞ,"MUNICIPIUL TIMIŞOARA",155243,TIMIŞOARA,"COLEGIUL TEHNIC ”AZUR”",127,"Alegeri Prezidentiale",1,1327,1070,724,316,30,1051,19,1400,330,835,216
37,TIMIŞ,"MUNICIPIUL TIMIŞOARA",155243,TIMIŞOARA,"COLEGIUL TEHNIC ”AZUR”",128,"Alegeri Prezidentiale",1,1179,874,549,302,23,855,19,1300,426,698,157
37,TIMIŞ,"MUNICIPIUL TIMIŞOARA",155243,TIMIŞOARA,"COLEGIUL TEHNIC ”AZUR”",129,"Alegeri Prezidentiale",1,1231,662,570,67,25,650,12,1400,738,499,151
37,TIMIŞ,"MUNICIPIUL TIMIŞOARA",155243,TIMIŞOARA,"COLEGIUL TEHNIC ”AZUR”",130,"Alegeri Prezidentiale",1,1368,751,657,66,28,730,21,1500,749,560,170
37,TIMIŞ,"MUNICIPIUL TIMIŞOARA",155243,TIMIŞOARA,"COLEGIUL TEHNIC ”AZUR”",131,"Alegeri Prezidentiale",1,1165,616,550,43,23,608,8,1300,684,455,153
37,TIMIŞ,"MUNICIPIUL TIMIŞOARA",155243,TIMIŞOARA,"LICEUL TEORETIC ”IRIS”",132,"Alegeri Prezidentiale",1,1449,900,691,209,0,878,22,1600,700,700,178
37,TIMIŞ,"MUNICIPIUL TIMIŞOARA",155243,TIMIŞOARA,"ŞCOALA GIMNAZIALĂ NR.25",133,"Alegeri Prezidentiale",1,1564,1015,785,230,0,993,22,1800,785,759,234
37,TIMIŞ,"MUNICIPIUL TIMIŞOARA",155243,TIMIŞOARA,"ŞCOALA GIMNAZIALĂ NR.25",134,"Alegeri Prezidentiale",1,1561,952,804,147,1,928,24,1700,748,718,210
37,TIMIŞ,"MUNICIPIUL TIMIŞOARA",155243,TIMIŞOARA,"ŞCOALA GIMNAZIALĂ NR.25",135,"Alegeri Prezidentiale",1,1947,1202,1098,104,0,1179,23,1600,398,949,230
37,TIMIŞ,"MUNICIPIUL TIMIŞOARA",155243,TIMIŞOARA,"ŞCOALA GIMNAZIALĂ NR.25",136,"Alegeri Prezidentiale",1,1513,804,753,51,0,780,24,1700,896,602,178
37,TIMIŞ,"MUNICIPIUL TIMIŞOARA",155243,TIMIŞOARA,"ŞCOALA GIMNAZIALĂ NR.25",137,"Alegeri Prezidentiale",1,1602,913,773,140,0,901,12,1800,887,724,177
37,TIMIŞ,"MUNICIPIUL TIMIŞOARA",155243,TIMIŞOARA,"GRĂDINIŢA CU PROGRAM PRELUNGIT NR. 11 ( GRĂDINIŢA CU PROGRAM PRELUNGIT NR.12)",138,"Alegeri Prezidentiale",1,863,492,401,91,0,479,13,1000,508,352,127
37,TIMIŞ,"MUNICIPIUL TIMIŞOARA",155243,TIMIŞOARA,"ŞCOALA GIMNAZIALĂ NR.15",139,"Alegeri Prezidentiale",1,1368,699,605,94,0,692,7,1500,801,530,162
37,TIMIŞ,"MUNICIPIUL TIMIŞOARA",155243,TIMIŞOARA,"ŞCOALA GIMNAZIALĂ NR.15",140,"Alegeri Prezidentiale",1,1063,609,529,80,0,594,15,1200,591,445,149
37,TIMIŞ,"MUNICIPIUL TIMIŞOARA",155243,TIMIŞOARA,"ŞCOALA GIMNAZIALĂ NR.15",141,"Alegeri Prezidentiale",1,1252,722,638,84,0,700,22,1400,678,565,135
37,TIMIŞ,"MUNICIPIUL TIMIŞOARA",155243,TIMIŞOARA,"ŞCOALA GIMNAZIALĂ NR.15",142,"Alegeri Prezidentiale",1,1277,583,534,49,0,573,10,1400,817,420,153
37,TIMIŞ,"MUNICIPIUL TIMIŞOARA",155243,TIMIŞOARA,"S.C.” DRUMURI MUNICIPALE TIMIŞOARA ” S.A.",143,"Alegeri Prezidentiale",1,1724,756,668,88,0,746,10,1400,644,592,154
37,TIMIŞ,"MUNICIPIUL TIMIŞOARA",155243,TIMIŞOARA,"S.C.” DRUMURI MUNICIPALE TIMIŞOARA ” S.A.",144,"Alegeri Prezidentiale",1,1677,767,713,54,0,754,13,1100,333,594,160
37,TIMIŞ,"MUNICIPIUL TIMIŞOARA",155243,TIMIŞOARA,"GRADINIŢA CU PROGRAM PRELUNGIT NR.23",145,"Alegeri Prezidentiale",1,1193,795,589,206,0,778,17,1300,505,569,209
37,TIMIŞ,"MUNICIPIUL TIMIŞOARA",155243,TIMIŞOARA,"ŞCOALA GIMNAZIALĂ NR.13",146,"Alegeri Prezidentiale",1,1110,544,467,77,0,533,11,1200,656,424,109
37,TIMIŞ,"MUNICIPIUL TIMIŞOARA",155243,TIMIŞOARA,"ŞCOALA GIMNAZIALĂ NR.13",147,"Alegeri Prezidentiale",1,1380,777,633,144,0,764,13,1500,723,587,177
37,TIMIŞ,"MUNICIPIUL TIMIŞOARA",155243,TIMIŞOARA,"ŞCOALA GIMNAZIALĂ NR.13",148,"Alegeri Prezidentiale",1,1305,746,583,162,1,731,15,1500,754,577,154
37,TIMIŞ,"MUNICIPIUL TIMIŞOARA",155243,TIMIŞOARA,"ŞCOALA GIMNAZIALĂ NR.13",149,"Alegeri Prezidentiale",1,1076,512,454,56,2,502,10,1208,696,403,99
37,TIMIŞ,"MUNICIPIUL TIMIŞOARA",155243,TIMIŞOARA,"COLEGIUL TEHNIC ELECTROTIMIŞ",150,"Alegeri Prezidentiale",1,1570,982,781,201,0,958,24,1800,818,767,191
37,TIMIŞ,"MUNICIPIUL TIMIŞOARA",155243,TIMIŞOARA,"COLEGIUL TEHNIC ELECTROTIMIŞ",151,"Alegeri Prezidentiale",1,1556,825,718,107,0,807,18,1700,875,656,151
37,TIMIŞ,"MUNICIPIUL TIMIŞOARA",155243,TIMIŞOARA,"COLEGIUL TEHNIC ELECTROTIMIŞ",152,"Alegeri Prezidentiale",1,1689,973,843,130,0,959,14,1900,927,766,193
37,TIMIŞ,"MUNICIPIUL TIMIŞOARA",155243,TIMIŞOARA,"COLEGIUL TEHNIC ELECTROTIMIŞ",153,"Alegeri Prezidentiale",1,1690,889,673,216,0,877,12,1900,1011,730,147
37,TIMIŞ,"MUNICIPIUL TIMIŞOARA",155243,TIMIŞOARA,"LICEUL TEORETIC ”VLAD TEPES”",154,"Alegeri Prezidentiale",1,1508,959,799,160,0,939,20,1700,741,711,228
37,TIMIŞ,"MUNICIPIUL TIMIŞOARA",155243,TIMIŞOARA,"LICEUL TEORETIC ”VLAD TEPES”",155,"Alegeri Prezidentiale",2,1314,681,494,187,0,671,10,1500,819,567,104
37,TIMIŞ,"MUNICIPIUL TIMIŞOARA",155243,TIMIŞOARA,"CENTRUL SCOLAR PENTRU EDUCATIE INCLUZIVA ”CONSTANTIN PUFAN”",156,"Alegeri Prezidentiale",1,1307,969,660,309,0,949,20,1400,431,748,201
37,TIMIŞ,"MUNICIPIUL TIMIŞOARA",155243,TIMIŞOARA,"ȘCOALA GIMNAZIALĂ NR.30 TIMIȘOARA",157,"Alegeri Prezidentiale",3,1604,939,816,123,0,928,11,1800,861,753,175
37,TIMIŞ,"MUNICIPIUL TIMIŞOARA",155243,TIMIŞOARA,"ȘCOALA GIMNAZIALĂ NR.30 TIMIȘOARA",158,"Alegeri Prezidentiale",1,1531,955,797,158,0,932,23,1700,745,729,203
37,TIMIŞ,"MUNICIPIUL TIMIŞOARA",155243,TIMIŞOARA,"ŞCOALA GIMNAZIALĂ NR.16 ” TAKE IONESCU ”",159,"Alegeri Prezidentiale",1,1391,882,655,114,113,866,16,1500,618,588,278
37,TIMIŞ,"MUNICIPIUL TIMIŞOARA",155243,TIMIŞOARA,"ŞCOALA GIMNAZIALĂ NR.16 ” TAKE IONESCU ”",160,"Alegeri Prezidentiale",1,1089,1024,565,327,132,995,29,1200,176,716,279
37,TIMIŞ,"MUNICIPIUL TIMIŞOARA",155243,TIMIŞOARA,"ŞCOALA GIMNAZIALĂ NR.16 ” TAKE IONESCU ”",161,"Alegeri Prezidentiale",1,1003,730,503,141,86,714,16,1100,370,454,260
37,TIMIŞ,"MUNICIPIUL TIMIŞOARA",155243,TIMIŞOARA,"GRĂDINIŢA CU PROGRAM PRELUNGIT NR.53 ( GRĂDINIŢA CU PROGRAM PRELUNGIT NR.48)",162,"Alegeri Prezidentiale",1,942,546,455,90,1,542,4,1000,454,422,120
37,TIMIŞ,"MUNICIPIUL TIMIŞOARA",155243,TIMIŞOARA,"LICEUL DE ARTE PLASTICE TIMIȘOARA ( FOSTUL GRUP ȘCOLAR TUDOR TĂNĂSESCU)",163,"Alegeri Prezidentiale",1,1644,819,736,55,28,804,15,1500,681,609,195
37,TIMIŞ,"MUNICIPIUL TIMIŞOARA",155243,TIMIŞOARA,"LICEUL DE ARTE PLASTICE TIMIȘOARA ( FOSTUL GRUP ȘCOLAR TUDOR TĂNĂSESCU)",164,"Alegeri Prezidentiale",1,1526,647,542,43,62,639,8,1400,753,505,134
37,TIMIŞ,"MUNICIPIUL TIMIŞOARA",155243,TIMIŞOARA,"LICEUL DE ARTE PLASTICE TIMIȘOARA ( FOSTUL GRUP ȘCOLAR TUDOR TĂNĂSESCU)",165,"Alegeri Prezidentiale",1,963,540,387,96,57,530,10,1100,560,423,107
37,TIMIŞ,"MUNICIPIUL TIMIŞOARA",155243,TIMIŞOARA,"ŞCOALA GIMNAZIALĂ NR.21 ” VICENŢIU BABEŞ ”",166,"Alegeri Prezidentiale",1,1419,971,702,269,0,957,14,1600,629,748,209
37,TIMIŞ,"MUNICIPIUL TIMIŞOARA",155243,TIMIŞOARA,"ŞCOALA GIMNAZIALĂ NR.21 ” VICENŢIU BABEŞ ”",167,"Alegeri Prezidentiale",1,1573,879,708,171,0,861,18,1700,821,660,201
37,TIMIŞ,"MUNICIPIUL TIMIŞOARA",155243,TIMIŞOARA,"ŞCOALA GIMNAZIALĂ NR.21 ” VICENŢIU BABEŞ ”",168,"Alegeri Prezidentiale",1,1533,940,768,172,0,910,30,1700,760,666,244
37,TIMIŞ,"MUNICIPIUL TIMIŞOARA",155243,TIMIŞOARA,"ŞCOALA GIMNAZIALĂ NR.21 ” VICENŢIU BABEŞ ”",169,"Alegeri Prezidentiale",1,1165,732,572,159,1,722,10,1300,568,549,173
37,TIMIŞ,"MUNICIPIUL TIMIŞOARA",155243,TIMIŞOARA,"ŞCOALA GIMNAZIALĂ NR.7 ”SFÂNTA MARIA ”",170,"Alegeri Prezidentiale",1,1429,896,716,180,0,873,23,1600,704,692,181
37,TIMIŞ,"MUNICIPIUL TIMIŞOARA",155243,TIMIŞOARA,"ŞCOALA GIMNAZIALĂ NR.7 ”SFÂNTA MARIA ”",171,"Alegeri Prezidentiale",1,1489,866,682,184,0,850,16,1600,734,693,157
37,TIMIŞ,"MUNICIPIUL TIMIŞOARA",155243,TIMIŞOARA,"ŞCOALA GIMNAZIALĂ NR.7 ”SFÂNTA MARIA ”",172,"Alegeri Prezidentiale",1,1446,890,721,168,1,863,27,1600,710,639,224
37,TIMIŞ,"MUNICIPIUL TIMIŞOARA",155243,TIMIŞOARA,"ŞCOALA GIMNAZIALĂ NR.7 ”SFÂNTA MARIA ”",173,"Alegeri Prezidentiale",1,1380,853,648,205,0,845,8,1500,647,667,178
37,TIMIŞ,"MUNICIPIUL TIMIŞOARA",155243,TIMIŞOARA,"ŞCOALA GIMNAZIALĂ NR.7 ”SFÂNTA MARIA ”",174,"Alegeri Prezidentiale",1,1112,573,540,32,1,565,8,1200,627,420,145
37,TIMIŞ,"MUNICIPIUL TIMIŞOARA",155243,TIMIŞOARA,"ŞCOALA GIMNAZIALĂ NR.7 ”SFÂNTA MARIA ”",175,"Alegeri Prezidentiale",1,1280,787,680,107,0,770,17,1400,613,597,173
37,TIMIŞ,"MUNICIPIUL TIMIŞOARA",155243,TIMIŞOARA,"GRĂDINIŢA CU PROGRAM PRELUNGIT NR.20",176,"Alegeri Prezidentiale",1,1621,870,728,142,0,854,16,1800,930,673,181
37,TIMIŞ,"MUNICIPIUL TIMIŞOARA",155243,TIMIŞOARA,"GRADINIŢA CU PROGRAM PRELUNGIT NR.20",177,"Alegeri Prezidentiale",1,1651,848,779,69,0,833,15,1800,952,634,199
37,TIMIŞ,"MUNICIPIUL TIMIŞOARA",155243,TIMIŞOARA,"GRADINIŢA CU PROGRAM PRELUNGIT NR.20",178,"Alegeri Prezidentiale",1,1402,826,754,72,0,808,18,1500,674,619,189
37,TIMIŞ,"MUNICIPIUL TIMIŞOARA",155243,TIMIŞOARA,"DIRECȚIA DE ASISTENȚĂ SOCIALĂ A MUNICIPIULUI TIMIȘOARA, COMPLEXUL DE SERVICII SOCIALE PENTRU PERSOANE VÂRSTNICE „SF. ARH. MIHAIL ȘI GAVRIL”",179,"Alegeri Prezidentiale",1,1384,792,671,121,0,771,21,1500,708,617,154
37,TIMIŞ,"MUNICIPIUL TIMIŞOARA",155243,TIMIŞOARA,"DIRECȚIA DE ASISTENȚĂ SOCIALĂ A MUNICIPIULUI TIMIȘOARA, COMPLEXUL DE SERVICII SOCIALE PENTRU PERSOANE VÂRSTNICE „SF. ARH. MIHAIL ȘI GAVRIL”",180,"Alegeri Prezidentiale",1,1211,780,573,207,0,762,18,1300,520,636,126
37,TIMIŞ,"MUNICIPIUL TIMIŞOARA",155243,TIMIŞOARA,"COLEGIUL TEHNIC ENERGETIC ” REGELE FERDINAND I ”- CĂMIN NR.1 ( FOST GRUP ŞCOLAR ” TUDOR TĂNĂSESCU ”)",181,"Alegeri Prezidentiale",1,1446,802,674,128,0,786,16,1600,798,640,146
37,TIMIŞ,"MUNICIPIUL TIMIŞOARA",155243,TIMIŞOARA,"COLEGIUL TEHNIC ENERGETIC ” REGELE FERDINAND I ”- CĂMIN NR.1 ( FOST GRUP ŞCOLAR ” TUDOR TĂNĂSESCU ”)",182,"Alegeri Prezidentiale",1,1264,637,536,101,0,630,7,1400,763,492,138
37,TIMIŞ,"MUNICIPIUL TIMIŞOARA",155243,TIMIŞOARA,"COLEGIUL TEHNIC ENERGETIC ” REGELE FERDINAND I ”- CĂMIN NR.1 ( FOST GRUP ŞCOLAR ” TUDOR TĂNĂSESCU ”)",183,"Alegeri Prezidentiale",1,1375,688,594,94,0,678,10,1500,812,531,147
37,TIMIŞ,"MUNICIPIUL TIMIŞOARA",155243,TIMIŞOARA,"COLEGIUL TEHNIC ENERGETIC ” REGELE FERDINAND I ”- CĂMIN NR.1 ( FOST GRUP ŞCOLAR ” TUDOR TĂNĂSESCU ”)",184,"Alegeri Prezidentiale",1,1292,601,527,74,0,589,12,1400,799,468,121
37,TIMIŞ,"MUNICIPIUL TIMIŞOARA",155243,TIMIŞOARA,"LICEUL TEORETIC ”WILLIAM SHAKESPEARE”",185,"Alegeri Prezidentiale",1,1370,832,660,169,3,805,27,1500,668,597,208
37,TIMIŞ,"MUNICIPIUL TIMIŞOARA",155243,TIMIŞOARA,"CENTRUL SCOLAR PENTRU EDUCATIE INCLUZIVA ” PAUL POPESCU NEVEANU”",186,"Alegeri Prezidentiale",1,1221,584,525,58,1,571,13,1400,816,464,107
37,TIMIŞ,"MUNICIPIUL TIMIŞOARA",155243,TIMIŞOARA,"CENTRUL SCOLAR PENTRU EDUCATIE INCLUZIVA ” PAUL POPESCU NEVEANU”",187,"Alegeri Prezidentiale",1,1175,483,440,43,0,479,4,1300,817,394,85
37,TIMIŞ,"MUNICIPIUL TIMIŞOARA",155243,TIMIŞOARA,"CENTRUL SCOLAR PENTRU EDUCATIE INCLUZIVA ” PAUL POPESCU NEVEANU”",188,"Alegeri Prezidentiale",1,1257,569,482,87,0,563,6,1400,831,453,110
37,TIMIŞ,"MUNICIPIUL TIMIŞOARA",155243,TIMIŞOARA,"CENTRUL ŞCOLAR PENTRU EDUCAŢIE INCLUZIVĂ ”PAUL POPESCU NEVEANU”",189,"Alegeri Prezidentiale",1,1073,524,482,40,2,519,5,1200,676,398,121
37,TIMIŞ,"MUNICIPIUL TIMIŞOARA",155243,TIMIŞOARA,"LICEUL TEORETIC JEAN LOUIS CALDERON CORP A",190,"Alegeri Prezidentiale",1,1149,671,523,148,0,665,6,1300,629,531,134
37,TIMIŞ,"MUNICIPIUL TIMIŞOARA",155243,TIMIŞOARA,"LICEUL TEORETIC JEAN LOUIS CALDERON CORP A",191,"Alegeri Prezidentiale",1,1213,710,557,153,0,698,12,1400,690,569,129
37,TIMIŞ,"MUNICIPIUL TIMIŞOARA",155243,TIMIŞOARA,"LICEUL TEORETIC JEAN LOUIS CALDERON CORP A",192,"Alegeri Prezidentiale",1,1152,703,530,170,3,690,13,1300,597,538,152
37,TIMIŞ,"MUNICIPIUL TIMIŞOARA",155243,TIMIŞOARA,"LICEUL TEORETIC JEAN LOUIS CALDERON CORP A",193,"Alegeri Prezidentiale",1,985,673,467,200,6,653,20,1100,427,514,139
37,TIMIŞ,"MUNICIPIUL TIMIŞOARA",155243,TIMIŞOARA,"LICEUL TEOLOGIC PENTICOSTAL LOGOS",194,"Alegeri Prezidentiale",1,1433,815,728,86,1,794,21,1600,785,627,167
37,TIMIŞ,"MUNICIPIUL TIMIŞOARA",155243,TIMIŞOARA,"LICEUL TEOLOGIC PENTICOSTAL LOGOS",195,"Alegeri Prezidentiale",1,1062,562,482,80,0,550,12,1200,638,415,135
37,TIMIŞ,"MUNICIPIUL TIMIŞOARA",155243,TIMIŞOARA,"LICEUL TEOLOGIC PENTICOSTAL LOGOS",196,"Alegeri Prezidentiale",1,1120,615,511,104,0,604,11,1200,585,453,151
37,TIMIŞ,"MUNICIPIUL TIMIŞOARA",155243,TIMIŞOARA,"LICEUL TEOLOGIC PENTICOSTAL LOGOS",197,"Alegeri Prezidentiale",1,1266,604,566,38,0,593,11,1400,796,469,124
37,TIMIŞ,"MUNICIPIUL TIMIŞOARA",155243,TIMIŞOARA,"ŞCOALA GIMNAZIALĂ NR.6 (GRADINIŢA CU PROGRAM PRELUNGIT NR. 30)",198,"Alegeri Prezidentiale",1,1517,667,583,84,0,656,11,1700,1033,525,131
37,TIMIŞ,"MUNICIPIUL TIMIŞOARA",155243,TIMIŞOARA,"ŞCOALA GIMNAZIALĂ NR.6 (GRADINIŢA CU PROGRAM PRELUNGIT NR. 30)",199,"Alegeri Prezidentiale",1,1771,809,758,51,0,799,10,1900,1091,601,198
37,TIMIŞ,"MUNICIPIUL TIMIŞOARA",155243,TIMIŞOARA,"COLEGIUL TEHNIC ” ELECTROTIMIŞ ” ( ŞCOALA GIMNAZIALĂ NR.20 )",200,"Alegeri Prezidentiale",1,1729,1264,1094,170,0,1236,28,1900,636,1002,234
37,TIMIŞ,"MUNICIPIUL TIMIŞOARA",155243,TIMIŞOARA,"ŞCOALA GIMNAZIALĂ NR.1( ŞCOALA GIMNAZIALĂ NR. 4 )",201,"Alegeri Prezidentiale",1,1621,884,826,58,0,874,10,1800,916,666,208
37,TIMIŞ,"MUNICIPIUL TIMIŞOARA",155243,TIMIŞOARA,"ŞCOALA GIMNAZIALĂ NR.1( ŞCOALA GIMNAZIALĂ NR. 4 )",202,"Alegeri Prezidentiale",1,1429,734,704,30,0,712,22,1600,866,562,150
37,TIMIŞ,"MUNICIPIUL TIMIŞOARA",155243,TIMIŞOARA,"GRĂDINIŢA CU PROGRAM PRELUNGIT NR.38 ( GRĂDINIŢA CU PROGRAM PRELUNGIT NR.6 )",203,"Alegeri Prezidentiale",1,1288,778,716,62,0,759,19,1400,622,568,191
37,TIMIŞ,"MUNICIPIUL TIMIŞOARA",155243,TIMIŞOARA,"GRĂDINIŢA CU PROGRAM PRELUNGIT NR.38 ( GRĂDINIŢA CU PROGRAM PRELUNGIT NR.6 )",204,"Alegeri Prezidentiale",1,1312,709,655,54,0,689,20,1400,691,517,172
37,TIMIŞ,"MUNICIPIUL TIMIŞOARA",155243,TIMIŞOARA,"ȘCOALA GIMNAZIALĂ NR.1 TIMIȘOARA",205,"Alegeri Prezidentiale",1,1248,538,436,74,28,534,4,1400,862,404,130
37,TIMIŞ,"MUNICIPIUL TIMIŞOARA",155243,TIMIŞOARA,"ȘCOALA GIMNAZIALĂ NR.1 TIMIȘOARA",206,"Alegeri Prezidentiale",1,1073,600,469,131,0,586,14,1200,600,464,122
37,TIMIŞ,"MUNICIPIUL TIMIŞOARA",155243,TIMIŞOARA,"GRADINITA AEROPORT CU PROGRAM PRELUNGIT NR.13",207,"Alegeri Prezidentiale",1,507,345,283,62,0,342,3,600,255,268,74
37,TIMIŞ,"MUNICIPIUL LUGOJ",155350,LUGOJ,"COLEGIUL NAŢIONAL ”IULIA HAŞDEU”",208,"Alegeri Prezidentiale",1,1218,598,530,68,0,592,6,1300,702,414,178
37,TIMIŞ,"MUNICIPIUL LUGOJ",155350,LUGOJ,"ŞCOALA GIMNAZIALĂ NR.3",209,"Alegeri Prezidentiale",1,1565,732,632,100,0,731,1,1700,968,513,218
37,TIMIŞ,"MUNICIPIUL LUGOJ",155350,LUGOJ,"GRĂDINIŢA CU PROGRAM PRELUNGIT NR.3",210,"Alegeri Prezidentiale",1,1664,761,694,67,0,750,11,1800,1039,565,185
37,TIMIŞ,"MUNICIPIUL LUGOJ",155350,LUGOJ,"GRĂDINIŢA CU PROGRAM PRELUNGIT NR.4",211,"Alegeri Prezidentiale",1,1308,513,492,20,1,500,13,1500,987,355,145
37,TIMIŞ,"MUNICIPIUL LUGOJ",155350,LUGOJ,"GRĂDINIŢA CU PROGRAM PRELUNGIT NR.4",212,"Alegeri Prezidentiale",1,1033,470,423,47,0,461,9,1100,630,343,118
37,TIMIŞ,"MUNICIPIUL LUGOJ",155350,LUGOJ,"ŞCOALA GIMNAZIALĂ NR.4",213,"Alegeri Prezidentiale",1,1019,469,424,43,2,464,5,1100,631,336,128
37,TIMIŞ,"MUNICIPIUL LUGOJ",155350,LUGOJ,"GRĂDINIŢA CU PROGRAM PRELUNGIT NR.5",214,"Alegeri Prezidentiale",1,1404,627,591,36,0,620,7,1600,973,441,179
37,TIMIŞ,"MUNICIPIUL LUGOJ",155350,LUGOJ,"GRĂDINIŢA CU PROGRAM PRELUNGIT NR.5",215,"Alegeri Prezidentiale",1,1224,554,523,31,0,546,8,1400,846,396,150
37,TIMIŞ,"MUNICIPIUL LUGOJ",155350,LUGOJ,"ŞCOALA GIMNAZIALĂ NR.2",216,"Alegeri Prezidentiale",1,1468,669,622,47,0,660,9,1600,931,472,188
37,TIMIŞ,"MUNICIPIUL LUGOJ",155350,LUGOJ,"GRĂDINIŢA CU PROGRAM PRELUNGIT NR.7",217,"Alegeri Prezidentiale",1,1410,636,603,33,0,632,4,1600,964,463,169
37,TIMIŞ,"MUNICIPIUL LUGOJ",155350,LUGOJ,"GRĂDINIŢA CU PROGRAM NORMAL NR.11",218,"Alegeri Prezidentiale",1,1272,577,556,21,0,562,15,1400,823,423,139
37,TIMIŞ,"MUNICIPIUL LUGOJ",155350,LUGOJ,"GRĂDINIŢA CU PROGRAM NORMAL NR.11",219,"Alegeri Prezidentiale",1,1017,503,472,31,0,492,11,1100,597,331,161
37,TIMIŞ,"MUNICIPIUL LUGOJ",155350,LUGOJ,"SALA SPORTURILOR ”IOAN KUNST GHERMĂNESCU”",220,"Alegeri Prezidentiale",1,749,451,366,85,0,437,14,800,349,310,127
37,TIMIŞ,"MUNICIPIUL LUGOJ",155350,LUGOJ,"SALA SPORTURILOR ”IOAN KUNST GHERMĂNESCU”",221,"Alegeri Prezidentiale",1,1433,756,676,80,0,743,13,1600,844,523,220
37,TIMIŞ,"MUNICIPIUL LUGOJ",155350,LUGOJ,"SALA SPORTURILOR ”IOAN KUNST GHERMĂNESCU”",222,"Alegeri Prezidentiale",1,1303,660,614,46,0,647,13,1500,840,443,204
37,TIMIŞ,"MUNICIPIUL LUGOJ",155350,LUGOJ,"SALA SPORTURILOR ”IOAN KUNST GHERMĂNESCU”",223,"Alegeri Prezidentiale",1,1140,527,478,49,0,517,10,1300,773,357,160
37,TIMIŞ,"MUNICIPIUL LUGOJ",155350,LUGOJ,"ŞCOALA GIMNAZIALĂ ”EFTIMIE MURGU”",224,"Alegeri Prezidentiale",1,1146,600,549,50,1,594,6,1300,700,424,170
37,TIMIŞ,"MUNICIPIUL LUGOJ",155350,LUGOJ,"ŞCOALA GIMNAZIALĂ ”EFTIMIE MURGU”",225,"Alegeri Prezidentiale",1,1409,659,612,47,0,647,12,1600,941,462,185
37,TIMIŞ,"MUNICIPIUL LUGOJ",155350,LUGOJ,"GRĂDINIŢA CU PROGRAM NORMAL NR.13",226,"Alegeri Prezidentiale",1,1625,791,718,73,0,769,22,1800,1009,568,201
37,TIMIŞ,"MUNICIPIUL LUGOJ",155350,LUGOJ,"COLEGIUL TEHNIC ”VALERIU BRANIŞTE”",227,"Alegeri Prezidentiale",1,1124,660,537,56,67,652,8,1200,540,461,191
37,TIMIŞ,"MUNICIPIUL LUGOJ",155350,LUGOJ,"GRĂDINIŢA CU PROGRAM PRELUNGIT NR.2",228,"Alegeri Prezidentiale",1,1515,632,601,31,0,621,11,1700,1068,474,147
37,TIMIŞ,"MUNICIPIUL LUGOJ",155350,LUGOJ,"ŞCOALA GIMNAZIALĂ NR.1",229,"Alegeri Prezidentiale",1,1294,654,624,30,0,640,14,1400,746,509,131
37,TIMIŞ,"MUNICIPIUL LUGOJ",155350,LUGOJ,"ŞCOALA GIMNAZIALĂ NR.1",230,"Alegeri Prezidentiale",1,1293,669,639,30,0,658,11,1400,731,493,165
37,TIMIŞ,"MUNICIPIUL LUGOJ",155350,LUGOJ,"ŞCOALA GIMNAZIALĂ NR.1",231,"Alegeri Prezidentiale",1,446,197,164,33,0,193,4,500,303,171,22
37,TIMIŞ,"MUNICIPIUL LUGOJ",155350,LUGOJ,"CINEMATOGRAFUL ”BELA LUGOSI”",232,"Alegeri Prezidentiale",1,1090,537,410,127,0,528,9,1200,663,402,126
37,TIMIŞ,"MUNICIPIUL LUGOJ",155350,LUGOJ,"SALA DE LUPTE ŞI GIMNASTICĂ ”FRANCISC HORVATH”",233,"Alegeri Prezidentiale",1,1099,464,418,46,0,454,10,1200,736,325,129
37,TIMIŞ,"MUNICIPIUL LUGOJ",155350,LUGOJ,"BAZA DE AGREMENT ŞTRAND",234,"Alegeri Prezidentiale",1,1236,614,573,41,0,606,8,1400,786,435,171
37,TIMIŞ,"MUNICIPIUL LUGOJ",155350,LUGOJ,"SALA SPORTURILOR ”LAVINIA MILOŞOVICI”",235,"Alegeri Prezidentiale",1,1524,765,680,85,0,749,16,1700,935,581,168
37,TIMIŞ,"MUNICIPIUL LUGOJ",155350,LUGOJ,"SALA SPORTURILOR ”LAVINIA MILOŞOVICI”",236,"Alegeri Prezidentiale",1,1517,757,723,34,0,737,20,1700,943,573,164
37,TIMIŞ,"MUNICIPIUL LUGOJ",155350,LUGOJ,"SALA SPORTURILOR ”LAVINIA MILOŞOVICI”",237,"Alegeri Prezidentiale",1,1583,735,686,49,0,726,9,1800,1065,526,200
37,TIMIŞ,"MUNICIPIUL LUGOJ",155350,MĂGURI,"CĂMINUL CULTURAL MĂGURI",238,"Alegeri Prezidentiale",1,768,198,175,23,0,195,3,800,602,127,68
37,TIMIŞ,"MUNICIPIUL LUGOJ",155350,TAPIA,"GRĂDINIŢA CU PROGRAM NORMAL NR.5 TĂPIA",239,"Alegeri Prezidentiale",1,260,128,111,17,0,128,0,300,172,74,54
37,TIMIŞ,"ORAŞ BUZIAŞ",155403,BUZIAŞ,"ŞCOALA GIMNAZIALĂ BUZIAŞ",240,"Alegeri Prezidentiale",1,1513,748,640,96,12,730,18,1700,952,495,235
37,TIMIŞ,"ORAŞ BUZIAŞ",155403,BUZIAŞ,"ŞCOALA GENERALĂ",241,"Alegeri Prezidentiale",1,1351,774,478,186,110,762,12,1500,726,421,341
37,TIMIŞ,"ORAŞ BUZIAŞ",155403,BUZIAŞ,"LICEUL TEORETIC",242,"Alegeri Prezidentiale",1,1796,904,731,173,0,880,24,2000,1096,533,347
37,TIMIŞ,"ORAŞ BUZIAŞ",155403,BACOVA,"ŞCOALA GIMNAZIALĂ BACOVA",243,"Alegeri Prezidentiale",1,1613,643,562,81,0,637,6,1800,1157,521,116
37,TIMIŞ,"ORAŞ BUZIAŞ",155403,SILAGIU,"ŞCOALA PRIMARĂ SILAGIU",244,"Alegeri Prezidentiale",1,655,383,341,42,0,380,3,700,317,276,104
37,TIMIŞ,"ORAŞ CIACOVA",156357,CIACOVA,PRIMĂRIE,245,"Alegeri Prezidentiale",2,1287,593,520,73,0,585,8,1400,807,453,132
37,TIMIŞ,"ORAŞ CIACOVA",156357,CIACOVA,"LICEUL TEORETIC ”ALEXANDRU MOCIONI ”CIACOVA",246,"Alegeri Prezidentiale",1,991,448,372,48,28,442,6,1100,652,348,94
37,TIMIŞ,"ORAŞ CIACOVA",156357,CEBZA,"ȘCOALA PRIMARĂ CEBZA",247,"Alegeri Prezidentiale",1,623,311,230,81,0,306,5,700,389,223,83
37,TIMIŞ,"ORAŞ CIACOVA",156357,MACEDONIA,"ȘCOALA PRIMARĂ MACEDONIA",248,"Alegeri Prezidentiale",1,368,236,176,58,2,230,6,400,164,171,59
37,TIMIŞ,"ORAŞ CIACOVA",156357,OBAD,"ŞCOALA PRIMARĂ OBAD",249,"Alegeri Prezidentiale",1,515,277,236,41,0,276,1,600,323,214,62
37,TIMIŞ,"ORAŞ CIACOVA",156357,PETROMAN,"ŞCOALA PRIMARĂ PETROMAN",250,"Alegeri Prezidentiale",1,582,281,221,60,0,278,3,600,319,217,61
37,TIMIŞ,"ORAŞ DETA",155458,DETA,"LICEUL SFÂNTUL NICOLAE DETA",251,"Alegeri Prezidentiale",1,1631,707,637,70,0,702,5,1800,1093,528,174
37,TIMIŞ,"ORAŞ DETA",155458,DETA,"ȘCOALA GIMNAZIALĂ DETA",252,"Alegeri Prezidentiale",1,1466,531,458,73,0,523,8,1600,1069,388,135
37,TIMIŞ,"ORAŞ DETA",155458,DETA,"ȘCOALA GIMNAZIALĂ DETA",253,"Alegeri Prezidentiale",1,1601,548,518,30,0,538,10,1800,1252,402,136
37,TIMIŞ,"ORAŞ DETA",155458,DETA,"CENTRUL CULTURAL AL ORAȘULUI DETA",254,"Alegeri Prezidentiale",1,1126,422,392,30,0,411,11,1300,878,296,115
37,TIMIŞ,"ORAŞ DETA",155458,OPATIŢA,"CĂMINUL CULTURAL OPATIŢA",255,"Alegeri Prezidentiale",1,567,283,255,28,0,281,2,600,317,226,55
37,TIMIŞ,"ORAŞ FĂGET",156801,FĂGET,"CASA DE CULTURA FAGET",256,"Alegeri Prezidentiale",1,1561,777,661,114,2,767,10,1700,923,482,285
37,TIMIŞ,"ORAŞ FĂGET",156801,FĂGET,"SC TRANSPORT MIXT FAGETEANA SA",257,"Alegeri Prezidentiale",1,305,171,124,38,9,169,2,400,229,114,55
37,TIMIŞ,"ORAŞ FĂGET",156801,FĂGET,"GRĂDINIŢA CU PROGRAM NORMAL FĂGET",258,"Alegeri Prezidentiale",1,1380,708,663,43,2,699,9,1500,792,453,246
37,TIMIŞ,"ORAŞ FĂGET",156801,BĂTEŞTI,"ŞCOALA PRIMARĂ BĂTEȘTI,",259,"Alegeri Prezidentiale",1,407,209,190,17,2,200,9,400,191,124,76
37,TIMIŞ,"ORAŞ FĂGET",156801,"BEGHEIU MIC","FOSTA ŞCOALA GIMNAZIALĂ BEGHEIUL MIC",260,"Alegeri Prezidentiale",1,272,163,150,13,0,159,4,300,137,93,66
37,TIMIŞ,"ORAŞ FĂGET",156801,BICHIGI,"CĂMINUL CULTURAL BICHIGI",261,"Alegeri Prezidentiale",1,501,247,225,20,2,239,8,600,353,136,103
37,TIMIŞ,"ORAŞ FĂGET",156801,BRĂNEŞTI,"CAMINUL CULTURAL BRĂNEŞTI",262,"Alegeri Prezidentiale",1,407,200,179,21,0,198,2,500,300,103,95
37,TIMIŞ,"ORAŞ FĂGET",156801,"BUNEA MARE","ȘCOALA PRIMARĂ BUNEA MARE",263,"Alegeri Prezidentiale",1,171,92,82,10,0,91,1,200,108,62,29
37,TIMIŞ,"ORAŞ FĂGET",156801,"COLONIA MICĂ","ŞCOALA PRIMARĂ , COLONIA MICĂ",264,"Alegeri Prezidentiale",1,295,127,107,20,0,125,2,300,173,80,45
37,TIMIŞ,"ORAŞ FĂGET",156801,JUPÂNEŞTI,"FOSTA ȘCOALA GENERALĂ JUPÂNEŞTI",265,"Alegeri Prezidentiale",1,153,89,70,19,0,89,0,200,111,55,34
37,TIMIŞ,"ORAŞ FĂGET",156801,POVÂRGINA,"CAMINUL CULTURAL POVERGINA",266,"Alegeri Prezidentiale",1,132,79,66,13,0,79,0,200,121,51,28
37,TIMIŞ,"ORAŞ FĂGET",156801,TEMEREŞTI,"CAMINUL CULTURAL TEMEREŞTI",267,"Alegeri Prezidentiale",1,433,237,196,26,15,233,4,500,263,113,120
37,TIMIŞ,"ORAŞ GĂTAIA",157086,GĂTAIA,"CASA DE CULTURĂ GĂTAIA",268,"Alegeri Prezidentiale",1,1380,617,532,84,1,604,13,1500,883,416,188
37,TIMIŞ,"ORAŞ GĂTAIA",157086,GĂTAIA,"PRIMARIA ORAS GATAIA",269,"Alegeri Prezidentiale",1,1338,524,444,78,2,516,8,1400,876,337,179
37,TIMIŞ,"ORAŞ GĂTAIA",157086,SCULIA,"SCOALA PRIMARA SCULIA",270,"Alegeri Prezidentiale",1,1625,823,666,61,96,796,27,1800,977,542,254
37,TIMIŞ,"ORAŞ GĂTAIA",157086,BUTIN,"ŞCOALA PRIMARĂ BUTIN",271,"Alegeri Prezidentiale",2,311,147,129,18,0,147,0,400,253,115,32
37,TIMIŞ,"ORAŞ GĂTAIA",157086,PERCOSOVA,"ŞCOALA PRIMARĂ PERCOSOVA",272,"Alegeri Prezidentiale",1,233,156,114,42,0,155,1,300,144,107,48
37,TIMIŞ,"ORAŞ GĂTAIA",157086,"ŞEMLACU MARE","SCOALA PRIMARA SEMLACU MARE",273,"Alegeri Prezidentiale",1,271,122,87,35,0,122,0,300,178,95,27
37,TIMIŞ,"ORAŞ GĂTAIA",157086,"ŞEMLACU MIC","ŞCOALA PRIMARĂ ŞEMLACUL MIC",274,"Alegeri Prezidentiale",1,145,85,64,21,0,85,0,200,115,66,19
37,TIMIŞ,"ORAŞ JIMBOLIA",155494,JIMBOLIA,"LICEUL TEHNOLOGIC JIMBOLIA",275,"Alegeri Prezidentiale",1,1718,578,537,41,0,567,11,1900,1322,428,139
37,TIMIŞ,"ORAŞ JIMBOLIA",155494,JIMBOLIA,"LICEUL TEHNOLOGIC JIMBOLIA",276,"Alegeri Prezidentiale",1,1534,597,538,53,6,587,10,1700,1103,451,136
37,TIMIŞ,"ORAŞ JIMBOLIA",155494,JIMBOLIA,"ŞCOALA GIMNAZIALĂ JIMBOLIA",277,"Alegeri Prezidentiale",1,1620,564,528,36,0,558,6,1800,1236,450,108
37,TIMIŞ,"ORAŞ JIMBOLIA",155494,JIMBOLIA,"ŞCOALA GIMNAZIALĂ JIMBOLIA",278,"Alegeri Prezidentiale",1,1616,620,583,35,2,614,6,1800,1180,498,116
37,TIMIŞ,"ORAŞ JIMBOLIA",155494,JIMBOLIA,"INCUBATORUL DE AFACERI JIMBOLIA",279,"Alegeri Prezidentiale",1,1473,612,547,65,0,607,5,1600,988,482,125
37,TIMIŞ,"ORAŞ JIMBOLIA",155494,JIMBOLIA,"CASA DE CULTURĂ",280,"Alegeri Prezidentiale",1,1524,604,543,35,26,593,11,1700,1096,445,148
37,TIMIŞ,"ORAŞ JIMBOLIA",155494,JIMBOLIA,"CASA DE CULTURĂ",281,"Alegeri Prezidentiale",1,1327,485,413,72,0,479,6,1500,1015,375,104
37,TIMIŞ,"ORAŞ JIMBOLIA",155494,JIMBOLIA,"GRADINITA CU PROGRAM NORMAL CLARII VII",282,"Alegeri Prezidentiale",1,224,71,59,12,0,71,0,300,229,67,4
37,TIMIŞ,"ORAŞ RECAŞ",158314,RECAŞ,"PRIMĂRIA RECAȘ",283,"Alegeri Prezidentiale",1,1821,793,684,108,1,768,25,2000,1207,553,215
37,TIMIŞ,"ORAŞ RECAŞ",158314,RECAŞ,"GRĂDINIȚA CU P.P. RECAȘ",284,"Alegeri Prezidentiale",1,1412,633,583,50,0,626,7,1600,967,429,197
37,TIMIŞ,"ORAŞ RECAŞ",158314,RECAŞ,"LICEUL TEORETIC RECAȘ",285,"Alegeri Prezidentiale",1,1708,874,736,138,0,848,26,1900,1026,614,234
37,TIMIŞ,"ORAŞ RECAŞ",158314,BAZOŞ,"ȘCOALA GIMNAZIALĂ BAZOȘ",286,"Alegeri Prezidentiale",1,803,390,300,89,1,387,3,800,410,278,109
37,TIMIŞ,"ORAŞ RECAŞ",158314,HERNEACOVA,"ȘCOALA PRIMARĂ HERNEACOVA",287,"Alegeri Prezidentiale",1,365,204,152,52,0,200,4,400,196,140,60
37,TIMIŞ,"ORAŞ RECAŞ",158314,IZVIN,"ȘCOALA GIMNAZIALĂ IZVIN",288,"Alegeri Prezidentiale",1,1324,697,588,109,0,683,14,1400,703,525,158
37,TIMIŞ,"ORAŞ RECAŞ",158314,PETROVASELO,"ȘCOALA PRIMARĂ PETROVASELO",289,"Alegeri Prezidentiale",1,212,142,95,47,0,141,1,300,158,99,42
37,TIMIŞ,"ORAŞ RECAŞ",158314,STANCIOVA,"ȘCOALA PRIMARĂ STANCIOVA",290,"Alegeri Prezidentiale",1,301,166,112,54,0,164,2,400,234,124,40
37,TIMIŞ,"ORAŞ SÂNNICOLAU MARE",155528,"SÂNNICOLAU MARE","SALA CASEI DE CULTURĂ (CASTEL NAKO)ETAJ 1",291,"Alegeri Prezidentiale",1,1348,666,602,64,0,648,18,1500,834,514,134
37,TIMIŞ,"ORAŞ SÂNNICOLAU MARE",155528,"SÂNNICOLAU MARE","SALA CASEI DE CULTURĂ (CASTEL NAKO) DEMISOL",292,"Alegeri Prezidentiale",1,1671,779,719,59,1,773,6,1800,1021,589,184
37,TIMIŞ,"ORAŞ SÂNNICOLAU MARE",155528,"SÂNNICOLAU MARE","PRIMĂRIA ORAŞULUI SÂNNICOLAU MARE",293,"Alegeri Prezidentiale",1,1784,907,808,99,0,894,13,1900,993,667,227
37,TIMIŞ,"ORAŞ SÂNNICOLAU MARE",155528,"SÂNNICOLAU MARE","GRĂDINIŢA PP1 NR.1 PARTER, SÂNNICOLAU MARE",294,"Alegeri Prezidentiale",1,1836,797,749,46,2,784,13,2000,1203,645,139
37,TIMIŞ,"ORAŞ SÂNNICOLAU MARE",155528,"SÂNNICOLAU MARE","GRĂDINIŢA PP1 NR.1 ETAJ, SÂNNICOLAU MARE",295,"Alegeri Prezidentiale",1,1482,682,646,34,2,665,17,1600,918,509,156
37,TIMIŞ,"ORAŞ SÂNNICOLAU MARE",155528,"SÂNNICOLAU MARE","LICEUL TEHNOLOGIC CRISTOFOR NAKO ORAŞ SÂNNICOLAU MARE",296,"Alegeri Prezidentiale",1,1883,751,663,88,0,735,16,2000,1249,580,155
37,TIMIŞ,"ORAŞ SÂNNICOLAU MARE",155528,"SÂNNICOLAU MARE","ŞCOALA GIMNAZIALA THEODOR BUCURESCU NR.1, SÂNNICOLAU MARE, PARTER",297,"Alegeri Prezidentiale",1,1800,862,742,81,39,848,14,1900,1038,646,202
37,TIMIŞ,BALINŢ,155546,BALINŢ,"CĂMINUL CULTURAL BALINŢ",298,"Alegeri Prezidentiale",1,412,264,166,93,5,260,4,500,236,133,127
37,TIMIŞ,BALINŢ,155546,BODO,"GRADINITA PN BODO",299,"Alegeri Prezidentiale",1,399,224,168,53,3,222,2,400,176,183,39
37,TIMIŞ,BALINŢ,155546,FĂDIMAC,"ŞCOALA PRIMARĂ FĂDIMAC",300,"Alegeri Prezidentiale",1,185,115,85,27,3,113,2,200,85,57,56
37,TIMIŞ,BALINŢ,155546,TÂRGOVIŞTE,"ŞCOALA PRIMARĂ TÎRGOVIŞTE",301,"Alegeri Prezidentiale",1,269,195,144,49,2,192,3,300,105,110,82
37,TIMIŞ,BANLOC,155591,BANLOC,"PRIMĂRIA BANLOC",302,"Alegeri Prezidentiale",1,1363,491,447,44,0,485,6,1492,1001,317,168
37,TIMIŞ,BANLOC,155591,OFSENIŢA,"GRĂDINIŢA CU PROGRAM NORMAL OFSENIŢA",303,"Alegeri Prezidentiale",1,331,133,115,18,0,132,1,400,267,110,22
37,TIMIŞ,BANLOC,155591,PARTOŞ,"GRĂDINIŢA CU PROGRAM NORMAL PARTOŞ",304,"Alegeri Prezidentiale",1,376,178,138,40,0,176,2,400,222,120,56
37,TIMIŞ,BANLOC,155591,SOCA,"GRĂDINIŢA CU PROGRAM NORMAL SOCA",305,"Alegeri Prezidentiale",1,450,202,173,29,0,201,1,500,298,136,65
37,TIMIŞ,BARA,155662,BARA,"PRIMARIA BARA",306,"Alegeri Prezidentiale",1,143,104,69,31,4,104,0,200,96,45,59
37,TIMIŞ,BARA,155662,DOBREŞTI,"CLĂDIREA COMUNEI BARA ( FOSTA SCOALĂ DOBRESTI)",307,"Alegeri Prezidentiale",1,31,65,24,41,0,65,0,100,35,25,40
37,TIMIŞ,BARA,155662,LĂPUŞNIC,"CĂMINUL CULTURAL LĂPUŞNIC",308,"Alegeri Prezidentiale",1,37,46,25,21,0,46,0,100,54,19,27
37,TIMIŞ,BARA,155662,RĂDMĂNEŞTI,"CĂMINUL CULTURAL RĂDMĂNEŞTI",309,"Alegeri Prezidentiale",1,49,37,19,18,0,37,0,100,63,12,25
37,TIMIŞ,BÂRNA,155957,BÂRNA,"CĂMINUL CULTURAL BÎRNA",310,"Alegeri Prezidentiale",1,412,195,162,33,0,193,2,500,305,109,84
37,TIMIŞ,BÂRNA,155957,BOTINEŞTI,"CĂMINUL CULTURAL BOTINEŞTI",311,"Alegeri Prezidentiale",1,158,104,82,22,0,103,1,200,96,41,62
37,TIMIŞ,BÂRNA,155957,DRINOVA,"CĂMINUL CULTURAL DRINOVA",312,"Alegeri Prezidentiale",1,162,122,97,25,0,122,0,200,78,65,57
37,TIMIŞ,BÂRNA,155957,JUREŞTI,"CĂMINUL CULTURAL JUREŞTI",313,"Alegeri Prezidentiale",1,183,108,91,17,0,107,1,200,92,51,56
37,TIMIŞ,BÂRNA,155957,POGĂNEŞTI,"CĂMINUL CULTURAL POGĂNEŞTI",314,"Alegeri Prezidentiale",1,274,119,107,12,0,117,2,300,181,72,45
37,TIMIŞ,"BEBA VECHE",155724,"BEBA VECHE","CĂMINUL CULTURAL BEBA VECHE",315,"Alegeri Prezidentiale",1,842,441,395,46,0,435,6,899,458,250,185
37,TIMIŞ,"BEBA VECHE",155724,CHERESTUR,"CĂMINUL CULTURAL CHEREŞTUR",316,"Alegeri Prezidentiale",1,409,222,191,31,0,220,2,500,278,149,71
37,TIMIŞ,"BECICHERECU MIC",155760,"BECICHERECU MIC","GRĂDINIŢA PP DIMITRIE ŢICHINDEAL",317,"Alegeri Prezidentiale",1,1444,769,624,145,0,756,13,1500,731,530,226
37,TIMIŞ,"BECICHERECU MIC",155760,"BECICHERECU MIC","ŞCOALA GIMNAZIALĂ DIMITRIE ŢICHINDEAL",318,"Alegeri Prezidentiale",1,1264,630,488,142,0,616,14,1400,770,426,190
37,TIMIŞ,BELINŢ,155797,BELINŢ,"PRIMĂRIA BELINŢ",319,"Alegeri Prezidentiale",1,1174,659,530,129,0,650,9,1300,641,454,196
37,TIMIŞ,BELINŢ,155797,BABŞA,"GRADINITA CU PROGRAM NORMAL BABSA-GRUNI",320,"Alegeri Prezidentiale",1,181,118,90,28,0,114,4,200,82,70,44
37,TIMIŞ,BELINŢ,155797,GRUNI,"GRADINITA CU PROGRAM NORMAL BABSA-GRUNI",321,"Alegeri Prezidentiale",1,176,136,94,42,0,133,3,200,64,88,45
37,TIMIŞ,BELINŢ,155797,CHIZĂTĂU,"GRADINITA CU PROGRAM NORMAL CHIZATAU",322,"Alegeri Prezidentiale",1,608,353,262,89,2,343,10,700,347,245,98
37,TIMIŞ,BETHAUSEN,155840,BETHAUSEN,"PRIMĂRIA BETHAUSEN",323,"Alegeri Prezidentiale",1,699,366,313,53,0,365,1,800,434,212,153
37,TIMIŞ,BETHAUSEN,155840,CLADOVA,"ȘCOALA PRIMARĂ CLADOVA ȘI GRĂDINIȚA CU PROGRAM NORMAL CLADOVA",324,"Alegeri Prezidentiale",1,367,188,172,16,0,186,2,400,212,104,82
37,TIMIŞ,BETHAUSEN,155840,CLICIOVA,"CĂMINUL CULTURAL CLICIOVA",325,"Alegeri Prezidentiale",1,344,215,188,27,0,215,0,400,185,61,154
37,TIMIŞ,BETHAUSEN,155840,CUTINA,"ŞCOALA PRIMARĂ CUTINA",326,"Alegeri Prezidentiale",1,246,139,103,36,0,139,0,300,161,91,48
37,TIMIŞ,BETHAUSEN,155840,LEUCUŞEŞTI,"ŞCOALA PRIMARĂ LEUCUŞEŞTI",327,"Alegeri Prezidentiale",1,350,240,201,39,0,239,1,400,160,118,121
37,TIMIŞ,BETHAUSEN,155840,NEVRINCEA,"GRĂDINIŢA CU PROGRAM NORMAL NEVRINCEA",328,"Alegeri Prezidentiale",1,191,120,79,41,0,114,6,200,80,69,45
37,TIMIŞ,BILED,155911,BILED,"CAMINUL CULTURAL BILED",329,"Alegeri Prezidentiale",1,1874,945,830,93,22,931,14,2000,1055,660,271
37,TIMIŞ,BILED,155911,BILED,"GRADINITA PP BILED",330,"Alegeri Prezidentiale",1,1501,749,649,87,13,739,10,1600,851,521,218
37,TIMIŞ,BIRDA,159366,BIRDA,"ŞCOALA GIMNAZIALĂ BIRDA",331,"Alegeri Prezidentiale",1,924,542,446,88,8,539,3,1000,458,301,238
37,TIMIŞ,BIRDA,159366,BERECUŢA,"CĂMINUL CULTURAL BERECUŢA",332,"Alegeri Prezidentiale",1,154,100,75,24,1,100,0,200,100,55,45
37,TIMIŞ,BIRDA,159366,MÂNĂSTIRE,"ŞCOALA PRIMARĂ MÂNĂSTIRE",333,"Alegeri Prezidentiale",1,166,95,73,20,2,93,2,200,105,51,42
37,TIMIŞ,BIRDA,159366,SÂNGEORGE,"ŞCOALA PRIMARĂ SÂNGEORGE",334,"Alegeri Prezidentiale",1,438,254,204,47,3,251,3,500,246,128,123
37,TIMIŞ,BOGDA,156035,BOGDA,"SEDIUL PRIMĂRIEI BOGDA",335,"Alegeri Prezidentiale",1,245,183,108,74,1,182,1,300,117,118,64
37,TIMIŞ,BOGDA,156035,BUZAD,"CASA DE CULTURĂ BUZAD",336,"Alegeri Prezidentiale",1,149,122,64,49,9,122,0,200,78,61,61
37,TIMIŞ,BOLDUR,156106,BOLDUR,"ŞCOALA GIMNAZIALĂ BOLDUR",337,"Alegeri Prezidentiale",1,477,334,270,62,2,325,9,500,166,228,97
37,TIMIŞ,BOLDUR,156106,JABĂR,"ŞCOALA PRIMARĂ JABĂR",338,"Alegeri Prezidentiale",1,352,216,165,51,0,215,1,400,184,123,92
37,TIMIŞ,BOLDUR,156106,OHABA-FORGACI,"ŞCOALA PRIMARĂ OHABA-FORGACI",339,"Alegeri Prezidentiale",1,632,361,305,56,0,357,4,700,339,245,112
37,TIMIŞ,BOLDUR,156106,SINERSIG,"ŞCOALA PRIMARĂ SINERSIG",340,"Alegeri Prezidentiale",1,506,285,228,57,0,281,4,600,315,178,103
37,TIMIŞ,BRESTOVĂŢ,156151,BRESTOVĂŢ,"PRIMĂRIA BRESTOVĂŢ",341,"Alegeri Prezidentiale",1,229,133,104,27,2,132,1,300,167,97,35
37,TIMIŞ,BRESTOVĂŢ,156151,COŞARII,"CLADIREA COMUNEI BRESTOVAT (FOSTA ŞCOALA GENERALĂ COŞARII)",342,"Alegeri Prezidentiale",1,112,58,46,12,0,57,1,200,142,47,10
37,TIMIŞ,BRESTOVĂŢ,156151,TEŞ,"CĂMINUL CULTURAL TEŞ",343,"Alegeri Prezidentiale",1,228,163,125,38,0,162,1,300,137,110,52
37,TIMIŞ,BUCOVĂŢ,159516,BUCOVĂŢ,"CĂMINUL CULTURAL BUCOVĂŢ",344,"Alegeri Prezidentiale",1,1331,889,691,198,0,874,15,1400,511,694,180
37,TIMIŞ,BUCOVĂŢ,159516,"BAZOŞU NOU","CĂMINUL CULTURAL BAZOŞU NOU",345,"Alegeri Prezidentiale",1,323,275,199,76,0,271,4,300,25,211,60
37,TIMIŞ,CĂRPINIŞ,156213,CĂRPINIŞ,"PRIMARIA CĂRPINIŞ",346,"Alegeri Prezidentiale",1,1818,639,589,50,0,631,8,2000,1361,494,137
37,TIMIŞ,CĂRPINIŞ,156213,CĂRPINIŞ,"CĂMINUL CULTURAL CĂRPINIŞ",347,"Alegeri Prezidentiale",2,1680,725,655,70,0,715,10,1800,1075,524,191
37,TIMIŞ,CĂRPINIŞ,156213,"IECEA MICĂ","CĂMINUL CULTURAL IECEA MICĂ",348,"Alegeri Prezidentiale",1,1016,378,338,40,0,372,6,1100,722,292,80
37,TIMIŞ,CENAD,156259,CENAD,"ŞCOALA GIMNAZIALĂ CENAD",349,"Alegeri Prezidentiale",1,1961,634,548,86,0,623,11,2100,1466,500,123
37,TIMIŞ,CENAD,156259,CENAD,"ŞCOALA GIMNAZIALĂ CENAD",350,"Alegeri Prezidentiale",1,1923,593,526,67,0,587,6,2100,1507,433,154
37,TIMIŞ,CENEI,156277,CENEI,"SEDIUL PRIMĂRIEI CENEI",351,"Alegeri Prezidentiale",1,1800,726,633,92,1,722,4,2000,1274,572,150
37,TIMIŞ,CENEI,156277,BOBDA,"ŞCOALA PRIMARĂ BOBDA",352,"Alegeri Prezidentiale",1,773,467,366,94,7,460,7,800,333,338,122
37,TIMIŞ,CHECEA,159375,CHECEA,"CĂMINUL CULTURAL CHECEA",353,"Alegeri Prezidentiale",1,1662,618,548,69,1,609,9,1800,1182,517,92
37,TIMIŞ,"CHEVEREŞU MARE",156311,"CHEVEREŞU MARE","CONSILIUL LOCAL CHEVEREŞU MARE",354,"Alegeri Prezidentiale",1,1072,411,308,103,0,409,2,1200,789,287,122
37,TIMIŞ,"CHEVEREŞU MARE",156311,DRAGŞINA,"ŞCOALA PRIMARĂ DRAGŞINA",355,"Alegeri Prezidentiale",1,507,367,271,96,0,365,2,500,133,238,127
37,TIMIŞ,"CHEVEREŞU MARE",156311,VUCOVA,"ŞCOALA PRIMARĂ VUCOVA",356,"Alegeri Prezidentiale",1,314,189,140,49,0,185,4,400,211,127,58
37,TIMIŞ,"COMLOŞU MARE",156437,"COMLOŞU MARE","ŞCOALA GIMNAZIALĂ COMLOŞU MARE",357,"Alegeri Prezidentiale",1,1482,700,595,45,60,695,5,1592,892,430,265
37,TIMIŞ,"COMLOŞU MARE",156437,"COMLOŞU MARE","CĂMINUL CULTURAL COMLOŞU MARE",358,"Alegeri Prezidentiale",1,1446,637,567,61,9,629,8,1600,963,364,265
37,TIMIŞ,"COMLOŞU MARE",156437,"COMLOŞU MIC","BIBLIOTECA DIN COMLOŞU MIC",359,"Alegeri Prezidentiale",1,886,370,331,39,0,365,5,1000,630,249,116
37,TIMIŞ,"COMLOŞU MARE",156437,LUNGA,"ŞCOALA PRIMARĂ LUNGA",360,"Alegeri Prezidentiale",1,458,196,166,28,2,196,0,500,304,111,85
37,TIMIŞ,COŞTEIU,156473,COŞTEIU,"CĂMINUL CULTURAL COŞTEIU",361,"Alegeri Prezidentiale",1,661,385,328,57,0,379,6,700,315,262,117
37,TIMIŞ,COŞTEIU,156473,COŞTEIU,"PRIMĂRIA VECHECOŞTEIU",362,"Alegeri Prezidentiale",1,1246,583,521,62,0,577,6,1400,817,412,165
37,TIMIŞ,COŞTEIU,156473,HEZERIŞ,"ŞCOALA PRIMARA HEZERIS",363,"Alegeri Prezidentiale",1,215,135,110,25,0,134,1,300,165,83,51
37,TIMIŞ,COŞTEIU,156473,PĂRU,"CAMINUL CULTURAL PARU",364,"Alegeri Prezidentiale",1,200,124,96,28,0,123,1,300,176,80,43
37,TIMIŞ,COŞTEIU,156473,ŢIPARI,"CĂMINUL CULTURAL ŢIPARI",365,"Alegeri Prezidentiale",1,720,298,250,48,0,292,6,800,502,245,47
37,TIMIŞ,COŞTEIU,156473,"VALEA LUNGĂ ROMÂNĂ","CĂMINUL CULTURAL VALEA LUNGĂ ROMÂNĂ",366,"Alegeri Prezidentiale",1,125,70,54,16,0,70,0,200,130,43,27
37,TIMIŞ,CRICIOVA,156534,CRICIOVA,"GRĂDINIŢA CU PROGRAM NORMAL CRICIOVA",367,"Alegeri Prezidentiale",1,590,440,347,85,8,428,12,600,160,190,238
37,TIMIŞ,CRICIOVA,156534,CIREŞU,"CĂMINUL CULTURAL CIREŞU",368,"Alegeri Prezidentiale",1,298,214,182,31,1,214,0,300,86,124,90
37,TIMIŞ,CRICIOVA,156534,JDIOARA,"GRĂDINIŢA CU PROGRAM NORMAL JDIOARA",369,"Alegeri Prezidentiale",1,451,334,255,73,6,329,5,500,166,161,168
37,TIMIŞ,CURTEA,156589,CURTEA,"CĂMINUL CULTURAL CURTEA",370,"Alegeri Prezidentiale",1,525,318,260,58,0,310,8,600,282,145,165
37,TIMIŞ,CURTEA,156589,COŞAVA,"CĂMINUL CULTURAL COŞAVA",371,"Alegeri Prezidentiale",1,456,265,154,111,0,261,4,500,235,154,107
37,TIMIŞ,DAROVA,156623,DAROVA,"SCOALA GIMNAZIALA COMUNA DAROVA",372,"Alegeri Prezidentiale",1,1729,570,532,38,0,567,3,1900,1330,409,158
37,TIMIŞ,DAROVA,156623,HODOŞ,"GRADINITA PN",373,"Alegeri Prezidentiale",1,300,160,139,21,0,159,1,300,140,120,39
37,TIMIŞ,DAROVA,156623,"SACOŞU MARE","SCOALA PRIMARA",374,"Alegeri Prezidentiale",1,712,319,269,50,0,316,3,800,481,248,68
37,TIMIŞ,DENTA,156669,DENTA,"SCOALA GIMNAZIALA DENTA",375,"Alegeri Prezidentiale",1,968,494,428,66,0,487,7,1100,606,335,152
37,TIMIŞ,DENTA,156669,DENTA,"SCOALA GIMNAZIALA DENTA",376,"Alegeri Prezidentiale",1,965,412,378,33,1,406,6,1100,688,266,140
37,TIMIŞ,DENTA,156669,BREŞTEA,"ŞCOALA PRIMARA BRESTEA",377,"Alegeri Prezidentiale",1,399,236,180,56,0,233,3,500,264,149,84
37,TIMIŞ,DENTA,156669,"ROVINIŢA MARE","CĂMINUL CULTURAL ROVINIŢA MARE",378,"Alegeri Prezidentiale",1,307,203,161,38,4,201,2,400,197,146,55
37,TIMIŞ,"DUDEŞTII NOI",159384,"DUDEŞTII NOI","ȘCOALA GIMNAZIALĂ DUDEȘTII NOI",379,"Alegeri Prezidentiale",1,1441,606,517,89,0,596,10,1600,994,487,109
37,TIMIŞ,"DUDEŞTII NOI",159384,"DUDEŞTII NOI","ȘCOALA GIMNAZIALĂ DUDEȘTII NOI",380,"Alegeri Prezidentiale",1,1444,696,581,115,0,686,10,1600,904,547,139
37,TIMIŞ,"DUDEŞTII VECHI",156712,"DUDEŞTII VECHI","LICEUL TEORETIC ”SFINȚII KIRIL ȘI METODII” DUDESTII VECHI",381,"Alegeri Prezidentiale",1,1574,780,681,99,0,769,11,1700,920,597,172
37,TIMIŞ,"DUDEŞTII VECHI",156712,"DUDEŞTII VECHI","CONSILIUL LOCAL DUDEŞTII VECHI",382,"Alegeri Prezidentiale",1,1485,651,565,85,1,638,13,1600,949,547,91
37,TIMIŞ,"DUDEŞTII VECHI",156712,CHEGLEVICI,"CĂMINUL CULTURAL CHEGLEVICI",383,"Alegeri Prezidentiale",1,553,204,175,28,1,202,2,600,396,185,17
37,TIMIŞ,DUMBRAVA,156767,DUMBRAVA,"SEDIUL PRIMARIEI DUMBRAVA",384,"Alegeri Prezidentiale",1,905,406,365,41,0,401,5,1000,594,305,96
37,TIMIŞ,DUMBRAVA,156767,BUCOVĂŢ,"ŞCOALA PRIMARĂ BUCOVĂȚ",385,"Alegeri Prezidentiale",1,416,258,225,24,9,255,3,500,242,107,148
37,TIMIŞ,DUMBRAVA,156767,RĂCHITA,"ŞCOALA GIMNAZIALĂ RĂCHITA",386,"Alegeri Prezidentiale",1,909,389,355,32,2,385,4,1000,611,242,143
37,TIMIŞ,DUMBRĂVIŢA,155261,DUMBRĂVIŢA,"SCOALA GIMNAZIALA DUMBRAVITA",387,"Alegeri Prezidentiale",1,1750,1403,1051,352,0,1377,26,1900,497,1162,215
37,TIMIŞ,DUMBRĂVIŢA,155261,DUMBRĂVIŢA,"SCOALA GIMNAZIALA",388,"Alegeri Prezidentiale",1,1765,1529,1025,504,0,1509,20,1800,271,1276,233
37,TIMIŞ,DUMBRĂVIŢA,155261,DUMBRĂVIŢA,"SCOALA GIMNAZIALA",389,"Alegeri Prezidentiale",1,1827,1303,1035,268,0,1286,17,1900,597,1117,169
37,TIMIŞ,DUMBRĂVIŢA,155261,DUMBRĂVIŢA,"SALA DE MESE A COMUNEI DUMBRĂVIŢA( SALA DIN SPATE CU INTRARE DIN PARTEA DREAPTĂ)",390,"Alegeri Prezidentiale",1,1839,1539,1101,438,0,1513,26,2000,461,1270,243
37,TIMIŞ,DUMBRĂVIŢA,155261,DUMBRĂVIŢA,"ŞCOALA GIMNAZIALĂ DUMBRĂVIŢA",391,"Alegeri Prezidentiale",1,1884,1246,1067,179,0,1228,18,2000,754,1039,189
37,TIMIŞ,DUMBRĂVIŢA,155261,DUMBRĂVIŢA,"SALA DE MESE A COMUNEI DUMBRĂVIŢA( SALA DIN FAŢĂ)",392,"Alegeri Prezidentiale",1,1998,1574,1161,413,0,1545,29,2100,526,1289,256
37,TIMIŞ,FÂRDEA,156927,FÂRDEA,"CĂMINUL CULTURAL FÎRDEA",393,"Alegeri Prezidentiale",1,575,434,269,155,10,415,19,600,166,255,160
37,TIMIŞ,FÂRDEA,156927,DRĂGSINEŞTI,"CĂMINUL CULTURAL DRĂGŞINEŞTI",394,"Alegeri Prezidentiale",1,379,239,203,34,2,236,3,400,161,131,105
37,TIMIŞ,FÂRDEA,156927,"GLADNA ROMÂNĂ","CĂMINUL CULTURAL GLADNA ROMÂNĂ",395,"Alegeri Prezidentiale",1,445,264,227,37,0,261,3,500,236,151,110
37,TIMIŞ,FIBIŞ,159393,FIBIŞ,"CĂMINUL CULTURAL FIBIŞ",396,"Alegeri Prezidentiale",1,1412,826,665,161,0,823,3,1500,674,674,149
37,TIMIŞ,FOENI,157004,FOENI,"ŞCOALA GIMNAZIALĂ FOENI",397,"Alegeri Prezidentiale",1,988,438,353,85,0,436,2,1100,662,364,72
37,TIMIŞ,FOENI,157004,CRUCENI,"PRIMĂRIA VECHE CRUCENI",398,"Alegeri Prezidentiale",1,457,218,166,51,1,213,5,500,282,175,38
37,TIMIŞ,GAVOJDIA,157031,GAVOJDIA,"SEDIUL PRIMARIEI GĂVOJDIA",399,"Alegeri Prezidentiale",1,1098,471,416,55,0,466,5,1200,729,333,133
37,TIMIŞ,GAVOJDIA,157031,JENA,"CĂMINUL CULTURAL JENA",400,"Alegeri Prezidentiale",1,424,233,196,37,0,231,2,500,267,164,67
37,TIMIŞ,GAVOJDIA,157031,LUGOJEL,"CAMIN CULTURAL LUGOJEL",401,"Alegeri Prezidentiale",1,562,347,276,71,0,343,4,600,253,277,66
37,TIMIŞ,GAVOJDIA,157031,SĂLBĂGEL,"CĂMINUL CULTURAL SĂLBĂGEL",402,"Alegeri Prezidentiale",1,240,158,130,28,0,155,3,300,142,114,41
37,TIMIŞ,GHILAD,159400,GHILAD,"ŞCOALA GIMNAZIALA GHILAD",403,"Alegeri Prezidentiale",1,1550,690,606,84,0,675,15,1600,910,532,143
37,TIMIŞ,GHILAD,159400,GAD,"CĂMINUL CULTURAL GAD",404,"Alegeri Prezidentiale",1,118,81,42,39,0,80,1,200,119,63,17
37,TIMIŞ,GHIRODA,155289,GHIRODA,"ŞCOALA GIMNAZIALĂ GHIRODA",405,"Alegeri Prezidentiale",1,1899,1214,1045,168,1,1189,25,2000,786,942,247
37,TIMIŞ,GHIRODA,155289,GHIRODA,"ŞCOALA GIMNAZIALĂ GHIRODA",406,"Alegeri Prezidentiale",1,1513,1093,820,273,0,1074,19,1600,507,846,228
37,TIMIŞ,GHIRODA,155289,GHIRODA,"GRĂDINIŢA CU PROGRAM PRELUNGIT GHIRODA",407,"Alegeri Prezidentiale",1,1247,871,670,201,0,856,15,1498,627,632,224
37,TIMIŞ,GHIRODA,155289,GIARMATA-VII,"CĂMINUL CULTURAL GIARMATA - VII",408,"Alegeri Prezidentiale",1,1644,1198,950,247,1,1169,29,1800,602,954,215
37,TIMIŞ,GHIZELA,157193,GHIZELA,"SEDIUL PRIMARIEI GHIZELA",409,"Alegeri Prezidentiale",1,379,266,214,48,4,261,5,400,134,222,39
37,TIMIŞ,GHIZELA,157193,PANIOVA,"CĂMINUL CULTURAL PANIOVA",410,"Alegeri Prezidentiale",1,201,145,97,44,4,142,3,300,155,108,34
37,TIMIŞ,GHIZELA,157193,ŞANOVIŢA,"CASA NATIONALĂ ”NICOLAE URSU” ŞANOVIŢA",411,"Alegeri Prezidentiale",1,390,233,186,47,0,231,2,400,167,177,54
37,TIMIŞ,GIARMATA,157246,GIARMATA,"GRĂDINIȚA CU PROGRAM PRELUNGIT GIARMATA",412,"Alegeri Prezidentiale",1,1623,751,625,126,0,740,11,1800,1049,580,160
37,TIMIŞ,GIARMATA,157246,GIARMATA,"SCOALA GIMNAZIALA GIARMATA",413,"Alegeri Prezidentiale",1,1733,958,783,175,0,947,11,1800,842,734,213
37,TIMIŞ,GIARMATA,157246,GIARMATA,"GRADINITA CU PROGRAM PRELUNGIT COMUNA GIARMATA",414,"Alegeri Prezidentiale",1,1589,861,772,89,0,850,11,1700,839,703,147
37,TIMIŞ,GIARMATA,157246,CERNETEAZ,"ŞCOALA PRIMARA CERNETEAZ",415,"Alegeri Prezidentiale",1,1130,628,480,147,1,615,13,1200,572,476,139
37,TIMIŞ,GIERA,157273,GIERA,"SEDIUL PRIMARIEI GIERA",416,"Alegeri Prezidentiale",1,649,221,197,22,2,219,2,700,479,164,55
37,TIMIŞ,GIERA,157273,GRĂNICERII,"GRADINITA CU PROGRAM NORMAL GRĂNICERII",417,"Alegeri Prezidentiale",1,202,99,77,22,0,99,0,300,201,77,22
37,TIMIŞ,GIERA,157273,TOAGER,"GRADINITA CU PROGRAM NORMAL TOAGER",418,"Alegeri Prezidentiale",1,313,155,123,22,10,154,1,400,245,128,26
37,TIMIŞ,GIROC,155314,GIROC,"CĂMINUL CULTURAL GIROC",419,"Alegeri Prezidentiale",1,1979,1383,1128,255,0,1355,28,2100,717,1093,262
37,TIMIŞ,GIROC,155314,GIROC,"CĂMINUL CULTURAL GIROC",420,"Alegeri Prezidentiale",1,1989,1397,1070,327,0,1356,41,2100,703,1143,213
37,TIMIŞ,GIROC,155314,GIROC,"LICEUL TEORETIC ”DAVID VONIGA” GIROC",421,"Alegeri Prezidentiale",1,1545,1212,962,250,0,1195,17,1700,488,948,247
37,TIMIŞ,GIROC,155314,GIROC,"LICEUL TEORETIC DAVID VONIGA GIROC",422,"Alegeri Prezidentiale",1,1419,1210,853,357,0,1193,17,1500,290,968,225
37,TIMIŞ,GIROC,155314,GIROC,"CALEA TIMIȘOAREI (FOSTELE U.M)",423,"Alegeri Prezidentiale",1,1914,1610,1115,495,0,1582,28,2100,490,1364,218
37,TIMIŞ,GIROC,155314,CHIŞODA,"ŞCOALA GIMNAZIALĂ ”IOSIF CIOROGARIU” ,CHIȘODA",424,"Alegeri Prezidentiale",1,1625,1095,915,180,0,1077,18,1800,705,864,213
37,TIMIŞ,GIROC,155314,CHIŞODA,"ŞCOALA GIMNAZIALĂ ”IOSIF CIOROGARIU” ,CHIȘODA",425,"Alegeri Prezidentiale",1,1646,1109,879,230,0,1092,17,1800,691,848,244
37,TIMIŞ,GIROC,155314,GIROC,"ANEXA ADMINISTRATIVĂ A FOSTEI UNITĂȚI MILITARE",426,"Alegeri Prezidentiale",1,1791,1400,1081,319,0,1378,22,1900,500,1202,176
37,TIMIŞ,GIULVĂZ,157317,GIULVĂZ,"PRIMARA GIULVĂZ",427,"Alegeri Prezidentiale",1,1055,515,421,94,0,507,8,1100,585,371,136
37,TIMIŞ,GIULVĂZ,157317,"CRAI NOU","CĂMIN CULTURAL CRAI NOU",428,"Alegeri Prezidentiale",1,350,221,163,58,0,221,0,400,179,172,49
37,TIMIŞ,GIULVĂZ,157317,IVANDA,"CAMIN CULTURAL IVANDA",429,"Alegeri Prezidentiale",1,480,253,201,52,0,247,6,500,247,180,67
37,TIMIŞ,GIULVĂZ,157317,RUDNA,"CĂMIN CULTURAL RUDNA",430,"Alegeri Prezidentiale",1,577,242,179,63,0,238,4,600,358,187,51
37,TIMIŞ,GOTTLOB,159419,GOTTLOB,"CLADIREA COMUNEI GOTTLOB (SALA DE SEDINTE)",431,"Alegeri Prezidentiale",1,1831,626,569,57,0,621,5,1900,1274,523,98
37,TIMIŞ,GOTTLOB,159419,VIZEJDIA,"GRADINITA CU PN VIZEJDIA",432,"Alegeri Prezidentiale",1,371,132,115,17,0,132,0,400,268,115,17
37,TIMIŞ,"IECEA MARE",159428,"IECEA MARE","PRIMARIA IECEA MARE",433,"Alegeri Prezidentiale",2,1103,397,339,58,0,393,4,1200,803,258,135
37,TIMIŞ,"IECEA MARE",159428,"IECEA MARE","SCOALA PRIMARĂ IECEA MARE",434,"Alegeri Prezidentiale",1,1105,397,368,29,0,383,14,1200,803,260,123
37,TIMIŞ,"JAMU MARE",157362,"JAMU MARE","PRIMARIA JAMU MARE",435,"Alegeri Prezidentiale",1,1172,471,406,65,0,468,3,1300,829,337,131
37,TIMIŞ,"JAMU MARE",157362,CLOPODIA,"ŞCOALA PRIMARA CLOPODIA",436,"Alegeri Prezidentiale",1,584,252,224,27,1,250,2,600,348,201,49
37,TIMIŞ,"JAMU MARE",157362,FERENDIA,"ŞCOALA PRIMARA FERENDIA",437,"Alegeri Prezidentiale",1,340,151,115,36,0,151,0,400,249,117,34
37,TIMIŞ,"JAMU MARE",157362,GHERMAN,"CĂMINUL CULTURAL GHERMAN",438,"Alegeri Prezidentiale",1,186,124,85,39,0,123,1,200,76,89,34
37,TIMIŞ,"JAMU MARE",157362,LĂŢUNAŞ,"CLADIREA COMUNEI JAMU MARE (FOSTA ŞCOALA LĂŢUNAŞ)",439,"Alegeri Prezidentiale",1,195,110,74,36,0,110,0,300,190,67,43
37,TIMIŞ,JEBEL,157424,JEBEL,"CASA NATIONALA EFTA BOTOCA",440,"Alegeri Prezidentiale",1,1507,887,622,171,94,880,7,1700,813,644,236
37,TIMIŞ,JEBEL,157424,JEBEL,"GRADINITA PN JEBEL",441,"Alegeri Prezidentiale",1,1509,738,642,96,0,721,17,1600,862,523,198
37,TIMIŞ,LENAUHEIM,157451,LENAUHEIM,"GRĂDINIŢA CU PROGRAM NORMAL LENAUHEIM",442,"Alegeri Prezidentiale",1,1556,557,518,39,0,554,3,1600,1043,456,98
37,TIMIŞ,LENAUHEIM,157451,BULGĂRUŞ,"CĂMINUL CULTURAL BULGĂRUŞ",443,"Alegeri Prezidentiale",1,1791,605,550,55,0,601,4,1900,1295,475,126
37,TIMIŞ,LENAUHEIM,157451,GRABĂŢ,"CĂMINUL CULTURAL GRABAŢ",444,"Alegeri Prezidentiale",1,1756,519,471,48,0,510,9,1800,1281,430,80
37,TIMIŞ,LIEBLING,157497,LIEBLING,"CĂMINUL CULTURAL LIEBLING",445,"Alegeri Prezidentiale",1,1541,587,502,82,3,583,4,1700,1113,461,122
37,TIMIŞ,LIEBLING,157497,LIEBLING,"ȘCOALA GIMNAZIALĂ LIEBLING",446,"Alegeri Prezidentiale",1,1308,595,533,62,0,592,3,1400,805,453,139
37,TIMIŞ,LIEBLING,157497,CERNA,"CLADIREA FOSTEI PRIMARII DIN CERNA",447,"Alegeri Prezidentiale",1,194,122,61,61,0,121,1,200,78,95,26
37,TIMIŞ,LIEBLING,157497,IOSIF,"CĂMINUL CULTURAL SATUL IOSIF",448,"Alegeri Prezidentiale",1,298,158,119,39,0,154,4,300,142,123,31
37,TIMIŞ,LIVEZILE,159491,LIVEZILE,"PRIMARIA COMUNEI LIVEZILE",449,"Alegeri Prezidentiale",1,899,369,326,41,2,364,5,1000,631,270,94
37,TIMIŞ,LIVEZILE,159491,DOLAŢ,"ŞCOALA PRIMARA DOLAŢ",450,"Alegeri Prezidentiale",1,439,155,133,22,0,154,1,500,345,133,21
37,TIMIŞ,LOVRIN,157530,LOVRIN,"STATIUNEA DE CERCETARE SI DEZVOLTARE AGRICOLA LOVRIN",451,"Alegeri Prezidentiale",1,1632,548,505,43,0,543,5,1700,1152,413,130
37,TIMIŞ,LOVRIN,157530,LOVRIN,"STRAND TERMAL LOVRIN, NR 752/B",452,"Alegeri Prezidentiale",1,1757,697,636,61,0,685,12,1900,1203,532,153
37,TIMIŞ,MARGINA,157585,MARGINA,"CĂMINUL CULTURAL MARGINA",453,"Alegeri Prezidentiale",1,968,471,418,53,0,461,10,1000,529,221,240
37,TIMIŞ,MARGINA,157585,BREAZOVA,"GRĂDINIŢA CU PROGRAM NORMAL BREAZOVA",454,"Alegeri Prezidentiale",1,208,150,117,33,0,146,4,301,151,74,72
37,TIMIŞ,MARGINA,157585,"COŞTEIU DE SUS","CĂMINUL CULTURAL COŞTEIU DE SUS",455,"Alegeri Prezidentiale",1,171,95,73,22,0,95,0,200,105,46,49
37,TIMIŞ,MARGINA,157585,GROŞI,"CĂMINUL CULTURAL GROŞI",456,"Alegeri Prezidentiale",1,73,54,30,24,0,54,0,100,46,24,30
37,TIMIŞ,MARGINA,157585,SINTEŞTI,"ȘCOALA PRIMARĂ SINTEŞTI",457,"Alegeri Prezidentiale",1,407,205,173,31,1,202,3,500,295,120,82
37,TIMIŞ,MAŞLOC,157683,MAŞLOC,"PRIMARIA MAŞLOC",458,"Alegeri Prezidentiale",1,871,337,273,58,6,336,1,1000,663,247,89
37,TIMIŞ,MAŞLOC,157683,ALIOŞ,"CĂMINUL CULTURAL ALIOS",459,"Alegeri Prezidentiale",1,677,404,297,107,0,404,0,700,296,285,119
37,TIMIŞ,MAŞLOC,157683,"REMETEA MICĂ","CĂMINUL CULTURAL REMETEA MICĂ",460,"Alegeri Prezidentiale",1,460,218,188,27,3,217,1,500,282,179,38
37,TIMIŞ,MĂNĂŞTIUR,157736,MĂNĂŞTIUR,"ŞCOALA GIMNAZIALĂ GEORGE GÂRDA MĂNĂŞTIUR",461,"Alegeri Prezidentiale",1,967,558,476,77,5,554,4,1100,542,311,243
37,TIMIŞ,MĂNĂŞTIUR,157736,PĂDURANI,"CLĂDIREA COMUNEI MĂNĂŞTIUR (FOSTA ŞCOALĂ GENERALĂ PĂDURANI)",462,"Alegeri Prezidentiale",1,62,62,36,26,0,62,0,100,38,36,26
37,TIMIŞ,MĂNĂŞTIUR,157736,REMETEA-LUNCĂ,"CLĂDIREA COMUNEI MĂNĂŞTIUR ( FOSTA ŞCOALĂ GENERALĂ REMETEA LUNCĂ)",463,"Alegeri Prezidentiale",1,327,206,171,35,0,206,0,400,194,107,99
37,TIMIŞ,MORAVIŢA,157781,MORAVIŢA,"CASA NATIONALA DE CULTURA MORAVIŢA",464,"Alegeri Prezidentiale",1,1014,433,368,64,1,426,7,1100,667,254,172
37,TIMIŞ,MORAVIŢA,157781,DEJAN,"CASA NAŢIONALĂ DEJAN",465,"Alegeri Prezidentiale",1,221,109,98,11,0,107,2,300,191,72,35
37,TIMIŞ,MORAVIŢA,157781,"GAIU MIC","CASA NAȚIONALĂ GAIU MIC",466,"Alegeri Prezidentiale",1,138,87,62,25,0,86,1,200,113,29,57
37,TIMIŞ,MORAVIŢA,157781,"STAMORA GERMANĂ","ŞCOALA PRIMARA STAMORA GERMANĂ",467,"Alegeri Prezidentiale",1,827,336,307,29,0,333,3,900,564,220,113
37,TIMIŞ,"MOŞNIŢA NOUĂ",157834,"MOŞNIŢA NOUĂ","ȘCOALA GIMNAZIALĂ MOȘNIȚA NOUĂ",468,"Alegeri Prezidentiale",1,1920,1408,1001,407,0,1373,35,2100,692,1143,230
37,TIMIŞ,"MOŞNIŢA NOUĂ",157834,"MOŞNIŢA NOUĂ","ȘCOALA GIMNAZIALĂ MOȘNIȚA NOUĂ",469,"Alegeri Prezidentiale",1,1910,1593,1200,393,0,1561,32,2000,407,1363,198
37,TIMIŞ,"MOŞNIŢA NOUĂ",157834,ALBINA,"CLĂDIREA COMUNEI MOȘNIȚA NOUĂ FOSTA ȘCOALĂ PRIMARĂ ALBINA",470,"Alegeri Prezidentiale",1,335,308,194,114,0,299,9,400,92,205,94
37,TIMIŞ,"MOŞNIŢA NOUĂ",157834,"MOŞNIŢA VECHE","ŞCOALA PRIMARĂ MOŞNIŢA VECHE",471,"Alegeri Prezidentiale",1,1662,1100,807,293,0,1075,25,1800,700,904,171
37,TIMIŞ,"MOŞNIŢA NOUĂ",157834,"MOŞNIŢA VECHE","ŞCOALA PRIMARĂ MOŞNIŢA VECHE",472,"Alegeri Prezidentiale",1,1212,1118,870,248,0,1101,17,1400,282,996,105
37,TIMIŞ,"MOŞNIŢA NOUĂ",157834,URSENI,"ŞCOALA PRIMARĂ URSENI",473,"Alegeri Prezidentiale",1,1472,1078,825,252,1,1062,16,1600,522,913,149
37,TIMIŞ,NĂDRAG,157898,NĂDRAG,"GRĂDINIŢA CU PROGRAM PRELUNGIT NADRAG",474,"Alegeri Prezidentiale",1,1054,548,521,25,2,538,10,1100,552,276,262
37,TIMIŞ,NĂDRAG,157898,NĂDRAG,"LICEUL TEHNOLOGIC ”TRAIAN GROZĂVESCU” NĂDRAG",475,"Alegeri Prezidentiale",1,1106,561,518,43,0,552,9,1200,639,329,223
37,TIMIŞ,NĂDRAG,157898,CRIVINA,"ŞCOALA PRIMARA CRIVINA",476,"Alegeri Prezidentiale",1,248,184,155,28,1,183,1,300,116,74,109
37,TIMIŞ,NIŢCHIDORF,157923,NIŢCHIDORF,"HOLUL PRIMĂRIEI NIŢCHIDORF",477,"Alegeri Prezidentiale",1,1068,522,480,42,0,518,4,1100,578,394,124
37,TIMIŞ,NIŢCHIDORF,157923,BLAJOVA,"CASA NAŢIONALĂ BLAJOVA",478,"Alegeri Prezidentiale",1,90,104,63,41,0,104,0,130,26,55,49
37,TIMIŞ,NIŢCHIDORF,157923,DUBOZ,"CLADIREA COMUNEI NITCHIDORF(FOSTA SCOALA CU CLASELE I - IV)",479,"Alegeri Prezidentiale",1,157,107,68,39,0,107,0,200,93,66,41
37,TIMIŞ,"OHABA LUNGĂ",157969,"OHABA LUNGĂ","CĂMINUL CULTURAL OHABA LUNGĂ",480,"Alegeri Prezidentiale",1,310,202,175,25,2,201,1,400,198,105,96
37,TIMIŞ,"OHABA LUNGĂ",157969,DUBEŞTI,"CĂMINUL CULTURAL DUBEŞTI",481,"Alegeri Prezidentiale",1,190,133,115,18,0,132,1,200,67,86,46
37,TIMIŞ,"OHABA LUNGĂ",157969,IERŞNIC,"CĂMINUL CULTURAL IERŞNIC",482,"Alegeri Prezidentiale",1,129,141,90,48,3,138,3,200,59,71,67
37,TIMIŞ,"OHABA LUNGĂ",157969,"OHABA ROMÂNĂ","CĂMINUL CULTURAL OHABA ROMÂNĂ",483,"Alegeri Prezidentiale",1,172,113,89,21,3,111,2,200,87,66,45
37,TIMIŞ,ORŢIŞOARA,158010,ORŢIŞOARA,"ȘCOALA PRIMARĂ ORȚIȘOARA",484,"Alegeri Prezidentiale",1,1157,524,464,59,1,515,9,1300,776,445,70
37,TIMIŞ,ORŢIŞOARA,158010,ORŢIŞOARA,"BIBLIOTECA COMUNALA ORTISOARA",485,"Alegeri Prezidentiale",1,958,553,444,109,0,549,4,1000,447,443,106
37,TIMIŞ,ORŢIŞOARA,158010,CĂLACEA,"ŞCOALA PRIMARA CĂLACEA",486,"Alegeri Prezidentiale",1,612,318,256,62,0,316,2,700,382,228,88
37,TIMIŞ,ORŢIŞOARA,158010,CORNEŞTI,"ŞCOALA PRIMARA CORNEŞTI",487,"Alegeri Prezidentiale",1,549,362,265,97,0,356,6,600,238,297,59
37,TIMIŞ,ORŢIŞOARA,158010,SECEANI,"CĂMINUL CULTURAL SECEANI",488,"Alegeri Prezidentiale",1,475,257,192,65,0,254,3,492,235,189,65
37,TIMIŞ,OTELEC,159525,OTELEC,"ȘCOALA GIMNAZIALĂ OTELEC",489,"Alegeri Prezidentiale",1,654,311,257,54,0,309,2,700,389,276,33
37,TIMIŞ,OTELEC,159525,IOHANISFELD,"CĂMINUL CULTURAL IOHANISFELD",490,"Alegeri Prezidentiale",1,842,282,258,24,0,278,4,900,618,248,30
37,TIMIŞ,PARŢA,159437,PARŢA,"CĂMINUL CULTURAL PARŢA",491,"Alegeri Prezidentiale",2,1918,1064,832,232,0,1048,16,2000,936,768,280
37,TIMIŞ,PĂDURENI,159446,PĂDURENI,"ȘCOALA GIMNAZIALĂ PĂDURENI",492,"Alegeri Prezidentiale",1,1520,903,680,192,31,893,10,1700,797,761,132
37,TIMIŞ,"PECIU NOU",158065,"PECIU NOU","LICEUL TEORETIC PECIU NOU",493,"Alegeri Prezidentiale",1,1491,638,558,80,0,634,4,1600,962,524,110
37,TIMIŞ,"PECIU NOU",158065,"PECIU NOU","CĂMINUL CULTURAL PECIU NOU",494,"Alegeri Prezidentiale",1,1485,780,637,143,0,773,7,1600,820,644,129
37,TIMIŞ,"PECIU NOU",158065,DINIAŞ,"CĂMINUL CULTURAL DINIAŞ",495,"Alegeri Prezidentiale",1,913,522,434,88,0,516,6,1000,478,441,75
37,TIMIŞ,"PECIU NOU",158065,"SÂNMARTINU SÂRBESC","ŞCOALA PRIMARĂ SÎNMARTINU SÎRBESC",496,"Alegeri Prezidentiale",1,792,407,299,107,1,401,6,800,393,326,75
37,TIMIŞ,PERIAM,158109,PERIAM,"LICEUL TEORETIC PERIAM",497,"Alegeri Prezidentiale",1,1405,607,558,48,1,601,6,1500,893,482,119
37,TIMIŞ,PERIAM,158109,PERIAM,"LICEUL TEORETIC PERIAM",498,"Alegeri Prezidentiale",1,1497,765,698,63,4,750,15,1500,735,571,179
37,TIMIŞ,PERIAM,158109,PERIAM,"CASA DE CULTURĂ",499,"Alegeri Prezidentiale",1,1210,428,390,30,8,423,5,1300,872,254,169
37,TIMIŞ,PESAC,159507,PESAC,"BIBLIOTECA COMUNALĂ PESAC",500,"Alegeri Prezidentiale",1,904,382,344,38,0,376,6,1000,618,232,144
37,TIMIŞ,PESAC,159507,PESAC,"ȘCOALA GIMNAZIALĂ „MARIA BRINDEA”",501,"Alegeri Prezidentiale",1,918,312,283,29,0,306,6,1000,688,198,108
37,TIMIŞ,PIETROASA,158136,PIETROASA,"GRĂDINIȚA CU PROGRAM NORMAL PIETROASA",502,"Alegeri Prezidentiale",1,270,193,180,13,0,187,6,300,107,114,73
37,TIMIŞ,PIETROASA,158136,"CRIVINA DE SUS","GRĂDINIȚA CU PROGRAM NORMAL CRIVINA DE SUS",503,"Alegeri Prezidentiale",1,173,135,112,23,0,133,2,200,65,64,69
37,TIMIŞ,PIETROASA,158136,FĂRĂŞEŞTI,"ȘCOALA PRIMARĂ FĂRĂŞEŞTI",504,"Alegeri Prezidentiale",1,178,134,108,26,0,134,0,200,66,62,72
37,TIMIŞ,PIETROASA,158136,POIENI,"ȘCOALA PRIMARĂ POIENI",505,"Alegeri Prezidentiale",1,219,195,171,23,1,192,3,300,105,91,101
37,TIMIŞ,PIŞCHIA,158181,PIŞCHIA,"ȘCOALA GIMNAZIALĂ PIŞCHIA",506,"Alegeri Prezidentiale",1,1075,533,431,102,0,525,8,1200,667,368,157
37,TIMIŞ,PIŞCHIA,158181,"BENCECU DE JOS","GRĂDINIȚA CU P.N. BENCECU DE JOS",507,"Alegeri Prezidentiale",1,325,179,142,37,0,176,3,400,221,138,38
37,TIMIŞ,PIŞCHIA,158181,"BENCECU DE SUS","ȘCOALA GIMNAZIALĂ BENCECU DE SUS",508,"Alegeri Prezidentiale",1,777,395,344,51,0,389,6,800,405,322,67
37,TIMIŞ,PIŞCHIA,158181,MURANI,"GRĂDINIȚA CU P.N.MURANI NR.383",509,"Alegeri Prezidentiale",1,488,292,211,81,0,284,8,500,208,190,94
37,TIMIŞ,RACOVIŢA,158243,RACOVIŢA,"ŞCOALA GIMNAZIALĂ RACOVIŢA",510,"Alegeri Prezidentiale",1,675,438,333,103,2,435,3,700,262,260,175
37,TIMIŞ,RACOVIŢA,158243,CĂPĂT,"ŞCOALA PRIMARĂ CĂPĂT",511,"Alegeri Prezidentiale",1,205,127,96,30,1,124,3,300,173,91,33
37,TIMIŞ,RACOVIŢA,158243,DRĂGOIEŞTI,"ŞCOALA PRIMARĂ DRĂGOIESTI",512,"Alegeri Prezidentiale",1,316,184,132,52,0,183,1,400,216,119,64
37,TIMIŞ,RACOVIŢA,158243,FICĂTAR,"ŞCOALA PRIMARĂ FICĂTAR",513,"Alegeri Prezidentiale",1,315,178,134,43,1,176,2,400,222,123,53
37,TIMIŞ,RACOVIŢA,158243,HITIAŞ,"ŞCOALA GIMNAZIALĂ HITIAŞ",514,"Alegeri Prezidentiale",1,672,452,365,87,0,447,5,700,248,229,218
37,TIMIŞ,RACOVIŢA,158243,SÂRBOVA,"ŞCOALA PRIMARĂ SÎRBOVA",515,"Alegeri Prezidentiale",1,237,130,104,26,0,128,2,300,170,81,47
37,TIMIŞ,"REMETEA MARE",158396,"REMETEA MARE","ŞCOALA GIMNAZIALA REMETEA MARE",516,"Alegeri Prezidentiale",1,1422,889,688,201,0,872,17,1500,611,630,242
37,TIMIŞ,"REMETEA MARE",158396,IANOVA,"ŞCOALA PRIMARA IANOVA",517,"Alegeri Prezidentiale",1,804,491,372,119,0,482,9,900,409,369,113
37,TIMIŞ,"SACOŞU TURCESC",158449,"SACOŞU TURCESC","SCOALA GIMNAZIALA SACOSU TURCESC",518,"Alegeri Prezidentiale",1,765,420,316,103,1,414,6,800,380,311,103
37,TIMIŞ,"SACOŞU TURCESC",158449,BERINI,"ŞCOALA PRIMARA BERINI",519,"Alegeri Prezidentiale",1,403,242,156,86,0,237,5,500,258,189,48
37,TIMIŞ,"SACOŞU TURCESC",158449,ICLODA,"CLADIREA COMUNEI SACOSU TURCESC ( FOSTA SCOALA PRIMARA ICLODA )",520,"Alegeri Prezidentiale",1,214,163,114,48,1,157,6,300,137,123,34
37,TIMIŞ,"SACOŞU TURCESC",158449,OTVEŞTI,"ŞCOALA PRIMARA OTVESTI",521,"Alegeri Prezidentiale",1,281,201,143,58,0,197,4,300,99,171,26
37,TIMIŞ,"SACOŞU TURCESC",158449,"STAMORA ROMÂNĂ","CLADIREA COMUNEI SACOSU TURCESC ( FOSTA SCOALA PRIMARA STAMORA ROMANA )",522,"Alegeri Prezidentiale",1,217,184,89,95,0,179,5,300,116,137,42
37,TIMIŞ,"SACOŞU TURCESC",158449,ULIUC,"ŞCOALA GIMNAZIALA ULIUC",523,"Alegeri Prezidentiale",1,569,319,236,83,0,316,3,600,281,241,75
37,TIMIŞ,"SACOŞU TURCESC",158449,UNIP,"CAMIN CULTURAL UNIP",524,"Alegeri Prezidentiale",1,179,132,98,34,0,129,3,200,68,103,26
37,TIMIŞ,SARAVALE,159455,SARAVALE,"SALA PRIMARIEI NR. 167B, SARAVALE",525,"Alegeri Prezidentiale",1,1202,469,428,41,0,466,3,1300,831,349,117
37,TIMIŞ,SARAVALE,159455,SARAVALE,"CAMINUL CULTURAL NR. 673, SARAVALE",526,"Alegeri Prezidentiale",1,903,400,373,27,0,399,1,1000,600,280,119
37,TIMIŞ,SATCHINEZ,158528,SATCHINEZ,"SCOALA GIMNAZIALA SATCHINEZ",527,"Alegeri Prezidentiale",1,1185,508,425,83,0,501,7,1300,792,384,117
37,TIMIŞ,SATCHINEZ,158528,SATCHINEZ,"SCOALA GIMNAZIALA SATCHINEZ",528,"Alegeri Prezidentiale",1,1312,549,492,57,0,538,11,1400,851,447,91
37,TIMIŞ,SATCHINEZ,158528,BĂRĂTEAZ,"CĂMINUL CULTURAL BĂRĂTEAZ",529,"Alegeri Prezidentiale",1,562,284,239,45,0,279,5,600,316,220,59
37,TIMIŞ,SATCHINEZ,158528,HODONI,"SCOALA GIMNAZIALA HODONI",530,"Alegeri Prezidentiale",1,988,482,422,60,0,479,3,1100,618,354,125
37,TIMIŞ,SĂCĂLAZ,158564,SĂCĂLAZ,"ŞCOALA GIMNAZIALA SACALAZ",531,"Alegeri Prezidentiale",1,1895,1035,883,152,0,1014,21,2000,965,807,207
37,TIMIŞ,SĂCĂLAZ,158564,SĂCĂLAZ,"ŞCOALA GIMNAZIALA SĂCĂLAZ",532,"Alegeri Prezidentiale",1,1758,895,675,219,1,878,17,1900,1005,698,180
37,TIMIŞ,SĂCĂLAZ,158564,SĂCĂLAZ,"CĂMINUL CULTURAL SĂCĂLAZ",533,"Alegeri Prezidentiale",1,1759,830,638,192,0,815,15,1900,1070,640,175
37,TIMIŞ,SĂCĂLAZ,158564,"BEREGSĂU MARE","CĂMINUL CULTURAL BEREGSĂU MARE",534,"Alegeri Prezidentiale",2,1835,912,761,151,0,884,28,1900,988,720,164
37,TIMIŞ,SĂCĂLAZ,158564,"BEREGSĂU MIC","CĂMINUL CULTURAL BEREGSĂU MIC",535,"Alegeri Prezidentiale",1,748,413,355,58,0,409,4,800,387,310,99
37,TIMIŞ,SÂNANDREI,158653,SÂNANDREI,"CAMINUL CULTURAL SINANDREI",536,"Alegeri Prezidentiale",1,2037,1282,946,336,0,1266,16,2100,818,1007,259
37,TIMIŞ,SÂNANDREI,158653,SÂNANDREI,"ŞCOALA GIMNAZIALA SINANDREI",537,"Alegeri Prezidentiale",1,1590,790,616,174,0,779,11,1700,910,560,219
37,TIMIŞ,SÂNANDREI,158653,CARANI,"CAMINUL CULTURAL CARANI",538,"Alegeri Prezidentiale",1,1697,796,685,111,0,789,7,1800,1004,632,157
37,TIMIŞ,SÂNANDREI,158653,COVACI,"ŞCOALA PRIMARA COVACI",539,"Alegeri Prezidentiale",1,782,514,377,137,0,509,5,800,286,393,116
37,TIMIŞ,"SÂNMIHAIU ROMÂN",158699,"SÂNMIHAIU ROMÂN","PRIMĂRIA SÎNMIHAIU ROMÂN",540,"Alegeri Prezidentiale",1,1600,933,745,188,0,924,9,1700,767,737,187
37,TIMIŞ,"SÂNMIHAIU ROMÂN",158699,"SÂNMIHAIU ROMÂN","ȘCOALA GIMNAZIALA SÎNMIHAIU ROMÂN",541,"Alegeri Prezidentiale",1,1605,1012,830,182,0,1000,12,1700,688,821,179
37,TIMIŞ,"SÂNMIHAIU ROMÂN",158699,"SÂNMIHAIU GERMAN","ŞCOALA PRIMARA SÂNMIHAIU GERMAN",542,"Alegeri Prezidentiale",1,868,497,405,92,0,490,7,900,403,401,89
37,TIMIŞ,"SÂNMIHAIU ROMÂN",158699,UTVIN,"GRADINITA CU P.N UTVIN",543,"Alegeri Prezidentiale",1,1150,662,555,107,0,655,7,1200,538,523,132
37,TIMIŞ,"SÂNMIHAIU ROMÂN",158699,UTVIN,"ȘCOALA GIMNAZIALA UTVIN",544,"Alegeri Prezidentiale",2,1343,898,686,210,2,880,16,1400,504,733,147
37,TIMIŞ,"SÂNPETRU MARE",158733,"SÂNPETRU MARE","PRIMĂRIA COMUNEI SÎNPETRU MARE",545,"Alegeri Prezidentiale",1,970,344,310,34,0,342,2,1100,756,250,92
37,TIMIŞ,"SÂNPETRU MARE",158733,"SÂNPETRU MARE","PRIMĂRIA COMUNEI SÎNPETRU MARE",546,"Alegeri Prezidentiale",1,856,333,299,34,0,332,1,900,567,255,77
37,TIMIŞ,"SÂNPETRU MARE",158733,IGRIŞ,"ŞCOALA GIMNAZIALA ACADEMICIAN PROFESOR DOCTOR MUNTEANU IOAN",547,"Alegeri Prezidentiale",1,952,378,323,55,0,377,1,1000,622,291,86
37,TIMIŞ,SECAŞ,158608,SECAŞ,"SEDIUL PRIMĂRIEI SECAŞ",548,"Alegeri Prezidentiale",1,218,102,77,25,0,98,4,300,198,70,28
37,TIMIŞ,SECAŞ,158608,CRIVOBARA,"CĂMINUL CULTURAL CRIVOBARA",549,"Alegeri Prezidentiale",1,59,52,27,25,0,51,1,100,48,32,19
37,TIMIŞ,ŞAG,158779,ŞAG,"CASA NATIONALA MIHAI VITEAZU",550,"Alegeri Prezidentiale",1,1640,1176,805,371,0,1150,26,1800,624,807,343
37,TIMIŞ,ŞAG,158779,ŞAG,"CASA NATIONALA MIHAI VITEAZUL",551,"Alegeri Prezidentiale",2,1700,1358,974,374,10,1340,18,1800,442,976,364
37,TIMIŞ,ŞANDRA,159464,ŞANDRA,"SCOALA GIMNAZIALA SANDRA",552,"Alegeri Prezidentiale",1,1229,558,501,57,0,550,8,1300,742,426,124
37,TIMIŞ,ŞANDRA,159464,ŞANDRA,"SCOALA GIMNAZIALA SANDRA",553,"Alegeri Prezidentiale",1,830,411,372,38,1,410,1,900,489,327,83
37,TIMIŞ,ŞANDRA,159464,UIHEI,"ŞCOALA PRIMARA UIHEI",554,"Alegeri Prezidentiale",1,471,199,169,29,1,195,4,500,301,170,25
37,TIMIŞ,ŞTIUCA,158804,ŞTIUCA,"CĂMINUL CULTURAL ŞTIUCA",555,"Alegeri Prezidentiale",1,883,417,377,40,0,410,7,1000,583,346,64
37,TIMIŞ,ŞTIUCA,158804,DRAGOMIREŞTI,"ŞCOALA PRIMARĂ DRAGOMIREŞTI",556,"Alegeri Prezidentiale",1,292,117,98,19,0,117,0,300,183,83,34
37,TIMIŞ,ŞTIUCA,158804,OLOŞAG,"CĂMINUL CULTURAL OLOŞAG",557,"Alegeri Prezidentiale",1,289,170,124,46,0,170,0,300,130,136,34
37,TIMIŞ,ŞTIUCA,158804,ZGRIBEŞTI,"CĂMINUL CULTURAL ZGRIBEŞTI",558,"Alegeri Prezidentiale",1,192,118,88,30,0,117,1,200,82,86,31
37,TIMIŞ,"TEREMIA MARE",158859,"TEREMIA MARE","ȘCOALA GIMNAZIALĂ TEREMIA MARE",559,"Alegeri Prezidentiale",1,1131,376,355,20,1,374,2,1200,824,308,66
37,TIMIŞ,"TEREMIA MARE",158859,"TEREMIA MARE","ȘCOALA GIMNAZIALĂ TEREMIA MARE",560,"Alegeri Prezidentiale",1,1136,416,388,28,0,407,9,1200,784,318,89
37,TIMIŞ,"TEREMIA MARE",158859,NERĂU,"CAMINUL CULTURAL NERAU",561,"Alegeri Prezidentiale",1,914,345,316,28,1,340,5,1000,655,287,53
37,TIMIŞ,"TEREMIA MARE",158859,"TEREMIA MICĂ","ŞCOALA PRIMARA TEREMIA MICĂ",562,"Alegeri Prezidentiale",1,558,189,170,19,0,188,1,600,411,160,28
37,TIMIŞ,TOMEŞTI,158895,"COLONIA FABRICII","ŞCOALA GIMNAZIALĂ ”SORIN LEIA”, COLONIA FABRICII",563,"Alegeri Prezidentiale",1,651,315,279,36,0,307,8,700,385,203,104
37,TIMIŞ,TOMEŞTI,158895,BALOŞEŞTI,"CĂMINUL CULTURAL BALOȘEȘTI",564,"Alegeri Prezidentiale",1,109,81,70,11,0,81,0,200,119,60,21
37,TIMIŞ,TOMEŞTI,158895,"LUNCANII DE JOS","GRĂDINIȚA CU PROGRAM NORMAL LUNCANII DE JOS",565,"Alegeri Prezidentiale",1,285,193,169,24,0,190,3,300,107,130,60
37,TIMIŞ,TOMEŞTI,158895,ROMÂNEŞTI,"GRĂDINIȚA CU PROGRAM NORMAL ROMÂNEŞTI",566,"Alegeri Prezidentiale",1,407,250,197,53,0,243,7,500,250,127,116
37,TIMIŞ,TOMEŞTI,158895,TOMEŞTI,"GRĂDINIȚA CU PROGRAM NORMAL TOMEŞTI",567,"Alegeri Prezidentiale",1,266,199,178,21,0,195,4,300,101,127,68
37,TIMIŞ,TOMNATIC,159473,TOMNATIC,"PRIMARIA COMUNEI TOMNATIC , CORP A",568,"Alegeri Prezidentiale",1,1698,530,500,27,3,524,6,1800,1270,353,171
37,TIMIŞ,TOMNATIC,159473,TOMNATIC,"PRIMARIA COMUNEI TOMNATIC , CORP B",569,"Alegeri Prezidentiale",1,1392,476,449,25,2,468,8,1500,1024,320,148
37,TIMIŞ,"TOPOLOVĂŢU MARE",158966,"TOPOLOVĂŢU MARE","PRIMĂRIA TOPOLOVĂŢU MARE",570,"Alegeri Prezidentiale",1,946,558,429,129,0,554,4,1000,442,420,134
37,TIMIŞ,"TOPOLOVĂŢU MARE",158966,CRALOVĂŢ,"CĂMINUL CULTURAL CRALOVĂŢ",571,"Alegeri Prezidentiale",1,89,73,30,43,0,72,1,100,27,49,23
37,TIMIŞ,"TOPOLOVĂŢU MARE",158966,ICTAR-BUDINŢI,"CLADIREA COMUNEI TOPOLOVATU MARE (SEDIUL FOSTULUI CAP ICTAR - BUDINŢI)",572,"Alegeri Prezidentiale",1,330,253,154,99,0,250,3,400,147,201,49
37,TIMIŞ,"TOPOLOVĂŢU MARE",158966,IOSIFALĂU,"SCOALA PRIMARĂ IOSIFALĂU",573,"Alegeri Prezidentiale",1,440,199,167,32,0,196,3,500,301,178,18
37,TIMIŞ,"TOPOLOVĂŢU MARE",158966,SUŞTRA,"CĂMINUL CULTURAL ŞUŞTRA",574,"Alegeri Prezidentiale",1,325,173,118,55,0,171,2,400,227,132,39
37,TIMIŞ,TORMAC,159035,TORMAC,"CĂMINUL CULTURAL TORMAC",575,"Alegeri Prezidentiale",1,1408,631,549,81,1,625,6,1500,869,550,75
37,TIMIŞ,TORMAC,159035,CADAR,"CĂMINUL CULTURAL CADĂR",576,"Alegeri Prezidentiale",1,215,135,105,28,2,135,0,300,165,99,36
37,TIMIŞ,TORMAC,159035,ŞIPET,"CĂMINUL CULTURAL ŞIPET",577,"Alegeri Prezidentiale",1,694,303,263,40,0,298,5,700,397,214,84
37,TIMIŞ,"TRAIAN VUIA",159071,SUDRIAŞ,"TELECENTRUL ”TRAIAN VUIA” SUDRIAŞ",578,"Alegeri Prezidentiale",1,639,242,198,43,1,236,6,700,458,155,81
37,TIMIŞ,"TRAIAN VUIA",159071,SĂCENI,"CĂMINUL CULTURAL SĂCENI",579,"Alegeri Prezidentiale",1,174,98,79,19,0,95,3,200,102,66,29
37,TIMIŞ,"TRAIAN VUIA",159071,"SURDUCU MIC","CĂMINUL CULTURAL SURDUCU MIC",580,"Alegeri Prezidentiale",1,259,130,104,25,1,127,3,300,170,78,49
37,TIMIŞ,"TRAIAN VUIA",159071,SUSANI,"GRĂDINIȚA CU PROGRAM NORMAL SUSANI",581,"Alegeri Prezidentiale",1,317,149,130,18,1,148,1,400,251,99,49
37,TIMIŞ,"TRAIAN VUIA",159071,"TRAIAN VUIA","CĂMINUL CULTURAL TRAIAN VUIA",582,"Alegeri Prezidentiale",1,365,231,187,44,0,228,3,400,169,161,67
37,TIMIŞ,UIVAR,159142,UIVAR,"CĂMINUL CULTURAL UIVAR",583,"Alegeri Prezidentiale",1,1159,468,381,87,0,464,4,1200,732,331,133
37,TIMIŞ,UIVAR,159142,PUSTINIŞ,"CĂMINUL CULTURAL PUSTINIŞ",584,"Alegeri Prezidentiale",1,590,295,246,49,0,293,2,700,405,199,94
37,TIMIŞ,UIVAR,159142,RĂUŢI,"CĂMINUL CULTURAL RĂUŢI",585,"Alegeri Prezidentiale",1,503,220,182,38,0,216,4,600,380,180,36
37,TIMIŞ,UIVAR,159142,"SÂNMARTINU MAGHIAR","CĂMINUL CULTURAL SÂNMARTINU MAGHIAR",586,"Alegeri Prezidentiale",1,234,133,108,25,0,132,1,300,167,118,14
37,TIMIŞ,VARIAŞ,159213,VARIAŞ,"CĂMINUL CULTURAL VARIAŞ",587,"Alegeri Prezidentiale",1,1800,767,678,68,21,759,8,1900,1133,584,175
37,TIMIŞ,VARIAŞ,159213,VARIAŞ,"SCOALA GIMNAZIALA VARIAS",588,"Alegeri Prezidentiale",1,1829,831,727,101,3,818,13,2000,1169,598,220
37,TIMIŞ,VARIAŞ,159213,GELU,"ȘCOALA GIMNAZIALA GELU",589,"Alegeri Prezidentiale",1,1179,576,473,103,0,566,10,1300,724,429,137
37,TIMIŞ,VARIAŞ,159213,"SÂNPETRU MIC","GRADINITA CU PROGRAM NORMAL SINPETRU MIC",590,"Alegeri Prezidentiale",2,456,170,151,19,0,169,1,457,287,148,21
37,TIMIŞ,VĂLCANI,159482,VĂLCANI,"PRIMARIA VĂLCANI",591,"Alegeri Prezidentiale",1,1132,561,509,51,1,554,7,1200,639,403,151
37,TIMIŞ,"VICTOR VLAD DELAMARINA",159259,"VICTOR VLAD DELAMARINA","CĂMINUL CULTURAL V.V DELAMARINA",592,"Alegeri Prezidentiale",1,370,257,208,49,0,254,3,400,143,144,110
37,TIMIŞ,"VICTOR VLAD DELAMARINA",159259,HERENDEŞTI,"CĂMINUL CULTURAL HERENDEŞTI",593,"Alegeri Prezidentiale",1,366,241,181,60,0,239,2,400,159,148,91
37,TIMIŞ,"VICTOR VLAD DELAMARINA",159259,HONORICI,"CĂMINUL CULTURAL HONORICI",594,"Alegeri Prezidentiale",1,249,153,125,28,0,151,2,300,147,114,37
37,TIMIŞ,"VICTOR VLAD DELAMARINA",159259,PĂDURENI,"CLADIREA COMUNEI VICTOR VLAD DELAMARINA(FOSTA ŞCOALĂ CU CLS I-IV PĂDURENI)",595,"Alegeri Prezidentiale",1,145,88,71,17,0,88,0,200,112,59,29
37,TIMIŞ,"VICTOR VLAD DELAMARINA",159259,"PETROASA MARE","ŞCOALA GIMNAZIALĂ PETROASA MARE",596,"Alegeri Prezidentiale",1,880,316,287,29,0,312,4,1000,684,231,81
37,TIMIŞ,"VICTOR VLAD DELAMARINA",159259,VISAG,"ŞCOALA PRIMARĂ VIȘAG",597,"Alegeri Prezidentiale",1,283,144,96,48,0,143,1,300,156,80,63
37,TIMIŞ,VOITEG,159339,VOITEG,"PRIMĂRIA VOITEG",598,"Alegeri Prezidentiale",1,1650,718,618,100,0,710,8,1700,982,510,200
37,TIMIŞ,VOITEG,159339,FOLEA,"ŞCOALA PRIMARĂ FOLEA",599,"Alegeri Prezidentiale",1,375,160,129,31,0,160,0,400,240,115,45
38,TULCEA,"MUNICIPIUL TULCEA",159614,TULCEA,"GRĂDINIŢA CU PROGRAM PRELUNGIT NR.18",1,"Alegeri Prezidentiale",1,1072,422,392,30,0,416,6,1178,756,278,138
38,TULCEA,"MUNICIPIUL TULCEA",159614,TULCEA,"GRĂDINIŢA CU PROGRAM PRELUNGIT NR.18",2,"Alegeri Prezidentiale",1,1301,600,566,33,1,587,13,1432,832,409,178
38,TULCEA,"MUNICIPIUL TULCEA",159614,TULCEA,"ŞCOALA GIMNAZIALĂ ” ION LUCA CARAGIALE”",3,"Alegeri Prezidentiale",1,1822,798,766,32,0,787,11,2005,1207,494,293
38,TULCEA,"MUNICIPIUL TULCEA",159614,TULCEA,"ŞCOALA GIMNAZIALĂ ” ION LUCA CARAGIALE”",4,"Alegeri Prezidentiale",1,1699,762,728,34,0,754,8,1870,1108,454,300
38,TULCEA,"MUNICIPIUL TULCEA",159614,TULCEA,"ŞCOALA GIMNAZIALĂ ” ION LUCA CARAGIALE”",5,"Alegeri Prezidentiale",1,1757,741,689,52,0,728,13,1933,1192,511,217
38,TULCEA,"MUNICIPIUL TULCEA",159614,TULCEA,"GRĂDINIŢA CU PROGRAM PRELUNGIT NR.13",6,"Alegeri Prezidentiale",1,1682,662,631,31,0,652,10,1851,1189,437,215
38,TULCEA,"MUNICIPIUL TULCEA",159614,TULCEA,"LICEUL DE ARTE ”GEORGE GEORGESCU”",7,"Alegeri Prezidentiale",1,1206,712,614,98,0,695,17,1327,615,413,282
38,TULCEA,"MUNICIPIUL TULCEA",159614,TULCEA,"LICEUL DE ARTE ”GEORGE GEORGESCU”",8,"Alegeri Prezidentiale",1,1115,574,520,54,0,568,6,1227,653,342,226
38,TULCEA,"MUNICIPIUL TULCEA",159614,TULCEA,"LICEUL DE ARTE ”GEORGE GEORGESCU”",9,"Alegeri Prezidentiale",1,1326,578,540,37,1,569,9,1459,881,374,195
38,TULCEA,"MUNICIPIUL TULCEA",159614,TULCEA,"LICEUL DE ARTE ”GEORGE GEORGESCU”",10,"Alegeri Prezidentiale",1,970,534,449,85,0,525,9,1067,533,352,173
38,TULCEA,"MUNICIPIUL TULCEA",159614,TULCEA,"LICEUL DE ARTE ”GEORGE GEORGESCU”",11,"Alegeri Prezidentiale",1,926,468,393,75,0,461,7,1019,551,301,160
38,TULCEA,"MUNICIPIUL TULCEA",159614,TULCEA,"GRĂDINIŢA CU PROGRAM PRELUNGIT NR.12",12,"Alegeri Prezidentiale",1,1732,868,820,48,0,856,12,1906,1038,532,324
38,TULCEA,"MUNICIPIUL TULCEA",159614,TULCEA,"LICEUL TEORETIC ”ION CREANGĂ”",13,"Alegeri Prezidentiale",1,1167,810,545,74,191,795,15,1274,464,400,395
38,TULCEA,"MUNICIPIUL TULCEA",159614,TULCEA,"LICEUL TEORETIC ”ION CREANGĂ”",14,"Alegeri Prezidentiale",1,974,589,445,23,121,575,14,1072,483,309,266
38,TULCEA,"MUNICIPIUL TULCEA",159614,TULCEA,"ŞCOALA GIMNAZIALĂ ”ELENA DOAMNA”",15,"Alegeri Prezidentiale",1,1273,828,641,43,144,819,9,1400,572,444,375
38,TULCEA,"MUNICIPIUL TULCEA",159614,TULCEA,"ŞCOALA GIMNAZIALĂ ”ELENA DOAMNA”",16,"Alegeri Prezidentiale",1,982,542,447,26,69,538,4,1080,538,321,217
38,TULCEA,"MUNICIPIUL TULCEA",159614,TULCEA,"SEMINARUL TEOLOGIC ORTODOX ”SF. IOAN CASIAN”",17,"Alegeri Prezidentiale",1,1042,589,505,60,24,579,10,1147,558,374,205
38,TULCEA,"MUNICIPIUL TULCEA",159614,TULCEA,"SEMINARUL TEOLOGIC ORTODOX ”SF. IOAN CASIAN”",18,"Alegeri Prezidentiale",1,957,483,452,30,1,480,3,1052,569,321,159
38,TULCEA,"MUNICIPIUL TULCEA",159614,TULCEA,"TEATRUL ”JEAN BART”",19,"Alegeri Prezidentiale",1,1597,895,790,104,1,873,22,1757,862,508,365
38,TULCEA,"MUNICIPIUL TULCEA",159614,TULCEA,"ŞCOALA GIMNAZIALĂ ”GRIGORE ANTIPA”",20,"Alegeri Prezidentiale",1,1201,578,538,40,0,568,10,1322,744,322,246
38,TULCEA,"MUNICIPIUL TULCEA",159614,TULCEA,"ŞCOALA GIMNAZIALĂ ”GRIGORE ANTIPA”",21,"Alegeri Prezidentiale",1,1107,572,530,42,0,561,11,1218,646,358,203
38,TULCEA,"MUNICIPIUL TULCEA",159614,TULCEA,"GRĂDINIȚA CU PROGRAM PRELUNGIT ”DRUMBAVA MINUNATĂ”",22,"Alegeri Prezidentiale",1,1798,869,825,44,0,849,20,1979,1110,546,303
38,TULCEA,"MUNICIPIUL TULCEA",159614,TULCEA,"ŞCOALA GIMNAZIALĂ ”ALEXANDRU CIUCURENCU”",23,"Alegeri Prezidentiale",1,1263,767,600,161,6,751,16,1390,623,481,270
38,TULCEA,"MUNICIPIUL TULCEA",159614,TULCEA,"ŞCOALA GIMNAZIALĂ ”ALEXANDRU CIUCURENCU”",24,"Alegeri Prezidentiale",1,1672,828,757,71,0,815,13,1840,1012,536,279
38,TULCEA,"MUNICIPIUL TULCEA",159614,TULCEA,"ŞCOALA GIMNAZIALĂ ”CONSTANTIN GĂVENEA”",25,"Alegeri Prezidentiale",1,1698,837,789,48,0,825,12,1868,1031,551,274
38,TULCEA,"MUNICIPIUL TULCEA",159614,TULCEA,"ŞCOALA GIMNAZIALĂ ”CONSTANTIN GĂVENEA”",26,"Alegeri Prezidentiale",1,1396,694,618,76,0,686,8,1536,842,467,219
38,TULCEA,"MUNICIPIUL TULCEA",159614,TULCEA,"ŞCOALA GIMNAZIALĂ ”CONSTANTIN GĂVENEA”",27,"Alegeri Prezidentiale",1,1525,805,736,69,0,789,16,1678,873,534,255
38,TULCEA,"MUNICIPIUL TULCEA",159614,TULCEA,"PUNCT DE ÎNCASARE TAXE ŞI IMPOZITE LOCALE",28,"Alegeri Prezidentiale",1,1713,888,826,62,0,867,21,1885,997,601,266
38,TULCEA,"MUNICIPIUL TULCEA",159614,TULCEA,"LICEUL TEORETIC ”GRIGORE MOISIL”",29,"Alegeri Prezidentiale",1,1281,739,633,40,66,727,12,1428,689,449,278
38,TULCEA,"MUNICIPIUL TULCEA",159614,TULCEA,"LICEUL TEORETIC ”GRIGORE MOISIL”",30,"Alegeri Prezidentiale",1,1156,699,549,71,79,685,14,1272,573,440,245
38,TULCEA,"MUNICIPIUL TULCEA",159614,TULCEA,"ŞCOALA GIMNAZIALĂ NR.12",31,"Alegeri Prezidentiale",2,1318,642,596,46,0,633,9,1450,808,393,240
38,TULCEA,"MUNICIPIUL TULCEA",159614,TULCEA,"ŞCOALA GIMNAZIALĂ NR.12",32,"Alegeri Prezidentiale",1,1428,589,556,33,0,573,16,1571,982,366,207
38,TULCEA,"MUNICIPIUL TULCEA",159614,TULCEA,"SALA DE SPORT MULTIFUNCŢIONALĂ",33,"Alegeri Prezidentiale",1,1476,684,613,71,0,675,9,1623,939,439,236
38,TULCEA,"MUNICIPIUL TULCEA",159614,TULCEA,"GRĂDINIŢA CU PROGRAM PRELUNGIT NR.17",34,"Alegeri Prezidentiale",1,1585,871,801,70,0,860,11,1744,873,582,278
38,TULCEA,"MUNICIPIUL TULCEA",159614,TULCEA,"GRĂDINIŢA CU PROGRAM PRELUNGIT NR.17",35,"Alegeri Prezidentiale",1,1714,733,646,87,0,721,12,1886,1153,538,183
38,TULCEA,"MUNICIPIUL TULCEA",159614,TULCEA,"COLEGIUL TEHNIC ”HENRY COANDĂ”",36,"Alegeri Prezidentiale",1,1552,849,742,107,0,835,14,1708,859,571,264
38,TULCEA,"MUNICIPIUL TULCEA",159614,TULCEA,"BIBLIOTECA JUDEŢEANĂ",37,"Alegeri Prezidentiale",1,1364,764,668,96,0,749,15,1501,737,487,262
38,TULCEA,"MUNICIPIUL TULCEA",159614,TULCEA,"COLEGIUL ECONOMIC ” DELTA DUNĂRII”",38,"Alegeri Prezidentiale",1,1223,590,535,55,0,586,4,1345,755,448,138
38,TULCEA,"MUNICIPIUL TULCEA",159614,TULCEA,"COLEGIUL ECONOMIC ” DELTA DUNĂRII”",39,"Alegeri Prezidentiale",1,990,514,440,74,0,505,9,1090,576,372,133
38,TULCEA,"MUNICIPIUL TULCEA",159614,TULCEA,"GRĂDINIȚA CU PROGRAM PRELUNGIT DE PE LÂNGĂ LICEUL TEHNOLOGIC AGRICOL NICOLAE CORNĂȚEANU",40,"Alegeri Prezidentiale",1,1433,774,680,94,0,756,18,1577,803,557,199
38,TULCEA,"MUNICIPIUL TULCEA",159614,TULCEA,"COLEGIUL ”ANGHEL SALIGNY”",41,"Alegeri Prezidentiale",1,1630,652,568,84,0,644,8,1794,1142,500,144
38,TULCEA,"MUNICIPIUL TULCEA",159614,TULCEA,"CASA DE CULTURĂ",42,"Alegeri Prezidentiale",1,1457,730,656,73,1,713,17,1603,873,476,237
38,TULCEA,"MUNICIPIUL TULCEA",159614,TULCEA,"CASA DE CULTURĂ",43,"Alegeri Prezidentiale",1,527,294,212,82,0,290,4,580,286,197,93
38,TULCEA,"MUNICIPIUL TULCEA",159614,TULCEA,"COLEGIUL DOBROGEAN ”SPIRU HARET”",44,"Alegeri Prezidentiale",1,1797,892,806,86,0,876,16,1977,1085,603,273
38,TULCEA,"MUNICIPIUL TULCEA",159614,TULCEA,"ŞCOALA GIMNAZIALĂ ”NIFON BĂLĂŞESCU”",45,"Alegeri Prezidentiale",1,1119,510,473,36,1,500,10,1230,720,297,203
38,TULCEA,"MUNICIPIUL TULCEA",159614,TULCEA,"ŞCOALA GIMNAZIALĂ ”NIFON BĂLĂŞESCU”",46,"Alegeri Prezidentiale",1,1575,774,715,59,0,764,10,1733,959,501,263
38,TULCEA,"MUNICIPIUL TULCEA",159614,TULCEA,"ŞCOALA GIMNAZIALĂ ”NIFON BĂLĂŞESCU”",47,"Alegeri Prezidentiale",1,1449,655,609,28,18,643,12,1594,939,398,245
38,TULCEA,"MUNICIPIUL TULCEA",159614,TULCEA,"ŞCOALA PROFESIONALĂ ”DANUBIUS”",48,"Alegeri Prezidentiale",1,1152,445,411,33,1,435,10,1268,823,273,162
38,TULCEA,"MUNICIPIUL TULCEA",159614,TULCEA,"ŞCOALA PROFESIONALĂ ”DANUBIUS”",49,"Alegeri Prezidentiale",1,1144,424,396,28,0,416,8,1259,835,269,147
38,TULCEA,"MUNICIPIUL TULCEA",159614,TULCEA,"ŞCOALA PRIMARĂ NR. 9",50,"Alegeri Prezidentiale",1,1194,510,485,25,0,502,8,1314,804,327,175
38,TULCEA,"MUNICIPIUL TULCEA",159614,TULCEA,"ŞCOALA PRIMARĂ NR. 9",51,"Alegeri Prezidentiale",1,1359,574,527,47,0,560,14,1495,921,359,201
38,TULCEA,"MUNICIPIUL TULCEA",159614,TULCEA,"ŞCOALA GIMNAZIALĂ ”IOAN NENIŢESCU”",52,"Alegeri Prezidentiale",1,1282,636,587,49,0,623,13,1411,775,397,226
38,TULCEA,"MUNICIPIUL TULCEA",159614,TULCEA,"ŞCOALA GIMNAZIALĂ ”IOAN NENIŢESCU”",53,"Alegeri Prezidentiale",1,1384,666,617,45,4,655,11,1523,857,421,234
38,TULCEA,"ORAŞ BABADAG",159650,BABADAG,"GRUP SCOLAR DIMITRIE CANTEMIR",54,"Alegeri Prezidentiale",1,1450,589,504,85,0,578,11,1596,1007,340,238
38,TULCEA,"ORAŞ BABADAG",159650,BABADAG,"SCOALA GENERALA NR.1 MIRCEA CEL BATRAN",55,"Alegeri Prezidentiale",1,1807,788,708,64,16,766,22,1988,1200,461,305
38,TULCEA,"ORAŞ BABADAG",159650,BABADAG,"SCOALA GENERALA NR.2",56,"Alegeri Prezidentiale",1,1351,609,569,40,0,587,22,1486,877,347,240
38,TULCEA,"ORAŞ BABADAG",159650,BABADAG,"ŞCOALA GENERALĂ NR. 3 ”CONSTANTIN BRÂNCOVEANU”",57,"Alegeri Prezidentiale",1,1425,356,316,40,0,348,8,1568,1212,214,134
38,TULCEA,"ORAŞ BABADAG",159650,BABADAG,"GRĂDINIŢA DE COPII NR.2-VETERANI",58,"Alegeri Prezidentiale",1,608,224,200,24,0,223,1,669,445,143,80
38,TULCEA,"ORAŞ BABADAG",159650,BABADAG,"”SALA DE SPORT TOMA AUREL”",59,"Alegeri Prezidentiale",1,1246,568,533,35,0,554,14,1369,801,298,256
38,TULCEA,"ORAŞ ISACCEA",159687,ISACCEA,"SEDIUL ADMINISTRATIV AL PRIMĂRIEI ORAȘULUI ISACCEA",60,"Alegeri Prezidentiale",1,1309,574,535,38,1,567,7,1440,866,384,183
38,TULCEA,"ORAŞ ISACCEA",159687,ISACCEA,"LICEUL TEORETIC ”CONSTANTIN BRĂTESCU”",61,"Alegeri Prezidentiale",1,1150,510,470,40,0,501,9,1265,755,385,116
38,TULCEA,"ORAŞ ISACCEA",159687,ISACCEA,"GRĂDINIŢA ”CONSTANTIN BRĂTESCU”",62,"Alegeri Prezidentiale",1,1303,557,526,30,1,550,7,1434,877,395,155
38,TULCEA,"ORAŞ ISACCEA",159687,REVĂRSAREA,"GRĂDINIȚA CU PROGRAM NORMAL REVĂRSAREA",63,"Alegeri Prezidentiale",2,401,199,132,38,29,197,2,441,242,124,73
38,TULCEA,"ORAŞ MĂCIN",159730,MĂCIN,"ŞCOALA GIMNAZIALĂ ”GHEORGHE BANEA”",64,"Alegeri Prezidentiale",1,1249,527,486,41,0,519,8,1373,846,377,142
38,TULCEA,"ORAŞ MĂCIN",159730,MĂCIN,"ŞCOALA GIMNAZIALĂ ”GHEORGHE BANEA”",65,"Alegeri Prezidentiale",1,1360,561,543,17,1,557,4,1497,936,399,158
38,TULCEA,"ORAŞ MĂCIN",159730,MĂCIN,"GRĂDINIŢA NR. 3",66,"Alegeri Prezidentiale",1,1191,547,494,26,27,541,6,1311,764,388,153
38,TULCEA,"ORAŞ MĂCIN",159730,MĂCIN,"ŞCOALA GIMNAZIALĂ NR. 1",67,"Alegeri Prezidentiale",1,1672,623,594,29,0,610,13,1839,1216,410,200
38,TULCEA,"ORAŞ MĂCIN",159730,MĂCIN,"ŞCOALA GIMNAZIALĂ NR. 1",68,"Alegeri Prezidentiale",1,1094,466,436,30,0,454,12,1203,737,282,172
38,TULCEA,"ORAŞ MĂCIN",159730,MĂCIN,"LICEUL TEORETIC” GHEORGHE MUNTEANU MURGOCI”",69,"Alegeri Prezidentiale",1,1419,461,441,19,1,460,1,1560,1099,338,122
38,TULCEA,"ORAŞ MĂCIN",159730,MĂCIN,"LICEUL TEORETIC” GHEORGHE MUNTEANU MURGOCI”",70,"Alegeri Prezidentiale",1,930,283,266,17,0,278,5,1022,739,184,94
38,TULCEA,"ORAŞ SULINA",159767,SULINA,"SCOALA I- IV - INCAPERE EXPOZITIONALA",71,"Alegeri Prezidentiale",1,1020,434,403,31,0,424,10,1121,687,261,163
38,TULCEA,"ORAŞ SULINA",159767,SULINA,"LICEUL ”JEAN BART”, LOCALITATEA SULINA",72,"Alegeri Prezidentiale",1,211,114,88,26,0,112,2,231,117,80,32
38,TULCEA,"ORAŞ SULINA",159767,SULINA,"LICEUL ”JEAN BART”, LOCALITATEA SULINA",73,"Alegeri Prezidentiale",1,1077,486,429,57,0,474,12,1185,699,318,156
38,TULCEA,"ORAŞ SULINA",159767,SULINA,"PRIMĂRIA ORAŞULUI SULINA",74,"Alegeri Prezidentiale",1,1076,500,435,65,0,492,8,1184,684,301,191
38,TULCEA,BAIA,159785,BAIA,"ŞCOALA GIMNAZIALĂ BAIA",75,"Alegeri Prezidentiale",1,1547,757,658,99,0,749,8,1682,925,436,313
38,TULCEA,BAIA,159785,BAIA,"ŞCOALA CU CLASELE I-IV BAIA",76,"Alegeri Prezidentiale",1,813,371,348,22,1,366,5,895,524,196,170
38,TULCEA,BAIA,159785,CAMENA,"ŞCOALA PRIMARĂ CAMENA",77,"Alegeri Prezidentiale",1,287,160,130,30,0,158,2,315,155,83,75
38,TULCEA,BAIA,159785,CAUGAGIA,"ŞCOALA CU CLASELE I-IV CAUGAGIA",78,"Alegeri Prezidentiale",2,182,96,65,31,0,95,1,199,103,68,27
38,TULCEA,BAIA,159785,PANDURU,"ŞCOALA PRIMARĂ PANDURU",79,"Alegeri Prezidentiale",1,326,162,138,24,0,160,2,358,196,111,49
38,TULCEA,BAIA,159785,"CEAMURLIA DE SUS","ŞCOALA GIMNAZIALĂ CEAMURLIA DE SUS",80,"Alegeri Prezidentiale",1,535,155,127,28,0,155,0,588,433,88,67
38,TULCEA,BEIDAUD,159847,BEIDAUD,"INSTITUŢIA PRIMARULUI COMUNEI BEIDAUD",81,"Alegeri Prezidentiale",1,431,244,197,45,2,242,2,473,229,119,123
38,TULCEA,BEIDAUD,159847,NEATÂRNAREA,"CAMINUL CULTURAL",82,"Alegeri Prezidentiale",1,386,185,149,36,0,182,3,424,239,79,103
38,TULCEA,BEIDAUD,159847,"SARIGHIOL DE DEAL","CAMINUL CULTURAL",83,"Alegeri Prezidentiale",1,468,285,220,65,0,279,6,514,229,115,164
38,TULCEA,BEŞTEPE,161552,BEŞTEPE,"ŞCOALA GIMNAZIALĂ BEŞTEPE",84,"Alegeri Prezidentiale",1,1410,628,554,72,2,622,6,1552,924,395,227
38,TULCEA,BEŞTEPE,161552,"BĂLTENII DE JOS",ŞCOALA,85,"Alegeri Prezidentiale",1,59,44,29,15,0,44,0,65,21,28,16
38,TULCEA,"C.A. ROSETTI",159883,LETEA,"ŞCOALA PRIMARĂ",86,"Alegeri Prezidentiale",1,242,133,112,21,0,132,1,266,133,114,18
38,TULCEA,"C.A. ROSETTI",159883,PERIPRAVA,"ŞCOALA PRIMARĂ",87,"Alegeri Prezidentiale",1,173,84,61,23,0,83,1,190,106,62,21
38,TULCEA,"C.A. ROSETTI",159883,"C.A. ROSETTI","ŞCOALA GIMNAZIALĂ",88,"Alegeri Prezidentiale",1,234,85,69,16,0,82,3,256,171,58,24
38,TULCEA,CARCALIU,159945,CARCALIU,"ŞCOALA GIMNAZIALA CARCALIU",89,"Alegeri Prezidentiale",1,1365,419,375,44,0,409,10,1502,1083,217,192
38,TULCEA,CARCALIU,159945,CARCALIU,"ŞCOALA GIMNAZIALA CARCALIU",90,"Alegeri Prezidentiale",1,1128,360,304,56,0,357,3,1241,881,215,142
38,TULCEA,CASIMCEA,159963,"CIŞMEAUA NOUĂ",ŞCOALA,91,"Alegeri Prezidentiale",1,31,28,19,9,0,27,1,33,5,16,11
38,TULCEA,CASIMCEA,159963,CASIMCEA,"ŞCOALA GIMNAZIALĂ",92,"Alegeri Prezidentiale",1,1102,378,346,32,0,373,5,1213,835,251,122
38,TULCEA,CASIMCEA,159963,CORUGEA,"ŞCOALA PRIMARĂ",93,"Alegeri Prezidentiale",1,332,115,99,16,0,113,2,364,249,72,41
38,TULCEA,CASIMCEA,159963,RAHMAN,"ŞCOALA PRIMARĂ",94,"Alegeri Prezidentiale",1,249,104,86,18,0,104,0,273,169,57,47
38,TULCEA,CASIMCEA,159963,RĂZBOIENI,"ŞCOALA PRIMARĂ",95,"Alegeri Prezidentiale",1,485,184,163,21,0,183,1,534,350,116,67
38,TULCEA,"CEAMURLIA DE JOS",160092,"CEAMURLIA DE JOS","ȘCOALA GIMNZIALĂ CEMURLIA DE JOS",96,"Alegeri Prezidentiale",1,975,379,345,34,0,377,2,1073,694,267,110
38,TULCEA,"CEAMURLIA DE JOS",160092,LUNCA,"ŞCOALA PRIMARĂ LUNCA",97,"Alegeri Prezidentiale",1,1029,381,346,35,0,374,7,1131,750,268,106
38,TULCEA,CEATALCHIOI,160047,PĂTLĂGEANCA,"ŞCOALA VECHE",98,"Alegeri Prezidentiale",1,167,115,77,38,0,114,1,183,68,48,66
38,TULCEA,CEATALCHIOI,160047,CEATALCHIOI,"CĂMINUL CULTURAL",99,"Alegeri Prezidentiale",1,376,176,137,39,0,175,1,413,237,99,76
38,TULCEA,CEATALCHIOI,160047,PLAURU,"ŞCOALA VECHE",100,"Alegeri Prezidentiale",1,30,28,12,16,0,28,0,32,4,9,19
38,TULCEA,CERNA,160127,"MIRCEA VODĂ","ŞCOALA MIRCEA VODĂ",101,"Alegeri Prezidentiale",1,408,166,142,24,0,166,0,449,283,81,85
38,TULCEA,CERNA,160127,CERNA,"ŞCOALA GIMNAZIALĂ ”PANAIT CERNA”",102,"Alegeri Prezidentiale",1,1706,721,663,49,9,714,7,1857,1136,342,372
38,TULCEA,CERNA,160127,TRAIAN,"ŞCOALA TRAIAN",103,"Alegeri Prezidentiale",1,815,328,289,39,0,322,6,897,569,209,113
38,TULCEA,CERNA,160127,"GENERAL PRAPORGESCU","ŞCOALA GENERAL PRAPORGESCU",104,"Alegeri Prezidentiale",1,149,65,52,13,0,65,0,164,99,23,42
38,TULCEA,"CHILIA VECHE",160172,"CHILIA VECHE","CAMIN CULTURAL",105,"Alegeri Prezidentiale",1,814,326,265,43,18,324,2,896,570,210,114
38,TULCEA,"CHILIA VECHE",160172,"CHILIA VECHE","CAMIN CULTURAL",106,"Alegeri Prezidentiale",1,825,272,251,21,0,269,3,908,636,170,99
38,TULCEA,CIUCUROVA,160225,CIUCUROVA,"ŞCOALA GIMNAZIALĂ",107,"Alegeri Prezidentiale",1,1122,404,357,47,0,397,7,1234,830,256,141
38,TULCEA,CIUCUROVA,160225,ATMAGEA,"ŞCOALA PRIMARĂ",108,"Alegeri Prezidentiale",1,155,59,42,17,0,59,0,170,111,35,24
38,TULCEA,CIUCUROVA,160225,"FÂNTÂNA MARE","ŞCOALA PRIMARĂ",109,"Alegeri Prezidentiale",1,430,174,142,32,0,174,0,472,298,110,64
38,TULCEA,CRIŞAN,160261,CRIŞAN,"ŞCOALA GIMNAZIALĂ CRISAN",110,"Alegeri Prezidentiale",1,371,273,158,115,0,272,1,407,134,196,76
38,TULCEA,CRIŞAN,160261,CARAORMAN,"ŞCOALA PRIMARĂ CARAORMAN",111,"Alegeri Prezidentiale",1,242,139,114,25,0,132,7,266,127,99,33
38,TULCEA,CRIŞAN,160261,"MILA 23","ŞCOALA GIMNAZIALĂ MILA23",112,"Alegeri Prezidentiale",1,388,277,231,46,0,275,2,427,150,188,87
38,TULCEA,DĂENI,160305,DĂENI,"CĂMIN CULTURAL",113,"Alegeri Prezidentiale",1,1633,659,602,57,0,651,8,1797,1138,481,170
38,TULCEA,DOROBANŢU,160323,DOROBANŢU,"SCOALA GIMNAZIALA DOROBANTU",114,"Alegeri Prezidentiale",1,629,258,229,27,2,256,2,691,433,148,108
38,TULCEA,DOROBANŢU,160323,CÂRJELARI,"ȘCOALA CÎRJELARI",115,"Alegeri Prezidentiale",1,349,133,110,22,1,132,1,383,250,64,68
38,TULCEA,DOROBANŢU,160323,MEŞTERU,"ȘCOALA MEȘTERU",116,"Alegeri Prezidentiale",1,117,68,55,13,0,67,1,138,70,33,34
38,TULCEA,FRECĂŢEI,160387,FRECĂŢEI,"CAMIN CULTURAL FRECATEI",117,"Alegeri Prezidentiale",1,996,493,409,76,8,490,3,1096,603,339,151
38,TULCEA,FRECĂŢEI,160387,CATALOI,"CENTRU MULTIFUNCTIONAL CATALOI",118,"Alegeri Prezidentiale",1,1035,513,412,88,13,508,5,1147,634,337,171
38,TULCEA,FRECĂŢEI,160387,POŞTA,"CAMIN CULTURAL POSTA",119,"Alegeri Prezidentiale",1,529,288,218,53,17,285,3,581,293,185,100
38,TULCEA,FRECĂŢEI,160387,TELIŢA,"CĂMIN CULTURAL TELIȚA",120,"Alegeri Prezidentiale",1,439,216,159,51,6,214,2,482,266,120,94
38,TULCEA,GRECI,160430,GRECI,"ŞCOALA GIMNAZIALĂ GRECI, CORP A",121,"Alegeri Prezidentiale",1,1511,537,513,24,0,532,5,1642,1105,396,136
38,TULCEA,GRECI,160430,GRECI,"ŞCOALA GIMNAZIALĂ GRECI, CORP B",122,"Alegeri Prezidentiale",1,1533,559,534,25,0,554,5,1666,1107,419,135
38,TULCEA,GRECI,160430,GRECI,"ŞCOALA GIMNAZIALĂ GRECI, CORP B",123,"Alegeri Prezidentiale",1,1253,435,386,49,0,433,2,1378,943,329,104
38,TULCEA,GRINDU,160458,GRINDU,"CENTRUL SOCIAL DE ZI PENTRU PERSOANE DEFAVORIZATE",124,"Alegeri Prezidentiale",1,1120,555,474,55,26,549,6,1232,677,441,108
38,TULCEA,HAMCEARCA,160476,HAMCEARCA,SCOALA,125,"Alegeri Prezidentiale",1,272,161,122,31,8,159,2,299,138,112,47
38,TULCEA,HAMCEARCA,160476,BALABANCEA,SCOALA,126,"Alegeri Prezidentiale",1,262,211,148,45,18,211,0,268,57,148,63
38,TULCEA,HAMCEARCA,160476,NIFON,SCOALA,127,"Alegeri Prezidentiale",1,525,295,251,28,16,288,7,577,282,195,93
38,TULCEA,HORIA,160528,CLOŞCA,"ŞCOALA CU CLASELE I-IV",128,"Alegeri Prezidentiale",1,95,67,45,17,5,64,3,104,37,20,44
38,TULCEA,HORIA,160528,FLOREŞTI,"GRADINITA FLORESTI",129,"Alegeri Prezidentiale",1,216,132,91,30,11,132,0,237,105,61,71
38,TULCEA,HORIA,160528,HORIA,"GRADINITA HORIA",130,"Alegeri Prezidentiale",1,816,434,349,69,16,427,7,897,463,239,188
38,TULCEA,I.C.BRĂTIANU,161525,I.C.BRĂTIANU,"CĂMINUL CULTURAL",131,"Alegeri Prezidentiale",1,941,553,412,141,0,551,2,1034,481,421,130
38,TULCEA,IZVOARELE,160564,IZVOARELE,"ŞCOALA GIMNAZIALĂ",132,"Alegeri Prezidentiale",1,1281,572,484,67,21,570,2,1407,835,425,145
38,TULCEA,IZVOARELE,160564,ALBA,"ŞCOALA PRIMARĂ",133,"Alegeri Prezidentiale",1,206,100,70,27,3,98,2,226,126,72,26
38,TULCEA,IZVOARELE,160564,IULIA,"ŞCOALA PRIMARĂ",134,"Alegeri Prezidentiale",1,259,132,98,34,0,132,0,284,152,88,44
38,TULCEA,JIJILA,160617,JIJILA,"CĂMINUL CULTURAL",135,"Alegeri Prezidentiale",1,1837,828,789,39,0,823,5,2001,1173,641,182
38,TULCEA,JIJILA,160617,JIJILA,"CĂMINUL CULTURAL",136,"Alegeri Prezidentiale",1,1631,735,695,40,0,727,8,1775,1040,547,180
38,TULCEA,JIJILA,160617,GARVĂN,"CĂMINUL CULTURAL",137,"Alegeri Prezidentiale",1,1068,500,434,66,0,493,7,1175,675,341,152
38,TULCEA,JURILOVCA,160644,SĂLCIOARA,"CĂMINUL CULTURAL",138,"Alegeri Prezidentiale",1,1030,566,520,46,0,558,8,1133,567,278,280
38,TULCEA,JURILOVCA,160644,VIŞINA,"ȘCOALA PRIMARĂ VIȘINA",139,"Alegeri Prezidentiale",1,593,314,264,49,1,309,5,653,339,173,136
38,TULCEA,JURILOVCA,160644,JURILOVCA,"ŞCOALA GENERALĂ",140,"Alegeri Prezidentiale",1,967,475,421,53,1,466,9,1064,589,230,236
38,TULCEA,JURILOVCA,160644,JURILOVCA,"CĂMINUL CULTURAL JURILOVCA",141,"Alegeri Prezidentiale",1,1075,476,418,55,3,468,8,1183,707,225,243
38,TULCEA,LUNCAVIŢA,160680,LUNCAVIŢA,"CĂMIN CULTURAL",142,"Alegeri Prezidentiale",1,1603,705,633,72,0,694,11,1744,1039,495,199
38,TULCEA,LUNCAVIŢA,160680,LUNCAVIŢA,"CĂMIN CULTURAL",143,"Alegeri Prezidentiale",1,1292,561,465,95,1,551,10,1422,861,403,148
38,TULCEA,LUNCAVIŢA,160680,RACHELU,"ŞCOALA GENERALĂ",144,"Alegeri Prezidentiale",1,615,292,236,55,1,290,2,676,384,197,93
38,TULCEA,MAHMUDIA,160724,MAHMUDIA,"LICEUL TEHNOLOGIC ”VASILE BACALU”",145,"Alegeri Prezidentiale",1,1063,556,484,61,11,554,2,1170,614,296,258
38,TULCEA,MAHMUDIA,160724,MAHMUDIA,"LICEUL TEHNOLOGIC ”VASILE BACALU”",146,"Alegeri Prezidentiale",1,1104,577,495,70,12,572,5,1215,638,336,236
38,TULCEA,MALIUC,160779,GORGOVA,"ȘCOALA PRIMARĂ GORGOVA",147,"Alegeri Prezidentiale",1,106,97,52,45,0,96,1,116,19,74,22
38,TULCEA,MALIUC,160779,MALIUC,"ŞCOALA GIMNAZIALĂ MALIUC",148,"Alegeri Prezidentiale",1,325,127,111,16,0,127,0,357,230,88,39
38,TULCEA,MALIUC,160779,PARTIZANI,"ŞCOALA GIMNAZIALĂ ”IOAN NENIȚESCU ” PARTIZANI",149,"Alegeri Prezidentiale",1,351,169,139,30,0,166,3,386,217,115,51
38,TULCEA,"MIHAI BRAVU",160831,"SATU NOU","ŞCOALA CU CLASELE I-IV",150,"Alegeri Prezidentiale",1,569,264,233,31,0,262,2,626,362,147,115
38,TULCEA,"MIHAI BRAVU",160831,"MIHAI BRAVU","ŞCOALA CU CLASELE I-VIII",151,"Alegeri Prezidentiale",1,545,207,177,30,0,206,1,600,393,138,68
38,TULCEA,"MIHAI BRAVU",160831,TURDA,"ȘCOALA GIMNAZIALĂ TURDA",152,"Alegeri Prezidentiale",1,993,386,347,39,0,381,5,1093,707,202,179
38,TULCEA,"MIHAIL KOGĂLNICEANU",160877,LĂSTUNI,"ŞCOALA PRIMARĂ LĂSTUNI",153,"Alegeri Prezidentiale",1,405,162,126,36,0,162,0,447,285,90,72
38,TULCEA,"MIHAIL KOGĂLNICEANU",160877,RÂNDUNICA,"ŞCOALA PRIMARĂ RÎNDUNICA",154,"Alegeri Prezidentiale",1,529,239,215,24,0,238,1,781,542,164,74
38,TULCEA,"MIHAIL KOGĂLNICEANU",160877,"MIHAIL KOGĂLNICEANU","ŞCOALA GIMNAZIALĂ MIHAIL KOGĂLNICEANU",155,"Alegeri Prezidentiale",1,1640,768,667,95,6,757,11,1785,1017,476,281
38,TULCEA,MURIGHIOL,160911,MURIGHIOL,"ŞCOALA GIMNAZIALĂ MURIGHIOL",156,"Alegeri Prezidentiale",1,1209,612,483,129,0,606,6,1330,718,422,184
38,TULCEA,MURIGHIOL,160911,COLINA,"ŞCOALA CU CLASELE I-IV COLINA",157,"Alegeri Prezidentiale",1,117,71,45,26,0,70,1,129,58,47,23
38,TULCEA,MURIGHIOL,160911,"DUNAVĂŢU DE JOS","ŞCOALA CU CLASELE I-IV DUNAVĂȚU DE JOS",158,"Alegeri Prezidentiale",1,537,311,213,98,0,309,2,590,279,271,38
38,TULCEA,MURIGHIOL,160911,"DUNAVĂŢU DE SUS","ŞCOALA CU CLASELE I-IV DUNAVĂȚU DE SUS",159,"Alegeri Prezidentiale",1,126,76,40,36,0,75,1,139,63,53,22
38,TULCEA,MURIGHIOL,160911,PLOPUL,"ŞCOALA CU CLASELE I-IV PLOPUL",160,"Alegeri Prezidentiale",1,506,202,165,37,0,201,1,556,354,138,63
38,TULCEA,MURIGHIOL,160911,SARINASUF,"CĂMIN CULTURAL SARINASUF",161,"Alegeri Prezidentiale",1,345,194,167,27,0,189,5,380,186,119,70
38,TULCEA,NALBANT,160993,TRESTENIC,"ŞCOALA CU CLASELE I-IV",162,"Alegeri Prezidentiale",1,264,112,94,18,0,111,1,291,179,85,26
38,TULCEA,NALBANT,160993,NALBANT,"ŞCOALA CU CLASELE I-VIII",163,"Alegeri Prezidentiale",1,778,270,236,34,0,259,11,856,586,172,87
38,TULCEA,NALBANT,160993,"NICOLAE BĂLCESCU","GRĂDINIȚA NICOLAE BĂLCESCU",164,"Alegeri Prezidentiale",1,1022,309,284,25,0,306,3,1124,815,235,71
38,TULCEA,NICULIŢEL,161035,NICULIŢEL,"ŞCOALA GIMNAZIALĂ ”NICHIFOR LUDOVIG”",165,"Alegeri Prezidentiale",1,1296,567,479,82,6,562,5,1426,859,370,192
38,TULCEA,NICULIŢEL,161035,NICULIŢEL,"ŞCOALA GIMNAZIALĂ ”NICHIFOR LUDOVIG”",166,"Alegeri Prezidentiale",1,1206,471,424,45,2,470,1,1327,856,301,169
38,TULCEA,NICULIŢEL,161035,NICULIŢEL,"GRĂDINIŢA DE COPII",167,"Alegeri Prezidentiale",1,1247,553,477,74,2,546,7,1371,818,322,224
38,TULCEA,NUFĂRU,161053,VICTORIA,"ŞCOALA CU CLASELE I-IV",168,"Alegeri Prezidentiale",1,176,106,66,40,0,104,2,193,87,58,46
38,TULCEA,NUFĂRU,161053,NUFĂRU,"ŞCOALA CU CLASELE I-VIII",169,"Alegeri Prezidentiale",1,1032,471,376,95,0,464,7,1136,665,298,166
38,TULCEA,NUFĂRU,161053,MALCOCI,"CENTRUL CULTURAL ADMINISTRATIV SOCIAL",170,"Alegeri Prezidentiale",1,1035,557,435,122,0,554,3,1139,582,363,191
38,TULCEA,OSTROV,161106,OSTROV,"GRĂDINIŢA DE COPII OSTROV",171,"Alegeri Prezidentiale",1,1555,663,624,37,2,658,5,1691,1028,289,369
38,TULCEA,PARDINA,161133,PARDINA,"CAMINUL CULTURAL",172,"Alegeri Prezidentiale",1,469,259,211,47,1,253,6,516,257,144,109
38,TULCEA,PECENEAGA,161151,PECENEAGA,"CĂMINUL CULTURAL",173,"Alegeri Prezidentiale",1,1397,720,615,53,52,713,7,1537,817,356,357
38,TULCEA,SARICHIOI,161179,SABANGIA,"ŞCOALA PRIMARĂ SABANGIA",174,"Alegeri Prezidentiale",1,449,201,153,48,0,195,6,493,292,129,66
38,TULCEA,SARICHIOI,161179,VISTERNA,"ŞCOALA PRIMARĂ VISTERNA",175,"Alegeri Prezidentiale",1,325,122,105,17,0,121,1,357,235,72,49
38,TULCEA,SARICHIOI,161179,ENISALA,"ŞCOALA PRIMARĂ ENISALA",176,"Alegeri Prezidentiale",1,771,327,289,38,0,325,2,847,520,213,112
38,TULCEA,SARICHIOI,161179,ZEBIL,"ŞCOALA GIMNAZIALĂ ZEBIL",177,"Alegeri Prezidentiale",1,1109,400,347,53,0,396,4,1220,820,246,150
38,TULCEA,SARICHIOI,161179,SARICHIOI,"ŞCOALA GIMNAZIALĂ SARICHIOI",178,"Alegeri Prezidentiale",1,1570,579,543,35,1,568,11,1708,1129,442,126
38,TULCEA,SARICHIOI,161179,SARICHIOI,"ŞCOALA GIMNAZIALĂ SARICHIOI",179,"Alegeri Prezidentiale",1,1384,542,504,38,0,537,5,1523,981,425,112
38,TULCEA,"SFÂNTU GHEORGHE",161231,"SFÂNTU GHEORGHE","CAMIN CULTURAL",180,"Alegeri Prezidentiale",1,695,379,315,62,2,375,4,764,385,250,125
38,TULCEA,"SLAVA CERCHEZĂ",161259,"SLAVA CERCHEZĂ","CONSILIUL LOCAL",181,"Alegeri Prezidentiale",1,1011,339,278,61,0,339,0,1113,774,209,130
38,TULCEA,"SLAVA CERCHEZĂ",161259,"SLAVA RUSĂ","ŞCOALA GENERALĂ CU CLASELE I-IV",182,"Alegeri Prezidentiale",1,914,314,244,70,0,312,2,1005,691,203,109
38,TULCEA,SMÂRDAN,161286,SMÂRDAN,"ŞCOALA GIMNAZIALĂ ”MAIOR IOAN MURGESCU”",183,"Alegeri Prezidentiale",1,894,421,359,62,0,418,3,964,543,329,89
38,TULCEA,SOMOVA,161302,MINERI,"ŞCOALA CU CLASELE I-IV",184,"Alegeri Prezidentiale",1,1469,665,616,49,0,658,7,1616,951,540,118
38,TULCEA,SOMOVA,161302,PARCHEŞ,"ŞCOALA CU CLASELE I-IV",185,"Alegeri Prezidentiale",1,648,255,216,38,1,251,4,712,457,189,62
38,TULCEA,SOMOVA,161302,SOMOVA,"ŞCOALA ”TRAIAN COŞOVEI” CU CLASELE I-VIII",186,"Alegeri Prezidentiale",1,1965,883,748,135,0,873,10,2142,1259,692,181
38,TULCEA,STEJARU,161348,STEJARU,"CĂMINUL CULTURAL",187,"Alegeri Prezidentiale",1,502,283,228,54,1,282,1,552,269,168,114
38,TULCEA,STEJARU,161348,"MINA ALTÂN TEPE","CLUBUL DEALUL DE AUR ALTÂN-TEPE",188,"Alegeri Prezidentiale",1,345,135,114,21,0,134,1,380,245,63,71
38,TULCEA,STEJARU,161348,"VASILE ALECSANDRI","SEDIUL FOSTEI ŞCOLI",189,"Alegeri Prezidentiale",1,388,233,190,43,0,231,2,426,193,112,119
38,TULCEA,TOPOLOG,161384,TOPOLOG,"LICEUL TEHNOLOGIC TOPOLOG TOPOLOG",190,"Alegeri Prezidentiale",1,908,415,397,17,1,407,8,999,584,244,163
38,TULCEA,TOPOLOG,161384,TOPOLOG,"LICEUL TEHNOLOGIC TOPOLOG",191,"Alegeri Prezidentiale",1,967,465,421,42,2,457,8,1064,599,281,176
38,TULCEA,TOPOLOG,161384,CALFA,"ŞCOALA GENERALĂ",192,"Alegeri Prezidentiale",1,97,66,50,16,0,65,1,107,41,30,35
38,TULCEA,TOPOLOG,161384,CERBU,"ŞCOALA GENERALĂ",193,"Alegeri Prezidentiale",1,185,106,79,27,0,106,0,203,97,77,29
38,TULCEA,TOPOLOG,161384,"FĂGĂRAŞU NOU","ŞCOALA GENERALĂ",194,"Alegeri Prezidentiale",1,511,240,212,28,0,236,4,561,321,158,78
38,TULCEA,TOPOLOG,161384,LUMINIŢA,"ŞCOALA GENERALĂ",195,"Alegeri Prezidentiale",1,207,115,96,19,0,113,2,228,113,65,48
38,TULCEA,TOPOLOG,161384,MĂGURELE,"ŞCOALA GENERALĂ",196,"Alegeri Prezidentiale",1,188,136,109,27,0,136,0,206,70,72,64
38,TULCEA,TOPOLOG,161384,"SÂMBĂTA NOUĂ","ŞCOALA GENERALĂ",197,"Alegeri Prezidentiale",1,440,212,180,32,0,211,1,484,272,122,89
38,TULCEA,TURCOAIA,161464,TURCOAIA,"ŞCOALA GIMNAZIALĂ TURCOAIA",198,"Alegeri Prezidentiale",1,1474,638,594,44,0,629,9,1622,984,328,301
38,TULCEA,TURCOAIA,161464,TURCOAIA,"SCOALA GIMNAZIALA TURCOAIA",199,"Alegeri Prezidentiale",1,1199,510,486,24,0,505,5,1299,789,241,264
38,TULCEA,"VALEA NUCARILOR",161482,"VALEA NUCARILOR","CĂMINUL CULTURAL",200,"Alegeri Prezidentiale",1,811,480,377,85,18,471,9,892,412,261,210
38,TULCEA,"VALEA NUCARILOR",161482,AGIGHIOL,"CĂMINUL CULTURAL AGIGHIOL",201,"Alegeri Prezidentiale",1,1393,652,540,106,6,644,8,1533,881,458,186
38,TULCEA,"VALEA NUCARILOR",161482,IAZURILE,"CĂMIN CULTURAL IAZURILE",202,"Alegeri Prezidentiale",1,656,319,255,62,2,316,3,722,403,180,136
38,TULCEA,"VALEA TEILOR",161561,"VALEA TEILOR","ŞCOALA GIMNAZIALĂ ”MIHAI EMINESCU” VALEA TEILOR",203,"Alegeri Prezidentiale",1,1144,498,460,38,0,492,6,1258,760,294,198
38,TULCEA,VĂCĂRENI,161543,VĂCĂRENI,"CĂMINUL CULTURAL",204,"Alegeri Prezidentiale",1,1806,802,712,62,28,795,7,1984,1182,516,279
39,VASLUI,"MUNICIPIUL VASLUI",161945,VASLUI,"CASA DE CULTURĂ A SINDICATELOR ”CONSTANTIN TĂNASE”",1,"Alegeri Prezidentiale",1,1464,755,698,57,0,735,20,1500,745,416,319
39,VASLUI,"MUNICIPIUL VASLUI",161945,VASLUI,"CASA DE CULTURĂ A SINDICATELOR ”CONSTANTIN TĂNASE”",2,"Alegeri Prezidentiale",2,1644,690,633,57,0,675,15,1700,1010,365,310
39,VASLUI,"MUNICIPIUL VASLUI",161945,VASLUI,"LICEUL TEORETIC ”MIHAIL KOGĂLNICEANU”",3,"Alegeri Prezidentiale",1,1830,502,480,22,0,494,8,1900,1398,300,194
39,VASLUI,"MUNICIPIUL VASLUI",161945,VASLUI,"LICEUL TEORETIC ”MIHAIL KOGĂLNICEANU”",4,"Alegeri Prezidentiale",1,2120,205,188,17,0,203,2,2200,1995,99,104
39,VASLUI,"MUNICIPIUL VASLUI",161945,VASLUI,"LICEUL TEORETIC ”MIHAIL KOGĂLNICEANU”",5,"Alegeri Prezidentiale",1,1831,280,254,26,0,276,4,1900,1620,152,124
39,VASLUI,"MUNICIPIUL VASLUI",161945,VASLUI,"LICEUL TEORETIC ”MIHAIL KOGĂLNICEANU”",6,"Alegeri Prezidentiale",1,2211,101,87,12,2,100,1,2200,2099,55,45
39,VASLUI,"MUNICIPIUL VASLUI",161945,VASLUI,"GRĂDINIȚA CU PROGRAM PRELUNGIT NR.14",7,"Alegeri Prezidentiale",1,1002,421,411,10,0,414,7,1100,679,242,172
39,VASLUI,"MUNICIPIUL VASLUI",161945,VASLUI,"GRĂDINIȚA CU PROGRAM PRELUNGIT NR.14",8,"Alegeri Prezidentiale",1,1022,447,413,34,0,438,9,1100,653,275,163
39,VASLUI,"MUNICIPIUL VASLUI",161945,VASLUI,"GRĂDINIȚA CU PROGRAM PRELUNGIT NR.15",9,"Alegeri Prezidentiale",1,1505,607,556,50,1,593,14,1600,993,323,270
39,VASLUI,"MUNICIPIUL VASLUI",161945,VASLUI,"ȘCOALA GIMNAZIALĂ ”CONSTANTIN PARFENE”",10,"Alegeri Prezidentiale",2,1967,10,0,10,0,10,0,2100,2090,6,4
39,VASLUI,"MUNICIPIUL VASLUI",161945,VASLUI,"ȘCOALA GIMNAZIALĂ ”CONSTANTIN PARFENE”",11,"Alegeri Prezidentiale",2,1868,278,134,8,136,270,8,1900,1622,78,192
39,VASLUI,"MUNICIPIUL VASLUI",161945,VASLUI,"ȘCOALA GIMNAZIALĂ ”CONSTANTIN PARFENE”",12,"Alegeri Prezidentiale",1,2176,93,65,28,0,92,1,2200,2107,65,27
39,VASLUI,"MUNICIPIUL VASLUI",161945,VASLUI,"ȘCOALA GIMNAZIALĂ ”CONSTANTIN PARFENE”",13,"Alegeri Prezidentiale",1,1827,213,69,21,123,206,7,1900,1687,70,136
39,VASLUI,"MUNICIPIUL VASLUI",161945,VASLUI,"ȘCOALA GIMNAZIALĂ ”CONSTANTIN PARFENE”",14,"Alegeri Prezidentiale",2,1848,546,399,14,133,535,11,1900,1354,275,260
39,VASLUI,"MUNICIPIUL VASLUI",161945,VASLUI,"ȘCOALA GIMNAZIALĂ ”CONSTANTIN PARFENE”",15,"Alegeri Prezidentiale",1,654,249,66,15,168,246,3,900,651,54,192
39,VASLUI,"MUNICIPIUL VASLUI",161945,VASLUI,"ȘCOALA GIMNAZIALĂ ”CONSTANTIN PARFENE”",16,"Alegeri Prezidentiale",1,2317,36,27,9,0,35,1,2300,2264,23,12
39,VASLUI,"MUNICIPIUL VASLUI",161945,VASLUI,"GRĂDINIȚA CU PROGRAM PRELUNGIT NR.5",17,"Alegeri Prezidentiale",1,2027,366,336,30,0,360,6,2100,1734,216,144
39,VASLUI,"MUNICIPIUL VASLUI",161945,VASLUI,"GRĂDINIȚA CU PROGRAM PRELUNGIT NR.5",18,"Alegeri Prezidentiale",1,2268,174,158,16,0,172,2,2300,2126,106,66
39,VASLUI,"MUNICIPIUL VASLUI",161945,VASLUI,"GRĂDINIȚA CU PROGRAM PRELUNGIT NR.5",19,"Alegeri Prezidentiale",2,858,176,66,9,101,174,2,1200,1024,97,77
39,VASLUI,"MUNICIPIUL VASLUI",161945,VASLUI,"ROMSILVA - RA - FILIALA VASLUI",20,"Alegeri Prezidentiale",1,1717,704,680,24,0,689,15,1900,1196,431,258
39,VASLUI,"MUNICIPIUL VASLUI",161945,VASLUI,"CENTRUL ŞCOLAR DE EDUCAŢIE INCLUZIVĂ ”ELISABETA POLIHRONIADE”",21,"Alegeri Prezidentiale",1,1870,796,773,22,1,778,18,1900,1104,480,298
39,VASLUI,"MUNICIPIUL VASLUI",161945,VASLUI,"CENTRUL ŞCOLAR DE EDUCAŢIE INCLUZIVĂ ”ELISABETA POLIHRONIADE”",22,"Alegeri Prezidentiale",1,2430,229,195,34,0,226,3,2400,2171,140,86
39,VASLUI,"MUNICIPIUL VASLUI",161945,VASLUI,"CENTRUL ȘCOLAR DE EDUCAȚIE INCLUZIVĂ ”ELISABETA POLIHRONIADE”",23,"Alegeri Prezidentiale",1,1013,250,151,21,78,242,8,1100,850,144,98
39,VASLUI,"MUNICIPIUL VASLUI",161945,VASLUI,"ȘCOALA GIMNAZIALĂ ”MIHAIL SADOVEANU”",24,"Alegeri Prezidentiale",1,1916,357,345,12,0,353,4,2000,1643,207,146
39,VASLUI,"MUNICIPIUL VASLUI",161945,VASLUI,"ȘCOALA GIMNAZIALĂ ”MIHAIL SADOVEANU”",25,"Alegeri Prezidentiale",2,1877,586,551,35,0,572,14,1900,1314,345,227
39,VASLUI,"MUNICIPIUL VASLUI",161945,VASLUI,"ȘCOALA GIMNAZIALĂ ”DIMITRIE CANTEMIR”",26,"Alegeri Prezidentiale",1,1873,676,653,23,0,659,17,1900,1224,371,288
39,VASLUI,"MUNICIPIUL VASLUI",161945,VASLUI,"ȘCOALA GIMNAZIALĂ ”DIMITRIE CANTEMIR”",27,"Alegeri Prezidentiale",1,1746,88,50,38,0,86,2,1800,1712,44,42
39,VASLUI,"MUNICIPIUL VASLUI",161945,VASLUI,"ȘCOALA GIMNAZIALĂ ”DIMITRIE CANTEMIR”",28,"Alegeri Prezidentiale",1,1802,331,315,16,0,322,9,1900,1569,192,130
39,VASLUI,"MUNICIPIUL VASLUI",161945,VASLUI,"LICEUL CU PROGRAM SPORTIV",29,"Alegeri Prezidentiale",1,1789,698,662,36,0,680,18,1900,1202,413,267
39,VASLUI,"MUNICIPIUL VASLUI",161945,VASLUI,"GRADINITA CU PROGRAM PRELUNGIT NR. 6",30,"Alegeri Prezidentiale",1,2930,82,67,15,0,80,2,2900,2818,45,35
39,VASLUI,"MUNICIPIUL VASLUI",161945,VASLUI,"GRADINITA CU PROGRAM PRELUNGIT NR.17",31,"Alegeri Prezidentiale",1,1953,633,584,49,0,620,13,2000,1367,332,288
39,VASLUI,"MUNICIPIUL VASLUI",161945,VASLUI,"ŞCOALA GIMNAZIALĂ „STEFAN CEL MARE”,",32,"Alegeri Prezidentiale",1,953,418,382,36,0,411,7,1000,582,225,186
39,VASLUI,"MUNICIPIUL VASLUI",161945,VASLUI,"ŞCOALA GIMNAZIALĂ „STEFAN CEL MARE”,",33,"Alegeri Prezidentiale",2,1857,745,740,5,0,734,11,1900,1155,417,317
39,VASLUI,"MUNICIPIUL VASLUI",161945,VASLUI,"ŞCOALA GIMNAZIALĂ „STEFAN CEL MARE”,",34,"Alegeri Prezidentiale",1,1325,123,64,59,0,121,2,1400,1277,75,46
39,VASLUI,"MUNICIPIUL VASLUI",161945,VASLUI,"ȘCOALA GIMNAZIALĂ ”CONSTANTIN MOTAȘ”",35,"Alegeri Prezidentiale",1,1013,422,386,36,0,416,6,1100,678,243,173
39,VASLUI,"MUNICIPIUL VASLUI",161945,VASLUI,"ȘCOALA GIMNAZIALĂ ”CONSTANTIN MOTAȘ”",36,"Alegeri Prezidentiale",1,1139,420,395,25,0,415,5,1200,780,237,178
39,VASLUI,"MUNICIPIUL VASLUI",161945,VASLUI,"LICEUL TEORETIC „EMIL RACOVIŢĂ”",37,"Alegeri Prezidentiale",1,1576,641,609,32,0,630,11,1700,1059,356,274
39,VASLUI,"MUNICIPIUL VASLUI",161945,VASLUI,"GRĂDINIȚA CU PROGRAM NORMAL NR.12",38,"Alegeri Prezidentiale",1,1483,661,609,52,0,649,12,1500,839,393,256
39,VASLUI,"MUNICIPIUL VASLUI",161945,VASLUI,"GRĂDINIȚA CU PROGRAM PRELUNGIT NR.3",39,"Alegeri Prezidentiale",1,1190,565,528,37,0,554,11,1300,735,346,208
39,VASLUI,"MUNICIPIUL VASLUI",161945,VASLUI,"SALA SPORTURILOR",40,"Alegeri Prezidentiale",1,1520,622,609,13,0,610,12,1700,1078,346,264
39,VASLUI,"MUNICIPIUL VASLUI",161945,VASLUI,"SALA SPORTURILOR",41,"Alegeri Prezidentiale",1,1856,270,218,52,0,259,11,1900,1630,167,92
39,VASLUI,"MUNICIPIUL VASLUI",161945,VASLUI,"SALA SPORTURILOR",42,"Alegeri Prezidentiale",1,1873,408,393,15,0,398,10,1900,1492,235,163
39,VASLUI,"MUNICIPIUL VASLUI",161945,VASLUI,"ȘCOALA GIMNAZIALĂ ”MIHAI EMINESCU”",43,"Alegeri Prezidentiale",1,1782,723,633,90,0,711,12,1800,1077,433,278
39,VASLUI,"MUNICIPIUL VASLUI",161945,VASLUI,"ȘCOALA GIMNAZIALĂ ”VASILE ALECSANDRI”",44,"Alegeri Prezidentiale",1,1031,380,363,17,0,369,11,1100,720,224,145
39,VASLUI,"MUNICIPIUL VASLUI",161945,VASLUI,"ȘCOALA GIMNAZIALĂ ”VASILE ALECSANDRI”",45,"Alegeri Prezidentiale",1,1527,374,349,25,0,363,11,1700,1326,230,133
39,VASLUI,"MUNICIPIUL VASLUI",161945,VASLUI,"ȘCOALA GIMNAZIALĂ ”VASILE ALECSANDRI”",46,"Alegeri Prezidentiale",1,1185,370,320,50,0,368,2,1300,930,230,138
39,VASLUI,"MUNICIPIUL VASLUI",161945,VASLUI,"ȘCOALA GIMNAZIALĂ ”VASILE ALECSANDRI”",47,"Alegeri Prezidentiale",1,1603,598,558,40,0,591,7,1700,1102,379,212
39,VASLUI,"MUNICIPIUL VASLUI",161945,VASLUI,"ȘCOALA GIMNAZIALĂ ”ALEXANDRA NECHITA”",48,"Alegeri Prezidentiale",1,1920,440,407,33,0,429,11,2100,1660,282,147
39,VASLUI,"MUNICIPIUL VASLUI",161945,VASLUI,"ȘCOALA GIMNAZIALĂ ”ALEXANDRA NECHITA”",49,"Alegeri Prezidentiale",1,2098,656,614,42,0,641,15,2200,1544,382,259
39,VASLUI,"MUNICIPIUL VASLUI",161945,VASLUI,"ȘCOALA GIMNAZIALĂ ”ALEXANDRA NICHITA”",50,"Alegeri Prezidentiale",1,1844,25,3,22,0,25,0,1900,1875,18,7
39,VASLUI,"MUNICIPIUL VASLUI",161945,VASLUI,"ȘCOALA GIMNAZIALĂ ”ALEXANDRA NICHITA”",51,"Alegeri Prezidentiale",1,1418,514,491,23,0,505,9,1500,986,289,216
39,VASLUI,"MUNICIPIUL VASLUI",161945,VASLUI,"COLEGIUL ECONOMIC ”ANGHEL RUGINĂ”",52,"Alegeri Prezidentiale",1,1773,544,511,33,0,532,12,1800,1256,298,234
39,VASLUI,"MUNICIPIUL VASLUI",161945,VASLUI,"COLEGIUL ECONOMIC ”ANGHEL RUGINĂ”",53,"Alegeri Prezidentiale",1,735,357,298,26,33,340,17,1000,643,211,129
39,VASLUI,"MUNICIPIUL VASLUI",161945,VASLUI,"ŞCOALA GIMNAZIALĂ ”ELENA CUZA”",54,"Alegeri Prezidentiale",1,1032,461,428,33,0,447,14,1100,639,265,182
39,VASLUI,"MUNICIPIUL VASLUI",161945,VASLUI,"ŞCOALA GIMNAZIALĂ ”ELENA CUZA”",55,"Alegeri Prezidentiale",1,1020,477,441,36,0,472,5,1100,623,255,217
39,VASLUI,"MUNICIPIUL VASLUI",161945,VASLUI,"ŞCOALA GIMNAZIALĂ ”ALEXANDRU IOAN CUZA”",56,"Alegeri Prezidentiale",1,1785,448,438,10,0,444,4,1900,1452,235,209
39,VASLUI,"MUNICIPIUL VASLUI",161945,VASLUI,"ŞCOALA GIMNAZIALĂ ”ALEXANDRU IOAN CUZA”",57,"Alegeri Prezidentiale",1,1814,617,606,11,0,594,23,1900,1283,381,213
39,VASLUI,"MUNICIPIUL VASLUI",161945,VASLUI,"ŞCOALA GIMNAZIALĂ ”ALEXANDRU IOAN CUZA”",58,"Alegeri Prezidentiale",1,1549,79,48,31,0,78,1,1700,1621,51,27
39,VASLUI,"MUNICIPIUL VASLUI",161945,VASLUI,"ŞCOALA PRIMARĂ",59,"Alegeri Prezidentiale",1,337,122,108,14,0,119,3,400,278,53,66
39,VASLUI,"MUNICIPIUL VASLUI",161945,VASLUI,"ŞCOALA PRIMARĂ",60,"Alegeri Prezidentiale",1,1201,257,244,13,0,250,7,1301,1044,131,119
39,VASLUI,"MUNICIPIUL VASLUI",161945,VASLUI,"ŞCOALA PRIMARĂ",61,"Alegeri Prezidentiale",1,992,129,117,12,0,124,5,1100,971,44,80
39,VASLUI,"MUNICIPIUL VASLUI",161945,VASLUI,"ŞCOALA GIMNAZIALĂ",62,"Alegeri Prezidentiale",1,1349,573,561,12,0,569,4,1400,827,342,227
39,VASLUI,"MUNICIPIUL VASLUI",161945,VASLUI,"ŞCOALA GIMNAZIALĂ",63,"Alegeri Prezidentiale",1,1059,380,362,17,1,375,5,1100,720,200,175
39,VASLUI,"MUNICIPIUL VASLUI",161945,VASLUI,"GRĂDINIȚA CU PROGRAM NORMAL",64,"Alegeri Prezidentiale",1,1749,916,861,55,0,898,18,1800,884,543,355
39,VASLUI,"MUNICIPIUL VASLUI",161945,VASLUI,"LICEUL ”ȘTEFAN PROCOPIU”",65,"Alegeri Prezidentiale",1,3019,190,117,73,0,185,5,3000,2810,133,52
39,VASLUI,"MUNICIPIUL VASLUI",161945,VASLUI,"LICEUL ”ŞTEFAN PROCOPIU”",66,"Alegeri Prezidentiale",1,2633,597,590,7,0,583,14,2600,2003,399,184
39,VASLUI,"MUNICIPIUL VASLUI",161945,VASLUI,"GRĂDINIŢA CU PROGRAM NORMAL NR. 22",67,"Alegeri Prezidentiale",1,2001,116,104,12,0,114,2,2200,2084,75,39
39,VASLUI,"MUNICIPIUL VASLUI",161945,VASLUI,"GRĂDINIŢA CU PROGRAM NORMAL NR. 22",68,"Alegeri Prezidentiale",1,1915,358,340,18,0,355,3,2200,1842,237,118
39,VASLUI,"MUNICIPIUL VASLUI",161945,VASLUI,"CLUBUL ”PRIETENIA”",69,"Alegeri Prezidentiale",1,1849,65,55,10,0,65,0,1900,1835,34,31
39,VASLUI,"MUNICIPIUL VASLUI",161945,VASLUI,"CLUBUL ”PRIETENIA”",70,"Alegeri Prezidentiale",2,1585,16,0,16,0,16,0,1700,1684,10,6
39,VASLUI,"MUNICIPIUL VASLUI",161945,VASLUI,"CLUBUL PENSIONARILOR",71,"Alegeri Prezidentiale",1,2225,45,18,27,0,44,1,2200,2155,29,15
39,VASLUI,"MUNICIPIUL VASLUI",161945,VASLUI,"CLUBUL PENSIONARILOR",72,"Alegeri Prezidentiale",1,2141,24,10,14,0,24,0,2200,2176,12,12
39,VASLUI,"MUNICIPIUL BÂRLAD",161794,BÂRLAD,"ŞCOALA GIMNAZIALĂ NR. 10",73,"Alegeri Prezidentiale",3,1591,653,627,26,0,638,15,1700,1047,362,276
39,VASLUI,"MUNICIPIUL BÂRLAD",161794,BÂRLAD,"ŞCOALA GIMNAZIALĂ NR. 10",74,"Alegeri Prezidentiale",1,1923,919,881,38,0,900,19,2000,1081,562,338
39,VASLUI,"MUNICIPIUL BÂRLAD",161794,BÂRLAD,"ŞCOALA GIMNAZIALĂ NR. 10",75,"Alegeri Prezidentiale",1,1688,814,750,28,36,793,21,1700,886,475,318
39,VASLUI,"MUNICIPIUL BÂRLAD",161794,BÂRLAD,"ŞCOALA GENERALA NR. 7 ”CĂPITAN GRIGORE IGNAT”",76,"Alegeri Prezidentiale",1,831,380,357,23,0,371,9,900,520,223,148
39,VASLUI,"MUNICIPIUL BÂRLAD",161794,BÂRLAD,"ŞCOALA GENERALA NR. 7 ”CĂPITAN GRIGORE IGNAT”",77,"Alegeri Prezidentiale",1,907,396,384,11,1,389,7,1000,604,214,175
39,VASLUI,"MUNICIPIUL BÂRLAD",161794,BÂRLAD,"COLEGIUL NAŢIONAL ”GHEORGHE ROŞCA CODREANU”",78,"Alegeri Prezidentiale",1,962,493,456,37,0,480,13,1100,607,315,165
39,VASLUI,"MUNICIPIUL BÂRLAD",161794,BÂRLAD,"COLEGIUL NAŢIONAL ”GHEORGHE ROŞCA CODREANU”",79,"Alegeri Prezidentiale",1,1524,632,602,30,0,624,8,1600,968,378,246
39,VASLUI,"MUNICIPIUL BÂRLAD",161794,BÂRLAD,"COLEGIUL NAŢIONAL ”GHEORGHE ROŞCA CODREANU”",80,"Alegeri Prezidentiale",1,997,524,497,27,0,510,14,1100,576,304,206
39,VASLUI,"MUNICIPIUL BÂRLAD",161794,BÂRLAD,"ŞCOALA GIMNAZIALĂ DE ARTE ”N. N. TONITZA”",81,"Alegeri Prezidentiale",1,1117,571,561,10,0,560,11,1200,629,359,201
39,VASLUI,"MUNICIPIUL BÂRLAD",161794,BÂRLAD,"ŞCOALA GIMNAZIALĂ DE ARTE ”N. N. TONITZA”",82,"Alegeri Prezidentiale",1,944,522,463,59,0,512,10,1000,478,312,200
39,VASLUI,"MUNICIPIUL BÂRLAD",161794,BÂRLAD,"ŞCOALA GIMNAZIALĂ NR. 8",83,"Alegeri Prezidentiale",1,600,451,268,55,128,442,9,1000,549,238,204
39,VASLUI,"MUNICIPIUL BÂRLAD",161794,BÂRLAD,"ŞCOALA GIMNAZIALĂ NR. 8",84,"Alegeri Prezidentiale",1,1279,602,582,20,0,590,12,1300,698,318,272
39,VASLUI,"MUNICIPIUL BÂRLAD",161794,BÂRLAD,"ŞCOALA GIMNAZIALĂ NR. 8",85,"Alegeri Prezidentiale",1,1226,497,473,24,0,487,10,1300,803,274,213
39,VASLUI,"MUNICIPIUL BÂRLAD",161794,BÂRLAD,"ŞCOALA GIMNAZIALĂ NR. 8",86,"Alegeri Prezidentiale",1,1505,653,635,17,1,647,6,1600,947,327,320
39,VASLUI,"MUNICIPIUL BÂRLAD",161794,BÂRLAD,"ŞCOALA GIMNAZIALĂ ”MANOLACHE COSTACHE EPUREANU”",87,"Alegeri Prezidentiale",2,1354,645,569,76,0,629,16,1500,855,354,275
39,VASLUI,"MUNICIPIUL BÂRLAD",161794,BÂRLAD,"COLEGIUL ”ALEXANDRU IOAN CUZA”",88,"Alegeri Prezidentiale",2,1552,595,555,40,0,589,6,1700,1105,357,232
39,VASLUI,"MUNICIPIUL BÂRLAD",161794,BÂRLAD,"COLEGIUL ”ALEXANDRU IOAN CUZA”",89,"Alegeri Prezidentiale",1,1349,600,576,24,0,585,15,1400,800,284,301
39,VASLUI,"MUNICIPIUL BÂRLAD",161794,BÂRLAD,"COLEGIUL ”ALEXANDRU IOAN CUZA”",90,"Alegeri Prezidentiale",3,1352,603,586,17,0,592,11,1400,797,316,276
39,VASLUI,"MUNICIPIUL BÂRLAD",161794,BÂRLAD,"COLEGIUL ”ALEXANDRU IOAN CUZA”",91,"Alegeri Prezidentiale",1,1237,448,413,35,0,437,11,1400,952,256,181
39,VASLUI,"MUNICIPIUL BÂRLAD",161794,BÂRLAD,"COLEGIUL ”ALEXANDRU IOAN CUZA”",92,"Alegeri Prezidentiale",1,1272,552,528,24,0,542,10,1300,748,308,234
39,VASLUI,"MUNICIPIUL BÂRLAD",161794,BÂRLAD,"COLEGIUL ”ALEXANDRU IOAN CUZA”",93,"Alegeri Prezidentiale",1,1357,585,558,27,0,572,13,1500,915,333,239
39,VASLUI,"MUNICIPIUL BÂRLAD",161794,BÂRLAD,"COLEGIUL ”ALEXANDRU IOAN CUZA”",94,"Alegeri Prezidentiale",1,1401,550,519,31,0,535,15,1500,950,272,263
39,VASLUI,"MUNICIPIUL BÂRLAD",161794,BÂRLAD,"LICEUL TEHNOLOGIC ”PETRU RAREŞ”",95,"Alegeri Prezidentiale",1,1058,499,478,21,0,488,11,1200,701,268,220
39,VASLUI,"MUNICIPIUL BÂRLAD",161794,BÂRLAD,"LICEUL TEHNOLOGIC ”PETRU RAREŞ”",96,"Alegeri Prezidentiale",1,1377,595,577,18,0,587,8,1500,905,346,241
39,VASLUI,"MUNICIPIUL BÂRLAD",161794,BÂRLAD,"LICEUL TEHNOLOGIC ”PETRU RAREŞ”",97,"Alegeri Prezidentiale",1,1520,577,553,24,0,563,14,1700,1123,322,241
39,VASLUI,"MUNICIPIUL BÂRLAD",161794,BÂRLAD,"ŞCOALA GIMNAZIALĂ ”VICTOR IOAN POPA”",98,"Alegeri Prezidentiale",1,1210,511,488,23,0,497,14,1300,789,292,205
39,VASLUI,"MUNICIPIUL BÂRLAD",161794,BÂRLAD,"ŞCOALA GIMNAZIALĂ ”VICTOR IOAN POPA”",99,"Alegeri Prezidentiale",1,1409,583,565,18,0,575,8,1500,917,326,249
39,VASLUI,"MUNICIPIUL BÂRLAD",161794,BÂRLAD,"ŞCOALA GIMNAZIALĂ ”VICTOR IOAN POPA”",100,"Alegeri Prezidentiale",1,1370,529,506,23,0,516,13,1500,971,328,188
39,VASLUI,"MUNICIPIUL BÂRLAD",161794,BÂRLAD,"CASA DE CULTURĂ A SINDICATELOR ”GEORGE TUTOVEANU”",101,"Alegeri Prezidentiale",1,1377,692,619,73,0,678,14,1500,808,397,281
39,VASLUI,"MUNICIPIUL BÂRLAD",161794,BÂRLAD,"CASA DE CULTURĂ A SINDICATELOR ”GEORGE TUTOVEANU”",102,"Alegeri Prezidentiale",1,1537,745,697,47,1,730,15,1700,955,462,268
39,VASLUI,"MUNICIPIUL BÂRLAD",161794,BÂRLAD,"ŞCOALA GIMNAZIALĂ ”PRINCIPESA ELENA BIBESCU”",103,"Alegeri Prezidentiale",1,1442,663,616,45,2,654,9,1600,937,388,266
39,VASLUI,"MUNICIPIUL BÂRLAD",161794,BÂRLAD,"ŞCOALA GIMNAZIALĂ ”PRINCIPESA ELENA BIBESCU”",104,"Alegeri Prezidentiale",1,1534,698,646,51,1,689,9,1700,1002,412,277
39,VASLUI,"MUNICIPIUL BÂRLAD",161794,BÂRLAD,"ŞCOALA GIMNAZIALĂ NR. 2",105,"Alegeri Prezidentiale",1,962,437,409,28,0,426,11,1100,663,277,149
39,VASLUI,"MUNICIPIUL BÂRLAD",161794,BÂRLAD,"ŞCOALA GIMNAZIALĂ NR. 2",106,"Alegeri Prezidentiale",1,653,323,299,24,0,318,5,700,377,185,133
39,VASLUI,"MUNICIPIUL BÂRLAD",161794,BÂRLAD,"ŞCOALA GIMNAZIALĂ NR. 2",107,"Alegeri Prezidentiale",1,1005,488,459,29,0,482,6,1100,612,293,189
39,VASLUI,"MUNICIPIUL BÂRLAD",161794,BÂRLAD,"ŞCOALA GIMNAZIALĂ NR. 2",108,"Alegeri Prezidentiale",1,881,400,370,30,0,389,11,1000,600,252,137
39,VASLUI,"MUNICIPIUL BÂRLAD",161794,BÂRLAD,"ŞCOALA GIMNAZIALĂ ”GEORGE TUTOVEANU”",109,"Alegeri Prezidentiale",1,1435,628,596,32,0,615,13,1600,972,378,237
39,VASLUI,"MUNICIPIUL BÂRLAD",161794,BÂRLAD,"ŞCOALA GIMNAZIALĂ ”GEORGE TUTOVEANU”",110,"Alegeri Prezidentiale",1,1626,668,629,39,0,657,11,1800,1132,395,262
39,VASLUI,"MUNICIPIUL BÂRLAD",161794,BÂRLAD,"ŞCOALA GIMNAZIALĂ ”GEORGE TUTOVEANU”",111,"Alegeri Prezidentiale",1,1338,652,606,46,0,638,14,1500,848,408,230
39,VASLUI,"MUNICIPIUL BÂRLAD",161794,BÂRLAD,"LICEUL PEDAGOGIC ”IOAN POPESCU”",112,"Alegeri Prezidentiale",1,1113,486,426,60,0,473,13,1200,714,306,167
39,VASLUI,"MUNICIPIUL BÂRLAD",161794,BÂRLAD,"LICEUL PEDAGOGIC ”IOAN POPESCU”",113,"Alegeri Prezidentiale",1,1327,612,575,37,0,599,13,1500,888,423,176
39,VASLUI,"MUNICIPIUL BÂRLAD",161794,BÂRLAD,"LICEUL PEDAGOGIC ”IOAN POPESCU”",114,"Alegeri Prezidentiale",1,1464,601,582,19,0,591,10,1600,999,362,229
39,VASLUI,"MUNICIPIUL BÂRLAD",161794,BÂRLAD,"LICEUL PEDAGOGIC ”IOAN POPESCU”",115,"Alegeri Prezidentiale",1,1205,546,498,48,0,539,7,1300,754,377,162
39,VASLUI,"MUNICIPIUL BÂRLAD",161794,BÂRLAD,"GRĂDINIȚA CU PROGRAM PRELUNGIT ”LICURICI”",116,"Alegeri Prezidentiale",1,1214,566,538,28,0,556,10,1300,734,366,190
39,VASLUI,"MUNICIPIUL BÂRLAD",161794,BÂRLAD,"GRĂDINIȚA CU PROGRAM PRELUNGIT ”LICURICI”",117,"Alegeri Prezidentiale",1,1324,602,583,19,0,586,16,1500,898,417,169
39,VASLUI,"MUNICIPIUL BÂRLAD",161794,BÂRLAD,"GRĂDINIȚA CU PROGRAM PRELUNGIT ”LICURICI”",118,"Alegeri Prezidentiale",1,868,407,370,37,0,401,6,1000,593,259,142
39,VASLUI,"MUNICIPIUL HUŞI",161829,HUŞI,"ASOCIATIA AGRICOLA ”CORNI”",119,"Alegeri Prezidentiale",1,1103,471,456,15,0,465,6,1200,729,328,137
39,VASLUI,"MUNICIPIUL HUŞI",161829,HUŞI,"SCOALA PROFESIONALA SPECIALĂ ”SF.ECATERINA”",120,"Alegeri Prezidentiale",1,1994,426,365,61,0,414,12,2100,1674,255,159
39,VASLUI,"MUNICIPIUL HUŞI",161829,HUŞI,"CENTRUL CONSULTATIV HUȘI",121,"Alegeri Prezidentiale",1,1672,852,665,65,122,837,15,1800,948,388,449
39,VASLUI,"MUNICIPIUL HUŞI",161829,HUŞI,"COLEGIUL NAȚIONAL ”CUZA VODA”",122,"Alegeri Prezidentiale",1,1772,440,407,33,0,430,10,1900,1460,208,222
39,VASLUI,"MUNICIPIUL HUŞI",161829,HUŞI,"LICEUL TEHNOLOGIC ”IOAN CORIVAN”",123,"Alegeri Prezidentiale",1,1071,510,469,40,1,502,8,1200,690,254,248
39,VASLUI,"MUNICIPIUL HUŞI",161829,HUŞI,"COLEGIUL AGRICOL ”DIMITRIE CANTEMIR”",124,"Alegeri Prezidentiale",1,1073,486,458,28,0,475,11,1100,614,247,228
39,VASLUI,"MUNICIPIUL HUŞI",161829,HUŞI,"SCOALA GIMNAZIALĂ ”ANASTASIE PANU”",125,"Alegeri Prezidentiale",1,1877,472,424,48,0,462,10,1999,1527,259,203
39,VASLUI,"MUNICIPIUL HUŞI",161829,HUŞI,"SCOALA GIMNAZIALĂ ”ANASTASIE PANU”",126,"Alegeri Prezidentiale",2,950,403,370,33,0,392,11,1000,597,212,180
39,VASLUI,"MUNICIPIUL HUŞI",161829,HUŞI,"SCOALA GIMNAZIALĂ ”ANASTASIE PANU”",127,"Alegeri Prezidentiale",1,1614,689,644,45,0,679,10,1800,1111,405,274
39,VASLUI,"MUNICIPIUL HUŞI",161829,HUŞI,"CASA DE CULTURA ”ALEXANDRU GIUGARU”",128,"Alegeri Prezidentiale",1,1083,541,473,68,0,529,12,1200,659,294,235
39,VASLUI,"MUNICIPIUL HUŞI",161829,HUŞI,"SCOALA GIMNAZIALĂ „MIHAIL SADOVEANU”",129,"Alegeri Prezidentiale",1,1665,715,676,39,0,703,12,1800,1085,371,332
39,VASLUI,"MUNICIPIUL HUŞI",161829,HUŞI,"SCOALA GIMNAZIALĂ „MIHAIL SADOVEANU”",130,"Alegeri Prezidentiale",2,1153,579,525,54,0,566,13,1300,721,305,261
39,VASLUI,"MUNICIPIUL HUŞI",161829,HUŞI,"ŞCOALA GIMNAZIALĂ ”ION CREANGĂ”",131,"Alegeri Prezidentiale",1,1468,720,671,49,0,708,12,1600,880,364,344
39,VASLUI,"MUNICIPIUL HUŞI",161829,HUŞI,"SCOALA GIMNAZIALA”ION CREANGA”",132,"Alegeri Prezidentiale",1,1168,483,467,16,0,467,16,1300,817,235,232
39,VASLUI,"MUNICIPIUL HUŞI",161829,HUŞI,"SCOALA GIMNAZIALĂ ”ION CREANGA”",133,"Alegeri Prezidentiale",1,1378,562,526,36,0,550,12,1500,938,280,270
39,VASLUI,"MUNICIPIUL HUŞI",161829,HUŞI,"SCOALA GIMNAZIALĂ NR.5",134,"Alegeri Prezidentiale",1,2050,405,394,11,0,403,2,2200,1795,288,115
39,VASLUI,"MUNICIPIUL HUŞI",161829,HUŞI,"SCOALA GIMNAZIALĂ NR.5",135,"Alegeri Prezidentiale",1,2020,301,271,30,0,296,5,2200,1899,231,65
39,VASLUI,"MUNICIPIUL HUŞI",161829,HUŞI,"SCOALA GIMNAZIALĂ NR.4",136,"Alegeri Prezidentiale",1,1218,510,495,15,0,500,10,1300,790,287,213
39,VASLUI,"MUNICIPIUL HUŞI",161829,HUŞI,"SCOALA GIMNAZIALĂ NR.4",137,"Alegeri Prezidentiale",1,1490,595,566,29,0,592,3,1600,1005,374,218
39,VASLUI,"MUNICIPIUL HUŞI",161829,HUŞI,"DIRECTIA AGRICOLA JUDETEANA VASLUI - UNITATEA FITOSANITARA HUSI",138,"Alegeri Prezidentiale",1,1860,638,608,30,0,624,14,2100,1462,383,241
39,VASLUI,"ORAŞ MURGENI",164981,MURGENI,"CASA DE CULTURA MURGENI",139,"Alegeri Prezidentiale",2,1791,630,582,48,0,620,10,2000,1370,270,350
39,VASLUI,"ORAŞ MURGENI",164981,MURGENI,"SCOALA PRIMARA SAT NOU",140,"Alegeri Prezidentiale",1,1095,166,149,17,0,161,5,1200,1034,96,65
39,VASLUI,"ORAŞ MURGENI",164981,CÂRJA,"ȘCOALA PRIMARĂ SAT CÂRJA",141,"Alegeri Prezidentiale",1,772,326,264,62,0,325,1,900,574,123,202
39,VASLUI,"ORAŞ MURGENI",164981,FLORENI,"ȘCOALA GIMNAZIALĂ SAT FLORENI",142,"Alegeri Prezidentiale",1,544,234,213,21,0,230,4,600,366,120,110
39,VASLUI,"ORAŞ MURGENI",164981,LĂŢEŞTI,"ȘCOALA PRIMARĂ SAT LĂȚEȘTI",143,"Alegeri Prezidentiale",1,252,112,90,22,0,111,1,301,189,70,41
39,VASLUI,"ORAŞ MURGENI",164981,RAIU,"ȘCOALA PRIMARĂ SAT RAIU",144,"Alegeri Prezidentiale",1,521,196,184,12,0,190,6,600,404,95,95
39,VASLUI,"ORAŞ MURGENI",164981,SĂRĂŢENI,"ȘCOALA GIMNAZIALĂ EMIL JUVARA SAT SĂRĂȚENI",145,"Alegeri Prezidentiale",1,293,128,109,19,0,127,1,300,172,76,51
39,VASLUI,"ORAŞ MURGENI",164981,SCHINENI,"ȘCOALA PRIMARĂ SAT SCHINENI",146,"Alegeri Prezidentiale",1,373,160,139,21,0,159,1,400,240,71,88
39,VASLUI,"ORAŞ NEGREŞTI",161856,NEGREŞTI,"CASA DE CULTURĂ",147,"Alegeri Prezidentiale",1,1561,608,576,32,0,600,8,1700,1092,314,286
39,VASLUI,"ORAŞ NEGREŞTI",161856,NEGREŞTI,"CASA DE CULTURĂ",148,"Alegeri Prezidentiale",1,1498,605,560,45,0,588,17,1700,1095,347,241
39,VASLUI,"ORAŞ NEGREŞTI",161856,NEGREŞTI,"SERVICIUL PUBLIC DE ASISTENȚĂ SOCIALĂ NEGREȘTI",149,"Alegeri Prezidentiale",1,1874,745,698,47,0,732,13,2100,1355,437,295
39,VASLUI,"ORAŞ NEGREŞTI",161856,NEGREŞTI,"GRĂDINIȚA CU PROGRAM NORMAL NR.2 NEGREȘTI",150,"Alegeri Prezidentiale",1,867,346,325,21,0,340,6,1000,654,190,150
39,VASLUI,"ORAŞ NEGREŞTI",161856,"VALEA MARE","ŞCOALA GIMNAZIALĂ SAT VALEA MARE",151,"Alegeri Prezidentiale",1,680,319,300,19,0,316,3,700,381,179,137
39,VASLUI,"ORAŞ NEGREŞTI",161856,POIANA,"ȘCOALA PRIMARĂ SAT POIANA",152,"Alegeri Prezidentiale",1,216,103,91,12,0,102,1,300,197,57,45
39,VASLUI,"ORAŞ NEGREŞTI",161856,CIOATELE,"ŞCOALA PRIMARĂ SAT CIOATELE",153,"Alegeri Prezidentiale",1,285,125,114,11,0,125,0,400,275,68,57
39,VASLUI,"ORAŞ NEGREŞTI",161856,PARPANIŢA,"GRĂDINIȚA CU PROGRAM NORMAL SAT PARPANIȚA",154,"Alegeri Prezidentiale",1,466,199,181,18,0,196,3,500,301,113,83
39,VASLUI,"ORAŞ NEGREŞTI",161856,GLODENI,"SCOALA PRIMARĂ SAT GLODENI",155,"Alegeri Prezidentiale",1,223,109,90,19,0,107,2,300,191,51,56
39,VASLUI,"ORAŞ NEGREŞTI",161856,CĂZĂNEŞTI,"ŞCOALA PRIMARĂ SAT CĂZĂNEȘTI",156,"Alegeri Prezidentiale",1,347,158,141,17,0,158,0,400,242,100,58
39,VASLUI,ALBEŞTI,162014,ALBEŞTI,"ŞCOALA GIMNAZIALA NR. 1 ALBESTI",157,"Alegeri Prezidentiale",1,817,359,304,54,1,356,3,900,541,188,168
39,VASLUI,ALBEŞTI,162014,CORNI-ALBEŞTI,"ŞCOALA GIMNAZIALA CORNI-ALBESTI",158,"Alegeri Prezidentiale",1,992,449,401,48,0,447,2,1100,651,224,223
39,VASLUI,ALBEŞTI,162014,CRASNA,"ȘCOALA PRIMARĂ CRASNA",159,"Alegeri Prezidentiale",1,443,210,171,39,0,207,3,500,290,145,62
39,VASLUI,ALBEŞTI,162014,"GURA ALBEŞTI","ŞCOALA PRIMARA - GURA ALBEŞTI",160,"Alegeri Prezidentiale",1,120,66,51,15,0,65,1,200,134,30,35
39,VASLUI,"ALEXANDRU VLAHUŢĂ",162069,"ALEXANDRU VLAHUŢĂ","ŞCOALA GIMNAZIALA, ALEXANDRU VLAHUŢĂ",161,"Alegeri Prezidentiale",2,639,255,228,27,0,251,4,700,445,136,115
39,VASLUI,"ALEXANDRU VLAHUŢĂ",162069,GHICANI,"ŞCOALA PRIMARA, GHICANI",162,"Alegeri Prezidentiale",1,132,66,47,19,0,66,0,200,134,41,25
39,VASLUI,"ALEXANDRU VLAHUŢĂ",162069,BUDA,"ŞCOALA PRIMARA, BUDA",163,"Alegeri Prezidentiale",1,209,89,76,13,0,88,1,300,211,59,29
39,VASLUI,"ALEXANDRU VLAHUŢĂ",162069,MORĂRENI,"ŞCOALA PRIMARA, MORĂRENI",164,"Alegeri Prezidentiale",1,194,84,71,13,0,83,1,200,116,52,31
39,VASLUI,ARSURA,162149,ARSURA,"ŞCOALA PRIMARĂ ”NICOLAE GH. LUPU” ARSURA",165,"Alegeri Prezidentiale",1,519,258,220,35,3,256,2,600,342,126,130
39,VASLUI,ARSURA,162149,FUNDĂTURA,"ŞCOALA PRIMARĂ ”ÎNV. ION BUSUIOC” FUNDĂTURA",166,"Alegeri Prezidentiale",1,317,152,126,25,1,151,1,400,248,96,55
39,VASLUI,ARSURA,162149,PÂHNEŞTI,"ŞCOALA PRIMARĂ PÎHNEŞTI",167,"Alegeri Prezidentiale",1,331,135,115,20,0,135,0,400,265,82,53
39,VASLUI,ARSURA,162149,"MIHAIL KOGĂLNICEANU","ŞCOALA PRIMARĂ MIHAIL KOGĂLNICEANU",168,"Alegeri Prezidentiale",1,73,41,24,17,0,41,0,100,59,22,19
39,VASLUI,BANCA,162194,"GARA BANCA","ŞCOALA GIMNAZIALĂ NR. 1 GARA BANCA",169,"Alegeri Prezidentiale",1,1069,502,435,67,0,497,5,1200,698,365,132
39,VASLUI,BANCA,162194,BANCA,"ŞCOALA GIMNAZIALĂ BANCA",170,"Alegeri Prezidentiale",1,828,351,322,29,0,348,3,900,549,252,96
39,VASLUI,BANCA,162194,GHERMĂNEŞTI,"ŞCOALA PRIMARĂ GHERMĂNEŞTI",171,"Alegeri Prezidentiale",1,385,178,155,23,0,174,4,400,222,129,45
39,VASLUI,BANCA,162194,STOIŞEŞTI,"ŞCOALA PRIMARĂ STOIŞEŞTI",172,"Alegeri Prezidentiale",1,486,225,194,31,0,222,3,500,275,122,100
39,VASLUI,BANCA,162194,ŢIFU,"CĂMINUL CULTURAL DIN SAT ȚIFU",173,"Alegeri Prezidentiale",1,311,139,121,18,0,138,1,400,261,101,37
39,VASLUI,BANCA,162194,"1 DECEMBRIE","ŞCOALA PRIMARĂ 1 DECEMBRIE",174,"Alegeri Prezidentiale",1,331,173,154,19,0,173,0,400,227,95,78
39,VASLUI,BANCA,162194,MITOC,"GRĂDINIȚA MITOC",175,"Alegeri Prezidentiale",1,304,137,124,13,0,137,0,400,263,67,70
39,VASLUI,BANCA,162194,SÂRBI,"CAMINUL CULTURAL",176,"Alegeri Prezidentiale",1,330,164,131,33,0,163,1,400,236,89,74
39,VASLUI,BANCA,162194,STRÂMTURA-MITOC,"LOCUINȚĂ PROPRIETATE PRIVATĂ ANTON NICU",177,"Alegeri Prezidentiale",1,169,78,62,16,0,77,1,200,122,62,15
39,VASLUI,BANCA,162194,MICLEŞTI,"ŞCOALA PRIMARA MICLEȘTI",178,"Alegeri Prezidentiale",1,191,90,77,13,0,89,1,200,110,66,23
39,VASLUI,BĂCANI,162327,BĂCANI,"ŞCOALA GIMNAZIALA NR. 1 SAT BĂCANI",179,"Alegeri Prezidentiale",1,1079,421,395,26,0,410,11,1200,779,275,135
39,VASLUI,BĂCANI,162327,BĂLTĂŢENI,"SEDIUL SC CMB GREEN TECHNOLOGY SRL",180,"Alegeri Prezidentiale",1,384,187,174,13,0,184,3,400,213,121,63
39,VASLUI,BĂCANI,162327,DRUJEŞTI,"ŞCOALA PRIMARA SAT DRUJEŞTI",181,"Alegeri Prezidentiale",1,339,175,142,33,0,173,2,400,225,105,68
39,VASLUI,BĂCANI,162327,SUSENI,"ŞCOALA PRIMARA SAT SUSENI",182,"Alegeri Prezidentiale",1,338,171,145,26,0,166,5,400,229,110,56
39,VASLUI,BĂCANI,162327,VULPĂŞENI,"FOSTA ŞCOALA CU CLASELE I-IV VULPĂȘENI",183,"Alegeri Prezidentiale",1,160,79,59,20,0,78,1,200,121,50,28
39,VASLUI,BĂCEŞTI,162381,BĂCEŞTI,"ŞCOALA GIMNAZIALĂ NR.1 SAT BĂCEŞTI",184,"Alegeri Prezidentiale",1,1720,572,516,23,33,558,14,1900,1328,218,340
39,VASLUI,BĂCEŞTI,162381,ARMĂŞENI,"ŞCOALA PRIMARĂ SAT ARMĂŞENI",185,"Alegeri Prezidentiale",1,312,160,149,11,0,157,3,400,240,66,91
39,VASLUI,BĂCEŞTI,162381,BĂBUŞA,"ŞCOALA PRIMARĂ SAT BĂBUŞA",186,"Alegeri Prezidentiale",1,336,141,123,18,0,138,3,400,259,65,73
39,VASLUI,BĂCEŞTI,162381,PĂLTINIŞ,"ŞCOALA PRIMARĂ SAT PĂLTINIŞ",187,"Alegeri Prezidentiale",1,239,121,112,9,0,119,2,300,179,15,104
39,VASLUI,BĂCEŞTI,162381,"ŢIBĂNEŞTII BUHLII","ŞCOALA PRIMARĂ SAT ŢIBĂNEŞTII BUHLII",188,"Alegeri Prezidentiale",1,171,82,61,21,0,81,1,200,118,34,47
39,VASLUI,BĂCEŞTI,162381,VOVRIEŞTI,"ŞCOALA PRIMARĂ SAT VOVRIEŞTI",189,"Alegeri Prezidentiale",1,252,114,102,12,0,113,1,300,186,59,54
39,VASLUI,BĂLTENI,162452,BĂLTENI,"CENTRUL CULTURAL BĂLTENI",190,"Alegeri Prezidentiale",1,779,405,354,51,0,402,3,900,495,158,244
39,VASLUI,BĂLTENI,162452,BĂLTENI-DEAL,"IMOBIL PROPRIETATE PRIVATĂ ÎNTREPRINDERE INDIVIDUALĂ CRAILIUC CĂTĂLINA-MIHAELA",191,"Alegeri Prezidentiale",1,375,182,151,31,0,181,1,400,218,91,90
39,VASLUI,BĂLTENI,162452,CHETREŞTI,"ŞCOALA PRIMARA CHETREŞTI",192,"Alegeri Prezidentiale",1,99,84,64,20,0,84,0,200,116,24,60
39,VASLUI,BEREZENI,162498,BEREZENI,"ŞCOALA GIMNAZIALĂ ”ANASTASIE FĂTU” BEREZENI- CORP 1",193,"Alegeri Prezidentiale",1,1109,496,433,63,0,490,6,1200,704,238,252
39,VASLUI,BEREZENI,162498,BEREZENI,"ŞCOALA GIMNAZIALĂ ”ANASTASIE FĂTU” BEREZENI- CORP 3",194,"Alegeri Prezidentiale",1,715,340,321,19,0,335,5,800,460,150,185
39,VASLUI,BEREZENI,162498,MUŞATA,"ŞCOALA PRIMARĂ MUŞATA",195,"Alegeri Prezidentiale",1,363,143,129,14,0,143,0,400,257,57,86
39,VASLUI,BEREZENI,162498,RÂNCENI,"ŞCOALA GIMNAZIALĂ RÎNCENI",196,"Alegeri Prezidentiale",1,428,178,155,23,0,175,3,500,322,74,101
39,VASLUI,BEREZENI,162498,STUHULEŢ,"ŞCOALA PRIMARĂ STUHULEŢ",197,"Alegeri Prezidentiale",1,180,82,63,19,0,80,2,200,118,41,39
39,VASLUI,BEREZENI,162498,"SATU NOU","ȘCOALA GIMNAZIALĂ ”ANASTASIE FĂTU” BEREZENI-CORP 2 SATU NOU",198,"Alegeri Prezidentiale",2,1143,451,426,25,0,446,5,1300,849,224,222
39,VASLUI,BLĂGEŞTI,162559,BLĂGEŞTI,"CĂMINUL CULTURAL BLĂGEŞTI",199,"Alegeri Prezidentiale",1,813,385,311,74,0,379,6,900,515,168,211
39,VASLUI,BLĂGEŞTI,162559,IGEŞTI,"ŞCOALA PRIMARA IGEŞTI",200,"Alegeri Prezidentiale",1,195,97,74,23,0,96,1,300,203,44,52
39,VASLUI,BLĂGEŞTI,162559,SIPENI,"ŞCOALA PRIMARA SIPENI",201,"Alegeri Prezidentiale",1,70,51,26,25,0,51,0,100,49,21,30
39,VASLUI,BOGDANA,162595,BOGDANA,"ŞCOALA GIMNAZIALĂ NR. 1 BOGDANA",202,"Alegeri Prezidentiale",1,451,210,181,29,0,207,3,500,290,136,71
39,VASLUI,BOGDANA,162595,SUCEVENI,"ŞCOALA SUCEVENI",203,"Alegeri Prezidentiale",1,157,78,60,18,0,77,1,200,122,50,27
39,VASLUI,BOGDANA,162595,GĂVANU,"ŞCOALA PRIMARĂ GĂVANU",204,"Alegeri Prezidentiale",1,96,62,46,16,0,46,16,200,138,27,19
39,VASLUI,BOGDANA,162595,VERDEŞ,"ŞCOALA VERDEŞ",205,"Alegeri Prezidentiale",1,157,71,60,11,0,71,0,200,129,32,39
39,VASLUI,BOGDANA,162595,"LACU BABEI","ŞCOALA PRIMARĂ LACU BABEI",206,"Alegeri Prezidentiale",1,336,115,104,11,0,115,0,400,285,89,26
39,VASLUI,BOGDĂNEŞTI,162693,BOGDĂNEŞTI,"CĂMINUL CULTURAL BOGDĂNEŞTI",207,"Alegeri Prezidentiale",1,789,374,332,41,1,369,5,900,526,180,189
39,VASLUI,BOGDĂNEŞTI,162693,BUDA,"ŞCOALA PRIMARA, SAT BUDA",208,"Alegeri Prezidentiale",1,285,218,188,30,0,218,0,300,82,23,195
39,VASLUI,BOGDĂNEŞTI,162693,VIŞINARI,"ŞCOALA PRIMARĂ, SAT VIȘINARI",209,"Alegeri Prezidentiale",1,156,105,79,26,0,103,2,200,95,36,67
39,VASLUI,BOGDĂNEŞTI,162693,ULEA,"ŞCOALA PRIMARĂ, SAT ULEA",210,"Alegeri Prezidentiale",1,265,174,122,51,1,171,3,300,126,60,111
39,VASLUI,BOGDĂNEŞTI,162693,UNŢEŞTI,"ŞCOALA GIMNAZIALĂ, SAT UNȚEȘTI",211,"Alegeri Prezidentiale",1,781,425,382,42,1,422,3,900,475,98,324
39,VASLUI,BOGDĂNEŞTI,162693,HOROIATA,"ŞCOALA PRIMARĂ, SAT HOROIATA",212,"Alegeri Prezidentiale",1,121,93,59,34,0,93,0,200,107,38,55
39,VASLUI,BOGDĂNIŢA,162791,BOGDĂNIŢA,"SEDIUL PRIMARIEI",213,"Alegeri Prezidentiale",1,154,76,64,12,0,76,0,200,124,47,29
39,VASLUI,BOGDĂNIŢA,162791,COROIEŞTI,"ŞCOALA PRIMARA COROIEŞTI",214,"Alegeri Prezidentiale",1,355,139,124,15,0,139,0,400,261,55,84
39,VASLUI,BOGDĂNIŢA,162791,TUNSEŞTI,"ŞCOALA PRIMARA TUNSEŞTI",215,"Alegeri Prezidentiale",1,213,90,80,10,0,90,0,300,210,33,57
39,VASLUI,BOGDĂNIŢA,162791,CEPEŞTI,"ŞCOALA GIMNAZIALA NR 1 CEPEŞTI",216,"Alegeri Prezidentiale",1,428,210,167,42,1,209,1,500,290,104,105
39,VASLUI,BOŢEŞTI,162871,BOŢEŞTI,"ŞCOALA GIMNAZIALĂ NR.1 BOŢEŞTI",217,"Alegeri Prezidentiale",1,789,344,317,27,0,337,7,900,556,234,103
39,VASLUI,BOŢEŞTI,162871,GUGEŞTI,"ŞCOALA GIMNAZIALĂ ”ALEXANDRU OBREJA” SAT GUGEŞTI",218,"Alegeri Prezidentiale",1,788,386,344,42,0,383,3,900,514,260,123
39,VASLUI,BUNEŞTI-AVEREŞTI,162924,AVEREŞTI,"ŞCOALA GIMNAZIALA NR. 1 SAT AVEREŞTI",219,"Alegeri Prezidentiale",1,219,122,104,14,4,119,3,300,178,31,88
39,VASLUI,BUNEŞTI-AVEREŞTI,162924,BUNEŞTI,"ŞCOALA GIMNAZIALĂ I-IV BUNEŞTI",220,"Alegeri Prezidentiale",1,959,506,464,30,12,504,2,1100,594,225,279
39,VASLUI,BUNEŞTI-AVEREŞTI,162924,PLOPI,"ŞCOALA PRIMARĂ PLOPI",221,"Alegeri Prezidentiale",1,364,168,142,25,1,165,3,400,232,91,74
39,VASLUI,BUNEŞTI-AVEREŞTI,162924,ARMĂŞENI,"FOSTA ŞCOALA GENERALĂ ARMĂŞENI",222,"Alegeri Prezidentiale",1,275,137,118,19,0,137,0,300,163,70,67
39,VASLUI,BUNEŞTI-AVEREŞTI,162924,"PODU OPRII","ŞCOALA PRIMARĂ PODU-OPRII",223,"Alegeri Prezidentiale",1,192,129,94,35,0,128,1,200,71,60,68
39,VASLUI,CIOCANI,167268,CIOCANI,"CĂMINUL CULTURAL CIOCANI",224,"Alegeri Prezidentiale",1,913,375,315,60,0,372,3,1000,625,188,184
39,VASLUI,CIOCANI,167268,CRÂNG,"ȘCOALA PRIMARĂ CRÂNG",225,"Alegeri Prezidentiale",1,359,200,156,44,0,198,2,400,200,101,97
39,VASLUI,CODĂEŞTI,163002,CODĂEŞTI,"ȘCOALA GIMNAZIALĂ CODĂEȘTI",226,"Alegeri Prezidentiale",1,892,344,315,22,7,341,3,1000,656,215,126
39,VASLUI,CODĂEŞTI,163002,CODĂEŞTI,"ȘCOALA GIMNAZIALĂ CODĂEȘTI",227,"Alegeri Prezidentiale",1,769,300,265,26,9,296,4,900,600,196,100
39,VASLUI,CODĂEŞTI,163002,PRIBEŞTI,"ȘCOALA GIMNAZIALĂ PRIBEȘTI",228,"Alegeri Prezidentiale",1,978,314,286,28,0,313,1,1100,786,187,126
39,VASLUI,CODĂEŞTI,163002,"REDIU GALIAN","CĂMINUL CULTURAL REDIU-GALIAN",229,"Alegeri Prezidentiale",1,463,216,189,27,0,210,6,500,284,153,57
39,VASLUI,CODĂEŞTI,163002,GHERGHELEU,"ȘCOALA GENERALĂ GHERGHELEU",230,"Alegeri Prezidentiale",1,321,130,110,20,0,129,1,400,270,78,51
39,VASLUI,COROIEŞTI,163057,COROIEŞTI,"SCOALA GIMNAZIALA GEORGE C DRAGU SAT COROIESTI",231,"Alegeri Prezidentiale",1,714,211,174,37,0,209,2,800,589,78,131
39,VASLUI,COROIEŞTI,163057,CHILIENI,"DISPENSAR UMAN, SAT CHILIENI",232,"Alegeri Prezidentiale",2,200,85,61,24,0,85,0,300,215,20,65
39,VASLUI,COROIEŞTI,163057,MIRENI,"SCOALA GIMNAZIALA SAT MIRENI",233,"Alegeri Prezidentiale",1,371,157,136,21,0,153,4,400,243,77,76
39,VASLUI,COROIEŞTI,163057,HREASCA,"SCOALA PRIMARA SAT HREASCA",234,"Alegeri Prezidentiale",1,309,131,110,21,0,131,0,400,269,59,72
39,VASLUI,COSTEŞTI,163137,COSTEŞTI,"ŞCOALA GIMNAZIALĂ SFÂNTUL IERARH LUCA COSTEȘTI",235,"Alegeri Prezidentiale",1,1449,647,570,77,0,639,8,1600,953,400,239
39,VASLUI,COSTEŞTI,163137,PUNTIŞENI,"ŞCOALA GIMNAZIALĂ PUNTIŞENI",236,"Alegeri Prezidentiale",1,225,102,80,22,0,101,1,300,198,39,62
39,VASLUI,COSTEŞTI,163137,CHIŢCANI,"ŞCOALA PRIMARĂ CHIŢCANI",237,"Alegeri Prezidentiale",1,259,96,85,11,0,96,0,300,204,55,41
39,VASLUI,COSTEŞTI,163137,DINGA,"ŞCOALA PRIMARĂ DINGA",238,"Alegeri Prezidentiale",1,103,62,45,17,0,62,0,200,138,31,31
39,VASLUI,COSTEŞTI,163137,RĂDEŞTI,"ŞCOALA PRIMARĂ RĂDEŞTI",239,"Alegeri Prezidentiale",1,116,73,57,16,0,73,0,200,127,39,34
39,VASLUI,COSTEŞTI,163137,PÂRVEŞTI,"ŞCOALA PRIMARĂ PÎRVEŞTI",240,"Alegeri Prezidentiale",2,78,53,30,23,0,53,0,100,47,25,28
39,VASLUI,COZMEŞTI,167277,BĂLEŞTI,"ŞCOALA PRIMARÃ BÃLEŞTI",241,"Alegeri Prezidentiale",1,581,246,214,32,0,243,3,600,354,119,124
39,VASLUI,COZMEŞTI,167277,FÂSTÂCI,"ŞCOALA GIMNAZIALÃ ” CEZAR BOTEZ ” FÂSTÂCI",242,"Alegeri Prezidentiale",1,272,115,91,24,0,113,2,300,185,43,70
39,VASLUI,COZMEŞTI,167277,COZMEŞTI,"FOSTA ŞCOALÃ CU CLASELE I-IV COZMEŞTI",243,"Alegeri Prezidentiale",2,248,107,82,25,0,106,1,300,193,38,68
39,VASLUI,COZMEŞTI,167277,FÂSTÂCI,"ŞCOALA PRIMARÃ FÂSTÂCI",244,"Alegeri Prezidentiale",1,590,194,179,15,0,191,3,600,406,60,131
39,VASLUI,CREŢEŞTI,163208,CREŢEŞTI,"CĂMINUL CULTURAL ” VASILE FOLESCU” CREŢEŞTI",245,"Alegeri Prezidentiale",3,482,212,190,22,0,209,3,500,288,130,79
39,VASLUI,CREŢEŞTI,163208,"CREŢEŞTII DE SUS","ŞCOALA GIMNAZIALA NR.1 CRETESTII DE SUS",246,"Alegeri Prezidentiale",1,488,257,191,62,4,252,5,500,243,133,119
39,VASLUI,CREŢEŞTI,163208,"SATU NOU","ŞCOALA NOUA SATU NOU",247,"Alegeri Prezidentiale",2,247,143,115,28,0,140,3,276,133,94,46
39,VASLUI,CREŢEŞTI,163208,BUDEŞTI,"ŞCOALA DEZAFECTATA BUDEŞTI",248,"Alegeri Prezidentiale",1,155,100,75,23,2,100,0,200,100,34,66
39,VASLUI,DĂNEŞTI,163253,DĂNEŞTI,"CĂMINUL CULTURAL DĂNEŞTI",249,"Alegeri Prezidentiale",1,446,166,141,25,0,165,1,500,334,79,86
39,VASLUI,DĂNEŞTI,163253,"EMIL RACOVIŢĂ","ŞCOALA GIMNAZIALA EMIL RACOVIŢĂ",250,"Alegeri Prezidentiale",1,646,219,204,15,0,213,6,700,481,112,101
39,VASLUI,DĂNEŞTI,163253,BEREASA,"ŞCOALA PRIMARA BEREASA",251,"Alegeri Prezidentiale",1,305,103,80,23,0,103,0,400,297,56,47
39,VASLUI,DĂNEŞTI,163253,TĂTĂRĂNI,"ŞCOALA PRIMARA TĂTĂRĂNI",252,"Alegeri Prezidentiale",1,159,74,49,25,0,73,1,200,126,34,39
39,VASLUI,DELENI,163324,DELENI,"ŞCOALA GIMNAZIALA NR. 1 DELENI",253,"Alegeri Prezidentiale",1,1359,601,487,114,0,594,7,1500,899,325,269
39,VASLUI,DELENI,163324,BULBOACA,"GRADINITA CU PROGRAM NORMAL, SAT BULBOACA",254,"Alegeri Prezidentiale",1,485,230,204,26,0,227,3,500,270,148,79
39,VASLUI,DELEŞTI,163379,DELEŞTI,"ŞCOALA GIMNAZIALĂ NR. 1, DELEŞTI",255,"Alegeri Prezidentiale",1,600,244,208,36,0,243,1,700,456,140,103
39,VASLUI,DELEŞTI,163379,ALBEŞTI,"ŞCOALA PRIMARĂ, ALBEŞTI",256,"Alegeri Prezidentiale",1,155,68,47,21,0,65,3,200,132,33,32
39,VASLUI,DELEŞTI,163379,FUNDĂTURA,"ŞCOALA PRIMARĂ, FUNDĂTURA",257,"Alegeri Prezidentiale",1,325,140,114,26,0,138,2,400,260,62,76
39,VASLUI,DELEŞTI,163379,HÂRSOVA,"FOSTUL SEDIU AL PRIMĂRIEI HÎRŞOVA",258,"Alegeri Prezidentiale",1,382,158,138,20,0,158,0,400,242,100,58
39,VASLUI,DELEŞTI,163379,MÂNĂSTIREA,"ŞCOALA PRIMARĂ, MÎNĂSTIREA",259,"Alegeri Prezidentiale",1,151,79,59,20,0,79,0,200,121,55,24
39,VASLUI,DELEŞTI,163379,RĂDUIEŞTI,"ŞCOALA PRIMARĂ, RĂDUIEȘTI",260,"Alegeri Prezidentiale",2,165,80,61,19,0,78,2,199,119,57,21
39,VASLUI,"DIMITRIE CANTEMIR",164277,HURDUGI,"ŞCOALA GIMNAZIALĂ NR.1 HURDUGI",261,"Alegeri Prezidentiale",1,509,183,168,15,0,181,2,600,417,95,86
39,VASLUI,"DIMITRIE CANTEMIR",164277,GRUMEZOAIA,"ŞCOALA PRIMARĂ GRUMEZOAIA",262,"Alegeri Prezidentiale",2,317,140,106,34,0,140,0,400,260,69,71
39,VASLUI,"DIMITRIE CANTEMIR",164277,GUŞIŢEI,"ŞCOALA VECHE DIN SAT GUȘIȚEI",263,"Alegeri Prezidentiale",1,622,233,218,15,0,230,3,700,467,150,80
39,VASLUI,"DIMITRIE CANTEMIR",164277,PLOTONEŞTI,"ŞCOALA PRIMARĂ PLOTONEŞTI",264,"Alegeri Prezidentiale",1,261,121,107,14,0,119,2,300,179,73,46
39,VASLUI,"DIMITRIE CANTEMIR",164277,URLAŢI,"ŞCOALA PRIMARĂ URLAŢI",265,"Alegeri Prezidentiale",1,200,100,89,11,0,98,2,200,100,57,41
39,VASLUI,DODEŞTI,167286,DODEŞTI,"ŞCOALA GIMNAZIALĂ ”V.I. POPA”",266,"Alegeri Prezidentiale",1,1139,700,569,68,63,694,6,1300,600,202,492
39,VASLUI,DODEŞTI,167286,URDEŞTI,"ŞCOALA PRIMARĂ URDEŞTI",267,"Alegeri Prezidentiale",1,195,138,106,26,6,137,1,300,162,60,77
39,VASLUI,DRAGOMIREŞTI,163486,DRAGOMIREŞTI,"CĂMINUL CULTURAL DRAGOMIREŞTI",268,"Alegeri Prezidentiale",1,436,196,154,42,0,196,0,500,304,100,96
39,VASLUI,DRAGOMIREŞTI,163486,"POIANA PIETREI","ŞCOALA PRIMARĂ POIANA PIETREI",269,"Alegeri Prezidentiale",3,229,115,98,17,0,114,1,300,185,71,43
39,VASLUI,DRAGOMIREŞTI,163486,DOAGELE,"ŞCOALA GIMNAZIALĂ DOAGELE",270,"Alegeri Prezidentiale",1,833,280,254,26,0,276,4,900,620,132,144
39,VASLUI,DRAGOMIREŞTI,163486,VLADIA,"LICEUL TEHNOLOGIC VLADIA",271,"Alegeri Prezidentiale",1,386,141,114,27,0,139,2,400,259,71,68
39,VASLUI,DRAGOMIREŞTI,163486,BELZENI,"ŞCOALA PRIMARĂ BELZENI",272,"Alegeri Prezidentiale",1,201,73,63,10,0,72,1,200,127,36,36
39,VASLUI,DRAGOMIREŞTI,163486,BĂBUŢA,"ŞCOALA PRIMARĂ BĂBUŢA",273,"Alegeri Prezidentiale",1,130,60,52,8,0,60,0,200,140,19,41
39,VASLUI,DRAGOMIREŞTI,163486,RĂDENI,"ŞCOALA GIMNAZIALĂ NR. 1 RĂDENI",274,"Alegeri Prezidentiale",1,935,250,223,27,0,247,3,1000,750,99,148
39,VASLUI,DRAGOMIREŞTI,163486,TULEŞTI,"ŞCOALA PRIMARĂ TULEŞTI",275,"Alegeri Prezidentiale",1,144,65,50,15,0,62,3,200,135,36,26
39,VASLUI,DRAGOMIREŞTI,163486,POPEŞTI,"CĂMIN CULTURAL POPEŞTI",276,"Alegeri Prezidentiale",1,309,116,103,13,0,114,2,400,284,43,71
39,VASLUI,DRÂNCENI,163618,GHERMĂNEŞTI,"SALA DE EDUCAŢIE FIZICĂ ŞCOLARĂ GHERMĂNEŞTI",277,"Alegeri Prezidentiale",1,1629,681,627,54,0,670,11,1800,1119,386,284
39,VASLUI,DRÂNCENI,163618,DRÂNCENI,"ŞCOALA PRIMARĂ, SAT DRÎNCENI",278,"Alegeri Prezidentiale",2,473,176,154,22,0,175,1,500,324,78,97
39,VASLUI,DRÂNCENI,163618,RÂŞEŞTI,"ŞCOALA GIMNAZIALĂ, SAT RÎŞEŞTI",279,"Alegeri Prezidentiale",1,1670,646,571,75,0,633,13,1800,1154,352,281
39,VASLUI,DUDA-EPURENI,163681,EPURENI,"ŞCOALA GIMNAZIALA CONSTANTIN ASIMINEI",280,"Alegeri Prezidentiale",1,1188,512,476,36,0,509,3,1300,788,269,240
39,VASLUI,DUDA-EPURENI,163681,DUDA,"ŞCOALA GIMNAZIALA IOAN GHE. PRICOP",281,"Alegeri Prezidentiale",1,971,400,350,50,0,392,8,1100,700,191,201
39,VASLUI,DUDA-EPURENI,163681,"VALEA GRECULUI","ŞCOALA GIMNAZIALA NICOLAE POPA",282,"Alegeri Prezidentiale",1,1298,495,473,22,0,488,7,1403,908,235,253
39,VASLUI,DUDA-EPURENI,163681,BOBEŞTI,"FOSTA ŞCOALA CU CLASELE I-IV BOBEŞTI",283,"Alegeri Prezidentiale",1,105,68,45,23,0,67,1,200,132,39,28
39,VASLUI,DUMEŞTI,163734,DUMEŞTI,"ŞCOALA GIMNAZIALĂ ”MAREȘAL C-TIN PREZAN” DUMEŞTI",284,"Alegeri Prezidentiale",2,1029,314,285,29,0,304,10,1100,786,137,167
39,VASLUI,DUMEŞTI,163734,DUMEŞTI,"GRĂDINIŢA NR. 1 DUMEŞTI",285,"Alegeri Prezidentiale",1,724,257,233,24,0,253,4,800,543,122,131
39,VASLUI,DUMEŞTI,163734,"DUMEŞTII VECHI","GRĂDINIȚA DUMEŞTII VECHI",286,"Alegeri Prezidentiale",1,347,123,110,13,0,120,3,400,277,67,53
39,VASLUI,DUMEŞTI,163734,"VALEA MARE","ŞCOALA PRIMARĂ VALEA MARE",287,"Alegeri Prezidentiale",1,694,286,262,24,0,279,7,800,514,101,178
39,VASLUI,EPURENI,163789,EPURENI,"SCOALA GIMNAZIALA ” MANOLACHE COSTACHE EPUREANU” SAT EPURENI",288,"Alegeri Prezidentiale",1,788,337,302,35,0,334,3,900,563,192,142
39,VASLUI,EPURENI,163789,BURSUCI,"ȘCOALA PRIMARĂ NR.2 BURSUCI",289,"Alegeri Prezidentiale",2,727,309,288,21,0,307,2,900,591,129,178
39,VASLUI,EPURENI,163789,BÂRLĂLEŞTI,"SCOALA PRIMARA .SAT BIRLALESTI",290,"Alegeri Prezidentiale",1,558,261,225,36,0,259,2,600,339,133,126
39,VASLUI,EPURENI,163789,HORGA,"SCOALA PRIMARA ,SAT HORGA",291,"Alegeri Prezidentiale",1,318,141,122,19,0,139,2,400,259,48,91
39,VASLUI,FĂLCIU,163832,FĂLCIU,"LICEUL TEHNOLOGIC ”DIMITRIE CANTEMIR” SAT FĂLCIU",292,"Alegeri Prezidentiale",1,1031,416,376,40,0,412,4,1100,684,236,176
39,VASLUI,FĂLCIU,163832,FĂLCIU,"CĂMINUL CULTURAL FĂLCIU",293,"Alegeri Prezidentiale",1,1048,422,389,33,0,420,2,1200,778,242,178
39,VASLUI,FĂLCIU,163832,BOGDĂNEŞTI,"ŞCOALA PRIMARĂ SAT BOGDĂNEŞTI",294,"Alegeri Prezidentiale",1,464,173,146,27,0,172,1,500,327,102,70
39,VASLUI,FĂLCIU,163832,RÂNZEŞTI,"ŞCOALA GIMNAZIALĂ SAT RÂNZEŞTI",295,"Alegeri Prezidentiale",1,836,299,257,42,0,295,4,900,601,155,140
39,VASLUI,FĂLCIU,163832,BOZIA,"ŞCOALA PRIMARĂ SAT BOZIA",296,"Alegeri Prezidentiale",1,322,147,124,23,0,143,4,400,253,75,68
39,VASLUI,FĂLCIU,163832,COPĂCEANA,"ŞCOALA PRIMARĂ SAT COPĂCEANA",297,"Alegeri Prezidentiale",1,448,208,188,20,0,204,4,500,292,124,80
39,VASLUI,FĂLCIU,163832,"ODAIA BOGDANA","ŞCOALA PRIMARĂ SAT ODAIA BOGDANA",298,"Alegeri Prezidentiale",1,256,126,103,23,0,125,1,300,174,85,40
39,VASLUI,FEREŞTI,167295,FEREŞTI,"CENTRUL CULTURAL ”SANDU TRIFAN”, FEREŞTI",299,"Alegeri Prezidentiale",1,1657,626,587,39,0,624,2,1800,1174,325,299
39,VASLUI,FRUNTIŞENI,167231,FRUNTIŞENI,"ŞCOALA GIMNAZIALĂ ”GENERAL AVIATOR INGINER GHEORGHE NEGRESCU” FRUNTIŞENI",300,"Alegeri Prezidentiale",1,768,279,256,23,0,276,3,800,521,123,153
39,VASLUI,FRUNTIŞENI,167231,GRĂJDENI,"ŞCOALA GIMNAZIALĂ GRĂJDENI",301,"Alegeri Prezidentiale",1,642,286,256,30,0,283,3,700,414,131,152
39,VASLUI,GĂGEŞTI,163903,GĂGEŞTI,"ŞCOALA GIMNAZIALA ”ION ARTENE” GĂGEŞTI",302,"Alegeri Prezidentiale",1,378,178,159,19,0,177,1,400,222,112,65
39,VASLUI,GĂGEŞTI,163903,GIURCANI,"GRĂDINIŢA CU PROGRAM NORMAL GIURCANI",303,"Alegeri Prezidentiale",1,464,230,200,30,0,228,2,500,270,109,119
39,VASLUI,GĂGEŞTI,163903,PEICANI,"ŞCOALA PRIMARA ”DUMITRU MARIN” PEICANI",304,"Alegeri Prezidentiale",1,430,215,196,19,0,212,3,500,285,120,92
39,VASLUI,GĂGEŞTI,163903,TUPILAŢI,"ŞCOALA PRIMARA TUPILATI",305,"Alegeri Prezidentiale",1,252,142,120,22,0,141,1,300,158,61,80
39,VASLUI,GÂRCENI,164062,GÂRCENI,"CĂMINUL CULTURAL GÎRCENI",306,"Alegeri Prezidentiale",2,714,359,279,51,29,350,9,800,441,104,246
39,VASLUI,GÂRCENI,164062,DUMBRĂVENI,"ŞCOALA PRIMARĂ, DUMBRĂVENI",307,"Alegeri Prezidentiale",1,170,109,68,33,8,109,0,200,91,34,75
39,VASLUI,GÂRCENI,164062,TROHAN,"ŞCOALA PRIMARĂ, TROHAN",308,"Alegeri Prezidentiale",1,182,87,64,23,0,87,0,200,113,33,54
39,VASLUI,GÂRCENI,164062,RACOVA,"ŞCOALA GIMNAZIALĂ, RACOVA",309,"Alegeri Prezidentiale",1,159,80,70,10,0,80,0,200,120,37,43
39,VASLUI,GÂRCENI,164062,RACOVIŢA,"ŞCOALA PRIMARĂ, RACOVIŢA",310,"Alegeri Prezidentiale",1,176,85,75,10,0,85,0,200,115,26,59
39,VASLUI,GÂRCENI,164062,SLOBOZIA,"ŞCOALA PRIMARĂ, SLOBOZIA",311,"Alegeri Prezidentiale",1,346,183,168,15,0,179,4,400,217,38,141
39,VASLUI,GHERGHEŞTI,163967,GHERGHEŞTI,"CĂMINUL CULTURAL, GHERGHEŞTI",312,"Alegeri Prezidentiale",1,923,390,356,34,0,385,5,1000,610,157,228
39,VASLUI,GHERGHEŞTI,163967,LUNCA,"CONTAINER MODULAR",313,"Alegeri Prezidentiale",1,395,161,153,8,0,158,3,400,239,63,95
39,VASLUI,GHERGHEŞTI,163967,CORODEŞTI,"ŞCOALA PRIMARA SAT CORODESTI",314,"Alegeri Prezidentiale",1,177,96,75,21,0,95,1,200,104,40,55
39,VASLUI,GHERGHEŞTI,163967,CHETROSU,"ŞCOALA GIMNAZIALA SAT CHETROSU",315,"Alegeri Prezidentiale",1,395,221,202,19,0,219,2,400,179,55,164
39,VASLUI,GHERGHEŞTI,163967,DRĂXENI,"ŞCOALA PRIMARĂ SAT DRAXENI (CONTAINER MODULAR)",316,"Alegeri Prezidentiale",1,124,78,62,16,0,78,0,200,122,22,56
39,VASLUI,GRIVIŢA,164133,GRIVIŢA,"GRĂDINIŢA CU PROGRAM NORMAL GRIVIŢA",317,"Alegeri Prezidentiale",1,1317,537,479,58,0,532,5,1400,863,330,202
39,VASLUI,GRIVIŢA,164133,TRESTIANA,"ŞCOALA GIMNAZIALĂ TRESTIANA",318,"Alegeri Prezidentiale",1,1131,456,409,47,0,451,5,1200,744,261,190
39,VASLUI,GRIVIŢA,164133,"ODAIA BURSUCANI","ŞCOALĂ PRIMARĂ STROE BELLOESCU CUPLATĂ CU GRĂDINIŢĂ – PROGRAM NORMAL",319,"Alegeri Prezidentiale",1,428,180,140,39,1,179,1,500,320,94,85
39,VASLUI,HOCENI,164197,HOCENI,"ȘCOALA GIMNAZIALĂ NR. 1 HOCENI",320,"Alegeri Prezidentiale",1,436,241,217,18,6,241,0,500,259,70,171
39,VASLUI,HOCENI,164197,BARBOŞI,"GRĂDINIŢA CU PROGRAM NORMAL BARBOŞI",321,"Alegeri Prezidentiale",1,542,289,250,28,11,284,5,600,311,83,201
39,VASLUI,HOCENI,164197,DELENI,"ŞCOALA PRIMARĂ DELENI",322,"Alegeri Prezidentiale",1,352,202,169,28,5,202,0,400,198,69,133
39,VASLUI,HOCENI,164197,OŢELENI,"ŞCOALA PRIMARĂ OŢELENI",323,"Alegeri Prezidentiale",2,397,265,216,44,5,263,2,500,235,79,184
39,VASLUI,HOCENI,164197,ŞIŞCANI,"ŞCOALA PRIMARĂ ”MIHAI CIOFU” ȘIȘCANI",324,"Alegeri Prezidentiale",1,243,140,104,26,10,137,3,300,160,32,105
39,VASLUI,HOCENI,164197,TOMŞA,"ŞCOALA PRIMARĂ TOMŞA",325,"Alegeri Prezidentiale",1,95,69,52,13,4,69,0,200,131,19,50
39,VASLUI,IANA,164339,IANA,"ŞCOALA GIMNAZIALA NR.1 IANA",326,"Alegeri Prezidentiale",1,928,425,390,35,0,421,4,1000,575,170,251
39,VASLUI,IANA,164339,HĂLĂREŞTI,"ŞCOALA PRIMARA HĂLĂREŞTI",327,"Alegeri Prezidentiale",1,819,398,358,40,0,392,6,900,502,243,149
39,VASLUI,IANA,164339,SILIŞTEA,"CONTAINER MODULAR",328,"Alegeri Prezidentiale",1,770,444,421,23,0,440,4,800,356,204,236
39,VASLUI,IANA,164339,RECEA,"ŞCOALA GIMNAZIALA RECEA",329,"Alegeri Prezidentiale",1,383,170,144,26,0,170,0,400,230,79,91
39,VASLUI,IANA,164339,VADURILE,"GRĂDINIŢA VADURILE",330,"Alegeri Prezidentiale",1,258,114,97,17,0,113,1,300,186,41,72
39,VASLUI,IBĂNEŞTI,167222,IBĂNEŞTI,"CĂMINUL CULTURAL IBĂNEŞTI",331,"Alegeri Prezidentiale",1,530,298,253,45,0,295,3,600,302,116,179
39,VASLUI,IBĂNEŞTI,167222,MÂNZAŢI,"ŞCOALA PRIMARĂ SAT. MÎNZAŢI",332,"Alegeri Prezidentiale",2,506,220,202,18,0,216,4,600,380,86,130
39,VASLUI,IBĂNEŞTI,167222,"PUŢU OLARULUI","FOSTA ŞCOALA CU CLASELE I-IV, PUŢU OLARULUI",333,"Alegeri Prezidentiale",2,103,88,54,34,0,88,0,200,112,28,60
39,VASLUI,IVĂNEŞTI,164393,IVĂNEŞTI,"ŞCOALA IVĂNEŞTI",334,"Alegeri Prezidentiale",1,994,391,331,60,0,387,4,1100,709,237,150
39,VASLUI,IVĂNEŞTI,164393,BROŞTENI,"ŞCOALA BROŞTENI",335,"Alegeri Prezidentiale",1,462,174,154,16,4,170,4,500,326,111,59
39,VASLUI,IVĂNEŞTI,164393,COŞEŞTI,"ŞCOALA COȘEȘTI",336,"Alegeri Prezidentiale",2,268,81,48,20,13,81,0,300,219,35,46
39,VASLUI,IVĂNEŞTI,164393,COŞEŞTI,"ŞCOALA COŞEȘTI",337,"Alegeri Prezidentiale",1,289,126,91,26,9,125,1,300,174,56,69
39,VASLUI,IVĂNEŞTI,164393,"VALEA MARE","IMOBIL - LOCUINȚĂ - PROPRIETATE PRIVATĂ, PROPRIETAR CHIRIAC EUGEN, PERSOANĂ FIZICĂ",338,"Alegeri Prezidentiale",1,410,162,137,22,3,161,1,500,338,42,119
39,VASLUI,IVĂNEŞTI,164393,"VALEA OANEI","ŞCOALA VALEA OANEI",339,"Alegeri Prezidentiale",1,221,98,82,16,0,98,0,300,202,63,35
39,VASLUI,IVĂNEŞTI,164393,URSOAIA,"GRĂDINIȚA CU PROGRAM NORMAL SAT URSOAIA",340,"Alegeri Prezidentiale",1,370,185,146,32,7,183,2,400,215,85,98
39,VASLUI,IVĂNEŞTI,164393,URSOAIA,"GRADINITA CU PROGRAM NORMAL SAT.URSOAIA",341,"Alegeri Prezidentiale",1,381,140,109,31,0,139,1,400,260,83,56
39,VASLUI,IVEŞTI,164543,IVEŞTI,"ŞCOALA GIMNAZIALĂ NR. 1 IVEŞTI - CORP A",342,"Alegeri Prezidentiale",1,1107,421,387,34,0,414,7,1200,779,235,179
39,VASLUI,IVEŞTI,164543,IVEŞTI,"ŞCOALA GIMNAZIALĂ NR. 1 IVEŞTI - CORP B",343,"Alegeri Prezidentiale",1,1093,411,372,39,0,408,3,1200,789,213,195
39,VASLUI,LAZA,164598,LAZA,"ŞCOALA GIMNAZIALĂ ”MIHAI EMINESCU” LAZA",344,"Alegeri Prezidentiale",1,1480,581,536,45,0,566,15,1600,1019,403,163
39,VASLUI,LAZA,164598,SAUCA,"ŞCOALA PRIMARA ,SAUCA",345,"Alegeri Prezidentiale",1,876,379,353,26,0,372,7,1000,621,211,161
39,VASLUI,LAZA,164598,RÂŞNIŢA,"ŞCOALA PRIMARĂ, RÂŞNIŢA",346,"Alegeri Prezidentiale",1,234,98,70,28,0,98,0,300,202,48,50
39,VASLUI,LIPOVĂŢ,164687,LIPOVĂŢ,"CENTRUL CULTURAL ”ȘTEFAN CIOBOTĂRAȘU” SAT LIPOVAȚ",347,"Alegeri Prezidentiale",1,1274,596,550,46,0,588,8,1400,804,292,296
39,VASLUI,LIPOVĂŢ,164687,CORBU,"ŞCOALA PRIMARĂ SAT CORBU",348,"Alegeri Prezidentiale",1,448,211,192,19,0,211,0,500,289,117,94
39,VASLUI,LIPOVĂŢ,164687,CHIŢOC,"ŞCOALA GIMNAZIALĂ ”SPĂTAR ŞTEFAN ANGHELUȚĂ” SAT CHIŢOC",349,"Alegeri Prezidentiale",1,830,393,352,41,0,384,9,900,507,238,146
39,VASLUI,LIPOVĂŢ,164687,CĂPUŞNENI,"ŞCOALA PRIMARĂ SAT CĂPUŞNENI",350,"Alegeri Prezidentiale",1,196,111,94,17,0,111,0,300,189,41,70
39,VASLUI,LIPOVĂŢ,164687,"FUNDU VĂII","ŞCOALA GIMNAZIALĂ SAT FUNDU - VĂII",351,"Alegeri Prezidentiale",1,467,196,178,18,0,195,1,500,304,44,151
39,VASLUI,"LUNCA BANULUI",164749,"LUNCA BANULUI","ŞCOALA GIMNAZIALĂ NR. 1 LUNCA BANULUI",352,"Alegeri Prezidentiale",1,1642,713,667,46,0,704,9,1800,1087,348,356
39,VASLUI,"LUNCA BANULUI",164749,OŢETOAIA,"ŞCOALA PRIMARĂ SAT OŢETOAIA",353,"Alegeri Prezidentiale",1,659,305,279,26,0,302,3,700,395,139,163
39,VASLUI,"LUNCA BANULUI",164749,"LUNCA VECHE","ŞCOALA PRIMARĂ SAT LUNCA VECHE",354,"Alegeri Prezidentiale",1,74,46,29,17,0,46,0,100,54,20,26
39,VASLUI,"LUNCA BANULUI",164749,FOCŞA,"ŞCOALA PRIMARĂ SAT FOCŞA",355,"Alegeri Prezidentiale",1,153,90,77,13,0,87,3,200,110,50,37
39,VASLUI,"LUNCA BANULUI",164749,BROSCOŞEŞTI,"ŞCOALA PRIMARĂ SAT BROSCOŞEŞTI",356,"Alegeri Prezidentiale",1,383,170,148,17,5,166,4,400,230,91,75
39,VASLUI,MĂLUŞTENI,164829,MĂLUŞTENI,"ŞCOALA GIMNAZIALĂ NR.1,SAT MĂLUȘTENI",357,"Alegeri Prezidentiale",1,488,201,171,30,0,197,4,500,299,89,108
39,VASLUI,MĂLUŞTENI,164829,ŢUŢCANI,"ŞCOALA CENTRU ȚUȚCANI",358,"Alegeri Prezidentiale",1,427,181,153,28,0,180,1,500,319,75,105
39,VASLUI,MĂLUŞTENI,164829,MÂNĂSTIREA,"ŞCOALA MÎNĂSTIREA",359,"Alegeri Prezidentiale",1,80,54,35,19,0,54,0,100,46,20,34
39,VASLUI,MĂLUŞTENI,164829,GHIREASCA,"ŞCOALA GHIREASCA",360,"Alegeri Prezidentiale",1,150,72,53,19,0,71,1,200,128,33,38
39,VASLUI,MĂLUŞTENI,164829,LUPEŞTI,"SALA FESTIVITĂȚI LUPEȘTI",361,"Alegeri Prezidentiale",1,336,153,129,24,0,153,0,400,247,62,91
39,VASLUI,MĂLUŞTENI,164829,MÂNZĂTEŞTI,"SALA CULTURALĂ MÎNZĂTEȘTI",362,"Alegeri Prezidentiale",1,273,115,91,24,0,113,2,300,185,24,89
39,VASLUI,MICLEŞTI,164892,MICLEŞTI,"GRĂDINIȚA CU 3 SĂLI DE GRUPĂ",363,"Alegeri Prezidentiale",2,782,310,272,38,0,306,4,900,590,164,142
39,VASLUI,MICLEŞTI,164892,CHIRCEŞTI,"ŞCOALA GIMNAZIALĂ CHIRCEŞTI-DEAL",364,"Alegeri Prezidentiale",1,561,247,216,31,0,243,4,600,353,113,130
39,VASLUI,MICLEŞTI,164892,CHIRCEŞTI,"ŞCOALA DEZAFECTATĂ CHIRCEŞTI -VALE",365,"Alegeri Prezidentiale",2,360,187,164,21,2,185,2,400,213,86,99
39,VASLUI,MICLEŞTI,164892,POPEŞTI,"ŞCOALA PRIMARĂ POPEŞTI",366,"Alegeri Prezidentiale",2,351,172,150,22,0,171,1,400,228,60,111
39,VASLUI,"MUNTENII DE JOS",164936,"MUNTENII DE JOS","SALA DE EDUCAŢIE FIZICĂ ŞCOLARĂ MUNTENII DE JOS",367,"Alegeri Prezidentiale",1,1831,762,717,45,0,755,7,2200,1438,471,284
39,VASLUI,"MUNTENII DE JOS",164936,MÂNJEŞTI,"ŞCOALA PRIMARĂ SAT MÎNJEŞTI",368,"Alegeri Prezidentiale",1,645,273,237,36,0,269,4,700,427,124,145
39,VASLUI,"MUNTENII DE JOS",164936,BĂCĂOANI,"ŞCOALA PRIMARĂ SAT BĂCĂOANI",369,"Alegeri Prezidentiale",1,1073,496,450,46,0,493,3,1200,704,309,184
39,VASLUI,"MUNTENII DE SUS",167302,"MUNTENII DE SUS","CĂMINUL CULTURAL MUNTENII DE SUS",370,"Alegeri Prezidentiale",1,1213,444,413,31,0,440,4,1213,769,180,260
39,VASLUI,"MUNTENII DE SUS",167302,"SATU NOU","ŞCOALA PRIMARĂ, SATU-NOU",371,"Alegeri Prezidentiale",1,1172,429,407,22,0,425,4,1300,871,255,170
39,VASLUI,"MUNTENII DE SUS",167302,"SATU NOU","SCOALA PRIMARA, SATU NOU",372,"Alegeri Prezidentiale",1,1006,363,340,22,1,358,5,1100,737,209,149
39,VASLUI,OLTENEŞTI,165069,OLTENEŞTI,"ŞCOALA PRIMARĂ OLTENEŞTI",373,"Alegeri Prezidentiale",1,384,131,108,23,0,129,2,400,269,67,62
39,VASLUI,OLTENEŞTI,165069,ZGURA,"ŞCOALA PRIMARĂ ZGURA",374,"Alegeri Prezidentiale",1,64,42,29,13,0,40,2,100,58,22,18
39,VASLUI,OLTENEŞTI,165069,CURTENI,"ŞCOALA PRIMARĂ CURTENI",375,"Alegeri Prezidentiale",1,157,93,65,28,0,91,2,200,107,56,35
39,VASLUI,OLTENEŞTI,165069,VINEŢEŞTI,"ŞCOALA GIMNAZIALA GRIGORE ŞT. RĂILEANU VINEŢEŞTI",376,"Alegeri Prezidentiale",1,523,256,225,31,0,252,4,600,344,153,99
39,VASLUI,OLTENEŞTI,165069,TÂRZII,"ŞCOALA GIMNAZIALĂ CONSTANTIN ROTARU TÎRZII",377,"Alegeri Prezidentiale",1,886,325,291,34,0,322,3,1000,675,178,144
39,VASLUI,OLTENEŞTI,165069,PÂHNA,"ŞCOALA PRIMARĂ PÎHNA",378,"Alegeri Prezidentiale",1,111,64,50,14,0,64,0,200,136,26,38
39,VASLUI,OŞEŞTI,165130,OŞEŞTI,"ŞCOALA GIMNAZIALĂ ”MIHAI EMINESCU” SAT OŞEŞTI",379,"Alegeri Prezidentiale",1,1020,409,373,36,0,403,6,1100,691,206,197
39,VASLUI,OŞEŞTI,165130,BUDA,"ŞCOALA GIMNAZIALĂ ”LUIZA ZAVLOSCHI” SAT BUDA",380,"Alegeri Prezidentiale",1,1085,414,383,30,1,411,3,1200,786,233,178
39,VASLUI,OŞEŞTI,165130,PĂDURENI,"ŞCOALA PRIMARĂ SAT PĂDURENI",381,"Alegeri Prezidentiale",1,257,79,67,12,0,79,0,300,221,42,37
39,VASLUI,PĂDURENI,165185,PĂDURENI,"ŞCOALA GIMNAZIALA NR.1 PĂDURENI",382,"Alegeri Prezidentiale",1,1023,448,407,41,0,446,2,1100,652,200,246
39,VASLUI,PĂDURENI,165185,RUSCA,"ŞCOALA PRIMARA RUSCA",383,"Alegeri Prezidentiale",1,525,207,177,28,2,207,0,600,393,112,95
39,VASLUI,PĂDURENI,165185,DAVIDEŞTI,"ŞCOALA PRIMARA DAVIDEŞTI",384,"Alegeri Prezidentiale",1,412,179,158,21,0,179,0,500,321,76,103
39,VASLUI,PĂDURENI,165185,IVĂNEŞTI,"ŞCOALA PRIMARA IVĂNEŞTI",385,"Alegeri Prezidentiale",1,338,172,144,28,0,170,2,400,228,68,102
39,VASLUI,PĂDURENI,165185,VĂLENI,"ŞCOALA PRIMARA VĂLENI",386,"Alegeri Prezidentiale",1,853,414,376,38,0,409,5,900,486,211,198
39,VASLUI,PERIENI,165274,PERIENI,"ŞCOALA GIMNAZIALĂ PERIENI - CENTRU",387,"Alegeri Prezidentiale",1,1276,563,525,38,0,552,11,1400,837,251,301
39,VASLUI,PERIENI,165274,PERIENI,"ŞCOALA PRIMARĂ PERIENI - SATUL NOU",388,"Alegeri Prezidentiale",1,1210,558,514,44,0,555,3,1300,742,305,250
39,VASLUI,PERIENI,165274,PERIENI,"ŞCOALA PRIMARĂ PERIENI - VALE",389,"Alegeri Prezidentiale",1,471,232,214,18,0,228,4,500,268,125,103
39,VASLUI,POCHIDIA,167311,BORODEŞTI,"P.A.P.I. - ACCES INTERNET, BORODEŞTI",390,"Alegeri Prezidentiale",1,213,135,110,24,1,135,0,300,165,70,65
39,VASLUI,POCHIDIA,167311,POCHIDIA,"ȘCOALA PRIMARĂ POCHIDIA",391,"Alegeri Prezidentiale",1,360,171,142,24,5,169,2,400,229,80,89
39,VASLUI,POCHIDIA,167311,SĂLCENI,"ŞCOALA GIMNAZIALĂ NR.1 , SĂLCENI",392,"Alegeri Prezidentiale",1,792,445,408,37,0,444,1,900,455,228,216
39,VASLUI,POGANA,165416,POGANA,"ŞCOALA GIMNAZIALA NR. 1 POGANA",393,"Alegeri Prezidentiale",2,641,331,286,39,6,328,3,700,369,158,170
39,VASLUI,POGANA,165416,TOMEŞTI,"ŞCOALA GIMNAZIALA SAT TOMEŞTI",394,"Alegeri Prezidentiale",1,713,306,285,21,0,306,0,800,494,160,146
39,VASLUI,POGANA,165416,BOGEŞTI,"ŞCOALA GIMNAZIALA SAT BOGEŞTI",395,"Alegeri Prezidentiale",1,562,308,243,39,26,306,2,600,292,155,151
39,VASLUI,POGANA,165416,MĂSCUREI,"ŞCOALA GIMNAZIALA SAT MĂSCUREI",396,"Alegeri Prezidentiale",1,548,269,251,18,0,268,1,600,331,108,160
39,VASLUI,POGONEŞTI,167259,POGONEŞTI,"SCOALA GIMNAZIALA ”DIMITRIE NEGRUTIU”",397,"Alegeri Prezidentiale",1,1214,500,473,27,0,499,1,1300,800,260,239
39,VASLUI,POGONEŞTI,167259,POLOCIN,"”SALA TINERETULUI”",398,"Alegeri Prezidentiale",1,154,102,77,25,0,102,0,200,98,58,44
39,VASLUI,POIENEŞTI,165336,FLOREŞTI,"ŞCOALA GIMNAZIALA, FLOREŞTI",399,"Alegeri Prezidentiale",1,407,187,160,27,0,186,1,500,313,56,130
39,VASLUI,POIENEŞTI,165336,POIENEŞTI,"CĂMIN CULTURAL POIENEŞTI",400,"Alegeri Prezidentiale",1,719,270,247,23,0,265,5,800,530,98,167
39,VASLUI,POIENEŞTI,165336,OPRIŞIŢA,"ŞCOALA OPRIŞIŢA",401,"Alegeri Prezidentiale",1,688,313,278,35,0,311,2,800,487,197,114
39,VASLUI,POIENEŞTI,165336,FRASINU,"ŞCOALA FRASINU",402,"Alegeri Prezidentiale",1,296,113,97,16,0,112,1,400,287,45,67
39,VASLUI,POIENEŞTI,165336,POIENEŞTI-DEAL,"ŞCOALA POIENEŞTI DEAL",403,"Alegeri Prezidentiale",1,93,59,36,23,0,59,0,100,41,25,34
39,VASLUI,POIENEŞTI,165336,"FUNDU VĂII","ŞCOALA FUNDU VĂII",404,"Alegeri Prezidentiale",1,64,55,32,23,0,54,1,100,45,20,34
39,VASLUI,PUIEŞTI,165470,PUIEŞTI,"LICEUL TEHNOLOGIC, SAT PUIEŞTI",405,"Alegeri Prezidentiale",1,1135,434,396,38,0,428,6,1200,766,191,237
39,VASLUI,PUIEŞTI,165470,IEZER,"ŞCOALA PRIMARĂ,SAT IEZER",406,"Alegeri Prezidentiale",1,219,86,65,21,0,86,0,300,214,39,47
39,VASLUI,PUIEŞTI,165470,GÂLŢEŞTI,"ŞCOALA PRIMARĂ,SAT GÎLŢEŞTI",407,"Alegeri Prezidentiale",1,111,58,47,11,0,58,0,200,142,23,35
39,VASLUI,PUIEŞTI,165470,RUŞI,"ŞCOALA PRIMARĂ,SAT RUŞI",408,"Alegeri Prezidentiale",1,301,127,109,18,0,126,1,400,273,67,59
39,VASLUI,PUIEŞTI,165470,FÂNTÂNELE,"ŞCOALA PRIMARĂ, SAT FÎNTÎNELE",409,"Alegeri Prezidentiale",1,90,63,45,18,0,62,1,100,37,31,31
39,VASLUI,PUIEŞTI,165470,CĂLIMĂNEŞTI,"ŞCOALA PRIMARĂ, SAT CĂLIMĂNEŞTI",410,"Alegeri Prezidentiale",1,282,150,127,23,0,147,3,300,150,85,62
39,VASLUI,PUIEŞTI,165470,FULGU,"ŞCOALA PRIMARĂ, SAT FULGU",411,"Alegeri Prezidentiale",1,122,57,47,10,0,57,0,200,143,38,19
39,VASLUI,PUIEŞTI,165470,LĂLEŞTI,"ŞCOALA GIMNAZIALĂ, SAT LĂLEŞTI",412,"Alegeri Prezidentiale",1,377,175,161,14,0,173,2,400,225,63,110
39,VASLUI,PUIEŞTI,165470,CRISTEŞTI,"ŞCOALA PRIMARĂ, SAT CRISTEŞTI",413,"Alegeri Prezidentiale",1,356,156,140,16,0,156,0,400,244,91,65
39,VASLUI,PUIEŞTI,165470,CETĂŢUIA,"ŞCOALA PRIMARĂ, SAT CETĂŢUIA",414,"Alegeri Prezidentiale",1,309,123,110,13,0,122,1,400,277,59,63
39,VASLUI,PUIEŞTI,165470,ROTARI,"ŞCOALA PRIMARĂ, SAT ROTARI",415,"Alegeri Prezidentiale",1,90,43,34,9,0,43,0,100,57,25,18
39,VASLUI,PUIEŞTI,165470,BĂRTĂLUŞ-MOCANI,"ŞCOALA PRIMARĂ, SAT BĂRTĂLUŞ -MOCANI",416,"Alegeri Prezidentiale",1,202,94,76,18,0,93,1,300,206,36,57
39,VASLUI,PUNGEŞTI,165611,PUNGEŞTI,"ŞCOALA GIMNAZIALA NR. 1 , SAT PUNGEŞTI",417,"Alegeri Prezidentiale",1,798,291,269,22,0,285,6,900,609,171,114
39,VASLUI,PUNGEŞTI,165611,STEJARU,"ŞCOALA PRIMARA, SAT STEJARU",418,"Alegeri Prezidentiale",1,192,79,72,7,0,79,0,199,120,22,57
39,VASLUI,PUNGEŞTI,165611,SILIŞTEA,"ŞCOALA PRIMARA,SAT SILIŞTEA",419,"Alegeri Prezidentiale",1,207,105,97,8,0,105,0,300,195,72,33
39,VASLUI,PUNGEŞTI,165611,ARMĂŞOAIA,"ŞCOALA PRIMARA, SAT ARMÃŞOAIA",420,"Alegeri Prezidentiale",1,437,182,164,18,0,181,1,500,318,131,50
39,VASLUI,PUNGEŞTI,165611,TOPORĂŞTI,"ŞCOALA PRIMARA, SAT TOPORĂŞTI",421,"Alegeri Prezidentiale",1,515,237,209,28,0,232,5,600,363,173,59
39,VASLUI,PUNGEŞTI,165611,CURSEŞTI-DEAL,"ŞCOALA PRIMARA,SAT CURSEŞTI DEAL",422,"Alegeri Prezidentiale",1,170,78,71,7,0,76,2,200,122,33,43
39,VASLUI,PUNGEŞTI,165611,CURSEŞTI-VALE,"ŞCOALA PRIMARA, SAT CURSEŞTI VALE",423,"Alegeri Prezidentiale",2,210,89,70,19,0,88,1,300,211,51,37
39,VASLUI,PUŞCAŞI,167320,PUŞCAŞI,"ŞCOALA GIMNAZIALA NR. 1 PUŞCAŞI",424,"Alegeri Prezidentiale",1,1173,426,402,19,5,418,8,1300,874,263,155
39,VASLUI,PUŞCAŞI,167320,PUŞCAŞI,"ŞCOALA GIMNAZIALA NR. 1 PUŞCAŞI",425,"Alegeri Prezidentiale",1,957,349,318,23,8,346,3,1100,751,202,144
39,VASLUI,PUŞCAŞI,167320,"POIANA LUI ALEXA","ŞCOALA PRIMARA POIANA LUI ALEXA",426,"Alegeri Prezidentiale",1,259,150,106,37,7,150,0,300,150,78,72
39,VASLUI,PUŞCAŞI,167320,TEIŞORU,"SCOALA PRIMARA TEIŞORU",427,"Alegeri Prezidentiale",1,414,151,134,17,0,147,4,500,349,77,70
39,VASLUI,PUŞCAŞI,167320,"VALEA TÂRGULUI","ŞCOALA PRIMARA VALEA TÂRGULUI",428,"Alegeri Prezidentiale",1,124,131,73,51,7,129,2,200,69,50,79
39,VASLUI,RAFAILA,167240,RAFAILA,"GRĂDINIŢA CU PROGRAM NORMAL, RAFAILA",429,"Alegeri Prezidentiale",1,1451,554,524,19,11,540,14,1600,1046,269,271
39,VASLUI,REBRICEA,165719,REBRICEA,"ŞCOALA GIMNAZIALĂ REBRICEA",430,"Alegeri Prezidentiale",1,450,164,122,42,0,164,0,500,336,83,81
39,VASLUI,REBRICEA,165719,DRAXENI,"CĂMINUL CULTURAL, DRAXENI",431,"Alegeri Prezidentiale",1,669,345,311,34,0,341,4,700,355,143,198
39,VASLUI,REBRICEA,165719,SASOVA,"ŞCOALA PRIMARĂ SASOVA",432,"Alegeri Prezidentiale",1,241,118,99,19,0,117,1,300,182,61,56
39,VASLUI,REBRICEA,165719,"TUFEŞTII DE JOS","ŞCOALA PRIMARĂ TUFEŞTII DE JOS",433,"Alegeri Prezidentiale",1,315,153,134,19,0,151,2,400,247,81,70
39,VASLUI,REBRICEA,165719,BOLAŢI,"ŞCOALA PRIMARĂ BOLAŢI",434,"Alegeri Prezidentiale",1,153,70,54,16,0,70,0,200,130,34,36
39,VASLUI,REBRICEA,165719,CRĂCIUNEŞTI,"ŞCOALA PRIMARĂ CRĂCIUNEŞTI",435,"Alegeri Prezidentiale",1,242,161,131,30,0,158,3,300,139,73,85
39,VASLUI,REBRICEA,165719,TATOMIREŞTI,"ŞCOALA PRIMARĂ TATOMIREŞTI",436,"Alegeri Prezidentiale",1,254,104,90,14,0,103,1,300,196,45,58
39,VASLUI,REBRICEA,165719,"RATEŞU CUZEI","ŞCOALA PRIMARĂ RATEŞU-CUZEI",437,"Alegeri Prezidentiale",1,433,193,166,27,0,191,2,500,307,91,100
39,VASLUI,ROŞIEŞTI,165817,ROŞIEŞTI,"ŞCOALA GIMNAZIALĂ ”VENIAMIN COSTACHI” , ROŞIEŞTI",438,"Alegeri Prezidentiale",1,955,435,384,46,5,431,4,1000,565,249,182
39,VASLUI,ROŞIEŞTI,165817,"VALEA LUI DARIE","ŞCOALA PRIMARĂ VALEA LUI DARIE",439,"Alegeri Prezidentiale",1,457,249,213,36,0,244,5,500,251,102,142
39,VASLUI,ROŞIEŞTI,165817,IDRICI,"ŞCOALA PRIMARĂ IDRICI",440,"Alegeri Prezidentiale",1,329,159,131,28,0,156,3,400,241,66,90
39,VASLUI,ROŞIEŞTI,165817,"GURA IDRICI","ŞCOALA PRIMARĂ GURA IDRICI",441,"Alegeri Prezidentiale",1,355,179,159,20,0,178,1,400,221,88,90
39,VASLUI,ROŞIEŞTI,165817,"GARA ROŞIEŞTI","GRĂDINIȚA CU PROGRAM NORMAL GARA ROŞIEŞTI",442,"Alegeri Prezidentiale",1,315,177,153,24,0,174,3,400,223,90,84
39,VASLUI,ROŞIEŞTI,165817,REDIU,"ŞCOALA PRIMARĂ REDIU",443,"Alegeri Prezidentiale",1,135,78,63,15,0,78,0,200,122,40,38
39,VASLUI,SOLEŞTI,165899,SOLEŞTI,"BIBLIOTECA ”ELENA CUZA” DIN LOCALITATEA SOLEȘTI",444,"Alegeri Prezidentiale",1,936,361,344,17,0,358,3,1000,639,233,125
39,VASLUI,SOLEŞTI,165899,BOUŞORI,"FOSTA ŞCOALA CU CLASELE I-IV BOUȘORI",445,"Alegeri Prezidentiale",1,204,111,84,27,0,111,0,300,189,35,76
39,VASLUI,SOLEŞTI,165899,IAZ,"GRĂDINIȚA CU PROGRAM NORMAL IAZ",446,"Alegeri Prezidentiale",1,290,154,142,12,0,153,1,300,146,38,115
39,VASLUI,SOLEŞTI,165899,"SATU NOU","GRĂDINIȚA CU PROGRAM NORMAL SATU NOU",447,"Alegeri Prezidentiale",1,310,146,131,15,0,144,2,400,254,80,64
39,VASLUI,SOLEŞTI,165899,ŞERBOTEŞTI,"ŞCOALA GIMNAZIALĂ ȘERBOTEȘTI",448,"Alegeri Prezidentiale",1,602,302,264,38,0,297,5,700,398,163,134
39,VASLUI,SOLEŞTI,165899,ŞTIOBORĂNI,"GRĂDINIȚA CU PROGRAM NORMAL ȘTIOBORĂNI",449,"Alegeri Prezidentiale",1,289,138,105,33,0,135,3,300,162,66,69
39,VASLUI,SOLEŞTI,165899,"VALEA SILIŞTEI","FOSTA ŞCOALA CU CLASELE I-IV VALEA SILIȘTEI",450,"Alegeri Prezidentiale",1,232,126,100,26,0,123,3,300,174,52,71
39,VASLUI,STĂNILEŞTI,165979,STĂNILEŞTI,"ŞCOALA GIMNAZIALĂ NR. 1, CORP B",451,"Alegeri Prezidentiale",1,1401,537,508,29,0,531,6,1500,963,313,218
39,VASLUI,STĂNILEŞTI,165979,STĂNILEŞTI,"ŞCOALA GIMNAZIALĂ NR. 1, CORP B",452,"Alegeri Prezidentiale",1,869,328,304,24,0,320,8,1000,672,181,139
39,VASLUI,STĂNILEŞTI,165979,BOGDANA-VOLOSENI,"ŞCOALA PRIMARĂ, BOGDANA - VOLOSENI",453,"Alegeri Prezidentiale",1,126,55,38,17,0,54,1,200,145,28,26
39,VASLUI,STĂNILEŞTI,165979,"BUDU CANTEMIR","ŞCOALA PRIMARĂ, BUDU - CANTEMIR",454,"Alegeri Prezidentiale",1,216,80,73,7,0,80,0,300,220,49,31
39,VASLUI,STĂNILEŞTI,165979,CHERSĂCOSU,"ŞCOALA PRIMARĂ, CHERSĂCOSU",455,"Alegeri Prezidentiale",1,419,195,165,30,0,193,2,500,305,150,43
39,VASLUI,STĂNILEŞTI,165979,"GURA VĂII","GRĂDINIŢA CU PROGRAM NORMAL, GURA VĂII",456,"Alegeri Prezidentiale",1,372,156,131,25,0,152,4,400,244,98,54
39,VASLUI,STĂNILEŞTI,165979,POGĂNEŞTI,"ŞCOALA GIMNAZIALĂ, POGĂNEŞTI",457,"Alegeri Prezidentiale",1,869,378,339,39,0,368,10,1000,622,254,114
39,VASLUI,"ŞTEFAN CEL MARE",166057,"ŞTEFAN CEL MARE","CĂMINUL CULTURAL, ŞTEFAN CEL MARE",458,"Alegeri Prezidentiale",1,600,374,311,57,6,369,5,700,326,109,260
39,VASLUI,"ŞTEFAN CEL MARE",166057,BÂRZEŞTI,"CĂMINUL CULTURAL BÎRZEŞTI",459,"Alegeri Prezidentiale",1,994,527,479,39,9,515,12,1100,573,231,284
39,VASLUI,"ŞTEFAN CEL MARE",166057,MĂRĂŞENI,"ŞCOALA PRIMARA ”CONSTANTIN MANOILESCU” MARASENI",460,"Alegeri Prezidentiale",1,739,434,379,42,13,430,4,800,366,94,336
39,VASLUI,"ŞTEFAN CEL MARE",166057,BRĂHĂŞOAIA,"ŞCOALA PRIMARA, BRĂHĂŞOAIA",461,"Alegeri Prezidentiale",1,429,231,177,44,10,231,0,500,269,72,159
39,VASLUI,ŞULETEA,166137,ŞULETEA,"CĂMINUL CULTURAL ”VIRGIL CARAIVAN” ŞULETEA",462,"Alegeri Prezidentiale",2,931,432,398,34,0,427,5,1000,568,223,204
39,VASLUI,ŞULETEA,166137,FEDEŞTI,"CREȘA FEDEȘTI",463,"Alegeri Prezidentiale",1,473,242,190,29,23,237,5,500,258,130,107
39,VASLUI,ŞULETEA,166137,JIGĂLIA,"ŞCOALA PRIMARĂ ”DUMITRU BAHRIM”",464,"Alegeri Prezidentiale",1,183,120,96,17,7,119,1,200,80,63,56
39,VASLUI,ŞULETEA,166137,RĂŞCANI,"ŞCOALA PRIMARĂ RĂŞCANI",465,"Alegeri Prezidentiale",1,199,118,93,19,6,116,2,300,182,53,63
39,VASLUI,TANACU,166182,TANACU,"ŞCOALA GIMNAZIALĂ NR. 1 SAT. TANACU",466,"Alegeri Prezidentiale",1,1276,581,477,104,0,577,4,1400,819,287,290
39,VASLUI,TANACU,166182,BENEŞTI,"ŞCOALA PRIMARĂ SAT. BENEŞTI",467,"Alegeri Prezidentiale",1,270,141,115,26,0,139,2,300,159,74,65
39,VASLUI,TĂCUTA,166235,TĂCUTA,"CĂMINUL CULTURAL TĂCUTA",468,"Alegeri Prezidentiale",1,681,324,292,32,0,322,2,700,376,191,131
39,VASLUI,TĂCUTA,166235,DUMASCA,"ŞCOALA PRIMARĂ DUMASCA",469,"Alegeri Prezidentiale",1,235,114,91,23,0,112,2,300,186,69,43
39,VASLUI,TĂCUTA,166235,MIRCEŞTI,"ŞCOALA PRIMARĂ MIRCEŞTI",470,"Alegeri Prezidentiale",1,220,132,104,28,0,131,1,300,168,105,26
39,VASLUI,TĂCUTA,166235,FOCŞEASCA,"ŞCOALA GIMNAZIALĂ FOCŞEAŞCA",471,"Alegeri Prezidentiale",1,626,251,227,24,0,248,3,700,449,133,115
39,VASLUI,TĂCUTA,166235,PROTOPOPEŞTI,"ŞCOALA GIMNAZIALĂ PROTOPOPEŞTI",472,"Alegeri Prezidentiale",1,663,271,235,36,0,271,0,700,429,206,65
39,VASLUI,TĂTĂRANI,166315,LEOŞTI,"SCOALA PRIMARA - SAT.LEOSTI",473,"Alegeri Prezidentiale",1,250,94,77,17,0,94,0,300,206,39,55
39,VASLUI,TĂTĂRANI,166315,TĂTĂRĂNI,"CĂMINUL CULTURAL TĂTĂRĂNI",474,"Alegeri Prezidentiale",1,600,233,197,36,0,231,2,700,467,105,126
39,VASLUI,TĂTĂRANI,166315,BĂLŢAŢI,"ŞCOALA GIMNAZIALA ”ION ANGHELUTA” - SAT BALTATI",475,"Alegeri Prezidentiale",1,466,149,130,19,0,148,1,500,351,73,75
39,VASLUI,TĂTĂRANI,166315,STROIEŞTI,"SCOALA PRIMARA - SAT STROIESTI",476,"Alegeri Prezidentiale",1,279,117,93,24,0,115,2,300,183,68,47
39,VASLUI,TODIREŞTI,166413,SILIŞTEA,"ŞCOALA PRIMARA SAT SILIŞTEA",477,"Alegeri Prezidentiale",1,293,140,116,24,0,135,5,300,160,75,60
39,VASLUI,TODIREŞTI,166413,TODIREŞTI,"ŞCOALA GIMNAZIALA ”GH.CIOATĂ” TODIREŞTI",478,"Alegeri Prezidentiale",1,755,277,248,29,0,276,1,800,523,150,126
39,VASLUI,TODIREŞTI,166413,COTIC,"ANEXA BISERICII SF.” MIHAIL ȘI GAVRIL”",479,"Alegeri Prezidentiale",1,242,96,82,14,0,94,2,300,204,37,57
39,VASLUI,TODIREŞTI,166413,DRĂGEŞTI,"ŞCOALA PRIMARA SAT DRĂGEŞTI",480,"Alegeri Prezidentiale",1,305,112,96,16,0,106,6,400,288,44,62
39,VASLUI,TODIREŞTI,166413,HUC,"ŞCOALA PRIMARA SAT HUC",481,"Alegeri Prezidentiale",2,474,207,193,14,0,206,1,487,280,87,119
39,VASLUI,TODIREŞTI,166413,PLOPOASA,"ŞCOALA PRIMARA SAT PLOPOASA",482,"Alegeri Prezidentiale",1,193,102,92,10,0,102,0,200,98,27,75
39,VASLUI,TODIREŞTI,166413,SOFRONEŞTI,"ŞCOALA PRIMARA SAT SOFRONEŞTI",483,"Alegeri Prezidentiale",1,119,51,38,13,0,48,3,200,149,27,21
39,VASLUI,TODIREŞTI,166413,"VALEA POPII","ŞCOALA PRIMARA SAT VALEA -POPII",484,"Alegeri Prezidentiale",1,90,59,49,10,0,58,1,100,41,24,34
39,VASLUI,TODIREŞTI,166413,VIIŞOARA,"ŞCOALA PRIMARA SAT VIIŞOARA",485,"Alegeri Prezidentiale",1,97,59,48,11,0,59,0,100,41,31,28
39,VASLUI,TUTOVA,166529,TUTOVA,"CĂMINUL CULTURAL TUTOVA",486,"Alegeri Prezidentiale",1,1112,609,526,83,0,602,7,1200,591,345,257
39,VASLUI,TUTOVA,166529,BĂDEANA,"ŞCOALA GIMNAZIALA BADEANA",487,"Alegeri Prezidentiale",1,1134,483,441,41,1,478,5,1300,817,265,213
39,VASLUI,TUTOVA,166529,CRIVEŞTI,"CĂMINUL CULTURAL CRIVESTI",488,"Alegeri Prezidentiale",1,363,186,157,29,0,185,1,400,214,89,96
39,VASLUI,TUTOVA,166529,CIORTOLOM,"ŞCOALA CIORTOLOM",489,"Alegeri Prezidentiale",1,140,88,68,20,0,88,0,200,112,38,50
39,VASLUI,TUTOVA,166529,COROIU,"ŞCOALA COROIU",490,"Alegeri Prezidentiale",1,165,78,56,22,0,76,2,200,122,46,30
39,VASLUI,TUTOVA,166529,VIZURENI,"ŞCOALA VIZURENI",491,"Alegeri Prezidentiale",1,139,76,59,17,0,76,0,200,124,32,44
39,VASLUI,VĂLENI,166636,VĂLENI,"ŞCOALA GIMNAZIALĂ NR. 1 SAT VĂLENI COM VĂLENI",492,"Alegeri Prezidentiale",1,1429,441,420,21,0,436,5,1600,1159,294,142
39,VASLUI,VĂLENI,166636,VĂLENI,"ŞCOALA GIMNAZIALĂ NR. 1 SAT VĂLENI COM. VĂLENI",493,"Alegeri Prezidentiale",1,1471,426,408,18,0,420,6,1600,1174,313,107
39,VASLUI,VĂLENI,166636,"MOARA DOMNEASCĂ","ŞCOALA PRIMARĂ SAT MOARA DOMNEASCĂ",494,"Alegeri Prezidentiale",1,1313,426,407,19,0,415,11,1400,974,276,139
39,VASLUI,VETRIŞOAIA,166672,VETRIŞOAIA,"LICEUL TEHNOLOGIC ”PETRU RARES” - CENTRU",495,"Alegeri Prezidentiale",1,1518,578,532,31,15,574,4,1700,1122,345,229
39,VASLUI,VETRIŞOAIA,166672,VETRIŞOAIA,"LICEUL TEHNOLOGIC ”PETRU RAREȘ” VETRIȘOAIA",496,"Alegeri Prezidentiale",2,832,401,342,46,13,398,3,900,499,233,165
39,VASLUI,VETRIŞOAIA,166672,BUMBĂTA,"ȘCOALA BUMBĂTA",497,"Alegeri Prezidentiale",1,98,69,52,14,3,68,1,100,31,40,28
39,VASLUI,VIIŞOARA,166707,VIIŞOARA,"CAMIN CULTURAL, SAT VIIȘOARA",498,"Alegeri Prezidentiale",2,934,415,330,52,33,410,5,1000,585,153,257
39,VASLUI,VIIŞOARA,166707,"HALTA DODEŞTI","ȘCOALA PRIMARĂ HALTA DODEȘTI",499,"Alegeri Prezidentiale",1,161,107,67,35,5,105,2,200,93,65,40
39,VASLUI,VIIŞOARA,166707,VĂLENI,"ȘCOALA PRIMARĂ VĂLENI",500,"Alegeri Prezidentiale",1,106,63,42,17,4,63,0,200,137,32,31
39,VASLUI,VIIŞOARA,166707,VILTOTEŞTI,"ȘCOALA PRIMARĂ VILTOTEȘTI",501,"Alegeri Prezidentiale",1,159,83,61,15,7,82,1,198,115,37,45
39,VASLUI,VINDEREI,166770,VINDEREI,"ŞCOALA GIMNAZIALA NR.1, VINDEREI",502,"Alegeri Prezidentiale",2,744,300,260,40,0,297,3,800,500,181,116
39,VASLUI,VINDEREI,166770,BRĂDEŞTI,"ŞCOALA PRIMARA, BRADESTI",503,"Alegeri Prezidentiale",1,441,174,147,27,0,174,0,500,326,83,91
39,VASLUI,VINDEREI,166770,DOCANI,"ŞCOALA GIMNAZIALA, DOCANI",504,"Alegeri Prezidentiale",1,477,180,155,25,0,179,1,500,320,95,84
39,VASLUI,VINDEREI,166770,DOCĂNEASA,"ŞCOALA PRIMARA DOCANEASA",505,"Alegeri Prezidentiale",1,380,160,137,23,0,158,2,400,240,105,53
39,VASLUI,VINDEREI,166770,OBÂRŞENI,"ŞCOALA GIMNAZIALA OBIRSENI",506,"Alegeri Prezidentiale",1,711,289,248,41,0,287,2,800,511,163,124
39,VASLUI,VINDEREI,166770,"VALEA LUNGĂ","ŞCOALA PRIMARA VALEA LUNGĂ",507,"Alegeri Prezidentiale",1,396,162,152,10,0,159,3,400,238,86,73
39,VASLUI,VOINEŞTI,166869,VOINEŞTI,"ȘCOALA GIMNAZIALĂ NR.1 VOINEȘTI",508,"Alegeri Prezidentiale",1,300,136,118,18,0,136,0,400,264,85,51
39,VASLUI,VOINEŞTI,166869,AVRĂMEŞTI,"ȘCOALA PRIMARĂ SAT AVRĂMEȘTI",509,"Alegeri Prezidentiale",2,511,198,168,30,0,193,5,600,402,97,96
39,VASLUI,VOINEŞTI,166869,MĂRĂŞEŞTI,"ȘCOALA PRIMARĂ MĂRĂȘEȘTI",510,"Alegeri Prezidentiale",1,164,93,77,16,0,93,0,200,107,44,49
39,VASLUI,VOINEŞTI,166869,BĂNCEŞTI,"ȘCOALA PRIMARĂ BĂNCEȘTI",511,"Alegeri Prezidentiale",1,158,75,63,12,0,74,1,200,125,29,45
39,VASLUI,VOINEŞTI,166869,STÂNCĂŞENI,"CONTAINER MODULAR",512,"Alegeri Prezidentiale",1,159,81,68,13,0,81,0,200,119,16,65
39,VASLUI,VOINEŞTI,166869,GÂRDEŞTI,"ȘCOALA GIMNAZIALĂ GÎRDEȘTI",513,"Alegeri Prezidentiale",1,504,270,258,12,0,265,5,600,330,75,190
39,VASLUI,VOINEŞTI,166869,OBÂRŞENI,"ȘCOALA PRIMARĂ OBÎRȘENI",514,"Alegeri Prezidentiale",1,282,105,92,13,0,104,1,300,195,62,42
39,VASLUI,VOINEŞTI,166869,"OBÂRŞENII LINGURARI","ȘCOALA GIMNAZIALĂ OBÎRȘENII LINGURARI",515,"Alegeri Prezidentiale",1,656,324,299,25,0,323,1,700,376,128,195
39,VASLUI,VULTUREŞTI,166985,VULTUREŞTI,"CĂMIN CULTURAL VULTUREŞTI",516,"Alegeri Prezidentiale",1,834,379,338,41,0,373,6,900,521,166,207
39,VASLUI,VULTUREŞTI,166985,BUHĂIEŞTI,"CĂMINUL CULTURAL BUHĂIEŞTI",517,"Alegeri Prezidentiale",1,622,267,241,26,0,266,1,700,433,132,134
39,VASLUI,VULTUREŞTI,166985,VOINEŞTI,"GRADINITA CU PROGRAM NORMAL VOINEŞTI",518,"Alegeri Prezidentiale",1,302,164,137,27,0,162,2,400,236,83,79
39,VASLUI,VUTCANI,167035,VUTCANI,"ŞCOALA GIMNAZIALĂ NR.1, VUTCANI",519,"Alegeri Prezidentiale",1,1104,599,462,77,60,591,8,1200,601,190,401
39,VASLUI,VUTCANI,167035,MĂLĂIEŞTI,"ŞCOALA PRIMARĂ MĂLĂIEŞTI",520,"Alegeri Prezidentiale",1,247,189,129,26,34,185,4,300,111,57,128
39,VASLUI,VUTCANI,167035,"POŞTA ELAN","ŞCOALA PRIMARĂ POŞTA-ELAN",521,"Alegeri Prezidentiale",1,126,88,61,16,11,88,0,200,112,25,63
39,VASLUI,ZĂPODENI,167071,ZĂPODENI,"CĂMINUL CULTURAL ZĂPODENI",522,"Alegeri Prezidentiale",1,1162,628,549,63,16,624,4,1300,672,284,340
39,VASLUI,ZĂPODENI,167071,CIOFENI,"ȘCOALA PRIMARĂ,SAT CIOFENI",523,"Alegeri Prezidentiale",1,110,75,54,21,0,75,0,200,125,39,36
39,VASLUI,ZĂPODENI,167071,PORTARI,"ȘCOALA PRIMARĂ, SAT PORTARI",524,"Alegeri Prezidentiale",1,738,251,212,34,5,247,4,800,549,115,132
39,VASLUI,ZĂPODENI,167071,DELEA,"ȘCOALA PRIMARĂ, SAT DELEA",525,"Alegeri Prezidentiale",1,164,100,74,24,2,98,2,200,100,45,53
39,VASLUI,ZĂPODENI,167071,TELEJNA,"ȘCOALA PRIMARĂ, SAT TELEJNA",526,"Alegeri Prezidentiale",1,294,169,129,32,8,165,4,300,131,67,98
39,VASLUI,ZĂPODENI,167071,BUTUCĂRIA,"ȘCOALA GIMNAZIALĂ, SAT BUTUCĂRIA",527,"Alegeri Prezidentiale",1,118,76,57,19,0,75,1,200,124,37,38
39,VASLUI,ZĂPODENI,167071,DOBROSLOVEŞTI,"ȘCOALA PRIMARĂ, SAT DOBROSLOVEȘTI",528,"Alegeri Prezidentiale",2,294,182,149,23,10,181,1,300,118,66,115
39,VASLUI,ZĂPODENI,167071,UNCEŞTI,"ȘCOALA PRIMARĂ, SAT UNCEȘTI",529,"Alegeri Prezidentiale",1,287,165,136,20,9,164,1,300,135,62,102
39,VASLUI,ZORLENI,167179,ZORLENI,"ŞCOALA GIMNAZIALĂ NR. 1 ZORLENI",530,"Alegeri Prezidentiale",2,1378,559,533,26,0,556,3,1400,841,321,235
39,VASLUI,ZORLENI,167179,ZORLENI,"ŞCOALA GIMNAZIALĂ NR.1 ZORLENI",531,"Alegeri Prezidentiale",1,1338,541,507,32,2,536,5,1400,859,285,251
39,VASLUI,ZORLENI,167179,ZORLENI,"ŞCOALA GIMNAZIALĂ NR. 2 ZORLENI",532,"Alegeri Prezidentiale",1,1470,552,525,27,0,545,7,1500,948,262,283
39,VASLUI,ZORLENI,167179,"DEALU MARE","ȘCOALA PRIMARĂ SAT DEALU MARE",533,"Alegeri Prezidentiale",1,214,97,80,17,0,97,0,300,203,49,48
39,VASLUI,ZORLENI,167179,SIMILA,"ŞCOALA PRIMARĂ SAT SIMILA",534,"Alegeri Prezidentiale",1,1070,505,474,31,0,493,12,1200,695,305,188
39,VASLUI,ZORLENI,167179,POPENI,"ŞCOALA GIMNAZIALĂ NR. 3 POPENI",535,"Alegeri Prezidentiale",1,1158,449,421,28,0,442,7,1200,751,226,216
39,VASLUI,ZORLENI,167179,POPENI,"ŞCOALA GIMNAZIALĂ NR. 3 POPENI",536,"Alegeri Prezidentiale",1,1057,416,380,35,1,412,4,1200,784,220,192
40,VÂLCEA,"MUNICIPIUL RÂMNICU VÂLCEA",167473,"RÂMNICU VÂLCEA","COLEGIUL ENERGETIC",1,"Alegeri Prezidentiale",1,1744,850,789,61,0,829,21,1920,1070,539,290
40,VÂLCEA,"MUNICIPIUL RÂMNICU VÂLCEA",167473,"RÂMNICU VÂLCEA","COLEGIUL ENERGETIC",2,"Alegeri Prezidentiale",1,925,496,467,29,0,482,14,1010,514,312,170
40,VÂLCEA,"MUNICIPIUL RÂMNICU VÂLCEA",167473,"RÂMNICU VÂLCEA","LICEUL SANITAR ”ANTIM IVIREANU”",3,"Alegeri Prezidentiale",1,1316,639,569,70,0,632,7,1450,811,361,271
40,VÂLCEA,"MUNICIPIUL RÂMNICU VÂLCEA",167473,"RÂMNICU VÂLCEA","LICEUL SANITAR ”ANTIM IVIREANU”",4,"Alegeri Prezidentiale",1,1232,558,476,82,0,547,11,1360,802,336,211
40,VÂLCEA,"MUNICIPIUL RÂMNICU VÂLCEA",167473,"RÂMNICU VÂLCEA","LICEUL SANITAR ”ANTIM IVIREANU”",5,"Alegeri Prezidentiale",1,1225,615,583,32,0,595,20,1340,725,371,224
40,VÂLCEA,"MUNICIPIUL RÂMNICU VÂLCEA",167473,"RÂMNICU VÂLCEA","GRĂDINIŢA CU PROGRAM PRELUNGIT NORD II",6,"Alegeri Prezidentiale",1,1013,497,445,52,0,481,16,1110,613,319,162
40,VÂLCEA,"MUNICIPIUL RÂMNICU VÂLCEA",167473,"RÂMNICU VÂLCEA","GRĂDINIŢA CU PROGRAM PRELUNGIT NORD II",7,"Alegeri Prezidentiale",1,1019,444,417,27,0,436,8,1120,676,251,185
40,VÂLCEA,"MUNICIPIUL RÂMNICU VÂLCEA",167473,"RÂMNICU VÂLCEA","GRĂDINIŢA CU PROGRAM PRELUNGIT NORD II",8,"Alegeri Prezidentiale",1,951,511,484,27,0,499,12,1050,539,303,196
40,VÂLCEA,"MUNICIPIUL RÂMNICU VÂLCEA",167473,"RÂMNICU VÂLCEA","LICEUL DE ARTE VICTOR GIULEANU",9,"Alegeri Prezidentiale",1,1032,466,425,41,0,457,9,1130,664,279,178
40,VÂLCEA,"MUNICIPIUL RÂMNICU VÂLCEA",167473,"RÂMNICU VÂLCEA","LICEUL DE ARTE VICTOR GIULEANU",10,"Alegeri Prezidentiale",1,1029,477,450,27,0,466,11,1130,653,281,185
40,VÂLCEA,"MUNICIPIUL RÂMNICU VÂLCEA",167473,"RÂMNICU VÂLCEA","LICEUL DE ARTE VICTOR GIULEANU",11,"Alegeri Prezidentiale",1,1001,492,472,20,0,478,14,1100,608,303,175
40,VÂLCEA,"MUNICIPIUL RÂMNICU VÂLCEA",167473,"RÂMNICU VÂLCEA","LICEUL DE ARTE VICTOR GIULEANU",12,"Alegeri Prezidentiale",1,1234,592,566,26,0,580,12,1350,758,344,236
40,VÂLCEA,"MUNICIPIUL RÂMNICU VÂLCEA",167473,"RÂMNICU VÂLCEA","LICEUL DE ARTE VICTOR GIULEANU",13,"Alegeri Prezidentiale",1,828,398,348,50,0,391,7,910,512,257,134
40,VÂLCEA,"MUNICIPIUL RÂMNICU VÂLCEA",167473,"RÂMNICU VÂLCEA","COLEGIUL NAŢIONAL DE INFORMATICĂ ”MATEI BASARAB”",14,"Alegeri Prezidentiale",1,1018,480,423,57,0,467,13,1120,640,263,204
40,VÂLCEA,"MUNICIPIUL RÂMNICU VÂLCEA",167473,"RÂMNICU VÂLCEA","COLEGIUL NAŢIONAL DE INFORMATICĂ ”MATEI BASARAB”",15,"Alegeri Prezidentiale",1,776,370,349,21,0,357,13,850,480,210,147
40,VÂLCEA,"MUNICIPIUL RÂMNICU VÂLCEA",167473,"RÂMNICU VÂLCEA","COLEGIUL NAŢIONAL DE INFORMATICĂ ”MATEI BASARAB”",16,"Alegeri Prezidentiale",1,1054,482,469,13,0,473,9,1160,678,309,164
40,VÂLCEA,"MUNICIPIUL RÂMNICU VÂLCEA",167473,"RÂMNICU VÂLCEA","COLEGIUL NAŢIONAL DE INFORMATICĂ ”MATEI BASARAB”",17,"Alegeri Prezidentiale",1,1282,608,584,24,0,596,12,1410,802,349,247
40,VÂLCEA,"MUNICIPIUL RÂMNICU VÂLCEA",167473,"RÂMNICU VÂLCEA","LICEUL TEHNOLOGIC FORESTIER",18,"Alegeri Prezidentiale",1,980,622,492,43,87,611,11,1080,458,363,248
40,VÂLCEA,"MUNICIPIUL RÂMNICU VÂLCEA",167473,"RÂMNICU VÂLCEA","LICEUL TEHNOLOGIC FORESTIER",19,"Alegeri Prezidentiale",1,902,575,462,41,72,559,16,990,415,301,258
40,VÂLCEA,"MUNICIPIUL RÂMNICU VÂLCEA",167473,"RÂMNICU VÂLCEA","LICEUL TEHNOLOGIC FORESTIER",20,"Alegeri Prezidentiale",1,879,462,388,22,52,451,11,970,508,271,180
40,VÂLCEA,"MUNICIPIUL RÂMNICU VÂLCEA",167473,"RÂMNICU VÂLCEA","ȘCOALA GIMNAZIALĂ ”IOAN GH. DUCA”",21,"Alegeri Prezidentiale",1,960,453,417,36,0,442,11,1050,597,292,150
40,VÂLCEA,"MUNICIPIUL RÂMNICU VÂLCEA",167473,"RÂMNICU VÂLCEA","ȘCOALA GIMNAZIALĂ ”IOAN GH. DUCA”",22,"Alegeri Prezidentiale",1,1003,568,483,85,0,551,17,1100,532,368,183
40,VÂLCEA,"MUNICIPIUL RÂMNICU VÂLCEA",167473,"RÂMNICU VÂLCEA","ȘCOALA GIMNAZIALĂ ”IOAN GH. DUCA”",23,"Alegeri Prezidentiale",1,1006,502,484,18,0,488,14,1100,598,291,197
40,VÂLCEA,"MUNICIPIUL RÂMNICU VÂLCEA",167473,"RÂMNICU VÂLCEA","ȘCOALA GIMNAZIALĂ ”IOAN GH. DUCA”",24,"Alegeri Prezidentiale",1,850,416,391,25,0,407,9,930,514,226,181
40,VÂLCEA,"MUNICIPIUL RÂMNICU VÂLCEA",167473,"RÂMNICU VÂLCEA","ȘCOALA GIMNAZIALĂ ”IOAN GH. DUCA”",25,"Alegeri Prezidentiale",1,882,412,385,27,0,403,9,970,558,253,150
40,VÂLCEA,"MUNICIPIUL RÂMNICU VÂLCEA",167473,"RÂMNICU VÂLCEA","ȘCOALA GIMNAZIALĂ ”IOAN GH. DUCA”",26,"Alegeri Prezidentiale",1,1078,618,490,128,0,601,17,1180,562,388,213
40,VÂLCEA,"MUNICIPIUL RÂMNICU VÂLCEA",167473,"RÂMNICU VÂLCEA","ȘCOALA GIMNAZIALĂ ”IOAN GH. DUCA”",27,"Alegeri Prezidentiale",1,878,428,415,12,1,420,8,970,542,225,195
40,VÂLCEA,"MUNICIPIUL RÂMNICU VÂLCEA",167473,"RÂMNICU VÂLCEA","ȘCOALA GIMNAZIALĂ TAKE IONESCU",28,"Alegeri Prezidentiale",1,956,590,475,115,0,577,13,1050,460,350,227
40,VÂLCEA,"MUNICIPIUL RÂMNICU VÂLCEA",167473,"RÂMNICU VÂLCEA","COLEGIUL NAȚIONAL ALEXANDRU LAHOVARI",29,"Alegeri Prezidentiale",1,1047,652,546,65,41,636,16,1150,498,363,273
40,VÂLCEA,"MUNICIPIUL RÂMNICU VÂLCEA",167473,"RÂMNICU VÂLCEA","COLEGIUL NAȚIONAL ALEXANDRU LAHOVARI",30,"Alegeri Prezidentiale",1,1393,835,717,72,46,822,13,1535,700,464,358
40,VÂLCEA,"MUNICIPIUL RÂMNICU VÂLCEA",167473,"RÂMNICU VÂLCEA","UNITATE DE ÎNVĂȚĂMÂNT- FOST LICEUL TEHNOLOGIC OLTCHIM",31,"Alegeri Prezidentiale",1,1378,683,590,62,31,663,20,1522,839,414,249
40,VÂLCEA,"MUNICIPIUL RÂMNICU VÂLCEA",167473,"RÂMNICU VÂLCEA","UNITATE DE ÎNVĂȚĂMÂNT - FOST LICEUL TEHNOLOGIC OLTCHIM",32,"Alegeri Prezidentiale",1,1405,752,619,76,57,738,14,1549,797,456,282
40,VÂLCEA,"MUNICIPIUL RÂMNICU VÂLCEA",167473,"RÂMNICU VÂLCEA","ŞCOALA GIMNAZIALĂ NR.5",33,"Alegeri Prezidentiale",1,1165,730,622,108,0,707,23,1280,550,444,263
40,VÂLCEA,"MUNICIPIUL RÂMNICU VÂLCEA",167473,"RÂMNICU VÂLCEA","DADP - SEDIU, BL A17",34,"Alegeri Prezidentiale",1,1789,934,854,80,0,918,16,1910,976,598,320
40,VÂLCEA,"MUNICIPIUL RÂMNICU VÂLCEA",167473,"RÂMNICU VÂLCEA","S.C. PIEȚE PREST S.A. - PT 13",35,"Alegeri Prezidentiale",1,796,448,413,35,0,440,8,880,432,245,195
40,VÂLCEA,"MUNICIPIUL RÂMNICU VÂLCEA",167473,"RÂMNICU VÂLCEA","S.C. PIEȚE PREST S.A. - PT 13",36,"Alegeri Prezidentiale",1,691,370,317,53,0,360,10,760,390,197,163
40,VÂLCEA,"MUNICIPIUL RÂMNICU VÂLCEA",167473,"RÂMNICU VÂLCEA","S.C. PIEȚE PREST S.A. - PT 13",37,"Alegeri Prezidentiale",1,939,529,483,46,0,518,11,1030,501,277,241
40,VÂLCEA,"MUNICIPIUL RÂMNICU VÂLCEA",167473,"RÂMNICU VÂLCEA","GRĂDINIȚA CU PROGRAM PRELUNGIT ”COZIA”",38,"Alegeri Prezidentiale",1,1229,735,618,114,3,718,17,1350,615,443,275
40,VÂLCEA,"MUNICIPIUL RÂMNICU VÂLCEA",167473,"RÂMNICU VÂLCEA","GRĂDINIŢA CU PROGRAM PRELUNGIT ”COZIA”",39,"Alegeri Prezidentiale",1,1112,538,515,21,2,525,13,1220,682,300,225
40,VÂLCEA,"MUNICIPIUL RÂMNICU VÂLCEA",167473,"RÂMNICU VÂLCEA","LICEUL TEHNOLOGIC ”CĂPITAN NICOLAE PLEŞOIANU”",40,"Alegeri Prezidentiale",1,1071,567,535,32,0,556,11,1180,613,302,254
40,VÂLCEA,"MUNICIPIUL RÂMNICU VÂLCEA",167473,"RÂMNICU VÂLCEA","LICEUL TEHNOLOGIC ”CĂPITAN NICOLAE PLEŞOIANU”",41,"Alegeri Prezidentiale",1,1011,590,524,66,0,578,12,1110,520,350,228
40,VÂLCEA,"MUNICIPIUL RÂMNICU VÂLCEA",167473,"RÂMNICU VÂLCEA","LICEUL TEHNOLOGIC ”CĂPITAN NICOLAE PLEŞOIANU”",42,"Alegeri Prezidentiale",1,1991,993,950,43,0,970,23,2190,1197,485,485
40,VÂLCEA,"MUNICIPIUL RÂMNICU VÂLCEA",167473,"RÂMNICU VÂLCEA","ŞCOALA GIMNAZIALĂ ”SPIRU HARET” (FOSTĂ NR. 3)",43,"Alegeri Prezidentiale",1,1543,827,777,50,0,813,14,1700,873,500,313
40,VÂLCEA,"MUNICIPIUL RÂMNICU VÂLCEA",167473,"RÂMNICU VÂLCEA","ȘCOALA GIMNAZIALĂ GORANU",44,"Alegeri Prezidentiale",1,1417,555,536,19,0,542,13,1560,1005,321,221
40,VÂLCEA,"MUNICIPIUL RÂMNICU VÂLCEA",167473,"RÂMNICU VÂLCEA","ŞCOALA GIMNAZIALĂ GORANU",45,"Alegeri Prezidentiale",1,1047,485,467,18,0,476,9,1150,665,279,197
40,VÂLCEA,"MUNICIPIUL RÂMNICU VÂLCEA",167473,"RÂMNICU VÂLCEA","ŞCOALA LESPEZI - ARHIVĂ",46,"Alegeri Prezidentiale",1,1139,634,596,38,0,613,21,1250,616,402,211
40,VÂLCEA,"MUNICIPIUL RÂMNICU VÂLCEA",167473,"RÂMNICU VÂLCEA","ŞCOALA FEŢENI",47,"Alegeri Prezidentiale",1,193,97,81,16,0,96,1,210,113,54,42
40,VÂLCEA,"MUNICIPIUL RÂMNICU VÂLCEA",167473,"RÂMNICU VÂLCEA","CARTIER PETRIŞOR - PT8",48,"Alegeri Prezidentiale",1,1572,650,623,27,0,636,14,1730,1080,375,261
40,VÂLCEA,"MUNICIPIUL RÂMNICU VÂLCEA",167473,"RÂMNICU VÂLCEA","ŞCOALA GIMNAZIALĂ NR.4",49,"Alegeri Prezidentiale",1,992,547,497,50,0,528,19,1090,543,296,232
40,VÂLCEA,"MUNICIPIUL RÂMNICU VÂLCEA",167473,"RÂMNICU VÂLCEA","ŞCOALA GIMNAZIALĂ NR.4",50,"Alegeri Prezidentiale",1,1319,671,618,52,1,651,20,1450,779,386,265
40,VÂLCEA,"MUNICIPIUL RÂMNICU VÂLCEA",167473,"RÂMNICU VÂLCEA","ŞCOALA GIMNAZIALĂ NR.4",51,"Alegeri Prezidentiale",1,956,557,515,42,0,544,13,1050,493,329,215
40,VÂLCEA,"MUNICIPIUL RÂMNICU VÂLCEA",167473,"RÂMNICU VÂLCEA","COLEGIUL ECONOMIC",52,"Alegeri Prezidentiale",1,1091,617,557,60,0,605,12,1200,583,352,253
40,VÂLCEA,"MUNICIPIUL RÂMNICU VÂLCEA",167473,"RÂMNICU VÂLCEA","COLEGIUL ECONOMIC",53,"Alegeri Prezidentiale",1,1094,558,522,36,0,548,10,1200,642,311,237
40,VÂLCEA,"MUNICIPIUL RÂMNICU VÂLCEA",167473,"RÂMNICU VÂLCEA","COLEGIUL ECONOMIC",54,"Alegeri Prezidentiale",1,1117,507,469,27,11,496,11,1230,723,279,217
40,VÂLCEA,"MUNICIPIUL RÂMNICU VÂLCEA",167473,"RÂMNICU VÂLCEA","ȘCOALA GIMNAZIALĂ NR. 10",55,"Alegeri Prezidentiale",1,1252,693,593,100,0,680,13,1380,687,451,229
40,VÂLCEA,"MUNICIPIUL RÂMNICU VÂLCEA",167473,"RÂMNICU VÂLCEA","ȘCOALA GIMNAZIALĂ NR. 10",56,"Alegeri Prezidentiale",1,1472,798,727,71,0,780,18,1620,822,441,339
40,VÂLCEA,"MUNICIPIUL RÂMNICU VÂLCEA",167473,"RÂMNICU VÂLCEA","ȘCOALA GIMNAZIALĂ NR. 10",57,"Alegeri Prezidentiale",1,1157,531,490,41,0,515,16,1270,739,316,199
40,VÂLCEA,"MUNICIPIUL RÂMNICU VÂLCEA",167473,"RÂMNICU VÂLCEA","GRĂDINIȚA CU PROGRAM PRELUNGIT OSTROVENI I",58,"Alegeri Prezidentiale",1,1289,594,546,48,0,584,10,1420,826,331,253
40,VÂLCEA,"MUNICIPIUL RÂMNICU VÂLCEA",167473,"RÂMNICU VÂLCEA","LICEUL TEHNOLOGIC FERDINAND I",59,"Alegeri Prezidentiale",1,865,413,363,50,0,398,15,950,537,237,161
40,VÂLCEA,"MUNICIPIUL RÂMNICU VÂLCEA",167473,"RÂMNICU VÂLCEA","LICEUL TEHNOLOGIC FERDINAND I",60,"Alegeri Prezidentiale",1,754,378,314,64,0,369,9,830,452,215,154
40,VÂLCEA,"MUNICIPIUL RÂMNICU VÂLCEA",167473,"RÂMNICU VÂLCEA","LICEUL TEHNOLOGIC FERDINAND I",61,"Alegeri Prezidentiale",1,869,403,389,14,0,390,13,950,547,227,163
40,VÂLCEA,"MUNICIPIUL RÂMNICU VÂLCEA",167473,"RÂMNICU VÂLCEA","LICEUL TEHNOLOGIC FERDINAND I",62,"Alegeri Prezidentiale",1,1195,533,504,29,0,514,19,1320,787,309,205
40,VÂLCEA,"MUNICIPIUL RÂMNICU VÂLCEA",167473,"RÂMNICU VÂLCEA","LICEUL TEHNOLOGIC FERDINAND I",63,"Alegeri Prezidentiale",2,838,398,381,17,0,390,8,920,522,224,166
40,VÂLCEA,"MUNICIPIUL RÂMNICU VÂLCEA",167473,"RÂMNICU VÂLCEA","LICEUL TEHNOLOGIC FERDINAND I",64,"Alegeri Prezidentiale",1,854,371,357,14,0,363,8,940,569,216,147
40,VÂLCEA,"MUNICIPIUL RÂMNICU VÂLCEA",167473,"RÂMNICU VÂLCEA","GRĂDINIȚA CU PROGRAM PRELUNGIT OSTROVENI II",65,"Alegeri Prezidentiale",1,1378,670,609,61,0,654,16,1520,850,408,246
40,VÂLCEA,"MUNICIPIUL RÂMNICU VÂLCEA",167473,"RÂMNICU VÂLCEA","GRĂDINIȚA CU PROGRAM PRELUNGIT OSTROVENI II",66,"Alegeri Prezidentiale",1,1313,619,604,15,0,603,16,1440,821,375,228
40,VÂLCEA,"MUNICIPIUL RÂMNICU VÂLCEA",167473,"RÂMNICU VÂLCEA","GRĂDINIŢA CU PROGRAM PRELUNGIT OSTROVENI II",67,"Alegeri Prezidentiale",1,1048,452,423,29,0,438,14,1150,698,257,181
40,VÂLCEA,"MUNICIPIUL RÂMNICU VÂLCEA",167473,"RÂMNICU VÂLCEA","GRĂDINIŢA CU PROGRAM PRELUNGIT OSTROVENI II",68,"Alegeri Prezidentiale",1,1270,551,509,42,0,539,12,1390,839,299,240
40,VÂLCEA,"MUNICIPIUL RÂMNICU VÂLCEA",167473,"RÂMNICU VÂLCEA","DIRECȚIA ADMINISTRĂRII DOMENIULUI PUBLIC",69,"Alegeri Prezidentiale",1,1453,829,741,68,20,813,16,1590,761,576,237
40,VÂLCEA,"MUNICIPIUL RÂMNICU VÂLCEA",167473,"RÂMNICU VÂLCEA","ŞCOALA GIMNAZIALĂ ”ANTON PANN”",70,"Alegeri Prezidentiale",1,1562,824,724,100,0,795,29,1728,904,459,336
40,VÂLCEA,"MUNICIPIUL RÂMNICU VÂLCEA",167473,"RÂMNICU VÂLCEA","ŞCOALA GIMNAZIALĂ ”ANTON PANN”",71,"Alegeri Prezidentiale",1,1012,503,420,83,0,492,11,1110,607,316,176
40,VÂLCEA,"MUNICIPIUL RÂMNICU VÂLCEA",167473,"RÂMNICU VÂLCEA","ŞCOALA GIMNAZIALĂ ”ANTON PANN”",72,"Alegeri Prezidentiale",1,1135,624,586,38,0,607,17,1250,626,360,247
40,VÂLCEA,"MUNICIPIUL RÂMNICU VÂLCEA",167473,"RÂMNICU VÂLCEA","ŞCOALA GIMNAZIALĂ ”ANTON PANN”",73,"Alegeri Prezidentiale",1,1011,502,462,40,0,488,14,1110,608,305,183
40,VÂLCEA,"MUNICIPIUL RÂMNICU VÂLCEA",167473,"RÂMNICU VÂLCEA","ŞCOALA GIMNAZIALĂ ”ANTON PANN”",74,"Alegeri Prezidentiale",1,780,375,352,23,0,367,8,860,485,195,172
40,VÂLCEA,"MUNICIPIUL RÂMNICU VÂLCEA",167473,"RÂMNICU VÂLCEA","ŞCOALA GIMNAZIALĂ ”ANTON PANN”",75,"Alegeri Prezidentiale",1,1095,489,462,27,0,483,6,1200,711,294,189
40,VÂLCEA,"MUNICIPIUL RÂMNICU VÂLCEA",167473,"RÂMNICU VÂLCEA","ŞCOALA GIMNAZIALĂ ”ANTON PANN”",76,"Alegeri Prezidentiale",1,1330,564,536,28,0,549,15,1460,896,320,229
40,VÂLCEA,"MUNICIPIUL RÂMNICU VÂLCEA",167473,"RÂMNICU VÂLCEA","ŞCOALA GIMNAZIALĂ NR. 13",77,"Alegeri Prezidentiale",1,959,391,375,16,0,378,13,1050,659,219,159
40,VÂLCEA,"MUNICIPIUL RÂMNICU VÂLCEA",167473,"RÂMNICU VÂLCEA","ŞCOALA GIMNAZIALĂ NR. 13",78,"Alegeri Prezidentiale",1,953,455,424,31,0,442,13,1040,585,253,189
40,VÂLCEA,"MUNICIPIUL RÂMNICU VÂLCEA",167473,"RÂMNICU VÂLCEA","ŞCOALA GIMNAZIALĂ NR. 13",79,"Alegeri Prezidentiale",1,954,510,456,54,0,500,10,1040,530,306,194
40,VÂLCEA,"MUNICIPIUL RÂMNICU VÂLCEA",167473,"RÂMNICU VÂLCEA","ŞCOALA GIMNAZIALĂ NR. 13",80,"Alegeri Prezidentiale",1,1003,507,459,48,0,491,16,1100,593,285,206
40,VÂLCEA,"MUNICIPIUL RÂMNICU VÂLCEA",167473,"RÂMNICU VÂLCEA","ŞCOALA GIMNAZIALĂ NR. 13",81,"Alegeri Prezidentiale",1,1012,454,439,15,0,437,17,1120,666,253,184
40,VÂLCEA,"MUNICIPIUL RÂMNICU VÂLCEA",167473,"RÂMNICU VÂLCEA","ŞCOALA GIMNAZIALĂ NR. 13",82,"Alegeri Prezidentiale",2,1356,685,663,22,0,674,11,1490,805,424,250
40,VÂLCEA,"MUNICIPIUL RÂMNICU VÂLCEA",167473,"RÂMNICU VÂLCEA","ŞCOALA GIMNAZIALĂ NR. 13",83,"Alegeri Prezidentiale",1,1389,679,646,33,0,656,23,1520,841,473,183
40,VÂLCEA,"MUNICIPIUL RÂMNICU VÂLCEA",167473,"RÂMNICU VÂLCEA","SECŢIA 1 DE POLIŢIE RURALĂ RÂMNICU VÂLCEA",84,"Alegeri Prezidentiale",1,830,409,380,29,0,404,5,910,501,236,168
40,VÂLCEA,"MUNICIPIUL RÂMNICU VÂLCEA",167473,"RÂMNICU VÂLCEA","ŞCOALA STOLNICENI",85,"Alegeri Prezidentiale",1,565,236,213,23,0,236,0,617,381,99,137
40,VÂLCEA,"MUNICIPIUL RÂMNICU VÂLCEA",167473,"RÂMNICU VÂLCEA","ŞCOALA GIMNAZIALĂ COLONIE",86,"Alegeri Prezidentiale",1,1085,424,383,41,0,419,5,1190,766,202,217
40,VÂLCEA,"MUNICIPIUL RÂMNICU VÂLCEA",167473,"RÂMNICU VÂLCEA","ŞCOALA COPĂCELU",87,"Alegeri Prezidentiale",1,1515,751,715,36,0,736,15,1670,919,362,374
40,VÂLCEA,"MUNICIPIUL RÂMNICU VÂLCEA",167473,"RÂMNICU VÂLCEA","GRĂDINIŢA CĂZĂNEŞTI",88,"Alegeri Prezidentiale",1,968,506,475,31,0,499,7,1040,534,238,261
40,VÂLCEA,"MUNICIPIUL RÂMNICU VÂLCEA",167473,"RÂMNICU VÂLCEA","SISTEMUL DE GOSPODĂRIRE A APELOR VÂLCEA",89,"Alegeri Prezidentiale",1,707,377,351,26,0,366,11,780,403,221,145
40,VÂLCEA,"MUNICIPIUL DRĂGĂŞANI",167981,DRĂGĂŞANI,"ŞCOALA TUDOR VLADIMIRESCU",90,"Alegeri Prezidentiale",2,1347,714,554,160,0,700,14,1480,766,375,325
40,VÂLCEA,"MUNICIPIUL DRĂGĂŞANI",167981,DRĂGĂŞANI,"ŞCOALA TUDOR VLADIMIRESCU",91,"Alegeri Prezidentiale",1,1247,571,466,103,2,564,7,1370,799,327,237
40,VÂLCEA,"MUNICIPIUL DRĂGĂŞANI",167981,DRĂGĂŞANI,"LICEUL TEHNOLOGIC BRĂTIANU",92,"Alegeri Prezidentiale",1,1451,586,543,43,0,577,9,1600,1014,302,275
40,VÂLCEA,"MUNICIPIUL DRĂGĂŞANI",167981,DRĂGĂŞANI,"LICEUL TEHNOLOGIC BRĂTIANU",93,"Alegeri Prezidentiale",1,1352,492,448,44,0,488,4,1490,998,259,229
40,VÂLCEA,"MUNICIPIUL DRĂGĂŞANI",167981,DRĂGĂŞANI,"GRĂDINIȚA CU PROGRAM PRELUNGIT NR. 2",94,"Alegeri Prezidentiale",1,1306,520,491,29,0,512,8,1440,920,270,242
40,VÂLCEA,"MUNICIPIUL DRĂGĂŞANI",167981,DRĂGĂŞANI,"GRĂDINIŢA I.C. BRĂTIANU",95,"Alegeri Prezidentiale",1,897,362,331,31,0,357,5,990,628,143,214
40,VÂLCEA,"MUNICIPIUL DRĂGĂŞANI",167981,DRĂGĂŞANI,"ȘCOALA NICOLAE BĂLCESCU",96,"Alegeri Prezidentiale",1,1290,618,549,69,0,605,13,1420,802,324,281
40,VÂLCEA,"MUNICIPIUL DRĂGĂŞANI",167981,DRĂGĂŞANI,"ŞCOALA NICOLAE BĂLCESCU",97,"Alegeri Prezidentiale",1,1267,571,534,34,3,555,16,1400,829,293,262
40,VÂLCEA,"MUNICIPIUL DRĂGĂŞANI",167981,DRĂGĂŞANI,"COLEGIUL NAȚIONAL GIB MIHĂESCU",98,"Alegeri Prezidentiale",1,1485,681,587,58,36,667,14,1640,959,347,320
40,VÂLCEA,"MUNICIPIUL DRĂGĂŞANI",167981,DRĂGĂŞANI,"LICEUL TEHNOLOGIC BRĂTIANU - ȘCOALA PROFESIONALĂ",99,"Alegeri Prezidentiale",1,1201,542,486,56,0,534,8,1320,778,218,316
40,VÂLCEA,"MUNICIPIUL DRĂGĂŞANI",167981,DRĂGĂŞANI,"ŞCOALA GIMNAZIALĂ NR. 8 (BÂRSANU)",100,"Alegeri Prezidentiale",1,922,431,398,31,2,423,8,1010,579,198,225
40,VÂLCEA,"MUNICIPIUL DRĂGĂŞANI",167981,DRĂGĂŞANI,"GRĂDINIŢA CU PROGRAM NORMAL NR. 8",101,"Alegeri Prezidentiale",1,532,273,256,17,0,269,4,532,259,76,193
40,VÂLCEA,"MUNICIPIUL DRĂGĂŞANI",167981,DRĂGĂŞANI,"ŞCOALA GIMNAZIALĂ NR. 5",102,"Alegeri Prezidentiale",1,760,343,331,12,0,333,10,830,487,158,175
40,VÂLCEA,"MUNICIPIUL DRĂGĂŞANI",167981,DRĂGĂŞANI,"GRĂDINIȚA CAPUL DEALULUI",103,"Alegeri Prezidentiale",1,782,362,329,33,0,356,6,860,498,174,182
40,VÂLCEA,"MUNICIPIUL DRĂGĂŞANI",167981,DRĂGĂŞANI,"ȘCOALA ZLĂTĂREI",104,"Alegeri Prezidentiale",1,1207,558,534,24,0,544,14,1330,772,309,235
40,VÂLCEA,"ORAŞ BĂBENI",168372,BĂBENI,"PRIMĂRIA ORAŞULUI BĂBENI",105,"Alegeri Prezidentiale",1,1755,892,788,103,1,869,23,1930,1038,431,438
40,VÂLCEA,"ORAŞ BĂBENI",168372,BĂBENI,"LICEUL”GEORGE ŢĂRNEA” BĂBENI",106,"Alegeri Prezidentiale",1,1183,543,498,45,0,529,14,1310,767,321,208
40,VÂLCEA,"ORAŞ BĂBENI",168372,BĂBENI,"S.C. ALFA FARM S.R.L.",107,"Alegeri Prezidentiale",1,675,455,340,115,0,449,6,740,285,241,208
40,VÂLCEA,"ORAŞ BĂBENI",168372,BĂBENI,"ŞCOALA GENERALĂ CU CLASELE I-IV VALEA MARE",108,"Alegeri Prezidentiale",1,857,386,364,22,0,375,11,940,554,165,210
40,VÂLCEA,"ORAŞ BĂBENI",168372,BĂBENI,"ŞCOALA GIMNAZIALĂ, SAT VALEA MARE, ORAȘ BĂBENI",109,"Alegeri Prezidentiale",1,1326,545,490,55,0,532,13,1460,915,219,313
40,VÂLCEA,"ORAŞ BĂBENI",168372,BĂBENI,"ŞCOALA GENERALĂ TĂTĂRANI",110,"Alegeri Prezidentiale",1,500,295,236,59,0,289,6,550,255,164,125
40,VÂLCEA,"ORAŞ BĂBENI",168372,BĂBENI,"ȘCOALA GENERALĂ ROMÂNI",111,"Alegeri Prezidentiale",1,1067,647,588,59,0,636,11,1170,523,345,291
40,VÂLCEA,"ORAŞ BĂBENI",168372,BĂBENI,"ȘCOALA PĂDUREȚU",112,"Alegeri Prezidentiale",1,180,129,110,19,0,129,0,200,71,57,72
40,VÂLCEA,"ORAŞ BĂILE GOVORA",167641,CURĂTURILE,"SALA DE CĂSĂTORII A PRIMĂRIEI",113,"Alegeri Prezidentiale",1,1059,860,504,356,0,834,26,1160,300,446,388
40,VÂLCEA,"ORAŞ BĂILE GOVORA",167641,PRAJILA,"LICEUL TEHNOLOGIC BĂILE GOVORA",114,"Alegeri Prezidentiale",1,977,566,491,73,2,554,12,1080,514,307,247
40,VÂLCEA,"ORAŞ BĂILE GOVORA",167641,GĂTEJEŞTI,"ȘCOALA GENERALĂ CU CLASELE I-IV GĂTEJEȘTI",115,"Alegeri Prezidentiale",1,321,198,157,41,0,194,4,350,152,120,74
40,VÂLCEA,"ORAŞ BĂILE OLĂNEŞTI",167696,LIVADIA,"LICEUL TEHNOLOGIC JUSTINIAN MARINA",116,"Alegeri Prezidentiale",1,1532,1543,771,770,2,1506,37,1690,147,681,825
40,VÂLCEA,"ORAŞ BĂILE OLĂNEŞTI",167696,OLĂNEŞTI,"ȘCOALA GIMNAZIALĂ DUMITRU BĂDESCU",117,"Alegeri Prezidentiale",1,1334,749,648,98,3,730,19,1470,721,338,392
40,VÂLCEA,"ORAŞ BĂILE OLĂNEŞTI",167696,CHEIA,"ȘCOALA GIMNAZIALĂ IONESCU CHEIANU",118,"Alegeri Prezidentiale",1,903,523,448,75,0,506,17,990,467,234,272
40,VÂLCEA,"ORAŞ BĂLCEŞTI",168452,BĂLCEŞTI,"LICEUL TEHNOLOGIC PETRACHE POENARU",119,"Alegeri Prezidentiale",1,1005,521,440,81,0,509,12,1100,579,270,239
40,VÂLCEA,"ORAŞ BĂLCEŞTI",168452,BĂLCEŞTI,"LICEUL TEHNOLOGIC PETRACHE POENARU",120,"Alegeri Prezidentiale",1,836,361,304,57,0,353,8,920,559,176,177
40,VÂLCEA,"ORAŞ BĂLCEŞTI",168452,BENEŞTI,"ŞCOALA PRIMARĂ BENEŞTI",121,"Alegeri Prezidentiale",1,365,176,156,20,0,176,0,400,224,76,100
40,VÂLCEA,"ORAŞ BĂLCEŞTI",168452,GORUNEŞTI,"ŞCOALA PRIMARĂ GORUNEŞTI",122,"Alegeri Prezidentiale",1,614,298,234,62,2,294,4,670,372,157,137
40,VÂLCEA,"ORAŞ BĂLCEŞTI",168452,CÂRLOGANI,"SCOALA PRIMARĂ CÂRLOGANI",123,"Alegeri Prezidentiale",1,439,225,188,37,0,220,5,480,255,95,125
40,VÂLCEA,"ORAŞ BĂLCEŞTI",168452,OTETELIŞU,"ŞCOALA PRIMARĂ OTETELIŞU",124,"Alegeri Prezidentiale",2,829,414,375,38,1,408,6,910,496,222,186
40,VÂLCEA,"ORAŞ BERBEŞTI",168602,BERBEŞTI,"GRĂDINIȚA NR.1 (PECO)",125,"Alegeri Prezidentiale",1,959,310,269,41,0,306,4,1050,740,184,122
40,VÂLCEA,"ORAŞ BERBEŞTI",168602,BERBEŞTI,"GRĂDINIȚA NR. 2 BLOCURI",126,"Alegeri Prezidentiale",1,1122,427,405,22,0,417,10,1230,803,214,203
40,VÂLCEA,"ORAŞ BERBEŞTI",168602,BERBEŞTI,"ȘCOALA GENERALĂ CU CLASELE I- VIII BERBEȘTI",127,"Alegeri Prezidentiale",1,1487,652,629,23,0,639,13,1622,970,291,348
40,VÂLCEA,"ORAŞ BERBEŞTI",168602,"TÂRGU GÂNGULEŞTI","GRUP ȘCOLAR PREDA BUZESCU",128,"Alegeri Prezidentiale",1,919,394,369,25,0,387,7,1010,616,241,146
40,VÂLCEA,"ORAŞ BREZOI",167794,PĂSCOAIA,"ŞCOALA CU CLASELE I-IV PĂSCOAIA",129,"Alegeri Prezidentiale",1,167,119,95,24,0,115,4,180,61,51,64
40,VÂLCEA,"ORAŞ BREZOI",167794,"VALEA LUI STAN","ŞCOALA CU CLASELE I-VIII VALEA LUI STAN",130,"Alegeri Prezidentiale",1,458,251,226,25,0,244,7,500,249,163,81
40,VÂLCEA,"ORAŞ BREZOI",167794,BREZOI,"ȘCOALA CU CLASELE I-IV NR. 2 BREZOI",131,"Alegeri Prezidentiale",1,1084,597,528,69,0,589,8,1190,593,393,196
40,VÂLCEA,"ORAŞ BREZOI",167794,BREZOI,"GRĂDINIȚA CU PROGRAM NORMAL NR.1- PARTER",132,"Alegeri Prezidentiale",1,948,355,317,38,0,352,3,1040,685,230,122
40,VÂLCEA,"ORAŞ BREZOI",167794,BREZOI,"GRĂDINIȚA CU PROGRAM NORMAL NR.1- PARTER",133,"Alegeri Prezidentiale",1,1110,415,384,31,0,409,6,1225,810,257,152
40,VÂLCEA,"ORAŞ BREZOI",167794,BREZOI,"ȘCOALA CU CLASELE I-IV NR 1 BREZOI",134,"Alegeri Prezidentiale",1,1413,610,550,60,0,601,9,1540,930,387,214
40,VÂLCEA,"ORAŞ BREZOI",167794,CĂLINEŞTI,"CĂMINUL CULTURAL CĂLINEŞTI",135,"Alegeri Prezidentiale",1,551,322,261,61,0,317,5,600,278,181,136
40,VÂLCEA,"ORAŞ CĂLIMĂNEŞTI",167909,CĂLIMĂNEŞTI,"ŞCOALA GENERALĂ CU CLASELE I-IV SEACA",136,"Alegeri Prezidentiale",1,454,245,225,20,0,238,7,500,255,147,91
40,VÂLCEA,"ORAŞ CĂLIMĂNEŞTI",167909,CĂLIMĂNEŞTI,"LICEUL TEHNOLOGIC DE TURISM CĂLIMĂNEŞTI (SALĂ CANTINĂ RESTAURANT)",137,"Alegeri Prezidentiale",1,897,577,412,165,0,565,12,990,413,354,211
40,VÂLCEA,"ORAŞ CĂLIMĂNEŞTI",167909,CĂLIMĂNEŞTI,"ŞCOALA GIMNAZIALĂ ”ŞERBAN VODĂ CANTACUZINO” CĂLIMĂNEŞTI",138,"Alegeri Prezidentiale",2,962,557,446,111,0,548,9,1060,503,347,201
40,VÂLCEA,"ORAŞ CĂLIMĂNEŞTI",167909,CĂLIMĂNEŞTI,"ŞCOALA GENERALĂ CU CLASELE I-IV CĂLIMĂNEŞTI (DEAL)",139,"Alegeri Prezidentiale",1,1057,537,504,33,0,533,4,1060,523,276,257
40,VÂLCEA,"ORAŞ CĂLIMĂNEŞTI",167909,CĂLIMĂNEŞTI,"CENTRUL DE INFORMARE TURISTICĂ CĂLIMĂNEŞTI",140,"Alegeri Prezidentiale",1,504,560,215,345,0,549,11,810,250,293,256
40,VÂLCEA,"ORAŞ CĂLIMĂNEŞTI",167909,CĂLIMĂNEŞTI,"CENTRUL DE INFORMARE TURISTICA CACIULATA",141,"Alegeri Prezidentiale",1,592,1333,255,1078,0,1310,23,1550,217,711,599
40,VÂLCEA,"ORAŞ CĂLIMĂNEŞTI",167909,CĂLIMĂNEŞTI,"ŞCOALA GIMNAZIALĂ JIBLEA VECHE",142,"Alegeri Prezidentiale",1,994,376,350,26,0,372,4,740,364,241,131
40,VÂLCEA,"ORAŞ CĂLIMĂNEŞTI",167909,CĂLIMĂNEŞTI,"ŞCOALA GIMNAZIALĂ JIBLEA VECHE",143,"Alegeri Prezidentiale",1,973,449,415,34,0,444,5,770,321,251,193
40,VÂLCEA,"ORAŞ CĂLIMĂNEŞTI",167909,CĂLIMĂNEŞTI,"ŞCOALA PRIMARĂ JIBLEA NOUĂ",144,"Alegeri Prezidentiale",1,885,379,359,20,0,375,4,578,199,242,133
40,VÂLCEA,"ORAŞ HOREZU",168041,URŞANI,"CĂMINUL CULTURAL URȘANI",145,"Alegeri Prezidentiale",1,386,252,221,31,0,245,7,420,168,127,118
40,VÂLCEA,"ORAŞ HOREZU",168041,HOREZU,"LICEUL CONSTANTIN BRÂNCOVEANU",146,"Alegeri Prezidentiale",1,1202,799,633,146,20,778,21,1320,521,414,364
40,VÂLCEA,"ORAŞ HOREZU",168041,HOREZU,"CLUBUL COPIILOR HOREZU",147,"Alegeri Prezidentiale",2,1053,595,513,82,0,581,14,1160,565,344,237
40,VÂLCEA,"ORAŞ HOREZU",168041,HOREZU,"CASA DE CULTURĂ CONSTANTIN BRÂNCOVEANU",148,"Alegeri Prezidentiale",1,1083,682,580,102,0,657,25,1190,508,369,288
40,VÂLCEA,"ORAŞ HOREZU",168041,RÂMEŞTI,"CĂMINUL CULTURAL RÂMEȘTI",149,"Alegeri Prezidentiale",1,372,236,208,28,0,235,1,410,174,114,121
40,VÂLCEA,"ORAŞ HOREZU",168041,"ROMANII DE JOS","ȘCOALA GENERALĂ CU CLASELE I - VIII ROMANII DE JOS",150,"Alegeri Prezidentiale",1,618,379,321,54,4,365,14,680,301,167,198
40,VÂLCEA,"ORAŞ HOREZU",168041,"ROMANII DE SUS","CĂMINUL CULTURAL ROMANII DE SUS",151,"Alegeri Prezidentiale",1,274,166,149,17,0,165,1,300,134,85,80
40,VÂLCEA,"ORAŞ HOREZU",168041,TĂNĂSEŞTI,"CĂMINUL CULTURAL TĂNĂSEȘTI",152,"Alegeri Prezidentiale",1,126,94,75,17,2,91,3,140,46,53,38
40,VÂLCEA,"ORAŞ HOREZU",168041,"ROMANII DE SUS","ȘCOALA GENERALĂ ROMANII DE SUS - SĂLIȘTEA",153,"Alegeri Prezidentiale",1,582,275,264,11,0,267,8,653,378,77,190
40,VÂLCEA,"ORAŞ OCNELE MARI",168130,"GURA SUHAŞULUI","ȘCOALA GIMNAZIALĂ COSTEA MARINOIU OCNELE MARI",154,"Alegeri Prezidentiale",1,1370,845,708,137,0,823,22,1510,665,405,418
40,VÂLCEA,"ORAŞ OCNELE MARI",168130,OCNIŢA,"FOSTA ȘCOALA CU CLASELE I-VIII OCNIŢA",155,"Alegeri Prezidentiale",1,1400,775,689,85,1,763,12,1540,765,349,414
40,VÂLCEA,ALUNU,168229,IGOIU,"ŞCOALA GIMNAZIALĂ, COMUNA ALUNU, SAT IGOIU",156,"Alegeri Prezidentiale",1,1471,693,634,59,0,677,16,1620,927,354,323
40,VÂLCEA,ALUNU,168229,BODEŞTI,"FOSTUL LOCAL AL GRĂDINIŢEI CU PROGRAM NORMAL BODEŞTI, SAT BODEŞTI",157,"Alegeri Prezidentiale",1,291,148,122,26,0,146,2,320,172,94,52
40,VÂLCEA,ALUNU,168229,COLTEŞTI,"GRĂDINIŢA CU PROGRAM NORMAL COLTEŞTI, SAT COLTEŞTI",158,"Alegeri Prezidentiale",1,1303,645,590,54,1,636,9,1430,785,202,434
40,VÂLCEA,ALUNU,168229,ROŞIA,"GRĂDINIȚA CU PROGRAM NORMAL ROȘIA",159,"Alegeri Prezidentiale",1,478,234,220,14,0,234,0,530,296,55,179
40,VÂLCEA,AMĂRĂŞTI,168309,AMĂRĂŞTI,"ŞCOALA GIMNAZIALĂ AMĂRĂŞTI",160,"Alegeri Prezidentiale",1,874,367,323,44,0,362,5,960,593,185,177
40,VÂLCEA,AMĂRĂŞTI,168309,NEMOIU,"FOSTA ŞCOALĂ NEMOIU",161,"Alegeri Prezidentiale",1,636,288,250,38,0,285,3,700,412,157,128
40,VÂLCEA,BĂRBĂTEŞTI,168559,BODEŞTI,"FOSTA ŞCOALĂ CU CLASELE I-IV BODEŞTI",162,"Alegeri Prezidentiale",1,767,420,375,45,0,411,9,840,420,165,246
40,VÂLCEA,BĂRBĂTEŞTI,168559,BĂRBĂTEŞTI,"CĂMINUL CULTURAL BĂRBĂTEŞTI",163,"Alegeri Prezidentiale",1,1256,682,587,95,0,665,17,1380,698,277,388
40,VÂLCEA,BĂRBĂTEŞTI,168559,BODEŞTI,"SCOALA GIMNAZIALĂ BODEȘTI",164,"Alegeri Prezidentiale",1,763,369,318,51,0,363,6,840,471,189,174
40,VÂLCEA,BERISLĂVEŞTI,168675,BERISLĂVEŞTI,"CĂMINUL CULTURAL STOENEŞTI",165,"Alegeri Prezidentiale",1,766,473,420,53,0,468,5,840,367,264,204
40,VÂLCEA,BERISLĂVEŞTI,168675,DÂNGEŞTI,"CĂMINUL CULTURAL DÎNGEŞTI",166,"Alegeri Prezidentiale",1,270,185,164,21,0,185,0,302,117,84,101
40,VÂLCEA,BERISLĂVEŞTI,168675,RĂDĂCINEŞTI,"CĂMINUL CULTURAL RĂDĂCINEŞTI",167,"Alegeri Prezidentiale",1,542,341,293,48,0,335,6,600,259,173,162
40,VÂLCEA,BERISLĂVEŞTI,168675,ROBAIA,"CĂMINUL CULTURAL ROBAIA",168,"Alegeri Prezidentiale",1,193,127,111,16,0,123,4,212,85,52,71
40,VÂLCEA,BERISLĂVEŞTI,168675,SCĂUENI,"ŞCOALA CU CLASELE I-IV SCĂUENI",169,"Alegeri Prezidentiale",1,405,247,218,29,0,245,2,450,203,136,109
40,VÂLCEA,BOIŞOARA,168755,BOIŞOARA,"ŞCOALA CU CLASELE I-VIII BOIŞOARA",170,"Alegeri Prezidentiale",1,984,435,377,58,0,428,7,1090,655,364,64
40,VÂLCEA,BUDEŞTI,168791,BUDEŞTI,"CASA CĂSĂTORIILOR DIN CADRUL CLĂDIRII BIBLIOTECII COMUNALE",171,"Alegeri Prezidentiale",1,1275,704,606,98,0,692,12,1400,696,466,226
40,VÂLCEA,BUDEŞTI,168791,LINIA,"ŞCOALA RACOVIŢA",172,"Alegeri Prezidentiale",1,541,261,197,64,0,256,5,590,329,142,114
40,VÂLCEA,BUDEŞTI,168791,BARZA,"ŞCOALA BARZA",173,"Alegeri Prezidentiale",1,893,486,443,43,0,481,5,980,494,319,162
40,VÂLCEA,BUDEŞTI,168791,BÂRSEŞTI,"ŞCOALA BÎRSEŞTI",174,"Alegeri Prezidentiale",1,743,424,378,46,0,420,4,820,396,253,167
40,VÂLCEA,BUDEŞTI,168791,RUDA,"CENTRU SOCIAL RUDA",175,"Alegeri Prezidentiale",1,458,229,200,27,2,225,4,500,271,149,76
40,VÂLCEA,BUDEŞTI,168791,BERCIOIU,"ŞCOALA BERCIOIU",176,"Alegeri Prezidentiale",1,289,163,133,30,0,161,2,320,157,108,53
40,VÂLCEA,BUDEŞTI,168791,RACOVIŢA,"GRĂDINIŢA RACOVIŢA",177,"Alegeri Prezidentiale",1,868,435,409,26,0,433,2,950,515,280,153
40,VÂLCEA,BUJORENI,168880,OLTENI,"ŞCOALA CU CLASELE I-VIII OLTENI",178,"Alegeri Prezidentiale",1,1508,863,698,165,0,839,24,1660,797,546,293
40,VÂLCEA,BUJORENI,168880,LUNCA,"ŞCOALA CU CLASELE I-IV LUNCA",179,"Alegeri Prezidentiale",1,600,346,310,36,0,341,5,660,314,151,190
40,VÂLCEA,BUJORENI,168880,BOGDĂNEŞTI,"ŞCOALA CU CLASELE I-IV BOGDĂNEŞTI",180,"Alegeri Prezidentiale",1,673,342,305,37,0,337,5,740,398,209,128
40,VÂLCEA,BUJORENI,168880,"GURA VĂII","CĂMINUL CULTURAL GURA VĂII",181,"Alegeri Prezidentiale",1,1152,572,517,55,0,566,6,1270,698,367,199
40,VÂLCEA,BUNEŞTI,168960,BUNEŞTI,"ŞCOALA CU CLASELE I-VIII BUNEŞTI",182,"Alegeri Prezidentiale",1,927,479,426,53,0,475,4,1020,541,206,269
40,VÂLCEA,BUNEŞTI,168960,TITIRECI,"ŞCOALA CU CLASELE I-VIII BUNEŞTI",183,"Alegeri Prezidentiale",1,860,427,392,35,0,423,4,950,523,211,212
40,VÂLCEA,BUNEŞTI,168960,TEIUŞU,"ŞCOALA TEIUŞU, COMUNA BUNEŞTI",184,"Alegeri Prezidentiale",1,435,170,135,35,0,169,1,480,310,73,96
40,VÂLCEA,CÂINENI,169119,"CÂINENII MICI","ŞCOALA PRIMARĂ CÎINENII MICI",185,"Alegeri Prezidentiale",1,490,249,201,47,1,245,4,540,291,154,91
40,VÂLCEA,CÂINENI,169119,"CÂINENII MARI","ŞCOALA GIMNAZIALĂ CÎINENII MARI",186,"Alegeri Prezidentiale",1,601,288,229,59,0,287,1,660,372,211,76
40,VÂLCEA,CÂINENI,169119,GREBLEŞTI,"CĂMIN CULTURAL GREBLEŞTI",187,"Alegeri Prezidentiale",1,554,349,259,90,0,345,4,610,261,253,92
40,VÂLCEA,CÂINENI,169119,ROBEŞTI,"CĂMINUL CULTURAL ROBEȘTI",188,"Alegeri Prezidentiale",1,171,129,68,61,0,124,5,190,61,81,43
40,VÂLCEA,CERNIŞOARA,169039,ARMĂŞEŞTI,"ŞCOALA CU CLASELE I-VIII ARMĂŞEŞTI",189,"Alegeri Prezidentiale",1,499,264,231,33,0,258,6,550,286,121,137
40,VÂLCEA,CERNIŞOARA,169039,CERNIŞOARA,"ŞCOALA CU CLASELE I-VIII CERNIŞOARA",190,"Alegeri Prezidentiale",1,687,358,327,31,0,353,5,750,392,176,177
40,VÂLCEA,CERNIŞOARA,169039,GROŞI,"ŞCOALA CU CLASELE I-IV GROŞI",191,"Alegeri Prezidentiale",1,754,374,330,44,0,372,2,830,456,174,198
40,VÂLCEA,CERNIŞOARA,169039,MĂDULARI,"ŞCOALA CU CLASELE I-VIII MĂDULARI",192,"Alegeri Prezidentiale",1,541,290,260,30,0,282,8,590,300,119,163
40,VÂLCEA,CERNIŞOARA,169039,OBÂRŞIA,"ŞCOALA CU CLASELE I-IV OBÎRŞIA",193,"Alegeri Prezidentiale",1,434,197,181,16,0,193,4,475,278,70,123
40,VÂLCEA,COPĂCENI,169182,ULMETU,"GRĂDINIŢA ULMETU",194,"Alegeri Prezidentiale",1,1128,519,472,47,0,513,6,1240,721,192,321
40,VÂLCEA,COPĂCENI,169182,VEŢELU,"ŞCOALA CU CLASELE I-IV VEŢELU",195,"Alegeri Prezidentiale",1,426,231,207,24,0,230,1,470,239,109,121
40,VÂLCEA,COPĂCENI,169182,BĂLTENI,"ȘCOALA CU CLASELE I-IV BĂLTENI",196,"Alegeri Prezidentiale",1,287,155,143,12,0,152,3,310,155,84,68
40,VÂLCEA,COPĂCENI,169182,HOTĂRASA,"ȘCOALA CU CLASELE I-VIII - HOTĂRASA",197,"Alegeri Prezidentiale",1,303,156,133,23,0,154,2,330,174,42,112
40,VÂLCEA,COSTEŞTI,169253,COSTEŞTI,"ŞCOALA CU CLASELE I-VIII COSTEŞTI",198,"Alegeri Prezidentiale",1,1538,953,824,109,20,944,9,1690,737,439,505
40,VÂLCEA,COSTEŞTI,169253,BISTRIŢA,"ŞCOALA CU CLASELE I-IV BISTRIŢA",199,"Alegeri Prezidentiale",1,715,439,365,66,8,426,13,780,341,147,279
40,VÂLCEA,COSTEŞTI,169253,PIETRENI,"ŞCOALA CU CLASELE I-IV PIETRENI",200,"Alegeri Prezidentiale",1,436,265,232,23,10,262,3,480,215,101,161
40,VÂLCEA,CREŢENI,169306,CREŢENI,"ȘCOALA GIMNAZIALĂ CREȚENI",201,"Alegeri Prezidentiale",1,874,465,383,78,4,459,6,960,495,220,239
40,VÂLCEA,CREŢENI,169306,IZVORU,"GRĂDINIȚA CU PROGRAM NORMAL IZVORU",202,"Alegeri Prezidentiale",1,473,243,206,36,1,238,5,520,277,116,122
40,VÂLCEA,CREŢENI,169306,STREMINOASA,"GRĂDINIȚA CU PROGRAM NORMAL STREMINOASA",203,"Alegeri Prezidentiale",1,483,320,263,56,1,316,4,530,210,173,143
40,VÂLCEA,DĂEŞTI,169351,DĂEŞTI,"ŞCOALA DĂEŞTI",204,"Alegeri Prezidentiale",1,832,481,419,62,0,476,5,910,429,326,150
40,VÂLCEA,DĂEŞTI,169351,SÂNBOTIN,"ŞCOALA GENERALĂ CU CLASELE I - IV, SÎNBOTIN",205,"Alegeri Prezidentiale",1,716,361,323,38,0,358,3,790,429,241,117
40,VÂLCEA,DĂEŞTI,169351,FEDELEŞOIU,"ŞCOALA FEDELEŞOIU",206,"Alegeri Prezidentiale",1,874,511,444,67,0,505,6,960,449,341,164
40,VÂLCEA,DĂEŞTI,169351,BĂBUEŞTI,"ŞCOALA BĂBUEŞTI",207,"Alegeri Prezidentiale",1,76,44,29,15,0,44,0,90,46,32,12
40,VÂLCEA,DĂNICEI,169404,UDREŞTI,"ŞCOALA GIMNAZIALĂ UDREŞTI",208,"Alegeri Prezidentiale",1,799,431,341,90,0,428,3,880,449,201,227
40,VÂLCEA,DĂNICEI,169404,"DEALU SCHEIULUI","ŞCOALA PRIMARĂ DEALU SCHEIULUI",209,"Alegeri Prezidentiale",1,226,150,111,39,0,148,2,250,100,73,75
40,VÂLCEA,DĂNICEI,169404,"LĂUNELE DE JOS","ŞCOALA GIMNAZIALĂ LĂUNELE DE JOS",210,"Alegeri Prezidentiale",1,351,274,194,80,0,270,4,390,116,74,196
40,VÂLCEA,DĂNICEI,169404,CERETU,"ȘCOALA PRIMARĂ CERETU",211,"Alegeri Prezidentiale",1,302,191,158,33,0,189,2,330,139,98,91
40,VÂLCEA,DICULEŞTI,174502,BĂBENI-OLTEŢU,"ŞCOALA CU CLASELE I-VIII BĂBENI-OLTEŢU",212,"Alegeri Prezidentiale",1,879,406,373,33,0,400,6,970,564,240,160
40,VÂLCEA,DICULEŞTI,174502,BUDEŞTI,"ŞCOALA CU CLASELE I-IV BUDEŞTI",213,"Alegeri Prezidentiale",1,663,310,272,38,0,303,7,730,420,206,97
40,VÂLCEA,DRĂGOEŞTI,169547,DRĂGOEŞTI,"ŞCOALA CU CLASELE I-VIII DRĂGOEŞTI",214,"Alegeri Prezidentiale",1,634,403,333,70,0,394,9,700,297,208,186
40,VÂLCEA,DRĂGOEŞTI,169547,DRĂGOEŞTI,"ȘCOALA CU CLASELE I- IV GEAMĂNA- BUCIUMENI",215,"Alegeri Prezidentiale",1,592,394,321,73,0,386,8,650,256,182,204
40,VÂLCEA,DRĂGOEŞTI,169547,DRĂGOEŞTI,"ŞCOALA CU CLASELE I-IV BONCANI",216,"Alegeri Prezidentiale",1,438,290,242,48,0,288,2,480,190,144,144
40,VÂLCEA,FĂUREŞTI,169583,MĂRCUŞU,"ŞCOALA GIMNAZIALĂ FĂUREŞTI",217,"Alegeri Prezidentiale",1,647,341,298,43,0,337,4,710,369,241,96
40,VÂLCEA,FĂUREŞTI,169583,MILEŞTI,"GRĂDINIŢA MILEŞTI",218,"Alegeri Prezidentiale",1,520,235,213,22,0,233,2,570,335,140,93
40,VÂLCEA,FÂRTĂŢEŞTI,169681,FÂRTĂŢEŞTI,"PRIMĂRIA FÎRTĂŢEŞTI",219,"Alegeri Prezidentiale",1,327,190,170,20,0,188,2,360,170,73,115
40,VÂLCEA,FÂRTĂŢEŞTI,169681,BECŞANI,"FOSTA ŞCOALĂ DEJOI",220,"Alegeri Prezidentiale",1,370,260,179,80,1,259,1,410,150,95,164
40,VÂLCEA,FÂRTĂŢEŞTI,169681,DOZEŞTI,"ŞCOALA CU CLASELE I-VIII DOZEŞTI",221,"Alegeri Prezidentiale",1,1028,422,357,65,0,420,2,1130,708,170,250
40,VÂLCEA,FÂRTĂŢEŞTI,169681,GIULEŞTI,"ŞCOALA CU CLASELE I-VIII RUSĂNEŞTI",222,"Alegeri Prezidentiale",1,715,336,283,52,1,331,5,790,454,139,192
40,VÂLCEA,FÂRTĂŢEŞTI,169681,"GIULEŞTII DE SUS","FOSTA ȘCOALA CU CLASELE I-IV GIULEȘTII DE SUS",223,"Alegeri Prezidentiale",1,261,157,139,18,0,156,1,290,133,54,102
40,VÂLCEA,FÂRTĂŢEŞTI,169681,CĂŢETU,"CENTRUL DE ÎNGRIJIRE ȘI ASISTENȚĂ PENTRU PERSOANE VARSTNICE",224,"Alegeri Prezidentiale",1,365,183,155,28,0,182,1,400,217,72,110
40,VÂLCEA,FRÂNCEŞTI,169896,FRÂNCEŞTI,"ŞCOALA CU CLASELE I-VIII FRÎNCEŞTI",225,"Alegeri Prezidentiale",1,607,297,262,35,0,295,2,660,363,151,144
40,VÂLCEA,FRÂNCEŞTI,169896,MĂNĂILEŞTI,"ȘCOALA GENERALĂ CU CLASELE I-VIII GENUNENI",226,"Alegeri Prezidentiale",1,642,358,320,38,0,354,4,710,352,165,189
40,VÂLCEA,FRÂNCEŞTI,169896,GENUNENI,"GRĂDINIŢA NEGRENI",227,"Alegeri Prezidentiale",1,401,235,195,40,0,235,0,440,205,129,106
40,VÂLCEA,FRÂNCEŞTI,169896,COŞANI,"ŞCOALA GENERALĂ CU CLASELE I-IV COŞANI",228,"Alegeri Prezidentiale",1,1149,433,399,34,0,427,6,1260,827,213,214
40,VÂLCEA,FRÂNCEŞTI,169896,DEZROBIŢI,"GRĂDINIŢA DEZROBIŢI",229,"Alegeri Prezidentiale",1,568,318,286,32,0,313,5,620,302,170,143
40,VÂLCEA,FRÂNCEŞTI,169896,MOŞTENI,"ŞCOALA GENERALĂ CU CLASELE I-IV SURPATE",230,"Alegeri Prezidentiale",1,651,349,307,42,0,346,3,720,371,157,189
40,VÂLCEA,FRÂNCEŞTI,169896,VIIŞOARA,"GRĂDINIŢA VIIŞOARA",231,"Alegeri Prezidentiale",1,230,157,125,32,0,155,2,250,93,80,75
40,VÂLCEA,GALICEA,169994,GALICEA,"CĂMINUL CULTURAL GALICEA",232,"Alegeri Prezidentiale",1,940,490,414,76,0,483,7,1030,540,246,237
40,VÂLCEA,GALICEA,169994,TEIU,"ŞCOALA TEIU",233,"Alegeri Prezidentiale",1,342,236,199,37,0,231,5,370,134,110,121
40,VÂLCEA,GALICEA,169994,"VALEA RÂULUI","ŞCOALA VALEA RÎULUI",234,"Alegeri Prezidentiale",1,346,211,188,23,0,208,3,380,169,117,91
40,VÂLCEA,GALICEA,169994,COCORU,"ŞCOALA COCORU",235,"Alegeri Prezidentiale",1,543,355,291,64,0,352,3,600,245,186,166
40,VÂLCEA,GALICEA,169994,"BRATIA DIN VALE","ŞCOALA BRATIA DIN VALE",236,"Alegeri Prezidentiale",1,371,175,147,28,0,173,2,410,235,83,90
40,VÂLCEA,GALICEA,169994,"BRATIA DIN DEAL","ŞCOALA BRATIA DIN DEAL",237,"Alegeri Prezidentiale",1,288,189,152,37,0,188,1,320,131,93,95
40,VÂLCEA,GALICEA,169994,CREMENARI,"CĂMINUL CULTURAL CREMENARI",238,"Alegeri Prezidentiale",1,331,216,165,51,0,214,2,360,144,80,134
40,VÂLCEA,GHIOROIU,170097,ŞTIRBEŞTI,"ŞCOALA ŞTIRBEŞTI",239,"Alegeri Prezidentiale",1,481,262,199,63,0,262,0,530,268,103,159
40,VÂLCEA,GHIOROIU,170097,GHIOROIU,"CĂMINUL CULTURAL GHIOROIU",240,"Alegeri Prezidentiale",1,475,258,194,63,1,256,2,520,262,92,164
40,VÂLCEA,GHIOROIU,170097,POIENARI,"ŞCOALA POIENARI",241,"Alegeri Prezidentiale",1,227,163,120,42,1,161,2,250,87,60,101
40,VÂLCEA,GLĂVILE,170168,GLĂVILE,"ŞCOALA GIMNAZIALĂ ”BARTOLOMEU VALERIU ANANIA”GLĂVILE",242,"Alegeri Prezidentiale",1,855,385,325,51,9,377,8,940,555,169,208
40,VÂLCEA,GLĂVILE,170168,ANINOASA,"ŞCOALA PRIMARĂ ANINOASA",243,"Alegeri Prezidentiale",1,146,132,90,39,3,130,2,160,28,50,80
40,VÂLCEA,GLĂVILE,170168,OLTEANCA,"ŞCOALA PRIMARĂ OLTEANCA",244,"Alegeri Prezidentiale",1,570,357,266,77,14,350,7,620,263,103,247
40,VÂLCEA,GOLEŞTI,170220,POPEŞTI,"ŞCOALA CU CLASELE I-VIII POPEŞTI",245,"Alegeri Prezidentiale",1,761,356,310,46,0,350,6,840,484,201,149
40,VÂLCEA,GOLEŞTI,170220,BLIDARI,"ŞCOALA BLIDARI",246,"Alegeri Prezidentiale",1,848,485,450,35,0,479,6,930,445,287,192
40,VÂLCEA,GOLEŞTI,170220,TULEI-CÂMPENI,"ŞCOALA POENIŢA",247,"Alegeri Prezidentiale",1,337,175,141,34,0,170,5,370,195,95,75
40,VÂLCEA,GOLEŞTI,170220,VĂTĂŞEŞTI,"ŞCOALA VĂTĂŞEŞTI",248,"Alegeri Prezidentiale",1,196,120,88,32,0,115,5,220,100,63,52
40,VÂLCEA,GRĂDIŞTEA,170346,GRĂDIŞTEA,"SALA DE SPORT DE LA LICEUL TEORETIC GRĂDIŞTEA",249,"Alegeri Prezidentiale",1,349,172,131,41,0,168,4,380,208,71,97
40,VÂLCEA,GRĂDIŞTEA,170346,"VALEA GRĂDIŞTEI","ŞCOALA CU CLASELE I-IV VALEA GRĂDIŞTEA",250,"Alegeri Prezidentiale",1,111,88,63,25,0,85,3,120,32,51,34
40,VÂLCEA,GRĂDIŞTEA,170346,DOBRICEA,"ȘCOALA CU CLASELE I-VIII DOBRICEA",251,"Alegeri Prezidentiale",1,639,266,232,34,0,263,3,700,434,143,120
40,VÂLCEA,GRĂDIŞTEA,170346,ŢUŢURU,"GRĂDINIŢA CU PROGRAM NORMAL ŢUŢURU",252,"Alegeri Prezidentiale",1,1032,418,367,50,1,409,9,1130,712,258,151
40,VÂLCEA,GUŞOENI,170444,SPÂRLENI,"ŞCOALA GIMNAZIALĂ GUŞOENI",253,"Alegeri Prezidentiale",1,718,481,347,117,17,475,6,790,309,227,248
40,VÂLCEA,GUŞOENI,170444,GUŞOIANCA,"CĂMINUL CULTURAL GUŞOIANCA",254,"Alegeri Prezidentiale",1,458,369,265,91,13,367,2,500,131,201,166
40,VÂLCEA,IONEŞTI,170514,IONEŞTI,"ŞCOALA IONEŞTII GOVORII",255,"Alegeri Prezidentiale",1,1130,440,379,61,0,435,5,1240,800,191,244
40,VÂLCEA,IONEŞTI,170514,DELURENI,"ŞCOALA FIŞCĂLIA",256,"Alegeri Prezidentiale",1,870,368,327,41,0,366,2,950,582,189,177
40,VÂLCEA,IONEŞTI,170514,FOTEŞTI,"ŞCOALA FOTEŞTI",257,"Alegeri Prezidentiale",1,690,295,262,33,0,292,3,760,465,157,135
40,VÂLCEA,IONEŞTI,170514,MARCEA,"ŞCOALA MARCEA",258,"Alegeri Prezidentiale",1,671,333,267,65,1,329,4,740,407,167,162
40,VÂLCEA,LALOŞU,170612,LALOŞU,"ŞCOALA PRIMARĂ LALOŞU",259,"Alegeri Prezidentiale",1,781,227,197,30,0,226,1,860,633,121,105
40,VÂLCEA,LALOŞU,170612,MOLOGEŞTI,"ŞCOALA GIMNAZIALĂ MOLOGEŞTI",260,"Alegeri Prezidentiale",1,513,203,175,28,0,202,1,560,357,123,79
40,VÂLCEA,LALOŞU,170612,BERBEŞTI,"ŞCOALA PRIMARĂ BERBEŞTI",261,"Alegeri Prezidentiale",1,356,135,112,23,0,132,3,390,255,71,61
40,VÂLCEA,LALOŞU,170612,OLTEŢANI,"ŞCOALA PRIMARĂ OLTEŢANI",262,"Alegeri Prezidentiale",1,202,121,97,24,0,120,1,220,99,71,49
40,VÂLCEA,LĂCUSTENI,174511,LĂCUSTENI,"ŞCOALA CU CLASELE I-IV LĂCUSTENI",263,"Alegeri Prezidentiale",1,402,227,190,37,0,220,7,440,213,93,127
40,VÂLCEA,LĂCUSTENI,174511,CONTEA,"ŞCOALA CU CLASELE V-VIII LĂCUSTENI",264,"Alegeri Prezidentiale",1,244,163,122,41,0,160,3,270,107,101,59
40,VÂLCEA,LĂCUSTENI,174511,GĂNEŞTI,"ŞCOALA CU CLASELE I-IV GĂNEŞTI",265,"Alegeri Prezidentiale",1,454,240,211,29,0,232,8,500,260,106,126
40,VÂLCEA,LĂDEŞTI,170685,LĂDEŞTI,"CĂMINUL CULTURAL LĂDEȘTI",266,"Alegeri Prezidentiale",1,731,574,403,145,26,567,7,800,226,263,304
40,VÂLCEA,LĂDEŞTI,170685,GĂGENI,"ȘCOALA PRIMARĂ GĂGENI",267,"Alegeri Prezidentiale",1,189,160,103,54,3,159,1,210,50,67,92
40,VÂLCEA,LĂDEŞTI,170685,CHIRICEŞTI,"ȘCOALA PRIMARĂ CHIRICEȘTI",268,"Alegeri Prezidentiale",1,393,262,198,64,0,255,7,430,168,107,148
40,VÂLCEA,LĂDEŞTI,170685,OLTEANCA,"ȘCOALA PRIMARĂ OLTEANCA",269,"Alegeri Prezidentiale",1,80,94,41,53,0,92,2,110,16,33,59
40,VÂLCEA,LĂPUŞATA,170792,SĂRULEŞTI,"ŞCOALA GIMNAZIALĂ SĂRULEŞTI",270,"Alegeri Prezidentiale",2,1137,558,463,95,0,547,11,1250,692,266,281
40,VÂLCEA,LĂPUŞATA,170792,BROŞTENI,"ŞCOALA PRIMARĂ BROŞTENI",271,"Alegeri Prezidentiale",1,536,309,253,56,0,306,3,590,281,123,183
40,VÂLCEA,LIVEZI,170872,LIVEZI,"CLĂDIRE ȘCOALĂ I-IV TINA",272,"Alegeri Prezidentiale",1,582,271,220,51,0,269,2,640,369,121,148
40,VÂLCEA,LIVEZI,170872,PLEŞOIU,"ŞCOALA CU CLASELE I-IV PLEŞOIU",273,"Alegeri Prezidentiale",1,313,177,134,27,16,176,1,340,163,67,109
40,VÂLCEA,LIVEZI,170872,"PÂRÂIENII DE JOS","CLĂDIRE GRĂDINIȚĂ PÎRÎIENII DE JOS",274,"Alegeri Prezidentiale",1,944,374,334,40,0,363,11,1040,666,141,222
40,VÂLCEA,LUNGEŞTI,170952,LUNGEŞTI,"ŞCOALA LUNGEŞTI",275,"Alegeri Prezidentiale",1,829,412,321,84,7,408,4,910,498,231,177
40,VÂLCEA,LUNGEŞTI,170952,STĂNEŞTI-LUNCA,"ŞCOALA CU CLASELE I-IV STĂNEŞTI-LUNCA",276,"Alegeri Prezidentiale",1,777,420,385,35,0,415,5,860,440,215,200
40,VÂLCEA,LUNGEŞTI,170952,FUMURENI,"CĂMINUL CULTURAL FUMURENI",277,"Alegeri Prezidentiale",1,543,284,225,59,0,279,5,600,316,131,148
40,VÂLCEA,LUNGEŞTI,170952,DUMBRAVA,"ŞCOALA CU CLASELE I-IV DUMBRAVA",278,"Alegeri Prezidentiale",1,309,160,133,27,0,160,0,340,180,87,73
40,VÂLCEA,MALAIA,171021,MALAIA,"ŞCOALA GIMNAZIALĂ MALAIA",279,"Alegeri Prezidentiale",1,864,557,436,116,5,547,10,950,393,324,223
40,VÂLCEA,MALAIA,171021,CIUNGETU,"ŞCOALA PRIMARĂ CIUNGET",280,"Alegeri Prezidentiale",1,394,214,172,42,0,212,2,430,216,155,57
40,VÂLCEA,MALAIA,171021,SĂLIŞTEA,"GRĂDINIŢA CU PROGRAM NORMAL SĂLIŞTE",281,"Alegeri Prezidentiale",1,232,178,130,48,0,174,4,260,82,112,62
40,VÂLCEA,MATEEŞTI,171067,MATEEŞTI,"ŞCOALA GIMNAZIALĂ MATEEŞTI",282,"Alegeri Prezidentiale",1,1071,571,491,78,2,568,3,1179,608,288,280
40,VÂLCEA,MATEEŞTI,171067,GRECI,"GRĂDINIŢA GRECI",283,"Alegeri Prezidentiale",1,468,270,232,32,6,269,1,510,240,130,139
40,VÂLCEA,MATEEŞTI,171067,TURCEŞTI,"ŞCOALA GIMNAZIALĂ TURCEŞTI",284,"Alegeri Prezidentiale",1,995,542,472,66,4,539,3,1100,558,223,316
40,VÂLCEA,MĂCIUCA,171101,OVESELU,"LICEUL TEORETIC",285,"Alegeri Prezidentiale",1,778,449,344,103,2,447,2,860,411,259,188
40,VÂLCEA,MĂCIUCA,171101,POPEŞTI,"ŞCOALA GENERALĂ POPEŞTI, COMUNA MĂCIUCA, SATUL POPEŞTI",286,"Alegeri Prezidentiale",1,370,198,147,50,1,197,1,410,212,106,91
40,VÂLCEA,MĂCIUCA,171101,ŞTEFĂNEŞTI,"ȘCOALA CU CLASELE I-IV ZĂVOIENI",287,"Alegeri Prezidentiale",1,249,175,123,52,0,170,5,270,95,115,55
40,VÂLCEA,MĂDULARI,171209,MĂDULARI,"ȘCOALA CU CLASELE . I-VIII MĂDULARI",288,"Alegeri Prezidentiale",1,620,396,325,45,26,392,4,672,276,153,239
40,VÂLCEA,MĂDULARI,171209,BĂLŞOARA,"ŞCOALA CU CLASELE I-IV BĂLŞOARA",289,"Alegeri Prezidentiale",1,249,200,135,46,19,197,3,270,70,72,125
40,VÂLCEA,MĂDULARI,171209,BĂNŢEŞTI,"ȘCOALA CU CLASELE. I-IV BĂNȚEȘTI",290,"Alegeri Prezidentiale",1,251,147,127,17,3,142,5,280,133,54,88
40,VÂLCEA,MĂLDĂREŞTI,171272,MĂLDĂREŞTI,"ŞCOALA VECHE MĂLDĂREŞTI",291,"Alegeri Prezidentiale",1,1503,704,630,74,0,692,12,1650,946,382,310
40,VÂLCEA,MĂLDĂREŞTI,171272,TELECHEŞTI,"ŞCOALA TELECHEŞTI",292,"Alegeri Prezidentiale",1,135,69,49,20,0,67,2,150,81,34,33
40,VÂLCEA,MIHĂEŞTI,171325,BULETA,"GRĂDINIȚA BULETA",293,"Alegeri Prezidentiale",1,1191,617,537,80,0,595,22,1300,683,300,295
40,VÂLCEA,MIHĂEŞTI,171325,MĂGURA,"CĂMINUL CULTURAL MĂGURA",294,"Alegeri Prezidentiale",1,726,432,352,80,0,424,8,800,368,213,211
40,VÂLCEA,MIHĂEŞTI,171325,VULPUEŞTI,"CĂMINUL CULTURAL VULPUEŞTI",295,"Alegeri Prezidentiale",1,634,361,320,41,0,358,3,690,329,146,212
40,VÂLCEA,MIHĂEŞTI,171325,BÂRSEŞTI,"ŞCOALA CU CLASELE I-IV BÎRSEŞTI",296,"Alegeri Prezidentiale",1,695,308,256,51,1,302,6,760,452,176,126
40,VÂLCEA,MIHĂEŞTI,171325,STUPĂREI,"GRĂDINIŢA STUPĂREI",297,"Alegeri Prezidentiale",1,725,366,305,61,0,358,8,800,434,193,165
40,VÂLCEA,MIHĂEŞTI,171325,MIHĂEŞTI,"GRĂDINIȚA MIHĂEȘTI",298,"Alegeri Prezidentiale",1,917,532,403,42,87,520,11,1010,478,218,302
40,VÂLCEA,MIHĂEŞTI,171325,GURIŞOARA,"ȘCOALA GENERALĂ",299,"Alegeri Prezidentiale",1,765,414,351,63,0,410,4,840,426,209,201
40,VÂLCEA,MILCOIU,171469,MILCOIU,"PRIMĂRIA MILCOIU",300,"Alegeri Prezidentiale",1,284,182,138,44,0,180,2,310,128,83,97
40,VÂLCEA,MILCOIU,171469,IZBĂŞEŞTI,"GRĂDINIŢA IZBĂŞEŞTI",301,"Alegeri Prezidentiale",1,194,116,89,27,0,113,3,210,94,63,50
40,VÂLCEA,MILCOIU,171469,CIUTEŞTI,"ANEXĂ PRIMĂRIE",302,"Alegeri Prezidentiale",1,236,160,105,36,19,155,5,260,100,91,64
40,VÂLCEA,MILCOIU,171469,TEPŞENARI,"CENTRUL CULTURAL TEPŞENARI",303,"Alegeri Prezidentiale",1,321,216,169,47,0,207,9,350,134,115,92
40,VÂLCEA,MITROFANI,174520,MITROFANI,"CÃMINUL CULTURAL MITROFANI",304,"Alegeri Prezidentiale",1,565,251,213,38,0,248,3,630,379,124,124
40,VÂLCEA,MITROFANI,174520,RACU,"FOSTA ŞCOALÃ RACU",305,"Alegeri Prezidentiale",1,234,153,131,22,0,153,0,260,107,75,78
40,VÂLCEA,MUEREASCA,171539,MUEREASCA,"ŞCOALA MUEREASCA DE JOS",306,"Alegeri Prezidentiale",1,916,412,365,47,0,407,5,1010,598,243,164
40,VÂLCEA,MUEREASCA,171539,"MUEREASCA DE SUS","ŞCOALA MUEREASCA DE SUS",307,"Alegeri Prezidentiale",1,1149,479,435,43,1,476,3,1270,791,333,143
40,VÂLCEA,"NICOLAE BĂLCESCU",171628,ROTĂRĂŞTI,"ŞCOALA CU CLASELE I-VIII ROTĂRĂŞTI",308,"Alegeri Prezidentiale",1,898,557,453,101,3,549,8,990,433,220,329
40,VÂLCEA,"NICOLAE BĂLCESCU",171628,"CORBII DIN VALE","ŞCOALA CU CLASELE I-IV CORBI",309,"Alegeri Prezidentiale",1,323,214,162,51,1,211,3,350,136,91,120
40,VÂLCEA,"NICOLAE BĂLCESCU",171628,ŞERBĂNEASA,"ŞCOALA CU CLASELE I-IV ŞERBĂNEASA",310,"Alegeri Prezidentiale",1,739,391,352,39,0,387,4,810,419,143,244
40,VÂLCEA,"NICOLAE BĂLCESCU",171628,PREDEŞTI,"ȘCOALA CU CLASELE I-VIII PREDEȘTI",311,"Alegeri Prezidentiale",1,681,388,320,55,13,382,6,750,362,181,201
40,VÂLCEA,"NICOLAE BĂLCESCU",171628,GÂLTOFANI,"ŞCOALA CU CLASELE I-IV GÂLTOFANI",312,"Alegeri Prezidentiale",1,139,102,65,37,0,101,1,150,48,39,62
40,VÂLCEA,OLANU,171806,OLANU,"ŞCOALA CU CLASELE I-IV PERETU",313,"Alegeri Prezidentiale",1,463,251,224,27,0,248,3,510,259,113,135
40,VÂLCEA,OLANU,171806,"CASA VECHE","ŞCOALA CU CLASELE.I-IV CASA VECHE",314,"Alegeri Prezidentiale",1,569,363,308,55,0,360,3,630,267,195,165
40,VÂLCEA,OLANU,171806,CIOBOŢI,"ŞCOALA CU CLASELE I-IV CIOBOŢI",315,"Alegeri Prezidentiale",1,598,331,274,57,0,323,8,660,329,168,155
40,VÂLCEA,OLANU,171806,DRĂGIOIU,"ŞCOALA CU CLASELE I-IV DRĂGIOIU",316,"Alegeri Prezidentiale",1,475,304,248,56,0,297,7,509,205,155,142
40,VÂLCEA,OLANU,171806,STOICĂNEŞTI,"ŞCOALA CU CLASELE I-IV STOICĂNEŞTI",317,"Alegeri Prezidentiale",1,346,216,177,39,0,213,3,380,164,109,104
40,VÂLCEA,ORLEŞTI,171879,ORLEŞTI,"CĂMIN CULTURAL(FOSTUL CĂMIN CULTURAL DIN CURTEA PRIMĂRIEI)",318,"Alegeri Prezidentiale",1,1500,827,700,90,37,812,15,1650,823,505,307
40,VÂLCEA,ORLEŞTI,171879,SILEA,"GRĂDINIŢA SILEA",319,"Alegeri Prezidentiale",1,863,526,448,52,26,516,10,950,424,273,243
40,VÂLCEA,OTEŞANI,171931,OTEŞANI,"CĂMINUL CULTURAL OTEŞANI",320,"Alegeri Prezidentiale",1,1093,487,441,46,0,482,5,1200,713,247,235
40,VÂLCEA,OTEŞANI,171931,CÂRSTĂNEŞTI,"ŞCOALA CÎRSTĂNEŞTI",321,"Alegeri Prezidentiale",1,1107,523,468,53,2,515,8,1220,697,274,241
40,VÂLCEA,PĂUŞEŞTI,171995,BARCANELE,"ŞCOALA PRIMARĂ BARCANELE",322,"Alegeri Prezidentiale",1,485,238,189,49,0,236,2,530,292,97,139
40,VÂLCEA,PĂUŞEŞTI,171995,PĂUŞEŞTI,"CĂMINUL CULTURAL PĂUŞEŞTI",323,"Alegeri Prezidentiale",1,757,395,346,49,0,389,6,830,435,175,214
40,VÂLCEA,PĂUŞEŞTI,171995,CERNELELE,"CĂMINUL CULTURAL ŞERBĂNEŞTI",324,"Alegeri Prezidentiale",1,494,281,246,35,0,280,1,540,259,156,124
40,VÂLCEA,PĂUŞEŞTI,171995,BUZDUGAN,"ŞCOALA GIMNAZIALĂ ŞERBĂNEŞTI",325,"Alegeri Prezidentiale",1,394,197,182,15,0,195,2,430,233,84,111
40,VÂLCEA,PĂUŞEŞTI-MĂGLAŞI,172082,PIETRARI,"ŞCOALA GIMNAZIALĂ ACHIM POPESCU",326,"Alegeri Prezidentiale",1,1097,655,572,83,0,640,15,1210,555,383,257
40,VÂLCEA,PĂUŞEŞTI-MĂGLAŞI,172082,PĂUŞEŞTI-MĂGLAŞI,"ŞCOALA GIMNAZIALĂ ACHIM POPESCU",327,"Alegeri Prezidentiale",1,1279,737,654,83,0,722,15,1410,673,436,286
40,VÂLCEA,PĂUŞEŞTI-MĂGLAŞI,172082,"VALEA CHEII","ŞCOALA PRIMARĂ VALEA CHEII",328,"Alegeri Prezidentiale",1,923,419,373,46,0,410,9,1010,591,239,171
40,VÂLCEA,PERIŞANI,172153,PERIŞANI,"ŞCOALA CU CLASELE I-VIII PERIŞANI",329,"Alegeri Prezidentiale",1,460,223,201,22,0,223,0,500,277,157,66
40,VÂLCEA,PERIŞANI,172153,MLĂCENI,"CĂMINUL CULTURAL MLĂCENI",330,"Alegeri Prezidentiale",1,435,246,216,30,0,241,5,480,234,171,70
40,VÂLCEA,PERIŞANI,172153,POIANA,"ŞCOALA CU CLASELE I-VIII POIANA",331,"Alegeri Prezidentiale",1,490,205,186,19,0,199,6,540,335,132,67
40,VÂLCEA,PERIŞANI,172153,SPINU,"CĂMINUL CULTURAL SPINU",332,"Alegeri Prezidentiale",1,295,140,124,16,0,138,2,320,180,89,49
40,VÂLCEA,PERIŞANI,172153,PODENI,"ŞCOALA PODENI",333,"Alegeri Prezidentiale",1,55,40,28,12,0,39,1,70,30,28,11
40,VÂLCEA,PESCEANA,172279,PESCEANA,"ŞCOALA CU CLASELE I-IV PESCEANA (ŞCOALA VECHE NR. 2 PESCEANA)",334,"Alegeri Prezidentiale",1,1345,734,623,111,0,723,11,1480,746,306,417
40,VÂLCEA,PIETRARI,172340,PIETRARI,"ŞCOALĂ GIMNAZIALĂ PIETRARI",335,"Alegeri Prezidentiale",1,1364,768,673,95,0,749,19,1500,732,438,311
40,VÂLCEA,PIETRARI,172340,"PIETRARII DE SUS","ŞCOALA PRIMARĂ PIETRARII DE SUS",336,"Alegeri Prezidentiale",1,1130,584,538,46,0,571,13,1240,656,293,278
40,VÂLCEA,POPEŞTI,172377,DĂEŞTI,"ŞCOALA CU CLASELE I-VIII DĂEŞTI",337,"Alegeri Prezidentiale",1,775,388,331,57,0,383,5,850,462,151,232
40,VÂLCEA,POPEŞTI,172377,MEIENI,"CĂMINUL CULTURAL POPEŞTI",338,"Alegeri Prezidentiale",1,385,224,192,32,0,218,6,420,196,66,152
40,VÂLCEA,POPEŞTI,172377,POPEŞTI,"ŞCOALA CU CLASELE I-IV POPEŞTI",339,"Alegeri Prezidentiale",1,495,275,231,44,0,272,3,550,275,108,164
40,VÂLCEA,POPEŞTI,172377,URŞI,"ŞCOALA CU CLASELE I-VIII URŞI",340,"Alegeri Prezidentiale",1,834,455,408,47,0,452,3,920,465,160,292
40,VÂLCEA,PRUNDENI,172457,PRUNDENI,"ȘCOALA PRUNDENI",341,"Alegeri Prezidentiale",1,1268,613,541,72,0,605,8,1390,777,264,341
40,VÂLCEA,PRUNDENI,172457,CĂLINA,"ȘCOALA CĂLINA",342,"Alegeri Prezidentiale",1,1180,549,490,59,0,538,11,1300,751,208,330
40,VÂLCEA,PRUNDENI,172457,BĂRBUCENI,"ȘCOALA BĂRBUCENI",343,"Alegeri Prezidentiale",1,975,452,407,45,0,446,6,1080,628,187,259
40,VÂLCEA,RACOVIŢA,172509,RACOVIŢA,"CĂMINUL CULTURAL RACOVIŢA",344,"Alegeri Prezidentiale",1,763,419,358,61,0,414,5,840,421,276,138
40,VÂLCEA,RACOVIŢA,172509,"GRUIU LUPULUI","ŞCOALA GRUIUL LUPULUI",345,"Alegeri Prezidentiale",1,123,89,64,25,0,88,1,140,51,54,34
40,VÂLCEA,RACOVIŢA,172509,TUŢULEŞTI,"OCOLUL SILVIC LOVIŞTEA",346,"Alegeri Prezidentiale",1,122,111,89,22,0,108,3,130,19,61,47
40,VÂLCEA,RACOVIŢA,172509,BALOTA,"CĂMINUL CULTURAL BALOTA",347,"Alegeri Prezidentiale",1,313,196,133,63,0,196,0,340,144,139,57
40,VÂLCEA,ROEŞTI,172581,BĂIAŞA,"ŞCOALA CU CLASELE I-IV ROEŞTI",348,"Alegeri Prezidentiale",1,615,312,256,48,8,307,5,670,358,135,172
40,VÂLCEA,ROEŞTI,172581,CIOCÂLTEI,"ŞCOALA CU CLASELE I-VIII CIOCÎLTEI",349,"Alegeri Prezidentiale",1,492,272,231,35,6,269,3,540,268,105,164
40,VÂLCEA,ROEŞTI,172581,CUENI,"ŞCOALA CU CLASELE I-VIII CUENI",350,"Alegeri Prezidentiale",1,516,294,237,49,8,291,3,570,276,140,151
40,VÂLCEA,ROEŞTI,172581,BĂRBĂRIGENI,"ŞCOALA CU CLASELE I-IV BĂRBĂRIGENI",351,"Alegeri Prezidentiale",1,162,100,66,28,6,97,3,180,80,42,55
40,VÂLCEA,ROŞIILE,172698,ROŞIILE,"ŞCOALA GIMNAZIALĂ ROŞIILE",352,"Alegeri Prezidentiale",1,865,408,339,67,2,404,4,950,542,198,206
40,VÂLCEA,ROŞIILE,172698,ROMANEŞTI,"ŞCOALA PRIMARĂ ROMANEŞTI",353,"Alegeri Prezidentiale",1,829,413,361,43,9,411,2,880,467,191,220
40,VÂLCEA,ROŞIILE,172698,ZGUBEA,"GRĂDINIŢA CU PROGRAM NORMAL ZGUBEA",354,"Alegeri Prezidentiale",1,266,193,153,40,0,192,1,290,97,100,92
40,VÂLCEA,ROŞIILE,172698,PERTEŞTI,"FOSTA ŞCOALĂ PERTEŞTI",355,"Alegeri Prezidentiale",1,44,62,19,43,0,62,0,80,18,37,25
40,VÂLCEA,RUNCU,172812,RUNCU,"ŞCOALA GIMNAZIALĂ CU CLASELE I-VIII RUNCU",356,"Alegeri Prezidentiale",1,433,257,204,53,0,250,7,480,223,121,129
40,VÂLCEA,RUNCU,172812,"VALEA BABEI","ŞCOALA GENERALĂ CU CLASELE I-IV VALEA BABEI",357,"Alegeri Prezidentiale",1,200,123,103,20,0,121,2,220,97,83,38
40,VÂLCEA,RUNCU,172812,SURPAŢI,"ŞCOALA GENERALĂ CU CLASELE I-IV SURPAŢI",358,"Alegeri Prezidentiale",1,111,76,62,14,0,74,2,120,44,39,35
40,VÂLCEA,SĂLĂTRUCEL,172894,SĂLĂTRUCEL,"CĂMINUL CULTURAL SĂLĂTRUCEL",359,"Alegeri Prezidentiale",1,1169,630,550,79,1,614,16,1290,660,386,228
40,VÂLCEA,SĂLĂTRUCEL,172894,ŞERBĂNEŞTI,"ŞCOALA ŞERBĂNEŞTI",360,"Alegeri Prezidentiale",1,402,193,167,26,0,191,2,440,247,121,70
40,VÂLCEA,SĂLĂTRUCEL,172894,PĂTEŞTI,"ŞCOALA PATEŞTI",361,"Alegeri Prezidentiale",1,102,67,56,11,0,66,1,110,43,47,19
40,VÂLCEA,SĂLĂTRUCEL,172894,SEACA,"ŞCOALA SEACA",362,"Alegeri Prezidentiale",1,88,55,42,13,0,55,0,100,45,33,22
40,VÂLCEA,SCUNDU,172947,SCUNDU,"ȘCOALA CU CLASELE I-VIII SCUNDU",363,"Alegeri Prezidentiale",1,947,626,477,96,53,618,8,1040,414,191,427
40,VÂLCEA,SCUNDU,172947,CRÂNGU,"ȘCOALA CU CLASELE I-VIII AVRĂMEȘTI",364,"Alegeri Prezidentiale",1,632,392,311,55,26,389,3,700,308,134,255
40,VÂLCEA,SINEŞTI,172992,SINEŞTI,"CĂMIN CULTURAL SINEȘTI",365,"Alegeri Prezidentiale",1,691,340,301,39,0,338,2,760,420,154,184
40,VÂLCEA,SINEŞTI,172992,MIJLOCU,"ȘCOALA URZICA, SAT URZICA",366,"Alegeri Prezidentiale",1,813,337,300,37,0,335,2,900,563,130,205
40,VÂLCEA,SINEŞTI,172992,POPEŞTI,"ȘCOALA PRIMARĂ, SAT POPEȘTI",367,"Alegeri Prezidentiale",1,511,227,211,16,0,226,1,560,333,116,110
40,VÂLCEA,SLĂTIOARA,173061,MOGEŞTI,"CASA DE CULTURĂ SLĂTIOARA",368,"Alegeri Prezidentiale",1,815,466,407,58,1,459,7,900,434,179,280
40,VÂLCEA,SLĂTIOARA,173061,MILOSTEA,"ȘCOALA CU CLASELE I-VIII MILOSTEA",369,"Alegeri Prezidentiale",1,643,335,293,42,0,330,5,710,375,155,175
40,VÂLCEA,SLĂTIOARA,173061,RUGETU,"ȘCOALA CU CLASELE I-VIII RUGETU",370,"Alegeri Prezidentiale",1,531,307,272,35,0,305,2,590,283,105,200
40,VÂLCEA,SLĂTIOARA,173061,GORUNEŞTI,"ŞCOALA GENERALĂ GORUNEȘTI",371,"Alegeri Prezidentiale",1,370,203,175,27,1,196,7,410,207,75,121
40,VÂLCEA,SLĂTIOARA,173061,SLĂTIOARA,"GRĂDINIŢA CUMPENE",372,"Alegeri Prezidentiale",1,413,226,206,20,0,222,4,465,239,95,127
40,VÂLCEA,STĂNEŞTI,173132,STĂNEŞTI,"ŞCOALA CU CLASELE I-VIII STĂNEŞTI",373,"Alegeri Prezidentiale",1,408,248,209,39,0,242,6,450,202,143,99
40,VÂLCEA,STĂNEŞTI,173132,VÂRLENI,"ŞCOALA CU CLASELE I-IV VÂRLENI",374,"Alegeri Prezidentiale",1,362,198,162,36,0,194,4,395,197,96,98
40,VÂLCEA,STĂNEŞTI,173132,"LINIA DEALULUI","ŞCOALA CU CLASELE I-IV LINIA DEALULUI",375,"Alegeri Prezidentiale",1,128,83,66,17,0,81,2,140,57,40,41
40,VÂLCEA,STOENEŞTI,173230,STOENEŞTI,"CĂMINUL CULTURAL STOENESTI",376,"Alegeri Prezidentiale",1,891,551,447,104,0,546,5,980,429,348,198
40,VÂLCEA,STOENEŞTI,173230,BÂRLOGU,"CĂMINUL CULTURAL BÂRLOGU",377,"Alegeri Prezidentiale",1,277,179,145,34,0,175,4,310,131,109,66
40,VÂLCEA,STOENEŞTI,173230,DOBRICENI,"CĂMINUL CULTURAL DOBRICENI",378,"Alegeri Prezidentiale",1,1016,528,461,67,0,525,3,1120,592,307,218
40,VÂLCEA,STOENEŞTI,173230,"PISCU MARE","CĂMINUL CULTURAL PISCU MARE",379,"Alegeri Prezidentiale",1,501,248,199,49,0,246,2,550,302,137,109
40,VÂLCEA,STOENEŞTI,173230,ZMEURĂTU,"CĂMINUL CULTURAL ZMEURĂTU",380,"Alegeri Prezidentiale",1,141,117,73,44,0,115,2,160,43,71,44
40,VÂLCEA,STOILEŞTI,173374,URŞI,"ŞCOALA CU CLASELE I-VIII URŞI",381,"Alegeri Prezidentiale",1,1161,637,573,62,2,630,7,1280,643,263,367
40,VÂLCEA,STOILEŞTI,173374,STOILEŞTI,"ȘCOALA CU CLASELE I-VIII STOILEȘTI",382,"Alegeri Prezidentiale",1,585,335,272,52,11,332,3,640,305,146,186
40,VÂLCEA,STOILEŞTI,173374,GEAMĂNA,"ŞCOALA CU CLASELE I-IV GEAMĂNA",383,"Alegeri Prezidentiale",1,770,387,335,52,0,383,4,850,463,192,191
40,VÂLCEA,STOILEŞTI,173374,BÂRSOIU,"ŞCOALA CU CLASELE I-IV BÎRSOIU",384,"Alegeri Prezidentiale",1,508,281,238,41,2,278,3,556,275,130,148
40,VÂLCEA,STROEŞTI,173533,STROEŞTI,"ŞCOALA CU CLASELE I-VIII CĂPITAN MĂRĂŞANU STROEŞTI",385,"Alegeri Prezidentiale",1,755,375,335,40,0,370,5,830,455,168,202
40,VÂLCEA,STROEŞTI,173533,CIREŞU,"ŞCOALA CU CLASELE I-VIII CIREŞU",386,"Alegeri Prezidentiale",1,643,352,309,43,0,346,6,710,358,180,166
40,VÂLCEA,STROEŞTI,173533,DIANU,"CAMINUL CULTURAL DIANU",387,"Alegeri Prezidentiale",1,413,230,209,21,0,228,2,450,220,106,122
40,VÂLCEA,STROEŞTI,173533,OBROCEŞTI,"CENTRUL SOCIAL OBROCEŞTI",388,"Alegeri Prezidentiale",1,270,138,115,23,0,134,4,300,162,57,77
40,VÂLCEA,STROEŞTI,173533,POJOGI-CERNA,"CĂMINUL CULTURAL POJOGI - CERNA",389,"Alegeri Prezidentiale",1,206,147,112,35,0,147,0,230,83,88,59
40,VÂLCEA,SUTEŞTI,173597,SUTEŞTI,"ṢCOALA GIMNAZIALĂ SUTEŞTI",390,"Alegeri Prezidentiale",1,1298,763,635,127,1,751,12,1430,667,526,225
40,VÂLCEA,SUTEŞTI,173597,VERDEA,"FOSTA ŞCOALA VERDEA",391,"Alegeri Prezidentiale",1,427,291,237,52,2,282,9,470,179,141,141
40,VÂLCEA,ŞIRINEASA,173686,ŞIRINEASA,"ŞCOALA GIMNAZIALĂ ŞIRINEASA",392,"Alegeri Prezidentiale",1,1177,578,526,51,1,571,7,1300,722,243,328
40,VÂLCEA,ŞIRINEASA,173686,CIORĂŞTI,"ŞCOALA PRIMARĂ CIORĂŞTI",393,"Alegeri Prezidentiale",1,488,277,247,30,0,275,2,540,263,111,164
40,VÂLCEA,ŞIRINEASA,173686,SLĂVITEŞTI,"ŞCOALA PRIMARĂ SLĂVITEŞTI",394,"Alegeri Prezidentiale",1,248,133,104,29,0,131,2,270,137,61,70
40,VÂLCEA,ŞTEFĂNEŞTI,173748,ŞTEFĂNEŞTI,"ŞCOALA CU CLASELE I-VIII ŞTEFĂNEŞTI",395,"Alegeri Prezidentiale",1,938,497,428,58,11,485,12,1030,533,239,246
40,VÂLCEA,ŞTEFĂNEŞTI,173748,ŞERBĂNEŞTI,"GRĂDINIŢA ŞERBĂNEŞTI",396,"Alegeri Prezidentiale",1,670,381,329,50,2,376,5,740,359,101,275
40,VÂLCEA,ŞTEFĂNEŞTI,173748,DOBRUŞA,"ŞCOALA GIMNAZIALĂ NR.1",397,"Alegeri Prezidentiale",1,519,294,241,48,5,289,5,569,275,109,180
40,VÂLCEA,ŞTEFĂNEŞTI,173748,DOBRUŞA,"GRĂDINIŢA DOBRUŞA DE SUS",398,"Alegeri Prezidentiale",2,499,284,240,39,5,279,5,550,266,87,192
40,VÂLCEA,ŞUŞANI,173793,UŞUREI,"CĂMINUL CULTURAL UŞUREI",399,"Alegeri Prezidentiale",1,446,182,149,33,0,178,4,490,308,53,125
40,VÂLCEA,ŞUŞANI,173793,ŞUŞANI,"ŞCOALA ŞUŞANII DE SUS",400,"Alegeri Prezidentiale",1,488,207,185,22,0,205,2,540,333,104,101
40,VÂLCEA,ŞUŞANI,173793,ŞUŞANI,"ŞCOALA ŞUŞANII DE JOS",401,"Alegeri Prezidentiale",1,438,247,193,54,0,244,3,480,233,118,126
40,VÂLCEA,ŞUŞANI,173793,STOICULEŞTI,"ŞCOALA STOICULEŞTI",402,"Alegeri Prezidentiale",1,299,179,149,30,0,179,0,330,151,100,79
40,VÂLCEA,ŞUŞANI,173793,RÂMEŞTI,"ŞCOALA RÎMEŞTI",403,"Alegeri Prezidentiale",1,863,407,330,77,0,404,3,950,543,241,163
40,VÂLCEA,TETOIU,173855,BĂROIU,"ŞCOALA CU CLASELE I-IV BĂROIU",404,"Alegeri Prezidentiale",1,322,159,128,31,0,156,3,350,191,55,101
40,VÂLCEA,TETOIU,173855,TETOIU,"CĂMINUL CULTURAL TETOIU",405,"Alegeri Prezidentiale",1,542,243,183,58,2,235,8,600,357,88,147
40,VÂLCEA,TETOIU,173855,ŢEPEŞTI,"ŞCOALA GENERALĂ CU CLASELE.I-VIII ŢEPEŞTI",406,"Alegeri Prezidentiale",1,689,306,248,57,1,303,3,760,454,183,120
40,VÂLCEA,TETOIU,173855,NENCIULEŞTI,"ŞCOALA GENERALĂ CU CLASELE.I-IV NENCIULEŞTI",407,"Alegeri Prezidentiale",1,273,145,111,34,0,142,3,300,155,67,75
40,VÂLCEA,TETOIU,173855,BUDELE,"SCOALA GENERALĂ CU CLASELE.I-IV BUDELE",408,"Alegeri Prezidentiale",1,149,102,77,25,0,101,1,160,58,56,45
40,VÂLCEA,TITEŞTI,174496,TITEŞTI,"ŞCOALA CU CLASELE I-VIII TITEŞTI (SALĂ DE FESTIVITĂȚI)",409,"Alegeri Prezidentiale",1,461,271,226,41,4,264,7,505,234,202,62
40,VÂLCEA,TITEŞTI,174496,BRATOVEŞTI,"ŞCOALA CU CLASELE I-IV BRATOVEŞTI",410,"Alegeri Prezidentiale",1,140,110,76,34,0,110,0,150,40,72,38
40,VÂLCEA,TOMŞANI,173935,TOMŞANI,"CĂMINUL CULTURAL TOMŞANI",411,"Alegeri Prezidentiale",1,938,559,503,56,0,545,14,1030,471,253,292
40,VÂLCEA,TOMŞANI,173935,"FOLEŞTII DE SUS","ŞCOALA GENERALĂ FOLEŞTII DE SUS",412,"Alegeri Prezidentiale",1,927,507,439,64,4,495,12,1020,513,235,260
40,VÂLCEA,TOMŞANI,173935,"FOLEŞTII DE JOS","CĂMINUL CULTURAL FOLEȘTII DE JOS",413,"Alegeri Prezidentiale",1,670,366,298,67,1,359,7,740,374,135,224
40,VÂLCEA,TOMŞANI,173935,BOGDĂNEŞTI,"CĂMINUL CULTURAL BOGDĂNEȘTI",414,"Alegeri Prezidentiale",1,589,367,337,30,0,363,4,650,283,171,192
40,VÂLCEA,VAIDEENI,174021,VAIDEENI,"CĂMINUL CULTURAL VAIDEENI",415,"Alegeri Prezidentiale",1,927,561,465,83,13,550,11,1020,459,280,270
40,VÂLCEA,VAIDEENI,174021,VAIDEENI,"CĂMINUL CULTURAL VAIDEENI",416,"Alegeri Prezidentiale",1,1186,704,641,48,15,690,14,1300,596,257,433
40,VÂLCEA,VAIDEENI,174021,"IZVORU RECE","CĂMINUL CULTURAL IZVORU RECE",417,"Alegeri Prezidentiale",1,648,375,323,42,10,368,7,710,335,148,220
40,VÂLCEA,VAIDEENI,174021,MARIŢA,"CĂMINUL CULTURAL MARIŢA",418,"Alegeri Prezidentiale",1,467,246,196,48,2,241,5,516,270,95,146
40,VÂLCEA,"VALEA MARE",174085,DELURENI,"ŞCOALA CU CLASELE I-IV DELURENI",419,"Alegeri Prezidentiale",1,411,177,159,18,0,177,0,450,273,77,100
40,VÂLCEA,"VALEA MARE",174085,"VALEA MARE","GRĂDINIŢA VALEA MARE",420,"Alegeri Prezidentiale",1,512,263,213,50,0,262,1,560,297,133,129
40,VÂLCEA,"VALEA MARE",174085,BĂTĂŞANI,"ŞCOALA CU CLASELE I-VIII BĂTĂŞANI",421,"Alegeri Prezidentiale",1,400,177,158,19,0,174,3,440,263,81,93
40,VÂLCEA,"VALEA MARE",174085,MĂRGINENI,"ŞCOALA MĂRGINENI",422,"Alegeri Prezidentiale",1,294,151,124,27,0,149,2,320,169,60,89
40,VÂLCEA,"VALEA MARE",174085,DRĂGANU,"CĂMINUL CULTURAL DRĂGANI",423,"Alegeri Prezidentiale",1,430,232,199,33,0,230,2,470,238,85,145
40,VÂLCEA,VLĂDEŞTI,174156,VLĂDEŞTI,"ŞCOALA CU CLASELE I-VIII VLĂDEŞTI",424,"Alegeri Prezidentiale",1,1532,938,837,89,12,909,29,1680,742,496,413
40,VÂLCEA,VLĂDEŞTI,174156,PRIPORU,"ŞCOALA CU CLASELE I-VIII VLĂDEŞTI",425,"Alegeri Prezidentiale",1,1166,741,632,108,1,722,19,1280,539,411,311
40,VÂLCEA,VOICEŞTI,174218,VOICEŞTI,"CĂMIN CULTURAL VOICEŞTI",426,"Alegeri Prezidentiale",1,1252,803,687,116,0,794,9,1370,567,517,277
40,VÂLCEA,VOINEASA,174254,VOINEASA,"LOCALUL PRIMĂRIEI VOINEASA",427,"Alegeri Prezidentiale",1,696,385,316,69,0,374,11,768,383,254,120
40,VÂLCEA,VOINEASA,174254,VOINEŞIŢA,"ŞCOALA CU CLASELE I-VIII VOINEASA",428,"Alegeri Prezidentiale",1,613,373,313,60,0,366,7,670,297,216,150
40,VÂLCEA,ZĂTRENI,174290,ZĂTRENI,"ŞCOALA GIMNAZIALĂ ZĂTRENI",429,"Alegeri Prezidentiale",1,540,243,201,42,0,235,8,590,347,100,135
40,VÂLCEA,ZĂTRENI,174290,STANOMIRU,"ŞCOALA PRIMARĂ STANOMIRU",430,"Alegeri Prezidentiale",1,379,177,148,29,0,173,4,420,243,70,103
40,VÂLCEA,ZĂTRENI,174290,VĂLENI,"ŞCOALA PRIMARĂ VĂLENI",431,"Alegeri Prezidentiale",1,369,172,133,39,0,172,0,392,220,71,101
40,VÂLCEA,ZĂTRENI,174290,"DEALU VĂLENI","ŞCOALA DEALUL VĂLENI",432,"Alegeri Prezidentiale",1,205,117,72,45,0,114,3,230,113,44,70
40,VÂLCEA,ZĂTRENI,174290,SĂŞCIOARA,"ŞCOALA PRIMARĂ SĂSCIOARA",433,"Alegeri Prezidentiale",1,318,174,128,46,0,169,5,340,166,71,98
41,VRANCEA,"MUNICIPIUL FOCŞANI",174744,FOCŞANI,"DIRECTIA SILVICĂ VRANCEA",1,"Alegeri Prezidentiale",1,1408,792,652,140,0,770,22,1600,808,497,273
41,VRANCEA,"MUNICIPIUL FOCŞANI",174744,FOCŞANI,"TEATRUL MUNICIPAL „MAIOR GHEORGHE PASTIA” FOCŞANI",2,"Alegeri Prezidentiale",1,1572,962,827,135,0,934,28,1700,738,640,294
41,VRANCEA,"MUNICIPIUL FOCŞANI",174744,FOCŞANI,"BIBLIOTECA JUDEŢEANĂ ”DUILIU ZAMFIRESCU”",3,"Alegeri Prezidentiale",1,1466,837,751,85,1,816,21,1600,763,518,298
41,VRANCEA,"MUNICIPIUL FOCŞANI",174744,FOCŞANI,"BIBLIOTECA JUDEŢEANĂ ”DUILIU ZAMFIRESCU”",4,"Alegeri Prezidentiale",1,1323,632,580,52,0,619,13,1430,798,425,194
41,VRANCEA,"MUNICIPIUL FOCŞANI",174744,FOCŞANI,"ŞCOALA GIMNAZIALĂ ”ŞTEFAN CEL MARE” - INTRAREA PRINCIPALĂ",5,"Alegeri Prezidentiale",1,1124,612,494,118,0,605,7,1220,608,394,211
41,VRANCEA,"MUNICIPIUL FOCŞANI",174744,FOCŞANI,"ŞCOALA GIMNAZIALĂ ”ŞTEFAN CEL MARE” - INTRAREA ELEVILOR",6,"Alegeri Prezidentiale",1,1186,626,559,67,0,611,15,1300,674,383,228
41,VRANCEA,"MUNICIPIUL FOCŞANI",174744,FOCŞANI,"ŞCOALA GIMNAZIALĂ ”ŞTEFAN CEL MARE” - INTRAREA SECUNDARA",7,"Alegeri Prezidentiale",1,837,489,432,57,0,477,12,900,411,307,170
41,VRANCEA,"MUNICIPIUL FOCŞANI",174744,FOCŞANI,"COLEGIUL TEHNIC AUTO „TRAIAN VUIA”",8,"Alegeri Prezidentiale",1,602,351,315,36,0,344,7,640,289,232,112
41,VRANCEA,"MUNICIPIUL FOCŞANI",174744,FOCŞANI,"COLEGIUL TEHNIC AUTO „TRAIAN VUIA”",9,"Alegeri Prezidentiale",1,1012,517,476,41,0,505,12,1100,583,327,178
41,VRANCEA,"MUNICIPIUL FOCŞANI",174744,FOCŞANI,"COLEGIUL ECONOMIC „MIHAIL KOGĂLNICEANU”",10,"Alegeri Prezidentiale",1,1679,812,759,52,1,795,17,1800,988,558,237
41,VRANCEA,"MUNICIPIUL FOCŞANI",174744,FOCŞANI,"COLEGIUL ECONOMIC „MIHAIL KOGĂLNICEANU”",11,"Alegeri Prezidentiale",1,1657,795,723,72,0,777,18,1800,1005,537,240
41,VRANCEA,"MUNICIPIUL FOCŞANI",174744,FOCŞANI,"COLEGIUL ECONOMIC ”MIHAIL KOGĂLNICEANU”",12,"Alegeri Prezidentiale",1,1549,781,679,102,0,758,23,1660,879,482,276
41,VRANCEA,"MUNICIPIUL FOCŞANI",174744,FOCŞANI,"COLEGIUL ECONOMIC ”MIHAIL KOGĂLNICEANU”",13,"Alegeri Prezidentiale",1,1647,782,694,86,2,758,24,1800,1018,486,272
41,VRANCEA,"MUNICIPIUL FOCŞANI",174744,FOCŞANI,"ŞCOALA GIMNAZIALĂ NR. 7",14,"Alegeri Prezidentiale",1,1255,659,549,110,0,639,20,1350,691,386,253
41,VRANCEA,"MUNICIPIUL FOCŞANI",174744,FOCŞANI,"GRĂDINIŢA CU PROGRAM PRELUNGIT NR. 15",15,"Alegeri Prezidentiale",1,942,498,443,55,0,481,17,1020,522,313,168
41,VRANCEA,"MUNICIPIUL FOCŞANI",174744,FOCŞANI,"GRĂDINIŢA CU PROGRAM PRELUNGIT NR. 15",16,"Alegeri Prezidentiale",1,1770,872,808,64,0,857,15,1900,1028,549,308
41,VRANCEA,"MUNICIPIUL FOCŞANI",174744,FOCŞANI,"LICEUL TEHNOLOGIC ”G.G.LONGINESCU”",17,"Alegeri Prezidentiale",1,1977,1018,859,159,0,994,24,2140,1122,684,310
41,VRANCEA,"MUNICIPIUL FOCŞANI",174744,FOCŞANI,"GRĂDINIȚA CU PROGRAM NORMAL NR. 4 FOCȘANI",18,"Alegeri Prezidentiale",1,1735,859,789,70,0,840,19,1900,1041,565,275
41,VRANCEA,"MUNICIPIUL FOCŞANI",174744,FOCŞANI,"GRĂDINIȚA CU PROGRAM NORMAL NR. 4 FOCȘANI",19,"Alegeri Prezidentiale",1,1564,800,746,40,14,778,22,1680,880,538,240
41,VRANCEA,"MUNICIPIUL FOCŞANI",174744,FOCŞANI,"GRĂDINIŢA CU PROGRAM NORMAL NR. 4 FOCȘANI",20,"Alegeri Prezidentiale",1,1679,816,744,71,1,796,20,1800,984,494,302
41,VRANCEA,"MUNICIPIUL FOCŞANI",174744,FOCŞANI,"COLEGIUL TEHNIC ”VALERIU D. COTEA”",21,"Alegeri Prezidentiale",1,1173,709,529,84,96,694,15,1271,562,409,285
41,VRANCEA,"MUNICIPIUL FOCŞANI",174744,FOCŞANI,"COLEGIUL NAŢIONAL ”AL. I. CUZA”",22,"Alegeri Prezidentiale",1,870,539,386,53,100,522,17,948,409,364,158
41,VRANCEA,"MUNICIPIUL FOCŞANI",174744,FOCŞANI,"ŞCOALA GIMNAZIALĂ ”ANGHEL SALIGNY”",23,"Alegeri Prezidentiale",1,1309,697,614,83,0,677,20,1400,703,466,211
41,VRANCEA,"MUNICIPIUL FOCŞANI",174744,FOCŞANI,"ȘCOALA GIMNAZIALĂ „ANGHEL SALIGNY” INTRAREA SECUNDARĂ",24,"Alegeri Prezidentiale",1,1711,769,735,34,0,752,17,1860,1091,509,243
41,VRANCEA,"MUNICIPIUL FOCŞANI",174744,MÂNDREŞTI-MUNTENI,"CONSILIUL LOCAL AL MUNICIPIULUI FOCŞANI (FOST SEDIU AL ȘCOLII CU CLASELE I-IV MÎNDREȘTI)",25,"Alegeri Prezidentiale",1,1355,799,595,31,173,788,11,1450,651,416,372
41,VRANCEA,"MUNICIPIUL FOCŞANI",174744,FOCŞANI,"COLEGIUL TEHNIC „ION MINCU” FOCȘANI",26,"Alegeri Prezidentiale",1,1035,501,458,43,0,493,8,1120,619,309,184
41,VRANCEA,"MUNICIPIUL FOCŞANI",174744,FOCŞANI,"COLEGIUL TEHNIC „ION MINCU” FOCȘANI",27,"Alegeri Prezidentiale",1,994,509,443,66,0,493,16,1080,571,339,154
41,VRANCEA,"MUNICIPIUL FOCŞANI",174744,FOCŞANI,"GRĂDINIŢA CU PROGRAM PRELUNGIT NR. 16",28,"Alegeri Prezidentiale",1,1354,618,548,70,0,608,10,1470,852,400,208
41,VRANCEA,"MUNICIPIUL FOCŞANI",174744,FOCŞANI,"GRĂDINIŢA CU PROGRAM PRELUNGIT NR. 16",29,"Alegeri Prezidentiale",1,1672,735,663,72,0,717,18,1800,1065,444,273
41,VRANCEA,"MUNICIPIUL FOCŞANI",174744,FOCŞANI,"COLEGIUL NAŢIONAL ”UNIREA”",30,"Alegeri Prezidentiale",1,1165,613,493,76,44,597,16,1250,637,365,232
41,VRANCEA,"MUNICIPIUL FOCŞANI",174744,FOCŞANI,"ȘCOALA GIMANZIALĂ „OANA-DIANA RENEA” FOCȘANI",31,"Alegeri Prezidentiale",1,1193,611,547,63,1,603,8,1300,689,404,199
41,VRANCEA,"MUNICIPIUL FOCŞANI",174744,FOCŞANI,"ȘCOALA GIMANZIALĂ „OANA-DIANA RENEA” FOCȘANI",32,"Alegeri Prezidentiale",1,719,388,309,79,0,380,8,800,412,230,150
41,VRANCEA,"MUNICIPIUL FOCŞANI",174744,FOCŞANI,"AGENŢIA JUDEŢEANĂ PENTRU PLĂŢI ŞI INSPECŢIE SOCIALĂ",33,"Alegeri Prezidentiale",1,1449,689,604,85,0,674,15,1600,911,407,267
41,VRANCEA,"MUNICIPIUL FOCŞANI",174744,FOCŞANI,"COLEGIUL TEHNIC ”EDMOND NICOLAU”",34,"Alegeri Prezidentiale",1,1196,646,547,99,0,627,19,1300,654,404,223
41,VRANCEA,"MUNICIPIUL FOCŞANI",174744,FOCŞANI,"SALA SPORTURILOR",35,"Alegeri Prezidentiale",1,1207,595,558,37,0,579,16,1300,705,346,233
41,VRANCEA,"MUNICIPIUL FOCŞANI",174744,FOCŞANI,"INSPECTORATUL TERITORIAL DE MUNCĂ VRANCEA",36,"Alegeri Prezidentiale",1,1324,728,625,103,0,712,16,1440,712,501,211
41,VRANCEA,"MUNICIPIUL FOCŞANI",174744,FOCŞANI,"DIRECŢIA JUDEŢEANĂ A SPORTURILOR VRANCEA",37,"Alegeri Prezidentiale",1,1457,741,674,67,0,729,12,1600,859,419,310
41,VRANCEA,"MUNICIPIUL FOCŞANI",174744,FOCŞANI,"GRĂDINIȚA CU PROGRAM PRELUNGIT NR. 7 FOCȘANI",38,"Alegeri Prezidentiale",1,894,396,372,24,0,385,11,960,564,249,136
41,VRANCEA,"MUNICIPIUL FOCŞANI",174744,FOCŞANI,"GRĂDINIȚA CU PROGRAM PRELUNGIT NR. 7 FOCȘANI",39,"Alegeri Prezidentiale",1,1411,658,602,56,0,644,14,1520,862,431,213
41,VRANCEA,"MUNICIPIUL FOCŞANI",174744,FOCŞANI,"GRĂDINIȚA CU PROGRAM PRELUNGIT NR. 7 FOCȘANI",40,"Alegeri Prezidentiale",1,1644,774,714,60,0,751,23,1770,996,492,259
41,VRANCEA,"MUNICIPIUL FOCŞANI",174744,FOCŞANI,"COLEGIUL NAȚIONAL PEDAGOGIC „SPIRU HARET” FOCȘANI",41,"Alegeri Prezidentiale",1,1647,866,796,69,1,844,22,1770,904,564,280
41,VRANCEA,"MUNICIPIUL FOCŞANI",174744,FOCŞANI,"GRĂDINIȚA CU PROGRAM PRELUNGIT NR. 18 FOCȘANI",42,"Alegeri Prezidentiale",1,1494,740,698,42,0,727,13,1600,860,486,241
41,VRANCEA,"MUNICIPIUL FOCŞANI",174744,FOCŞANI,"GRĂDINIŢA CU PROGRAM PRELUNGIT NR. 18",43,"Alegeri Prezidentiale",1,1014,590,509,81,0,568,22,1100,510,348,220
41,VRANCEA,"MUNICIPIUL FOCŞANI",174744,FOCŞANI,"COLEGIUL TEHNIC ”ION MINCU” FOCȘANI",44,"Alegeri Prezidentiale",1,895,522,377,59,86,510,12,970,448,296,214
41,VRANCEA,"MUNICIPIUL FOCŞANI",174744,FOCŞANI,"ŞCOALA GIMNAZIALĂ ”NICOLAE IORGA”",45,"Alegeri Prezidentiale",1,1427,647,569,78,0,634,13,1600,953,395,239
41,VRANCEA,"MUNICIPIUL FOCŞANI",174744,FOCŞANI,"ŞCOALA GIMNAZIALĂ ”NICOLAE IORGA”",46,"Alegeri Prezidentiale",1,1488,644,605,39,0,632,12,1600,956,375,257
41,VRANCEA,"MUNICIPIUL FOCŞANI",174744,FOCŞANI,"ŞCOALA GIMNAZIALĂ ”NICOLAE IORGA”",47,"Alegeri Prezidentiale",1,1548,687,618,69,0,673,14,1660,973,391,282
41,VRANCEA,"MUNICIPIUL FOCŞANI",174744,FOCŞANI,"ŞCOALA GIMNAZIALĂ ”ALEXANDRU VLAHUŢĂ”",48,"Alegeri Prezidentiale",1,872,431,387,44,0,414,17,940,509,252,162
41,VRANCEA,"MUNICIPIUL FOCŞANI",174744,FOCŞANI,"ŞCOALA GIMNAZIALĂ ”ALEXANDRU VLAHUŢĂ”",49,"Alegeri Prezidentiale",1,1450,673,621,52,0,663,10,1600,927,394,269
41,VRANCEA,"MUNICIPIUL FOCŞANI",174744,FOCŞANI,"ŞCOALA GIMNAZIALĂ ”ALEXANDRU VLAHUŢĂ”",50,"Alegeri Prezidentiale",1,901,478,422,56,0,469,9,981,503,300,169
41,VRANCEA,"MUNICIPIUL FOCŞANI",174744,FOCŞANI,"GRĂDINIŢA CU PROGRAM PRELUNGIT NR. 13",51,"Alegeri Prezidentiale",1,1671,834,757,77,0,812,22,1800,966,536,276
41,VRANCEA,"MUNICIPIUL FOCŞANI",174744,FOCŞANI,"GRĂDINIŢA CU PROGRAM PRELUNGIT NR. 13",52,"Alegeri Prezidentiale",1,1791,874,798,76,0,848,26,1940,1066,563,285
41,VRANCEA,"MUNICIPIUL FOCŞANI",174744,FOCŞANI,"GRĂDINIŢA CU PROGRAM PRELUNGIT NR. 1",53,"Alegeri Prezidentiale",1,933,470,434,36,0,460,10,1000,530,281,179
41,VRANCEA,"MUNICIPIUL FOCŞANI",174744,FOCŞANI,"ȘCOALA GIMNAZIALĂ „NICOLAE IORGA”",54,"Alegeri Prezidentiale",1,1015,670,631,39,0,644,26,1100,430,442,202
41,VRANCEA,"MUNICIPIUL FOCŞANI",174744,FOCŞANI,"DIRECŢIA SANITAR-VETERINARĂ",55,"Alegeri Prezidentiale",1,1668,965,787,73,105,941,24,1785,820,593,348
41,VRANCEA,"MUNICIPIUL FOCŞANI",174744,FOCŞANI,"GRĂDINIŢA CU PROGRAM PRELUNGIT NR. 8",56,"Alegeri Prezidentiale",1,962,483,438,45,0,469,14,1040,557,313,156
41,VRANCEA,"MUNICIPIUL FOCŞANI",174744,FOCŞANI,"SCOALA GIMNAZIALA „NICOLAE IORGA”",57,"Alegeri Prezidentiale",1,1668,757,712,45,0,746,11,1800,1043,459,287
41,VRANCEA,"MUNICIPIUL FOCŞANI",174744,FOCŞANI,"GRĂDINIŢA CU PROGRAM PRELUNGIT NR. 17",58,"Alegeri Prezidentiale",1,1096,537,487,50,0,527,10,1200,663,303,224
41,VRANCEA,"MUNICIPIUL ADJUD",174860,ADJUD,"CASA DE CULTURĂ ”TUDOR VORNICU”",59,"Alegeri Prezidentiale",1,945,427,361,66,0,422,5,1040,613,234,188
41,VRANCEA,"MUNICIPIUL ADJUD",174860,ADJUD,"SCOALĂ GIMNAZIALĂ ”MIHAIL ARMENCEA”",60,"Alegeri Prezidentiale",1,1053,445,420,25,0,441,4,1200,755,262,179
41,VRANCEA,"MUNICIPIUL ADJUD",174860,ADJUD,"SCOALĂ GIMNAZIALĂ ”MAREȘAL ALEXANDRU AVERESCU”",61,"Alegeri Prezidentiale",1,1332,397,367,30,0,388,9,1470,1073,182,206
41,VRANCEA,"MUNICIPIUL ADJUD",174860,ADJUD,"SCOALĂ GIMNAZIALĂ ”PRINCIPELE RADU” A",62,"Alegeri Prezidentiale",1,1237,475,457,18,0,468,7,1370,895,292,176
41,VRANCEA,"MUNICIPIUL ADJUD",174860,ADJUD,"SCOALĂ GIMNAZIALĂ ”PRINCIPELE RADU” B",63,"Alegeri Prezidentiale",1,1275,510,486,24,0,500,10,1410,900,292,208
41,VRANCEA,"MUNICIPIUL ADJUD",174860,ADJUD,"SCOALĂ GIMNAZIALĂ ”PRINCIPELE RADU” C",64,"Alegeri Prezidentiale",1,1273,506,458,48,0,496,10,1400,894,310,186
41,VRANCEA,"MUNICIPIUL ADJUD",174860,ADJUD,"MIXTCOM SRL ADJUD",65,"Alegeri Prezidentiale",1,1437,604,550,54,0,590,14,1600,996,370,220
41,VRANCEA,"MUNICIPIUL ADJUD",174860,ADJUD,"SALA DE SPORT",66,"Alegeri Prezidentiale",1,1186,609,503,66,40,597,12,1310,701,354,243
41,VRANCEA,"MUNICIPIUL ADJUD",174860,ADJUD,"SCOALĂ GIMNAZIALĂ ”ANGELA GHEORGHIU”",67,"Alegeri Prezidentiale",1,1625,751,651,100,0,731,20,1790,1039,453,278
41,VRANCEA,"MUNICIPIUL ADJUD",174860,ADJUD,"COLEGIUL TEHNIC ”GHEORGHE BALŞ” A",68,"Alegeri Prezidentiale",1,1384,598,543,55,0,584,14,1530,932,344,240
41,VRANCEA,"MUNICIPIUL ADJUD",174860,ADJUD,"COLEGIUL TEHNIC ”GHEORGHE BALŞ” B",69,"Alegeri Prezidentiale",1,1085,378,350,28,0,372,6,1200,822,220,152
41,VRANCEA,"MUNICIPIUL ADJUD",174860,BURCIOAIA,"SCOALĂ PRIMARA BURCIOAIA",70,"Alegeri Prezidentiale",1,457,200,174,26,0,195,5,500,300,130,65
41,VRANCEA,"MUNICIPIUL ADJUD",174860,ŞIŞCANI,"SCOALĂ PRIMARA SISCANI",71,"Alegeri Prezidentiale",1,686,259,242,17,0,257,2,760,501,150,107
41,VRANCEA,"MUNICIPIUL ADJUD",174860,"ADJUDU VECHI","SCOALĂ GENERALA ADJUDU VECHI",72,"Alegeri Prezidentiale",2,1385,523,484,38,1,515,8,1520,997,310,205
41,VRANCEA,"ORAŞ MĂRĂŞEŞTI",174922,MĂRĂŞEŞTI,"SCOALA GIMNAZIALĂ ”ECATERINA TEODOROIU”",73,"Alegeri Prezidentiale",1,1358,599,558,39,2,589,10,1500,901,317,272
41,VRANCEA,"ORAŞ MĂRĂŞEŞTI",174922,MĂRĂŞEŞTI,"SCOALA PRIMARĂ ”SIRETU”",74,"Alegeri Prezidentiale",1,1702,559,540,19,0,549,10,1880,1321,166,383
41,VRANCEA,"ORAŞ MĂRĂŞEŞTI",174922,MĂRĂŞEŞTI,"CLUBUL ELEVILOR",75,"Alegeri Prezidentiale",1,790,331,307,23,1,323,8,870,539,186,137
41,VRANCEA,"ORAŞ MĂRĂŞEŞTI",174922,MĂRĂŞEŞTI,"LICEUL TEHNOLOGIC ”EREMIA GRIGORESCU”",76,"Alegeri Prezidentiale",1,1658,675,640,34,1,660,15,1840,1165,358,302
41,VRANCEA,"ORAŞ MĂRĂŞEŞTI",174922,MĂRĂŞEŞTI,"LICEUL TEHNOLOGIC ”EREMIA GRIGORESCU”",77,"Alegeri Prezidentiale",1,1427,601,543,49,9,595,6,1570,969,340,255
41,VRANCEA,"ORAŞ MĂRĂŞEŞTI",174922,MĂRĂŞEŞTI,"SCOALA GENERALA NR.2",78,"Alegeri Prezidentiale",1,1174,443,414,29,0,437,6,1300,857,247,190
41,VRANCEA,"ORAŞ MĂRĂŞEŞTI",174922,MĂRĂŞEŞTI,"STATIE CFR MARASESTI",79,"Alegeri Prezidentiale",1,285,156,101,55,0,152,4,312,156,75,77
41,VRANCEA,"ORAŞ MĂRĂŞEŞTI",174922,HARET,"ŞCOALA PRIMARĂ HARET",80,"Alegeri Prezidentiale",1,498,253,217,29,7,252,1,550,297,143,109
41,VRANCEA,"ORAŞ MĂRĂŞEŞTI",174922,PĂDURENI,"ŞCOALA PRIMARĂ PĂDURENI",81,"Alegeri Prezidentiale",1,414,191,162,29,0,189,2,450,259,82,107
41,VRANCEA,"ORAŞ MĂRĂŞEŞTI",174922,CĂLIMĂNEŞTI,"ŞCOALA PRIMARĂ CĂLIMĂNEŞTI",82,"Alegeri Prezidentiale",1,452,208,182,26,0,204,4,500,292,101,103
41,VRANCEA,"ORAŞ MĂRĂŞEŞTI",174922,TIŞIŢA,"ŞCOALA PRIMARĂ DOAGA",83,"Alegeri Prezidentiale",1,220,96,75,21,0,96,0,240,144,70,26
41,VRANCEA,"ORAŞ ODOBEŞTI",175019,ODOBEŞTI,"BIBLIOTECA ORASENEASCA ”ANA GEORGESCU”",84,"Alegeri Prezidentiale",1,1539,840,723,117,0,821,19,1700,860,442,379
41,VRANCEA,"ORAŞ ODOBEŞTI",175019,ODOBEŞTI,"LICEUL TEORETIC ”DUILIU ZAMFIRESCU” ODOBESTI",85,"Alegeri Prezidentiale",1,1616,846,748,98,0,817,29,1780,934,434,383
41,VRANCEA,"ORAŞ ODOBEŞTI",175019,ODOBEŞTI,"GRUPUL SCOLAR AGRICOL ODOBESTI",86,"Alegeri Prezidentiale",1,1590,839,789,50,0,833,6,1750,911,430,403
41,VRANCEA,"ORAŞ ODOBEŞTI",175019,ODOBEŞTI,"GRADINITA NR.2 CARAGEA",87,"Alegeri Prezidentiale",1,916,444,396,48,0,438,6,1010,566,274,164
41,VRANCEA,"ORAŞ ODOBEŞTI",175019,UNIREA,"ȘCOALA PRIMARĂ UNIREA ODOBEȘTI",88,"Alegeri Prezidentiale",1,756,345,282,63,0,340,5,830,485,244,96
41,VRANCEA,"ORAŞ ODOBEŞTI",175019,UNIREA,"ȘCOALA PRIMARĂ UNIREA ODOBEȘTI",89,"Alegeri Prezidentiale",1,1416,677,632,45,0,666,11,1550,873,407,259
41,VRANCEA,"ORAŞ PANCIU",175055,PANCIU,"CASA DE CULTURA A ORASULUI PANCIU",90,"Alegeri Prezidentiale",1,1399,594,543,49,2,577,17,1540,946,369,208
41,VRANCEA,"ORAŞ PANCIU",175055,PANCIU,"LICEUL TEHNOLOGIC ”ALEXANDRU IOAN CUZA” PANCIU",91,"Alegeri Prezidentiale",1,1296,641,571,69,1,628,13,1420,779,378,250
41,VRANCEA,"ORAŞ PANCIU",175055,PANCIU,"FOSTUL SEDIU BANCPOST",92,"Alegeri Prezidentiale",1,1014,456,415,41,0,448,8,1120,664,295,153
41,VRANCEA,"ORAŞ PANCIU",175055,PANCIU,"SPITALUL ORASENESC",93,"Alegeri Prezidentiale",1,1167,517,436,68,13,508,9,1290,773,292,216
41,VRANCEA,"ORAŞ PANCIU",175055,"SATU NOU","SCOALA GENERALA SATU-NOU",94,"Alegeri Prezidentiale",1,823,381,343,37,1,375,6,910,529,224,151
41,VRANCEA,"ORAŞ PANCIU",175055,"CRUCEA DE JOS","CLUBUL DE SOCIALIZARE CRUCEA DE JOS",95,"Alegeri Prezidentiale",1,398,232,207,24,1,229,3,440,208,144,85
41,VRANCEA,"ORAŞ PANCIU",175055,DUMBRAVA,"SCOALA GENERALA DUMBRAVA",96,"Alegeri Prezidentiale",2,396,184,167,17,0,179,5,440,256,105,74
41,VRANCEA,"ORAŞ PANCIU",175055,"CRUCEA DE SUS","ȘCOALA GENERALĂ CRUCEA DE SUS",97,"Alegeri Prezidentiale",1,725,361,334,26,1,357,4,800,439,213,144
41,VRANCEA,"ORAŞ PANCIU",175055,NEICU,"CAMINUL CULTURAL NEICU",98,"Alegeri Prezidentiale",1,529,250,221,29,0,246,4,580,330,130,116
41,VRANCEA,"ANDREIAŞU DE JOS",175126,"ANDREIAŞU DE JOS","ȘCOALA GIMNAZIALĂ ANDREIAȘU DE JOS",99,"Alegeri Prezidentiale",1,465,272,226,34,12,266,6,510,238,89,177
41,VRANCEA,"ANDREIAŞU DE JOS",175126,RĂCHITAŞU,"ȘCOALA PRIMARĂ NR.1 RĂCHITAȘU",100,"Alegeri Prezidentiale",1,563,288,263,24,1,285,3,620,332,116,169
41,VRANCEA,"ANDREIAŞU DE JOS",175126,"ANDREIAŞU DE SUS","ȘCOALA GIMNAZIALĂ ANDREIAȘU DE SUS",101,"Alegeri Prezidentiale",1,381,204,188,14,2,200,4,420,216,106,94
41,VRANCEA,BĂLEŞTI,175206,BĂLEŞTI,"SCOALA GIMNAZIALA CU CLASELE I-VIII BALESTI",102,"Alegeri Prezidentiale",1,835,451,357,68,26,444,7,920,469,253,191
41,VRANCEA,BĂLEŞTI,175206,BĂLEŞTI,"SCOALA GIMNAZIALA CU CLASELE I-VIII BALESTI",103,"Alegeri Prezidentiale",1,712,392,330,37,25,383,9,800,408,239,144
41,VRANCEA,BÂRSEŞTI,175224,BÂRSEŞTI,"CAMIN CULTURAL(SALA FESTIVITATI)",104,"Alegeri Prezidentiale",1,1165,622,575,47,0,613,9,1290,668,383,230
41,VRANCEA,BILIEŞTI,178929,BILIEŞTI,"SCOALA GIMNAZIALA BILIESTI",105,"Alegeri Prezidentiale",1,1013,521,422,99,0,509,12,1120,599,358,151
41,VRANCEA,BILIEŞTI,178929,BILIEŞTI,"SCOALA GENERALA NR. 2 BILIESTI",106,"Alegeri Prezidentiale",1,1038,543,470,73,0,538,5,1140,597,399,139
41,VRANCEA,BOGHEŞTI,175260,BOGHEŞTI,PRIMARIE,107,"Alegeri Prezidentiale",1,662,331,268,63,0,329,2,730,399,214,115
41,VRANCEA,BOGHEŞTI,175260,PRISECANI,SCOALA,108,"Alegeri Prezidentiale",1,416,208,167,41,0,206,2,460,252,83,123
41,VRANCEA,BOGHEŞTI,175260,IUGANI,"SCOALA IUGANI",109,"Alegeri Prezidentiale",2,121,79,52,27,0,75,4,130,51,24,51
41,VRANCEA,BOLOTEŞTI,175368,BOLOTEŞTI,"CAMINUL CULTURAL BOLOTESTI",110,"Alegeri Prezidentiale",1,604,320,237,74,9,312,8,670,350,189,123
41,VRANCEA,BOLOTEŞTI,175368,PUTNA,"SCOALA GIMNAZIALA PUTNA",111,"Alegeri Prezidentiale",1,514,322,268,43,11,316,6,570,248,206,110
41,VRANCEA,BOLOTEŞTI,175368,IVĂNCEŞTI,"ŞCOALA PRIMARĂ IVĂNCEŞTI",112,"Alegeri Prezidentiale",1,364,188,144,38,6,185,3,400,212,143,42
41,VRANCEA,BOLOTEŞTI,175368,GĂGEŞTI,"SCOALA GIMNAZIALA GAGESTI",113,"Alegeri Prezidentiale",1,1247,631,561,56,14,617,14,1370,739,417,200
41,VRANCEA,BOLOTEŞTI,175368,GĂGEŞTI,"SCOALA GIMNAZIALA GAGESTI",114,"Alegeri Prezidentiale",1,498,311,251,57,3,309,2,550,239,232,77
41,VRANCEA,BOLOTEŞTI,175368,"VITĂNEŞTII DE SUB MĂGURĂ","SCOALA CU CLASELE I - IV VITANESTII DE SUB MAGURA",115,"Alegeri Prezidentiale",1,589,284,244,37,3,279,5,650,366,197,82
41,VRANCEA,BORDEŞTI,175439,BORDEŞTI,"CAMINUL CULTURAL",116,"Alegeri Prezidentiale",1,994,470,423,39,8,459,11,1100,630,312,147
41,VRANCEA,BORDEŞTI,175439,"BORDEŞTII DE JOS","SCOALA CU CLASELE I-IV",117,"Alegeri Prezidentiale",1,409,218,177,37,4,211,7,450,232,121,90
41,VRANCEA,BROŞTENI,175466,BROŞTENI,"CAMIN CULTURAL",118,"Alegeri Prezidentiale",1,1355,650,582,68,0,638,12,1490,840,417,221
41,VRANCEA,BROŞTENI,175466,ARVA,GRADINITA,119,"Alegeri Prezidentiale",1,517,239,224,15,0,237,2,570,331,155,82
41,VRANCEA,CÂMPINEANCA,174780,CÂMPINEANCA,"SCOALA PRIMARA CIMPINEANCA",120,"Alegeri Prezidentiale",1,1911,963,874,87,2,950,13,2100,1137,562,388
41,VRANCEA,CÂMPINEANCA,174780,CÂMPINEANCA,"SCOALA PRIMARA CIMPINEANCA",121,"Alegeri Prezidentiale",1,1610,913,768,141,4,901,12,1770,857,509,392
41,VRANCEA,CÂMPURI,175670,CÂMPURI,"SCOALA PRIMARA CÎMPURI",122,"Alegeri Prezidentiale",1,814,312,291,21,0,305,7,900,588,162,143
41,VRANCEA,CÂMPURI,175670,CÂMPURI,"ŞCOALA GIMNAZIALA CÎMPURI",123,"Alegeri Prezidentiale",1,898,324,295,29,0,314,10,990,666,182,132
41,VRANCEA,CÂMPURI,175670,"ROTILEŞTII MICI","SCOALA GIMNAZIALA ROTILESTII MICI",124,"Alegeri Prezidentiale",1,530,216,196,20,0,213,3,590,374,99,114
41,VRANCEA,CÂMPURI,175670,FETEŞTI,"SCOALA PRIMARA FETESTI",125,"Alegeri Prezidentiale",1,759,243,213,30,0,241,2,830,587,94,147
41,VRANCEA,CÂRLIGELE,175732,CÂRLIGELE,"CĂMIN CULTURAL",126,"Alegeri Prezidentiale",1,1085,504,434,70,0,499,5,1200,696,242,257
41,VRANCEA,CÂRLIGELE,175732,BLIDARI,"SCOALA BLIDARI",127,"Alegeri Prezidentiale",1,458,227,184,43,0,225,2,510,283,130,95
41,VRANCEA,CÂRLIGELE,175732,BONŢEŞTI,"ȘCOALA GIMNAZIALĂ CU CLASELE I-IV ” EPISCOP MITROFAN ”",128,"Alegeri Prezidentiale",1,379,229,182,47,0,221,8,420,191,98,123
41,VRANCEA,CÂRLIGELE,175732,DĂLHĂUŢ,GRĂDINIȚĂ,129,"Alegeri Prezidentiale",1,567,269,246,23,0,268,1,620,351,124,144
41,VRANCEA,CHIOJDENI,175509,CHIOJDENI,"GRĂDINIȚA CU PROGRAM NORMAL CHIOJDENI",130,"Alegeri Prezidentiale",1,795,358,321,36,1,355,3,880,522,247,108
41,VRANCEA,CHIOJDENI,175509,CĂTĂUŢI,"ȘCOALA PRIMARĂ CĂTĂUȚI",131,"Alegeri Prezidentiale",1,272,128,104,24,0,128,0,300,172,95,33
41,VRANCEA,CHIOJDENI,175509,LUNCILE,"ȘCOALA PRIMARĂ LUNCILE",132,"Alegeri Prezidentiale",1,746,351,337,14,0,343,8,820,469,216,127
41,VRANCEA,CIORĂŞTI,175590,CIORĂŞTI,"CAMIN CULTURAL CIORASTI",133,"Alegeri Prezidentiale",1,701,354,304,50,0,345,9,800,446,226,119
41,VRANCEA,CIORĂŞTI,175590,CODREŞTI,"MAGAZIN SC SAND VAD SRL",134,"Alegeri Prezidentiale",1,174,121,82,39,0,119,2,190,69,71,48
41,VRANCEA,CIORĂŞTI,175590,MIHĂLCENI,"SCOALA PRIMARA MIHALCENI",135,"Alegeri Prezidentiale",1,544,273,213,60,0,269,4,600,327,158,111
41,VRANCEA,CIORĂŞTI,175590,"SALCIA NOUĂ","CAMIN CULTURAL SAT SALCIA NOUA",136,"Alegeri Prezidentiale",1,329,204,164,40,0,204,0,400,196,156,48
41,VRANCEA,CIORĂŞTI,175590,"SALCIA VECHE","SCOALA SALCIA VECHE",137,"Alegeri Prezidentiale",1,233,172,127,45,0,171,1,260,88,127,44
41,VRANCEA,CIORĂŞTI,175590,"SATU NOU","SCOALA SATU NOU",138,"Alegeri Prezidentiale",1,197,149,112,37,0,148,1,220,71,100,48
41,VRANCEA,CIORĂŞTI,175590,CIORĂŞTI,"GRĂDINIŢA CU PROGRAM NORMAL CIORĂŞTI",139,"Alegeri Prezidentiale",1,160,104,67,37,0,103,1,180,76,70,33
41,VRANCEA,CORBIŢA,175787,ŞERBĂNEŞTI,PRIMARIE,140,"Alegeri Prezidentiale",1,339,185,148,37,0,182,3,400,215,91,91
41,VRANCEA,CORBIŢA,175787,BUDA,"SCOALA PRIMARA BUDA",141,"Alegeri Prezidentiale",1,406,202,179,23,0,198,4,450,248,121,77
41,VRANCEA,CORBIŢA,175787,RĂDĂCINEŞTI,"SCOALA RADACINESTI",142,"Alegeri Prezidentiale",1,349,193,150,43,0,192,1,400,207,94,98
41,VRANCEA,CORBIŢA,175787,OCHEŞEŞTI,"SCOALA OCHEŞEŞTI",143,"Alegeri Prezidentiale",1,271,143,131,12,0,142,1,300,157,96,46
41,VRANCEA,COTEŞTI,175885,COTEŞTI,"SCOALA GENERALA COTESTI",144,"Alegeri Prezidentiale",1,1093,515,435,72,8,509,6,1201,686,296,213
41,VRANCEA,COTEŞTI,175885,COTEŞTI,"SCOALA PRIMARA COTESTI",145,"Alegeri Prezidentiale",1,458,203,179,24,0,202,1,500,297,115,87
41,VRANCEA,COTEŞTI,175885,BUDEŞTI,"CAMINUL CULTURAL BUDESTI",146,"Alegeri Prezidentiale",1,1492,692,602,77,13,684,8,1650,958,446,238
41,VRANCEA,COTEŞTI,175885,"VALEA COTEŞTI","SCOALA VALEA COTESTI",147,"Alegeri Prezidentiale",1,589,289,267,22,0,287,2,650,361,184,103
41,VRANCEA,COTEŞTI,175885,"GOLEŞTII DE SUS","GRADINITA GOLESTII DE SUS",148,"Alegeri Prezidentiale",1,347,245,188,53,4,242,3,400,155,126,116
41,VRANCEA,DUMBRĂVENI,175938,DUMBRĂVENI,"CAMIN CULTURAL DUMBRAVENI",149,"Alegeri Prezidentiale",1,1599,799,690,109,0,786,13,1760,961,410,376
41,VRANCEA,DUMBRĂVENI,175938,CÂNDEŞTI,"CĂMINUL CULTURAL CÂNDEȘTI",150,"Alegeri Prezidentiale",2,1154,553,465,85,3,545,8,1262,709,330,215
41,VRANCEA,DUMBRĂVENI,175938,DRAGOSLOVENI,"ȘCOALA PRIMARĂ ALEXANDRU VLAHUȚĂ DRAGOSLOVENI",151,"Alegeri Prezidentiale",1,904,396,360,33,3,390,6,990,594,225,165
41,VRANCEA,DUMITREŞTI,175983,DUMITREŞTI,"LICEUL TEORETIC ”GRIGORE GHEBA” DUMITREȘTI",152,"Alegeri Prezidentiale",1,607,344,292,51,1,335,9,670,326,193,142
41,VRANCEA,DUMITREŞTI,175983,"DUMITREŞTII DE SUS","ȘCOALA PRIMARĂ DUMITREȘTII DE SUS",153,"Alegeri Prezidentiale",1,221,163,133,30,0,162,1,240,77,79,83
41,VRANCEA,DUMITREŞTI,175983,MOTNĂU,"ȘCOALA PRIMARĂ MOTNĂU",154,"Alegeri Prezidentiale",1,281,158,145,13,0,158,0,310,152,65,93
41,VRANCEA,DUMITREŞTI,175983,TRESTIA,"ȘCOALA PRIMARĂ TRESTIA",155,"Alegeri Prezidentiale",1,127,79,69,10,0,78,1,140,61,37,41
41,VRANCEA,DUMITREŞTI,175983,TINOASA,"ȘCOALA PRIMARĂ TINOASA",156,"Alegeri Prezidentiale",1,142,102,93,9,0,102,0,160,58,55,47
41,VRANCEA,DUMITREŞTI,175983,LĂSTUNI,"ȘCOALA GIMNAZIALĂ LĂSTUNI",157,"Alegeri Prezidentiale",1,262,139,120,19,0,136,3,290,151,46,90
41,VRANCEA,DUMITREŞTI,175983,POIENIŢA,"ȘCOALA PRIMARĂ POIENIȚA",158,"Alegeri Prezidentiale",1,185,133,122,11,0,132,1,200,67,63,69
41,VRANCEA,DUMITREŞTI,175983,DUMITREŞTII-FAŢĂ,"ȘCOALA PRIMARĂ DUMITREȘTII - FAȚĂ",159,"Alegeri Prezidentiale",1,170,107,88,19,0,107,0,190,83,30,77
41,VRANCEA,DUMITREŞTI,175983,"BICEŞTII DE SUS","ȘCOALA PRIMARĂ BICEȘTII DE SUS",160,"Alegeri Prezidentiale",1,589,345,309,36,0,336,9,650,305,175,161
41,VRANCEA,DUMITREŞTI,175983,GĂLOIEŞTI,"ȘCOALA PRIMARĂ GĂLOIEȘTI",161,"Alegeri Prezidentiale",1,476,237,218,19,0,235,2,530,293,92,143
41,VRANCEA,DUMITREŞTI,175983,"BICEŞTII DE JOS","ȘCOALA PRIMARĂ BICEȘTII DE JOS",162,"Alegeri Prezidentiale",1,530,269,242,27,0,263,6,590,321,154,109
41,VRANCEA,FITIONEŞTI,176150,FITIONEŞTI,"ȘCOALA GIMNAZIALĂ FITIONEȘTI",163,"Alegeri Prezidentiale",1,684,320,288,32,0,317,3,750,430,155,162
41,VRANCEA,FITIONEŞTI,176150,FITIONEŞTI,"SCOALA CU CLASELE I-IV PISC",164,"Alegeri Prezidentiale",1,545,263,248,15,0,259,4,600,337,155,104
41,VRANCEA,FITIONEŞTI,176150,GHIMICEŞTI,"GRADINITA GHIMICESTI",165,"Alegeri Prezidentiale",1,327,190,146,44,0,188,2,360,170,110,78
41,VRANCEA,FITIONEŞTI,176150,MĂNĂSTIOARA,"SCOALA I-IV MANASTIOARA",166,"Alegeri Prezidentiale",1,486,220,205,15,0,215,5,540,320,129,86
41,VRANCEA,FITIONEŞTI,176150,MĂNĂSTIOARA,"CENTRUL DE ZI SOCIO-EDUCATIONAL MULTIFUNCTIONAL COMUNA FITIONESTI",167,"Alegeri Prezidentiale",1,131,89,51,38,0,87,2,150,61,59,28
41,VRANCEA,GAROAFA,176212,GAROAFA,"CAMINUL CULTURAL",168,"Alegeri Prezidentiale",1,1602,713,622,91,0,695,18,1770,1057,500,195
41,VRANCEA,GAROAFA,176212,BIZIGHEŞTI,"ŞCOALA PRIMARĂ",169,"Alegeri Prezidentiale",1,588,280,255,25,0,277,3,650,370,164,113
41,VRANCEA,GAROAFA,176212,DOAGA,ŞCOALA,170,"Alegeri Prezidentiale",1,369,173,149,24,0,172,1,400,227,112,60
41,VRANCEA,GAROAFA,176212,CIUŞLEA,"ŞCOALA GIMNAZIALĂ ”PETRACHE BLÎNDU”",171,"Alegeri Prezidentiale",1,1319,594,501,93,0,585,9,1450,856,415,170
41,VRANCEA,GOLEŞTI,174824,GOLEŞTI,"ŞCOALA GIMNAZIALĂ GOLEŞTI",172,"Alegeri Prezidentiale",1,1389,767,645,122,0,752,15,1530,763,455,297
41,VRANCEA,GOLEŞTI,174824,GOLEŞTI,"CĂMIN CULTURAL GOLEŞTI",173,"Alegeri Prezidentiale",1,1910,979,905,74,0,959,20,2110,1131,616,343
41,VRANCEA,GOLEŞTI,174824,CEARDAC,"GRĂDINIŢA GOLEŞTI",174,"Alegeri Prezidentiale",1,544,291,264,27,0,282,9,600,309,172,110
41,VRANCEA,GOLOGANU,178938,GOLOGANU,"GRĂDINIȚA CU PROGRAM NORMAL GOLOGANU",175,"Alegeri Prezidentiale",1,1177,539,491,41,7,530,9,1300,761,277,253
41,VRANCEA,GOLOGANU,178938,GOLOGANU,"ȘCOALA GIMNAZIALĂ ”PROF. GENERAL GHEORGHE GHEORGHIU” GOLOGANU",176,"Alegeri Prezidentiale",1,1424,733,675,57,1,721,12,1570,837,378,343
41,VRANCEA,GUGEŞTI,176301,GUGEŞTI,"CĂMINUL CULTURAL „NICOLAE CIORĂSCU” GUGEŞTI",177,"Alegeri Prezidentiale",1,1631,710,653,48,9,702,8,1790,1080,389,313
41,VRANCEA,GUGEŞTI,176301,GUGEŞTI,"ŞCOALA GIMNAZIALĂ NR.2 GUGEŞTI",178,"Alegeri Prezidentiale",1,1465,722,670,45,7,718,4,1610,888,372,346
41,VRANCEA,GUGEŞTI,176301,GUGEŞTI,"GRĂDINIȚA CU PROGRAM NORMAL NR.3 GUGEŞTI",179,"Alegeri Prezidentiale",1,887,450,415,35,0,440,10,980,530,212,228
41,VRANCEA,GUGEŞTI,176301,GUGEŞTI,"ŞCOALA GIMNAZIALĂ ”ALEXANDRU VLAHUȚĂ” GUGEŞTI",180,"Alegeri Prezidentiale",1,1014,442,420,18,4,431,11,1120,678,227,204
41,VRANCEA,GUGEŞTI,176301,OREAVU,"ŞCOALA GIMNAZIALĂ NR.4 OREAVU",181,"Alegeri Prezidentiale",1,434,226,186,38,2,224,2,480,254,136,88
41,VRANCEA,"GURA CALIŢEI",176338,"GURA CALIŢEI","ȘCOALA GIMNAZIALĂ GURA CALIȚEI",182,"Alegeri Prezidentiale",1,822,363,314,47,2,356,7,900,537,260,96
41,VRANCEA,"GURA CALIŢEI",176338,"LACU LUI BABAN","ȘCOALA PRIMARĂ ”NICOLAE V. BĂLAN” LACU LUI BABAN",183,"Alegeri Prezidentiale",1,366,130,110,20,0,129,1,390,260,81,48
41,VRANCEA,"GURA CALIŢEI",176338,POENILE,"SCOALA GENERALA POIENILE",184,"Alegeri Prezidentiale",1,308,122,108,14,0,122,0,340,218,76,46
41,VRANCEA,"GURA CALIŢEI",176338,PLOPU,"ȘCOALA PRIMARĂ PLOPU",185,"Alegeri Prezidentiale",2,282,120,108,12,0,119,1,310,190,77,42
41,VRANCEA,"GURA CALIŢEI",176338,"DEALU LUNG","ȘCOALA PRIMARĂ DEALU LUNG",186,"Alegeri Prezidentiale",1,330,139,129,10,0,138,1,400,261,80,58
41,VRANCEA,HOMOCEA,176445,HOMOCEA,"CAMINUL CULTURAL",187,"Alegeri Prezidentiale",1,1598,374,336,38,0,365,9,1750,1376,236,129
41,VRANCEA,HOMOCEA,176445,LESPEZI,"CAMINUL CULTURAL",188,"Alegeri Prezidentiale",1,1024,406,360,46,0,405,1,1130,724,236,169
41,VRANCEA,HOMOCEA,176445,COSTIŞA,"SCOALA CU CLASELE I-IV",189,"Alegeri Prezidentiale",1,296,137,117,20,0,135,2,330,193,104,31
41,VRANCEA,HOMOCEA,176445,HOMOCEA,"GRADINITA NR. 1 CENTRU HOMOCEA",190,"Alegeri Prezidentiale",1,1686,401,381,20,0,396,5,1850,1449,256,140
41,VRANCEA,HOMOCEA,176445,HOMOCEA,"SCOALA CU CLASELE I-VIII",191,"Alegeri Prezidentiale",1,1261,383,354,28,1,377,6,1390,1007,256,121
41,VRANCEA,JARIŞTEA,176506,JARIŞTEA,"SCOALA GIMNAZIALA JARISTEA",192,"Alegeri Prezidentiale",1,1673,792,686,106,0,785,7,1850,1058,551,234
41,VRANCEA,JARIŞTEA,176506,JARIŞTEA,"SCOALA PRIMARA NR 2 MARGINEA",193,"Alegeri Prezidentiale",1,720,362,302,60,0,359,3,800,438,238,121
41,VRANCEA,JARIŞTEA,176506,VĂRSĂTURA,"SCOALA PRIMARA VARSATURA",194,"Alegeri Prezidentiale",1,472,227,186,41,0,223,4,520,293,168,55
41,VRANCEA,JARIŞTEA,176506,PĂDURENI,"SCOALA PRIMARA PADURENI",195,"Alegeri Prezidentiale",1,388,205,165,40,0,205,0,430,225,153,52
41,VRANCEA,JARIŞTEA,176506,SCÂNTEIA,"SCOALA PRIMARA SCINTEIA",196,"Alegeri Prezidentiale",1,170,104,85,19,0,104,0,190,86,68,36
41,VRANCEA,JITIA,176551,JITIA,"SCOALA CU CLASELE I-IV JITIA",197,"Alegeri Prezidentiale",1,792,373,333,40,0,368,5,880,507,228,140
41,VRANCEA,JITIA,176551,"JITIA DE JOS","SCOALA CU CLASELE I-IV JITIA DE JOS NR.1",198,"Alegeri Prezidentiale",1,324,150,134,15,1,149,1,360,210,44,105
41,VRANCEA,JITIA,176551,"DEALU SĂRII","SCOALA CU CLASELE I-IV DEALU SARII",199,"Alegeri Prezidentiale",1,155,109,88,21,0,109,0,170,61,51,58
41,VRANCEA,MĂICĂNEŞTI,176613,MĂICĂNEŞTI,"SCOALA GIMNAZIALA MAICANESTI",200,"Alegeri Prezidentiale",1,1173,477,418,51,8,471,6,1290,813,258,213
41,VRANCEA,MĂICĂNEŞTI,176613,TĂTARU,"SCOALA GENERALA TATARU",201,"Alegeri Prezidentiale",1,664,324,281,43,0,319,5,730,406,201,118
41,VRANCEA,MĂICĂNEŞTI,176613,RÂMNICENI,"SCOALA GIMNAZIALA RIMNICENI",202,"Alegeri Prezidentiale",1,1246,574,516,58,0,572,2,1380,806,266,306
41,VRANCEA,MĂICĂNEŞTI,176613,"SLOBOZIA BOTEŞTI","SCOALA GENERALA SLOBOZIA-BOTESTI",203,"Alegeri Prezidentiale",1,227,134,105,29,0,134,0,250,116,55,79
41,VRANCEA,MĂICĂNEŞTI,176613,"SLOBOZIA BOTEŞTI","SCOALA GENERALA SATU-NOU",204,"Alegeri Prezidentiale",1,226,113,85,28,0,112,1,250,137,44,68
41,VRANCEA,MĂICĂNEŞTI,176613,STUPINA,"GRADINITA CU PROGRAM NORMAL STUPINA",205,"Alegeri Prezidentiale",1,291,177,154,23,0,174,3,320,143,98,76
41,VRANCEA,MERA,176686,MERA,"CĂMINUL CULTURAL ”DIMITRIE CANTEMIR”",206,"Alegeri Prezidentiale",1,1616,758,676,54,28,753,5,1790,1032,257,496
41,VRANCEA,MERA,176686,VULCĂNEASA,"SCOALA VULCANEASA",207,"Alegeri Prezidentiale",1,1623,755,693,30,32,747,8,1790,1035,387,360
41,VRANCEA,MILCOVUL,176748,MILCOVUL,"ȘCOALA GIMNAZIALĂ MILCOVUL",208,"Alegeri Prezidentiale",1,1079,604,540,56,8,598,6,1200,596,365,233
41,VRANCEA,MILCOVUL,176748,MILCOVUL,"ȘCOALA GIMNAZIALĂ MILCOVUL",209,"Alegeri Prezidentiale",1,1087,621,549,67,5,604,17,1200,579,346,258
41,VRANCEA,MILCOVUL,176748,LĂMOTEŞTI,"GRĂDINIȚA CU PROGRAM NORMAL LĂMOTEȘTI",210,"Alegeri Prezidentiale",1,856,518,445,63,10,505,13,940,422,335,170
41,VRANCEA,MOVILIŢA,176793,DIOCHEŢI-REDIU,"SCOALA PRIMARA DIOCHETI-REDIU",211,"Alegeri Prezidentiale",1,578,265,235,30,0,264,1,640,375,136,128
41,VRANCEA,MOVILIŢA,176793,MOVILIŢA,"GRADINITA SPERIETI",212,"Alegeri Prezidentiale",1,381,167,140,27,0,165,2,420,253,82,83
41,VRANCEA,MOVILIŢA,176793,MOVILIŢA,"SCOALA NR.2",213,"Alegeri Prezidentiale",1,652,297,269,28,0,289,8,720,423,192,97
41,VRANCEA,MOVILIŢA,176793,MOVILIŢA,"SCOALA NR.1",214,"Alegeri Prezidentiale",1,734,285,248,37,0,279,6,810,525,203,76
41,VRANCEA,MOVILIŢA,176793,TROTUŞANU,"SCOALA PRIMARA TROTUSANU",215,"Alegeri Prezidentiale",1,382,157,146,11,0,154,3,420,263,102,52
41,VRANCEA,MOVILIŢA,176793,FRECĂŢEI,"SCOALA PRIMARA FRECATEI",216,"Alegeri Prezidentiale",1,401,139,124,15,0,137,2,440,301,87,50
41,VRANCEA,NĂNEŞTI,176855,NĂNEŞTI,"CAMIN CULTURAL NANESTI",217,"Alegeri Prezidentiale",1,1062,441,377,62,2,433,8,1200,759,278,155
41,VRANCEA,NĂNEŞTI,176855,"CĂLIENII VECHI","CAMIN CULTURAL CALIENII-VECHI",218,"Alegeri Prezidentiale",1,572,277,210,51,16,275,2,630,353,122,153
41,VRANCEA,NĂNEŞTI,176855,"CĂLIENII NOI","SCOALA CALIENII-NOI",219,"Alegeri Prezidentiale",1,270,156,99,51,6,154,2,300,144,88,66
41,VRANCEA,NĂRUJA,176891,NĂRUJA,"CĂMINUL CULTURAL",220,"Alegeri Prezidentiale",1,1004,547,499,48,0,535,12,1110,563,227,308
41,VRANCEA,NĂRUJA,176891,"PODU NĂRUJEI","ŞCOALA CU CLASELE I-IV",221,"Alegeri Prezidentiale",1,545,273,248,25,0,269,4,600,327,110,159
41,VRANCEA,NEGRILEŞTI,178885,NEGRILEŞTI,"ȘCOALA GIMNAZIALĂ ”DUMITRU PRICOP”",222,"Alegeri Prezidentiale",1,1424,632,585,30,17,622,10,1600,968,251,371
41,VRANCEA,NEREJU,176944,NEREJU,"SCOALA ” DIMITRIE GUSTI” NEREJU",223,"Alegeri Prezidentiale",1,1401,614,595,19,0,605,9,1550,936,354,251
41,VRANCEA,NEREJU,176944,"NEREJU MIC","SCOALA GIMNAZIALA NEREJU-MIC",224,"Alegeri Prezidentiale",1,1482,681,665,16,0,675,6,1630,949,411,264
41,VRANCEA,NEREJU,176944,"NEREJU MIC","INTERNAT SCOLAR",225,"Alegeri Prezidentiale",1,580,252,227,25,0,250,2,640,388,185,65
41,VRANCEA,NISTOREŞTI,177003,BÂTCARI,"ȘCOALA GIMNAZIALĂ NISTOREȘTI",226,"Alegeri Prezidentiale",1,893,419,332,37,50,405,14,990,571,180,225
41,VRANCEA,NISTOREŞTI,177003,VETREŞTI-HERĂSTRĂU,"CĂMINUL CULTURAL",227,"Alegeri Prezidentiale",1,828,423,347,25,51,410,13,920,497,225,185
41,VRANCEA,OBREJIŢA,178947,OBREJIŢA,"SCOALA GIMNAZIALĂ OBREJIŢA",228,"Alegeri Prezidentiale",1,1283,632,556,49,27,625,7,1410,778,289,336
41,VRANCEA,PALTIN,177101,PALTIN,"CAMIN CULTURAL PALTIN",229,"Alegeri Prezidentiale",1,1122,428,407,20,1,422,6,1240,812,216,206
41,VRANCEA,PALTIN,177101,PALTIN,"CAMIN CULTURAL PRAHUDA",230,"Alegeri Prezidentiale",1,457,219,203,16,0,218,1,510,291,112,106
41,VRANCEA,PĂULEŞTI,178910,PĂULEŞTI,"CAMIN CULTURAL PĂULEȘTI",231,"Alegeri Prezidentiale",1,610,263,248,13,2,259,4,670,407,119,140
41,VRANCEA,PĂULEŞTI,178910,PĂULEŞTI,"ŞCOALA CU CLASELE I-IV FUNDATURA",232,"Alegeri Prezidentiale",1,436,194,176,17,1,193,1,480,286,115,78
41,VRANCEA,PĂULEŞTI,178910,HĂULIŞCA,"CĂMINUL CULTURAL HĂULIȘCA",233,"Alegeri Prezidentiale",1,545,281,259,18,4,275,6,600,319,93,182
41,VRANCEA,PĂUNEŞTI,177236,PĂUNEŞTI,"SCOALA PRIMARA SURLEA",234,"Alegeri Prezidentiale",1,1117,377,352,25,0,371,6,1230,853,257,114
41,VRANCEA,PĂUNEŞTI,177236,PĂUNEŞTI,"SCOALA PRIMARA NOVACESTI",235,"Alegeri Prezidentiale",1,1460,546,504,42,0,537,9,1610,1064,380,157
41,VRANCEA,PĂUNEŞTI,177236,PĂUNEŞTI,"SCOALA PRIMARA BOSTANESTI",236,"Alegeri Prezidentiale",1,907,330,306,24,0,326,4,1000,670,206,120
41,VRANCEA,PĂUNEŞTI,177236,VIIŞOARA,"GRADINITA CU PROGRAM NORMAL VIISOARA",237,"Alegeri Prezidentiale",1,796,283,256,27,0,277,6,880,597,180,97
41,VRANCEA,PĂUNEŞTI,177236,PĂUNEŞTI,"CAMIN CULTURAL PAUNESTI",238,"Alegeri Prezidentiale",1,1107,422,350,72,0,418,4,1220,798,273,145
41,VRANCEA,PLOSCUŢENI,178894,PLOSCUŢENI,"SCOALA GENERALA NR.1, CORP A",239,"Alegeri Prezidentiale",1,991,411,352,36,23,408,3,1090,679,200,208
41,VRANCEA,PLOSCUŢENI,178894,PLOSCUŢENI,"SCOALA GENERALA NR.1, CORP B",240,"Alegeri Prezidentiale",1,1131,460,409,24,27,453,7,1250,790,194,259
41,VRANCEA,PLOSCUŢENI,178894,ARGEA,"SCOALA PRIMARA SAT ARGEA",241,"Alegeri Prezidentiale",1,347,133,118,13,2,133,0,400,267,17,116
41,VRANCEA,"POIANA CRISTEI",177263,"POIANA CRISTEI","CAMIN CULTURAL POIANA CRISTEI, PRIMARIA COMUNEI POIANA CRISTEI",242,"Alegeri Prezidentiale",1,940,456,413,43,0,454,2,1040,584,187,267
41,VRANCEA,"POIANA CRISTEI",177263,"PODU LACULUI","SCOALA CU CLASELE I-IV SAT PODU LACULUI, SCOALA COORDONATOARE POIANA CRISTEI",243,"Alegeri Prezidentiale",1,528,282,251,30,1,277,5,580,298,141,136
41,VRANCEA,"POIANA CRISTEI",177263,MAHRIU,"SCOALA CU CLASELE I-IV SAT MAHRIU, SCOALA COORDONATORARE POIANA CRISTEI",244,"Alegeri Prezidentiale",1,307,145,134,11,0,144,1,340,195,74,70
41,VRANCEA,"POIANA CRISTEI",177263,PETREANU,"SCOALA CU CLASELE I-IV SAT PETREANU. SCOALA COORDONATOARE POIANA CRISTEI",245,"Alegeri Prezidentiale",1,124,72,61,11,0,72,0,140,68,19,53
41,VRANCEA,"POIANA CRISTEI",177263,TÂRÂTU,"SCOALA CU CLASELE I-VIII SAT TIRITU, SCOALA COORDONATOARE POIANA CRISTEI",246,"Alegeri Prezidentiale",1,222,108,101,7,0,108,0,250,142,52,56
41,VRANCEA,POPEŞTI,178901,POPEŞTI,"SCOALA GIMNAZIALA PROFESOR DOCTOR GENERAL GHEORGHE V. ZAHARIA",247,"Alegeri Prezidentiale",1,1112,505,420,84,1,490,15,1230,725,333,157
41,VRANCEA,POPEŞTI,178901,POPEŞTI,"GRĂDINIȚA CU PROGRAM NORMAL NR.2 POPEȘTI",248,"Alegeri Prezidentiale",1,909,449,408,41,0,442,7,990,541,302,140
41,VRANCEA,POPEŞTI,178901,TERCHEŞTI,"SCOALA PRIMARA TERCHESTI",249,"Alegeri Prezidentiale",1,493,167,140,26,1,166,1,540,373,89,77
41,VRANCEA,PUFEŞTI,177352,PUFEŞTI,"ŞCOALA GIMNAZIALĂ PUFEŞTI",250,"Alegeri Prezidentiale",1,1300,571,531,40,0,567,4,1430,859,372,195
41,VRANCEA,PUFEŞTI,177352,CIORANI,"GRĂDINIŢA CIORANI",251,"Alegeri Prezidentiale",1,811,355,321,34,0,349,6,890,535,215,134
41,VRANCEA,PUFEŞTI,177352,DOMNEŞTI-TÂRG,"ŞCOALA GIMNAZIALĂ DOMNEŞTI",252,"Alegeri Prezidentiale",1,1236,529,489,38,2,520,9,1360,831,306,214
41,VRANCEA,RĂCOASA,177405,RĂCOASA,"CĂMINUL CULTURAL RĂCOASA",253,"Alegeri Prezidentiale",1,926,395,345,45,5,390,5,1020,625,198,192
41,VRANCEA,RĂCOASA,177405,GOGOIU,"SCOALA PRIMARA GOGOIU",254,"Alegeri Prezidentiale",1,177,78,60,16,2,75,3,200,122,43,32
41,VRANCEA,RĂCOASA,177405,MĂRĂŞTI,"SCOALA PRIMARA MARASTI",255,"Alegeri Prezidentiale",1,419,176,151,25,0,174,2,460,284,100,74
41,VRANCEA,RĂCOASA,177405,VARNIŢA,"SCOALA PRIMARA VARNITA",256,"Alegeri Prezidentiale",1,448,202,172,29,1,197,5,500,298,132,65
41,VRANCEA,RĂCOASA,177405,VERDEA,"SCOALA PRIMARA VERDEA",257,"Alegeri Prezidentiale",1,578,305,280,21,4,301,4,630,325,175,126
41,VRANCEA,RĂSTOACA,178956,RĂSTOACA,"ŞCOALA GIMNAZIALĂ CU CLASELE I-VIII RĂSTOACA",258,"Alegeri Prezidentiale",1,1239,596,522,62,12,588,8,1360,764,401,187
41,VRANCEA,RĂSTOACA,178956,RĂSTOACA,"ŞCOALA GIMNAZIALĂ CU CLASELE I-VIII RĂSTOACA",259,"Alegeri Prezidentiale",1,851,408,363,38,7,396,12,940,532,271,125
41,VRANCEA,REGHIU,177469,ŞINDRILARI,"SCOALA GIMNAZIALA SINDRILARI NR. 1",260,"Alegeri Prezidentiale",1,953,514,478,36,0,512,2,1060,546,237,275
41,VRANCEA,REGHIU,177469,REGHIU,"SCOALA PRIMARA REGHIU",261,"Alegeri Prezidentiale",1,525,271,234,37,0,265,6,580,309,145,120
41,VRANCEA,REGHIU,177469,RĂIUŢI,"ȘCOALA PRIMARĂ RĂIUȚI",262,"Alegeri Prezidentiale",1,275,146,135,11,0,145,1,300,154,83,62
41,VRANCEA,RUGINEŞTI,177557,RUGINEŞTI,"GRĂDINIȚA CU PROGRAM NORMAL RUGINEȘTI",263,"Alegeri Prezidentiale",1,796,320,278,39,3,313,7,880,560,187,126
41,VRANCEA,RUGINEŞTI,177557,RUGINEŞTI,"GRĂDINIȚA CU PROGRAM NORMAL RUGINEȘTI",264,"Alegeri Prezidentiale",1,774,317,280,36,1,309,8,850,533,177,132
41,VRANCEA,RUGINEŞTI,177557,ANGHELEŞTI,"GRĂDINIȚA CU PROGRAM NORMAL ANGHELEȘTI",265,"Alegeri Prezidentiale",1,1010,448,391,57,0,444,4,1110,662,281,163
41,VRANCEA,RUGINEŞTI,177557,COPĂCEŞTI,"SCOALA GENERALA",266,"Alegeri Prezidentiale",1,573,269,241,26,2,257,12,630,361,128,129
41,VRANCEA,RUGINEŞTI,177557,VĂLENI,"SCOALA GENERALA",267,"Alegeri Prezidentiale",1,260,126,104,22,0,126,0,290,164,64,62
41,VRANCEA,SIHLEA,177600,SIHLEA,"PRIMARIA COMUNEI SIHLEA",268,"Alegeri Prezidentiale",1,1891,659,590,68,1,641,18,2090,1431,330,311
41,VRANCEA,SIHLEA,177600,CĂIATA,"SCOALA CĂIATA",269,"Alegeri Prezidentiale",1,582,241,205,36,0,238,3,640,399,135,103
41,VRANCEA,SIHLEA,177600,BOGZA,"GRADINIŢA BOGZA",270,"Alegeri Prezidentiale",1,714,257,207,50,0,257,0,800,543,90,167
41,VRANCEA,SIHLEA,177600,VOETIN,"SCOALA VOETIN",271,"Alegeri Prezidentiale",1,894,325,255,64,6,322,3,990,665,147,175
41,VRANCEA,"SLOBOZIA BRADULUI",177655,"SLOBOZIA BRADULUI","ŞCOALA GIMNAZIALĂ SLOBOZIA BRADULUI SALA A",272,"Alegeri Prezidentiale",1,685,303,278,25,0,298,5,750,447,96,202
41,VRANCEA,"SLOBOZIA BRADULUI",177655,"SLOBOZIA BRADULUI","ŞCOALA GIMNAZIALĂ SLOBOZIA BRADULUI SALA B",273,"Alegeri Prezidentiale",1,779,355,332,23,0,352,3,860,505,114,238
41,VRANCEA,"SLOBOZIA BRADULUI",177655,"SLOBOZIA BRADULUI","ŞCOALA GIMNAZIALĂ SLOBOZIA BRADULUI SALA C",274,"Alegeri Prezidentiale",1,1107,407,387,20,0,404,3,1220,813,116,288
41,VRANCEA,"SLOBOZIA BRADULUI",177655,COROTENI,"ŞCOALA GIMNAZIALĂ COROTENI",275,"Alegeri Prezidentiale",1,761,417,363,54,0,414,3,840,423,282,132
41,VRANCEA,"SLOBOZIA BRADULUI",177655,CORNETU,"ŞCOALA PRIMARĂ CORNETU SALA A",276,"Alegeri Prezidentiale",1,507,262,249,13,0,258,4,560,298,89,169
41,VRANCEA,"SLOBOZIA BRADULUI",177655,CORNETU,"ŞCOALA PRIMARĂ CORNETU SALA B",277,"Alegeri Prezidentiale",1,549,273,263,10,0,264,9,600,327,102,162
41,VRANCEA,"SLOBOZIA CIORĂŞTI",177726,"SLOBOZIA CIORĂŞTI","CĂMINUL CULTURAL",278,"Alegeri Prezidentiale",1,1088,553,470,74,9,545,8,1210,657,276,269
41,VRANCEA,"SLOBOZIA CIORĂŞTI",177726,JILIŞTE,"GRĂDINIȚA CU PROGRAM NORMAL JILIȘTE",279,"Alegeri Prezidentiale",1,575,269,229,28,12,264,5,630,361,127,137
41,VRANCEA,SOVEJA,177762,DRAGOSLOVENI,"SCOALA GENERAL[ SIMION MEHEDINTI",280,"Alegeri Prezidentiale",1,1057,570,489,78,3,555,15,1160,590,286,269
41,VRANCEA,SOVEJA,177762,RUCĂRENI,"FOSTA SCOALA GENERALA",281,"Alegeri Prezidentiale",1,762,450,387,61,2,435,15,840,390,196,239
41,VRANCEA,SPULBER,178965,SPULBER,"CAMINUL CULTURAL",282,"Alegeri Prezidentiale",1,1011,544,520,24,0,535,9,1120,576,242,293
41,VRANCEA,STRĂOANE,177799,STRĂOANE,"CAMINUL CULTURAL STRAOANE DE JOS",283,"Alegeri Prezidentiale",1,1160,528,487,38,3,520,8,1280,752,262,258
41,VRANCEA,STRĂOANE,177799,STRĂOANE,"CAMINUL CULTURAL STRAOANE DE SUS",284,"Alegeri Prezidentiale",1,703,328,296,32,0,326,2,800,472,189,137
41,VRANCEA,STRĂOANE,177799,REPEDEA,"SCOALA GENERALA REPEDEA",285,"Alegeri Prezidentiale",1,289,130,118,12,0,128,2,320,190,61,67
41,VRANCEA,STRĂOANE,177799,MUNCELU,"CAMIN CULTURAL",286,"Alegeri Prezidentiale",1,796,415,382,33,0,405,10,870,455,198,207
41,VRANCEA,SURAIA,177842,SURAIA,"SCOALA GIMNAZIALA SURAIA",287,"Alegeri Prezidentiale",1,1772,706,651,54,1,699,7,1950,1244,520,179
41,VRANCEA,SURAIA,177842,SURAIA,"GRADINITA NR. 2 SURAIA",288,"Alegeri Prezidentiale",1,1510,551,503,48,0,544,7,1670,1119,377,167
41,VRANCEA,SURAIA,177842,SURAIA,"SCOALA VECHE SURAIA",289,"Alegeri Prezidentiale",1,1576,623,578,42,3,612,11,1740,1117,438,174
41,VRANCEA,TĂNĂSOAIA,177879,TĂNĂSOAIA,"CAMIN CULTURAL",290,"Alegeri Prezidentiale",1,741,432,369,49,14,427,5,820,388,250,177
41,VRANCEA,TĂNĂSOAIA,177879,FELDIOARA,"BIROU ASISTENŢĂ",291,"Alegeri Prezidentiale",1,567,266,222,32,12,264,2,630,364,152,112
41,VRANCEA,TĂNĂSOAIA,177879,TĂNĂSOAIA,"SCOALA GENERALA",292,"Alegeri Prezidentiale",1,199,121,91,20,10,119,2,220,99,53,66
41,VRANCEA,TĂNĂSOAIA,177879,TĂNĂSOAIA,"SCOALA GENERALA",293,"Alegeri Prezidentiale",1,193,138,90,31,17,137,1,210,72,67,70
41,VRANCEA,TĂTĂRANU,177986,TĂTĂRANU,"SCOALA GIMNAZIALA TATARANU",294,"Alegeri Prezidentiale",1,1171,509,427,67,15,505,4,1290,781,282,223
41,VRANCEA,TĂTĂRANU,177986,MĂRTINEŞTI,"FOSTA SCOALA GENERALA MARTINESTI",295,"Alegeri Prezidentiale",1,554,311,243,60,8,307,4,610,299,133,174
41,VRANCEA,TĂTĂRANU,177986,VÂJÂITOAREA,"FOSTA SCOALA PRIMARA VIJIITOAREA",296,"Alegeri Prezidentiale",1,184,127,98,28,1,124,3,210,83,48,76
41,VRANCEA,TĂTĂRANU,177986,"BORDEASCA VECHE","SCOALA GIMNAZIALA NR. 2 BORDEASCA VECHE",297,"Alegeri Prezidentiale",2,636,344,288,49,7,340,4,700,356,156,184
41,VRANCEA,TĂTĂRANU,177986,"BORDEASCA NOUĂ","FOSTA SCOALA GENERALA BORDEASCA NOUA",298,"Alegeri Prezidentiale",1,339,203,150,49,4,202,1,400,197,91,111
41,VRANCEA,TĂTĂRANU,177986,"BORDEASCA VECHE","FOSTA SCOALA GENERALA NR. 1 BORDEASCA VECHE",299,"Alegeri Prezidentiale",1,866,430,368,62,0,422,8,950,520,236,186
41,VRANCEA,TÂMBOEŞTI,178046,TÂMBOEŞTI,PRIMARIE,300,"Alegeri Prezidentiale",1,1048,552,443,77,32,541,11,1150,598,430,111
41,VRANCEA,TÂMBOEŞTI,178046,SLIMNIC,"SCOALA SLIMNIC",301,"Alegeri Prezidentiale",1,1197,679,572,80,27,669,10,1210,531,423,246
41,VRANCEA,TÂMBOEŞTI,178046,TRESTIENI,"SCOALA TRESTIENI",302,"Alegeri Prezidentiale",1,143,166,81,82,3,164,2,260,94,139,25
41,VRANCEA,TULNICI,178117,TULNICI,"CASA OBŞTII TULNICI",303,"Alegeri Prezidentiale",1,1143,552,481,70,1,544,8,1260,708,364,180
41,VRANCEA,TULNICI,178117,TULNICI,"CASA OBŞTII TULNICI",304,"Alegeri Prezidentiale",1,1199,515,468,45,2,504,11,1320,805,334,170
41,VRANCEA,TULNICI,178117,COZA,"ŞCOALA COZA",305,"Alegeri Prezidentiale",1,660,321,298,22,1,317,4,730,409,164,153
41,VRANCEA,TULNICI,178117,LEPŞA,"ŞCOALA LEPŞA",306,"Alegeri Prezidentiale",2,379,275,145,130,0,271,4,424,149,194,77
41,VRANCEA,ŢIFEŞTI,178180,ŢIFEŞTI,"ȘCOALA GIMNAZIALĂ ȚIFEȘTI",307,"Alegeri Prezidentiale",1,848,374,319,55,0,367,7,930,556,259,108
41,VRANCEA,ŢIFEŞTI,178180,BĂTINEŞTI,"ȘCOALA GIMNAZIALĂ BĂTINEȘTI",308,"Alegeri Prezidentiale",1,1317,603,551,52,0,596,7,1450,847,462,134
41,VRANCEA,ŢIFEŞTI,178180,CLIPICEŞTI,"ȘCOALA GIMNAZIALĂ CLIPICEȘTI",309,"Alegeri Prezidentiale",1,682,244,218,26,0,242,2,750,506,144,98
41,VRANCEA,ŢIFEŞTI,178180,OLEŞEŞTI,"ȘCOALA CU CLASELE I-IV OLEȘEȘTI",310,"Alegeri Prezidentiale",1,728,356,310,46,0,353,3,800,444,269,84
41,VRANCEA,ŢIFEŞTI,178180,SÂRBI,"GRĂDINIȚA CU PROGRAM NORNAL SÎRBI",311,"Alegeri Prezidentiale",1,633,268,230,38,0,264,4,700,432,190,74
41,VRANCEA,URECHEŞTI,178279,URECHEŞTI,"CONSILIUL LOCAL URECHEŞTI",312,"Alegeri Prezidentiale",1,1809,881,787,94,0,870,11,2000,1119,638,232
41,VRANCEA,URECHEŞTI,178279,URECHEŞTI,"ŞCOALA PRIMARĂ URECHEŞTI",313,"Alegeri Prezidentiale",1,457,285,227,58,0,280,5,500,215,213,67
41,VRANCEA,"VALEA SĂRII",178313,"VALEA SĂRII","SCOALA GIMNAZIALĂ ” VASILE IFTIMESCU ” VALEA SARII",314,"Alegeri Prezidentiale",1,654,340,294,37,9,339,1,720,380,171,168
41,VRANCEA,"VALEA SĂRII",178313,COLACU,"SALĂ FESTIVITĂŢI",315,"Alegeri Prezidentiale",1,619,293,264,26,3,289,4,680,387,134,155
41,VRANCEA,"VALEA SĂRII",178313,PODURI,"SCOALA GENERALA PODURI",316,"Alegeri Prezidentiale",1,240,133,117,14,2,133,0,260,127,58,75
41,VRANCEA,"VALEA SĂRII",178313,PRISACA,"OBŞTEA PRISACA",317,"Alegeri Prezidentiale",1,155,93,76,15,2,92,1,170,77,26,66
41,VRANCEA,VÂNĂTORI,178607,VÂNĂTORI,"ŞCOALA GIMNAZIALĂ VÎNĂTORI",318,"Alegeri Prezidentiale",1,1175,654,567,86,1,646,8,1290,636,442,204
41,VRANCEA,VÂNĂTORI,178607,JORĂŞTI,"GRĂDINIŢA CU PROGRAM NORMAL JORĂŞTI",319,"Alegeri Prezidentiale",1,1280,600,533,67,0,591,9,1410,810,408,183
41,VRANCEA,VÂNĂTORI,178607,PETREŞTI,"GRĂDINIŢA CU PROGRAM PRELUNGIT PETREŞTI",320,"Alegeri Prezidentiale",1,1231,677,583,94,0,662,15,1350,673,423,239
41,VRANCEA,VÂNĂTORI,178607,"MIRCEŞTII NOI","ŞCOALA GIMNAZIALĂ MIRCEŞTII NOI",321,"Alegeri Prezidentiale",1,761,420,359,61,0,409,11,830,410,243,166
41,VRANCEA,VÂNĂTORI,178607,"MIRCEŞTII VECHI","DISPENSARUL UMAN MIRCEŞTII VECHI",322,"Alegeri Prezidentiale",1,254,147,117,30,0,143,4,280,133,103,40
41,VRANCEA,VÂNĂTORI,178607,"BALTA RAŢEI","ŞCOALA PRIMARĂ BALTA RAŢEI",323,"Alegeri Prezidentiale",1,240,114,93,21,0,113,1,260,146,74,39
41,VRANCEA,VÂNĂTORI,178607,RĂDULEŞTI,"GRĂDINIŢA CU PROGRAM NORMAL RĂDULEŞTI",324,"Alegeri Prezidentiale",1,724,334,287,47,0,331,3,800,466,247,84
41,VRANCEA,VÂRTEŞCOIU,178689,VÂRTEŞCOIU,"CAMIN CULTURAL VIRTESCOIU",325,"Alegeri Prezidentiale",1,1275,522,462,57,3,514,8,1410,888,256,258
41,VRANCEA,VÂRTEŞCOIU,178689,FARAOANELE,"ȘCOALA GIMNAZIALĂ FARAOANELE",326,"Alegeri Prezidentiale",1,1004,496,435,44,17,491,5,1110,614,230,261
41,VRANCEA,VÂRTEŞCOIU,178689,BECIU,"SCOALA BECIU",327,"Alegeri Prezidentiale",1,346,197,153,37,7,195,2,400,203,109,86
41,VRANCEA,VÂRTEŞCOIU,178689,RÂMNICEANCA,"SCOALA PRIMARA RIMNICEANCA",328,"Alegeri Prezidentiale",1,232,131,113,18,0,130,1,250,119,73,57
41,VRANCEA,VIDRA,178377,VIDRA,"SALA DE SPORT VIDRA",329,"Alegeri Prezidentiale",1,1452,700,582,90,28,687,13,1600,900,346,341
41,VRANCEA,VIDRA,178377,VOLOŞCANI,"SCOALA GENERALA",330,"Alegeri Prezidentiale",1,289,116,101,15,0,115,1,320,204,69,46
41,VRANCEA,VIDRA,178377,IREŞTI,"SCOALA GENERALA",331,"Alegeri Prezidentiale",1,743,338,268,58,12,335,3,820,482,213,122
41,VRANCEA,VIDRA,178377,ŞERBEŞTI,"SCOALA GENERALA",332,"Alegeri Prezidentiale",1,474,234,196,24,14,233,1,520,286,161,72
41,VRANCEA,VIDRA,178377,BURCA,"SCOALA GENERALA",333,"Alegeri Prezidentiale",1,656,362,311,47,4,360,2,720,358,171,189
41,VRANCEA,VIDRA,178377,BURCA,"SCOALA GENERALA",334,"Alegeri Prezidentiale",1,710,369,335,32,2,361,8,800,431,181,180
41,VRANCEA,VIDRA,178377,SCAFARI,"SCOALA GENERALA",335,"Alegeri Prezidentiale",1,356,198,174,22,2,194,4,400,202,90,104
41,VRANCEA,VIDRA,178377,TICHIRIŞ,"ȘCOALA GENERALĂ TICHIRIȘ - ȘCOALA NOUĂ",336,"Alegeri Prezidentiale",1,634,329,294,31,4,324,5,700,371,155,169
41,VRANCEA,VIDRA,178377,VIIŞOARA,"SCOALA GENERALA",337,"Alegeri Prezidentiale",1,561,264,248,16,0,259,5,621,357,88,171
41,VRANCEA,VINTILEASCA,178475,VINTILEASCA,"SCOALA GIMNAZIALA „REGINA MARIA” VINTILEASCA",338,"Alegeri Prezidentiale",1,613,259,221,32,6,254,5,680,421,105,149
41,VRANCEA,VINTILEASCA,178475,NECULELE,"GRADINITA „VOINICELUL” NECULELE",339,"Alegeri Prezidentiale",1,388,136,117,18,1,135,1,430,294,60,75
41,VRANCEA,VINTILEASCA,178475,BAHNELE,"SCOALA GIMNAZIALA „ PICTOR MIHAIL BALASESCU” BAHNELE",340,"Alegeri Prezidentiale",1,469,173,159,12,2,170,3,520,347,73,97
41,VRANCEA,VINTILEASCA,178475,"DUPĂ MĂGURA","SCOALA ION CREANGA DUPA MAGURA",341,"Alegeri Prezidentiale",1,72,33,26,7,0,32,1,80,47,21,11
41,VRANCEA,VINTILEASCA,178475,"POIANA STOICHII","STAȚIE DE AȘTEPTARE MICROBUZ",342,"Alegeri Prezidentiale",1,57,33,22,11,0,31,2,60,27,21,10
41,VRANCEA,VIZANTEA-LIVEZI,178545,"VIZANTEA RĂZĂŞEASCĂ","SCOALA DIN VIZANTEA RAZASEASCA",343,"Alegeri Prezidentiale",1,612,269,234,22,13,263,6,670,401,178,85
41,VRANCEA,VIZANTEA-LIVEZI,178545,"VIZANTEA MĂNĂSTIREASCĂ","SCOALA DIN VIZANTEA MANASTIREASCA",344,"Alegeri Prezidentiale",2,1415,494,438,33,23,489,5,1560,1066,372,117
41,VRANCEA,VIZANTEA-LIVEZI,178545,"PISCU RADULUI","SOALA DIN PIISCU-RADULUI",345,"Alegeri Prezidentiale",1,350,154,143,11,0,153,1,400,246,113,40
41,VRANCEA,VIZANTEA-LIVEZI,178545,MESTEACĂNU,"SCOALA DIN MESTEACANU",346,"Alegeri Prezidentiale",1,299,147,132,15,0,145,2,330,183,121,24
41,VRANCEA,VIZANTEA-LIVEZI,178545,LIVEZILE,"SCOALA DIN LIVEZILE",347,"Alegeri Prezidentiale",1,568,267,249,18,0,262,5,630,363,179,83
41,VRANCEA,VRÂNCIOAIA,178750,VRÂNCIOAIA,"CAMIN CULTURAL VRINCIOAIA",348,"Alegeri Prezidentiale",1,497,231,205,18,8,230,1,549,318,117,113
41,VRANCEA,VRÂNCIOAIA,178750,POIANA,"SCOALA PRIMARĂ POIANA - SALA GRADINIȚEI",349,"Alegeri Prezidentiale",1,576,287,231,33,23,284,3,640,353,123,161
41,VRANCEA,VRÂNCIOAIA,178750,SPINEŞTI,"CĂMIN CULTURAL SAT SPINEȘTI",350,"Alegeri Prezidentiale",1,625,251,233,10,8,249,2,690,439,80,169
41,VRANCEA,VRÂNCIOAIA,178750,MUNCEI,"SALA DE FESTIVITĂŢI MUNCEI",351,"Alegeri Prezidentiale",1,573,235,204,13,18,234,1,630,395,67,167
41,VRANCEA,VULTURU,178821,VULTURU,"SCOALA GENERALA VULTURU",352,"Alegeri Prezidentiale",1,1255,487,423,64,0,477,10,1380,893,244,233
41,VRANCEA,VULTURU,178821,VULTURU,"SCOALA GENERALA VULTURU",353,"Alegeri Prezidentiale",1,1274,450,409,39,2,445,5,1400,950,245,200
41,VRANCEA,VULTURU,178821,VULTURU,"GRADINITA NR 1",354,"Alegeri Prezidentiale",1,1268,457,407,48,2,454,3,1400,943,240,214
41,VRANCEA,VULTURU,178821,BOŢÂRLĂU,"SCOALA BOTARLAU",355,"Alegeri Prezidentiale",1,1213,445,390,55,0,439,6,1340,895,267,172
41,VRANCEA,VULTURU,178821,HÂNGULEŞTI,"SCOALA HANGULESTI",356,"Alegeri Prezidentiale",1,959,482,415,66,1,475,7,1050,568,209,266
41,VRANCEA,VULTURU,178821,MALURI,"SCOALA MALURI",357,"Alegeri Prezidentiale",1,463,217,165,52,0,216,1,510,293,107,109
41,VRANCEA,VULTURU,178821,"VADU ROŞCA","SCOALA VADU ROSCA",358,"Alegeri Prezidentiale",1,581,197,183,14,0,194,3,656,459,103,91
42,"MUNICIPIUL BUCUREŞTI - SECTOR 1","MUNICIPIUL BUCUREŞTI",179132,"BUCUREŞTI SECTORUL 1","LICEUL TEORETIC ”NICOLAE IORGA”",1,"Alegeri Prezidentiale",2,1288,952,687,264,1,935,17,1400,448,675,260
42,"MUNICIPIUL BUCUREŞTI - SECTOR 1","MUNICIPIUL BUCUREŞTI",179132,"BUCUREŞTI SECTORUL 1","LICEUL TEORETIC ”NICOLAE IORGA”",2,"Alegeri Prezidentiale",2,1564,1109,880,167,62,1086,23,1600,491,745,341
42,"MUNICIPIUL BUCUREŞTI - SECTOR 1","MUNICIPIUL BUCUREŞTI",179132,"BUCUREŞTI SECTORUL 1","LICEUL TEORETIC ”NICOLAE IORGA”",3,"Alegeri Prezidentiale",1,1352,949,740,162,47,929,20,1500,551,651,278
42,"MUNICIPIUL BUCUREŞTI - SECTOR 1","MUNICIPIUL BUCUREŞTI",179132,"BUCUREŞTI SECTORUL 1","LICEUL TEORETIC ”NICOLAE IORGA”",4,"Alegeri Prezidentiale",2,1065,749,515,157,77,731,18,1200,451,514,217
42,"MUNICIPIUL BUCUREŞTI - SECTOR 1","MUNICIPIUL BUCUREŞTI",179132,"BUCUREŞTI SECTORUL 1","LICEUL GRECO-CATOLIC ”TIMOTEI CIPARIU”",5,"Alegeri Prezidentiale",1,1634,958,845,112,1,941,17,1700,742,656,285
42,"MUNICIPIUL BUCUREŞTI - SECTOR 1","MUNICIPIUL BUCUREŞTI",179132,"BUCUREŞTI SECTORUL 1","LICEUL GRECO-CATOLIC ”TIMOTEI CIPARIU”",6,"Alegeri Prezidentiale",1,1012,627,549,78,0,614,13,1100,473,425,189
42,"MUNICIPIUL BUCUREŞTI - SECTOR 1","MUNICIPIUL BUCUREŞTI",179132,"BUCUREŞTI SECTORUL 1","LICEUL GRECO-CATOLIC ”TIMOTEI CIPARIU”",7,"Alegeri Prezidentiale",1,1290,764,667,96,1,744,20,1300,536,539,205
42,"MUNICIPIUL BUCUREŞTI - SECTOR 1","MUNICIPIUL BUCUREŞTI",179132,"BUCUREŞTI SECTORUL 1","ȘCOALA GIMNAZIALĂ NR.13",8,"Alegeri Prezidentiale",1,962,530,494,36,0,522,8,1000,470,311,211
42,"MUNICIPIUL BUCUREŞTI - SECTOR 1","MUNICIPIUL BUCUREŞTI",179132,"BUCUREŞTI SECTORUL 1","ŞCOALA GIMNAZIALĂ NR.13",9,"Alegeri Prezidentiale",1,1014,566,495,71,0,550,16,1100,534,359,191
42,"MUNICIPIUL BUCUREŞTI - SECTOR 1","MUNICIPIUL BUCUREŞTI",179132,"BUCUREŞTI SECTORUL 1","ŞCOALA GIMNAZIALĂ NR.13",10,"Alegeri Prezidentiale",2,1616,856,727,83,46,845,11,1700,844,532,313
42,"MUNICIPIUL BUCUREŞTI - SECTOR 1","MUNICIPIUL BUCUREŞTI",179132,"BUCUREŞTI SECTORUL 1","ŞCOALA GIMNAZIALĂ NR.13",11,"Alegeri Prezidentiale",1,927,427,381,46,0,413,14,1000,573,257,156
42,"MUNICIPIUL BUCUREŞTI - SECTOR 1","MUNICIPIUL BUCUREŞTI",179132,"BUCUREŞTI SECTORUL 1","ŞCOALA GIMNAZIALĂ NR.179",12,"Alegeri Prezidentiale",1,1399,873,685,188,0,850,23,1500,627,598,252
42,"MUNICIPIUL BUCUREŞTI - SECTOR 1","MUNICIPIUL BUCUREŞTI",179132,"BUCUREŞTI SECTORUL 1","ŞCOALA GIMNAZIALĂ NR.179",13,"Alegeri Prezidentiale",1,1873,1168,1023,101,44,1132,36,1800,632,757,375
42,"MUNICIPIUL BUCUREŞTI - SECTOR 1","MUNICIPIUL BUCUREŞTI",179132,"BUCUREŞTI SECTORUL 1","ŞCOALA GIMNAZIALĂ NR.179",14,"Alegeri Prezidentiale",2,1023,616,561,55,0,604,12,1100,484,418,186
42,"MUNICIPIUL BUCUREŞTI - SECTOR 1","MUNICIPIUL BUCUREŞTI",179132,"BUCUREŞTI SECTORUL 1","ŞCOALA GIMNAZIALĂ NR.179",15,"Alegeri Prezidentiale",1,1765,1036,988,48,0,1009,27,1700,664,694,315
42,"MUNICIPIUL BUCUREŞTI - SECTOR 1","MUNICIPIUL BUCUREŞTI",179132,"BUCUREŞTI SECTORUL 1","LICEUL TEORETIC ”C-TIN BRÂNCOVEANU”",16,"Alegeri Prezidentiale",1,1586,1086,793,293,0,1064,22,1600,514,718,346
42,"MUNICIPIUL BUCUREŞTI - SECTOR 1","MUNICIPIUL BUCUREŞTI",179132,"BUCUREŞTI SECTORUL 1","LICEUL TEORETIC ”C-TIN BRÂNCOVEANU”",17,"Alegeri Prezidentiale",1,913,608,462,146,0,592,16,992,384,378,214
42,"MUNICIPIUL BUCUREŞTI - SECTOR 1","MUNICIPIUL BUCUREŞTI",179132,"BUCUREŞTI SECTORUL 1","LICEUL TEORETIC ”C-TIN BRÂNCOVEANU”",18,"Alegeri Prezidentiale",2,1018,636,540,96,0,617,18,1100,464,438,179
42,"MUNICIPIUL BUCUREŞTI - SECTOR 1","MUNICIPIUL BUCUREŞTI",179132,"BUCUREŞTI SECTORUL 1","LICEUL TEORETIC ”C-TIN BRÂNCOVEANU”",19,"Alegeri Prezidentiale",1,1470,826,777,48,1,803,23,1500,674,515,288
42,"MUNICIPIUL BUCUREŞTI - SECTOR 1","MUNICIPIUL BUCUREŞTI",179132,"BUCUREŞTI SECTORUL 1","ȘCOALA GIMNAZIALĂ NR.178",20,"Alegeri Prezidentiale",3,1393,850,697,153,0,828,22,1600,750,532,296
42,"MUNICIPIUL BUCUREŞTI - SECTOR 1","MUNICIPIUL BUCUREŞTI",179132,"BUCUREŞTI SECTORUL 1","ŞCOALA GIMNAZIALĂ NR.178",21,"Alegeri Prezidentiale",1,1373,832,711,120,1,805,27,1508,676,578,227
42,"MUNICIPIUL BUCUREŞTI - SECTOR 1","MUNICIPIUL BUCUREŞTI",179132,"BUCUREŞTI SECTORUL 1","ŞCOALA GIMNAZIALĂ NR.178",22,"Alegeri Prezidentiale",1,1047,694,564,129,1,676,18,1200,506,452,224
42,"MUNICIPIUL BUCUREŞTI - SECTOR 1","MUNICIPIUL BUCUREŞTI",179132,"BUCUREŞTI SECTORUL 1","ŞCOALA GIMNAZIALĂ SPECIALĂ NR.8",23,"Alegeri Prezidentiale",1,1433,787,653,133,1,764,23,1600,813,538,226
42,"MUNICIPIUL BUCUREŞTI - SECTOR 1","MUNICIPIUL BUCUREŞTI",179132,"BUCUREŞTI SECTORUL 1","ŞCOALA GIMNAZIALĂ SPECIALĂ NR.8",24,"Alegeri Prezidentiale",1,1700,994,867,127,0,976,18,1800,806,706,270
42,"MUNICIPIUL BUCUREŞTI - SECTOR 1","MUNICIPIUL BUCUREŞTI",179132,"BUCUREŞTI SECTORUL 1","ȘCOALA GIMNAZIALĂ SPECIALĂ NR.8",25,"Alegeri Prezidentiale",1,1654,1005,929,76,0,987,18,1800,795,720,267
42,"MUNICIPIUL BUCUREŞTI - SECTOR 1","MUNICIPIUL BUCUREŞTI",179132,"BUCUREŞTI SECTORUL 1","ŞCOALA GIMNAZIALĂ ”NICOLAE GRIGORESCU”",26,"Alegeri Prezidentiale",2,1933,1098,927,171,0,1070,28,1997,899,750,320
42,"MUNICIPIUL BUCUREŞTI - SECTOR 1","MUNICIPIUL BUCUREŞTI",179132,"BUCUREŞTI SECTORUL 1","ŞCOALA GIMNAZIALĂ ”NICOLAE GRIGORESCU”",27,"Alegeri Prezidentiale",1,1955,1126,1038,88,0,1102,24,2000,874,765,337
42,"MUNICIPIUL BUCUREŞTI - SECTOR 1","MUNICIPIUL BUCUREŞTI",179132,"BUCUREŞTI SECTORUL 1","CENTRUL SOCIAL SF. LAZĂR",28,"Alegeri Prezidentiale",2,1632,1033,869,164,0,1010,23,1700,667,717,293
42,"MUNICIPIUL BUCUREŞTI - SECTOR 1","MUNICIPIUL BUCUREŞTI",179132,"BUCUREŞTI SECTORUL 1","CENTRUL SOCIAL SF. LAZĂR",29,"Alegeri Prezidentiale",2,1120,773,630,143,0,763,10,1300,527,600,163
42,"MUNICIPIUL BUCUREŞTI - SECTOR 1","MUNICIPIUL BUCUREŞTI",179132,"BUCUREŞTI SECTORUL 1","CENTRUL SOCIAL SF. LAZĂR",30,"Alegeri Prezidentiale",1,1653,1018,929,89,0,998,20,1700,682,717,281
42,"MUNICIPIUL BUCUREŞTI - SECTOR 1","MUNICIPIUL BUCUREŞTI",179132,"BUCUREŞTI SECTORUL 1","ŞCOALA GIMNAZIALĂ NR.6",31,"Alegeri Prezidentiale",2,958,678,548,115,15,653,24,1100,422,467,186
42,"MUNICIPIUL BUCUREŞTI - SECTOR 1","MUNICIPIUL BUCUREŞTI",179132,"BUCUREŞTI SECTORUL 1","ŞCOALA GIMNAZIALĂ NR.6",32,"Alegeri Prezidentiale",2,1064,702,525,177,0,692,10,1192,490,513,179
42,"MUNICIPIUL BUCUREŞTI - SECTOR 1","MUNICIPIUL BUCUREŞTI",179132,"BUCUREŞTI SECTORUL 1","UNIVERSITATEA DE ȘTIINȚE AGRONOMICE ȘI MEDICINĂ VETERINARĂ BUCUREȘTI",33,"Alegeri Prezidentiale",2,1366,1224,682,491,51,1202,22,1700,476,913,289
42,"MUNICIPIUL BUCUREŞTI - SECTOR 1","MUNICIPIUL BUCUREŞTI",179132,"BUCUREŞTI SECTORUL 1","UNIVERSITATEA DE ŞTIINŢE AGRONOMICE ŞI MEDICINĂ VETERINARĂ BUCUREŞTI",34,"Alegeri Prezidentiale",1,812,1005,389,558,58,977,28,1400,395,768,209
42,"MUNICIPIUL BUCUREŞTI - SECTOR 1","MUNICIPIUL BUCUREŞTI",179132,"BUCUREŞTI SECTORUL 1","DIRECŢIA PUBLICĂ DE EVIDENŢĂ A PERSOANEI ŞI STARE CIVILĂ SECT.1",35,"Alegeri Prezidentiale",1,1127,649,558,90,1,635,14,1200,551,467,168
42,"MUNICIPIUL BUCUREŞTI - SECTOR 1","MUNICIPIUL BUCUREŞTI",179132,"BUCUREŞTI SECTORUL 1","ŞCOALA GIMNAZIALĂ NR.7",36,"Alegeri Prezidentiale",1,1290,922,670,252,0,900,22,1400,478,624,276
42,"MUNICIPIUL BUCUREŞTI - SECTOR 1","MUNICIPIUL BUCUREŞTI",179132,"BUCUREŞTI SECTORUL 1","ŞCOALA GIMNAZIALĂ NR.7",37,"Alegeri Prezidentiale",1,1490,877,780,96,1,852,25,1600,723,588,264
42,"MUNICIPIUL BUCUREŞTI - SECTOR 1","MUNICIPIUL BUCUREŞTI",179132,"BUCUREŞTI SECTORUL 1","ŞCOALA GIMNAZIALĂ NR.7",38,"Alegeri Prezidentiale",2,1415,874,799,75,0,847,27,1600,726,601,246
42,"MUNICIPIUL BUCUREŞTI - SECTOR 1","MUNICIPIUL BUCUREŞTI",179132,"BUCUREŞTI SECTORUL 1","COLEGIUL AGRICOL ”VIACESLAV HARNAJ”",39,"Alegeri Prezidentiale",1,1439,935,758,177,0,905,30,1592,657,653,252
42,"MUNICIPIUL BUCUREŞTI - SECTOR 1","MUNICIPIUL BUCUREŞTI",179132,"BUCUREŞTI SECTORUL 1","COLEGIUL AGRICOL ”VIACESLAV HARNAJ”",40,"Alegeri Prezidentiale",1,1404,751,639,112,0,735,16,1500,749,571,164
42,"MUNICIPIUL BUCUREŞTI - SECTOR 1","MUNICIPIUL BUCUREŞTI",179132,"BUCUREŞTI SECTORUL 1","ŞCOALA GIMNAZIALĂ ”HERĂSTRĂU”",41,"Alegeri Prezidentiale",1,1748,1330,914,411,5,1303,27,1692,362,979,324
42,"MUNICIPIUL BUCUREŞTI - SECTOR 1","MUNICIPIUL BUCUREŞTI",179132,"BUCUREŞTI SECTORUL 1","ŞCOALA GIMNAZIALĂ ”HERĂSTRĂU”",42,"Alegeri Prezidentiale",2,942,748,538,210,0,731,17,1000,252,531,200
42,"MUNICIPIUL BUCUREŞTI - SECTOR 1","MUNICIPIUL BUCUREŞTI",179132,"BUCUREŞTI SECTORUL 1","ŞCOALA GIMNAZIALĂ ”HERĂSTRĂU”",43,"Alegeri Prezidentiale",2,1321,811,746,65,0,788,23,1400,589,552,236
42,"MUNICIPIUL BUCUREŞTI - SECTOR 1","MUNICIPIUL BUCUREŞTI",179132,"BUCUREŞTI SECTORUL 1","ŞCOALA GIMNAZIALĂ ”HERĂSTRĂU”",44,"Alegeri Prezidentiale",1,1448,851,788,62,1,833,18,1500,649,597,236
42,"MUNICIPIUL BUCUREŞTI - SECTOR 1","MUNICIPIUL BUCUREŞTI",179132,"BUCUREŞTI SECTORUL 1","ŞCOALA GIMNAZIALĂ ”HERĂSTRĂU”",45,"Alegeri Prezidentiale",1,1541,992,818,174,0,975,17,1600,608,662,313
42,"MUNICIPIUL BUCUREŞTI - SECTOR 1","MUNICIPIUL BUCUREŞTI",179132,"BUCUREŞTI SECTORUL 1","ŞCOALA GIMNAZIALĂ ”HERĂSTRĂU”",46,"Alegeri Prezidentiale",1,802,677,467,209,1,659,18,900,223,501,158
42,"MUNICIPIUL BUCUREŞTI - SECTOR 1","MUNICIPIUL BUCUREŞTI",179132,"BUCUREŞTI SECTORUL 1","ŞCOALA GIMNAZIALĂ ”HERĂSTRĂU”",47,"Alegeri Prezidentiale",1,973,626,497,129,0,618,8,1100,474,467,151
42,"MUNICIPIUL BUCUREŞTI - SECTOR 1","MUNICIPIUL BUCUREŞTI",179132,"BUCUREŞTI SECTORUL 1","ŞCOALA GIMNAZIALĂ ”HERĂSTRĂU”",48,"Alegeri Prezidentiale",1,1442,856,771,85,0,838,18,1499,643,609,229
42,"MUNICIPIUL BUCUREŞTI - SECTOR 1","MUNICIPIUL BUCUREŞTI",179132,"BUCUREŞTI SECTORUL 1","ŞCOALA GIMNAZIALĂ ”HERĂSTRĂU”",49,"Alegeri Prezidentiale",1,1338,867,772,95,0,844,23,1500,633,648,196
42,"MUNICIPIUL BUCUREŞTI - SECTOR 1","MUNICIPIUL BUCUREŞTI",179132,"BUCUREŞTI SECTORUL 1","ŞCOALA GIMNAZIALĂ ”HERĂSTRĂU”",50,"Alegeri Prezidentiale",1,1210,710,659,51,0,696,14,1300,590,532,164
42,"MUNICIPIUL BUCUREŞTI - SECTOR 1","MUNICIPIUL BUCUREŞTI",179132,"BUCUREŞTI SECTORUL 1","ŞCOALA GIMNAZIALĂ ”HERĂSTRĂU”",51,"Alegeri Prezidentiale",1,1227,718,666,52,0,701,17,1292,574,478,223
42,"MUNICIPIUL BUCUREŞTI - SECTOR 1","MUNICIPIUL BUCUREŞTI",179132,"BUCUREŞTI SECTORUL 1","ŞCOALA GIMNAZIALĂ ”HERĂSTRĂU”",52,"Alegeri Prezidentiale",1,1146,653,604,49,0,628,25,1300,647,435,193
42,"MUNICIPIUL BUCUREŞTI - SECTOR 1","MUNICIPIUL BUCUREŞTI",179132,"BUCUREŞTI SECTORUL 1","ŞCOALA GIMNAZIALĂ ”PIA BRĂTIANU”",53,"Alegeri Prezidentiale",2,1247,780,664,115,1,765,15,1400,620,549,216
42,"MUNICIPIUL BUCUREŞTI - SECTOR 1","MUNICIPIUL BUCUREŞTI",179132,"BUCUREŞTI SECTORUL 1","ŞCOALA GIMNAZIALĂ ”PIA BRĂTIANU”",54,"Alegeri Prezidentiale",1,1221,735,610,125,0,721,14,1300,565,534,187
42,"MUNICIPIUL BUCUREŞTI - SECTOR 1","MUNICIPIUL BUCUREŞTI",179132,"BUCUREŞTI SECTORUL 1","COMPLEXUL SOCIAL DE SERVICII ”ODĂI”",55,"Alegeri Prezidentiale",1,763,540,418,71,51,527,13,1000,460,250,277
42,"MUNICIPIUL BUCUREŞTI - SECTOR 1","MUNICIPIUL BUCUREŞTI",179132,"BUCUREŞTI SECTORUL 1","COLEGIUL NAŢIONAL DE INFORMATICĂ ”TUDOR VIANU”",56,"Alegeri Prezidentiale",1,1142,788,615,121,52,768,20,1300,512,543,225
42,"MUNICIPIUL BUCUREŞTI - SECTOR 1","MUNICIPIUL BUCUREŞTI",179132,"BUCUREŞTI SECTORUL 1","COLEGIUL NAŢIONAL DE INFORMATICĂ ”TUDOR VIANU”",57,"Alegeri Prezidentiale",1,1349,1103,779,164,160,1078,25,1492,389,761,317
42,"MUNICIPIUL BUCUREŞTI - SECTOR 1","MUNICIPIUL BUCUREŞTI",179132,"BUCUREŞTI SECTORUL 1","COLEGIUL NAŢIONAL DE INFORMATICĂ ”TUDOR VIANU”",58,"Alegeri Prezidentiale",1,1043,651,522,96,33,635,16,1100,449,455,180
42,"MUNICIPIUL BUCUREŞTI - SECTOR 1","MUNICIPIUL BUCUREŞTI",179132,"BUCUREŞTI SECTORUL 1","COLEGIUL NAŢIONAL ”I.L. CARAGIALE”",59,"Alegeri Prezidentiale",2,899,757,437,252,68,740,17,1100,343,517,223
42,"MUNICIPIUL BUCUREŞTI - SECTOR 1","MUNICIPIUL BUCUREŞTI",179132,"BUCUREŞTI SECTORUL 1","COLEGIUL NAŢIONAL ”I.L. CARAGIALE”",60,"Alegeri Prezidentiale",1,1090,797,577,220,0,775,22,1300,503,539,236
42,"MUNICIPIUL BUCUREŞTI - SECTOR 1","MUNICIPIUL BUCUREŞTI",179132,"BUCUREŞTI SECTORUL 1","ŞCOALA GIMNAZIALĂ ”TITU MAIORESCU”",61,"Alegeri Prezidentiale",2,1451,957,750,206,1,932,25,1600,643,628,304
42,"MUNICIPIUL BUCUREŞTI - SECTOR 1","MUNICIPIUL BUCUREŞTI",179132,"BUCUREŞTI SECTORUL 1","ŞCOALA GIMNAZIALĂ ”TITU MAIORESCU”",62,"Alegeri Prezidentiale",1,1319,899,697,201,1,883,16,1392,493,629,254
42,"MUNICIPIUL BUCUREŞTI - SECTOR 1","MUNICIPIUL BUCUREŞTI",179132,"BUCUREŞTI SECTORUL 1","LICEUL TEORETIC ”JEAN MONNET”",63,"Alegeri Prezidentiale",1,1394,1047,706,339,2,1018,29,1600,553,716,302
42,"MUNICIPIUL BUCUREŞTI - SECTOR 1","MUNICIPIUL BUCUREŞTI",179132,"BUCUREŞTI SECTORUL 1","LICEUL TEORETIC ”JEAN MONNET”",64,"Alegeri Prezidentiale",1,1216,856,615,241,0,833,23,1400,544,598,235
42,"MUNICIPIUL BUCUREŞTI - SECTOR 1","MUNICIPIUL BUCUREŞTI",179132,"BUCUREŞTI SECTORUL 1","COLEGIUL ECONOMIC ”V. MADGEARU”",65,"Alegeri Prezidentiale",1,1023,761,502,251,8,745,16,1300,539,534,211
42,"MUNICIPIUL BUCUREŞTI - SECTOR 1","MUNICIPIUL BUCUREŞTI",179132,"BUCUREŞTI SECTORUL 1","COLEGIUL ECONOMIC ”V. MADGEARU”",66,"Alegeri Prezidentiale",1,1050,779,527,250,2,763,16,1300,521,548,215
42,"MUNICIPIUL BUCUREŞTI - SECTOR 1","MUNICIPIUL BUCUREŞTI",179132,"BUCUREŞTI SECTORUL 1","ACADEMIA DE STUDII ECONOMICE DIN BUCUREŞTI",67,"Alegeri Prezidentiale",2,974,660,388,271,1,637,23,1300,640,476,161
42,"MUNICIPIUL BUCUREŞTI - SECTOR 1","MUNICIPIUL BUCUREŞTI",179132,"BUCUREŞTI SECTORUL 1","ACADEMIA DE STUDII ECONOMICE DIN BUCUREŞTI",68,"Alegeri Prezidentiale",1,639,681,290,391,0,668,13,1000,319,524,144
42,"MUNICIPIUL BUCUREŞTI - SECTOR 1","MUNICIPIUL BUCUREŞTI",179132,"BUCUREŞTI SECTORUL 1","UNIVERSITATEA DE ARHITECTURĂ ŞI URBANISM ION MINCU",69,"Alegeri Prezidentiale",1,890,976,355,620,1,944,32,1300,324,733,211
42,"MUNICIPIUL BUCUREŞTI - SECTOR 1","MUNICIPIUL BUCUREŞTI",179132,"BUCUREŞTI SECTORUL 1","UNIVERSITATEA DE ARHITECTURĂ ŞI URBANISM ION MINCU",70,"Alegeri Prezidentiale",1,1034,873,433,440,0,844,29,1401,528,639,205
42,"MUNICIPIUL BUCUREŞTI - SECTOR 1","MUNICIPIUL BUCUREŞTI",179132,"BUCUREŞTI SECTORUL 1","ŞCOALA GIMNAZIALĂ NR.5",71,"Alegeri Prezidentiale",2,1069,706,499,207,0,693,13,1200,494,509,184
42,"MUNICIPIUL BUCUREŞTI - SECTOR 1","MUNICIPIUL BUCUREŞTI",179132,"BUCUREŞTI SECTORUL 1","ŞCOALA GIMNAZIALĂ NR.5",72,"Alegeri Prezidentiale",2,670,551,309,242,0,533,18,800,249,416,117
42,"MUNICIPIUL BUCUREŞTI - SECTOR 1","MUNICIPIUL BUCUREŞTI",179132,"BUCUREŞTI SECTORUL 1","COLEGIUL NAŢIONAL DE MUZICĂ ”GEORGE ENESCU”",73,"Alegeri Prezidentiale",1,1033,820,514,262,44,803,17,1308,488,598,205
42,"MUNICIPIUL BUCUREŞTI - SECTOR 1","MUNICIPIUL BUCUREŞTI",179132,"BUCUREŞTI SECTORUL 1","COLEGIUL NAŢIONAL DE MUZICĂ ”GEORGE ENESCU”",74,"Alegeri Prezidentiale",1,1264,876,528,278,70,864,12,1492,616,650,214
42,"MUNICIPIUL BUCUREŞTI - SECTOR 1","MUNICIPIUL BUCUREŞTI",179132,"BUCUREŞTI SECTORUL 1","COLEGIUL TEHNIC DE ARHITECTURĂ ŞI LUCRĂRI PUBLICE ”IOAN N. SOCOLESCU”",75,"Alegeri Prezidentiale",1,936,585,423,162,0,573,12,1200,615,413,160
42,"MUNICIPIUL BUCUREŞTI - SECTOR 1","MUNICIPIUL BUCUREŞTI",179132,"BUCUREŞTI SECTORUL 1","COLEGIUL NAŢIONAL ”SFÂNTUL SAVA”",76,"Alegeri Prezidentiale",1,775,567,344,223,0,548,19,900,333,404,144
42,"MUNICIPIUL BUCUREŞTI - SECTOR 1","MUNICIPIUL BUCUREŞTI",179132,"BUCUREŞTI SECTORUL 1","COLEGIUL NAŢIONAL ”SFÂNTUL SAVA”",77,"Alegeri Prezidentiale",1,910,498,390,108,0,483,15,1000,502,351,132
42,"MUNICIPIUL BUCUREŞTI - SECTOR 1","MUNICIPIUL BUCUREŞTI",179132,"BUCUREŞTI SECTORUL 1","COLEGIUL NAŢIONAL ”SFÂNTUL SAVA”",78,"Alegeri Prezidentiale",1,1012,476,424,52,0,461,15,1100,624,309,152
42,"MUNICIPIUL BUCUREŞTI - SECTOR 1","MUNICIPIUL BUCUREŞTI",179132,"BUCUREŞTI SECTORUL 1","COLEGIUL NAŢIONAL ”SFÂNTUL SAVA”",79,"Alegeri Prezidentiale",1,1165,558,524,34,0,540,18,1300,742,388,152
42,"MUNICIPIUL BUCUREŞTI - SECTOR 1","MUNICIPIUL BUCUREŞTI",179132,"BUCUREŞTI SECTORUL 1","UNIVERSITATEA NAŢIONALĂ DE MUZICĂ DIN BUCUREŞTI",80,"Alegeri Prezidentiale",1,927,694,371,321,2,676,18,1100,406,531,145
42,"MUNICIPIUL BUCUREŞTI - SECTOR 1","MUNICIPIUL BUCUREŞTI",179132,"BUCUREŞTI SECTORUL 1","UNIVERSITATEA NAŢIONALĂ DE MUZICĂ DIN BUCUREŞTI",81,"Alegeri Prezidentiale",1,904,629,405,224,0,612,17,1100,471,446,166
42,"MUNICIPIUL BUCUREŞTI - SECTOR 1","MUNICIPIUL BUCUREŞTI",179132,"BUCUREŞTI SECTORUL 1","LICEUL DE ARTE PLASTICE ”NICOLAE TONITZA”",82,"Alegeri Prezidentiale",1,676,326,277,49,0,323,3,800,474,203,120
42,"MUNICIPIUL BUCUREŞTI - SECTOR 1","MUNICIPIUL BUCUREŞTI",179132,"BUCUREŞTI SECTORUL 1","LICEUL DE ARTE PLASTICE ”NICOLAE TONITZA”",83,"Alegeri Prezidentiale",1,754,418,353,65,0,409,9,800,382,282,127
42,"MUNICIPIUL BUCUREŞTI - SECTOR 1","MUNICIPIUL BUCUREŞTI",179132,"BUCUREŞTI SECTORUL 1","LICEUL DE ARTE PLASTICE ”NICOLAE TONITZA”",84,"Alegeri Prezidentiale",1,1103,700,563,136,1,680,20,1200,500,473,207
42,"MUNICIPIUL BUCUREŞTI - SECTOR 1","MUNICIPIUL BUCUREŞTI",179132,"BUCUREŞTI SECTORUL 1","LICEUL DE ARTE PLASTICE ”NICOLAE TONITZA”",85,"Alegeri Prezidentiale",1,1220,721,588,133,0,706,15,1300,579,475,231
42,"MUNICIPIUL BUCUREŞTI - SECTOR 1","MUNICIPIUL BUCUREŞTI",179132,"BUCUREŞTI SECTORUL 1","LICEUL DE ARTE PLASTICE ”NICOLAE TONITZA”",86,"Alegeri Prezidentiale",3,1346,754,664,90,0,737,17,1500,746,518,219
42,"MUNICIPIUL BUCUREŞTI - SECTOR 1","MUNICIPIUL BUCUREŞTI",179132,"BUCUREŞTI SECTORUL 1","CENTRUL NAŢIONAL DE CALIFICARE ŞI INSTRUIRE FEROVIARĂ CENAFER",87,"Alegeri Prezidentiale",2,1477,1668,676,992,0,1638,30,1900,232,1160,478
42,"MUNICIPIUL BUCUREŞTI - SECTOR 1","MUNICIPIUL BUCUREŞTI",179132,"BUCUREŞTI SECTORUL 1","CENTRUL NAŢIONAL DE CALIFICARE ŞI INSTRUIRE FEROVIARĂ CENAFER",88,"Alegeri Prezidentiale",1,1192,707,581,125,1,693,14,1300,593,486,207
42,"MUNICIPIUL BUCUREŞTI - SECTOR 1","MUNICIPIUL BUCUREŞTI",179132,"BUCUREŞTI SECTORUL 1","CENTRUL NAŢIONAL DE CALIFICARE ŞI INSTRUIRE FEROVIARĂ CENAFER",89,"Alegeri Prezidentiale",2,1454,831,751,77,3,813,18,1600,769,546,267
42,"MUNICIPIUL BUCUREŞTI - SECTOR 1","MUNICIPIUL BUCUREŞTI",179132,"BUCUREŞTI SECTORUL 1","ŞCOALA GIMNAZIALĂ ”NICOLAE TITULESCU”",90,"Alegeri Prezidentiale",1,1245,763,594,169,0,745,18,1400,637,539,206
42,"MUNICIPIUL BUCUREŞTI - SECTOR 1","MUNICIPIUL BUCUREŞTI",179132,"BUCUREŞTI SECTORUL 1","ŞCOALA GIMNAZIALĂ ”NICOLAE TITULESCU”",91,"Alegeri Prezidentiale",1,909,665,432,233,0,650,15,1000,335,495,155
42,"MUNICIPIUL BUCUREŞTI - SECTOR 1","MUNICIPIUL BUCUREŞTI",179132,"BUCUREŞTI SECTORUL 1","ŞCOALA GIMNAZIALĂ ”NICOLAE TITULESCU”",92,"Alegeri Prezidentiale",2,1356,996,747,248,1,976,20,1500,504,695,281
42,"MUNICIPIUL BUCUREŞTI - SECTOR 1","MUNICIPIUL BUCUREŞTI",179132,"BUCUREŞTI SECTORUL 1","ŞCOALA GIMNAZIALĂ ”NICOLAE TITULESCU”",93,"Alegeri Prezidentiale",1,1247,717,613,104,0,709,8,1400,683,455,254
42,"MUNICIPIUL BUCUREŞTI - SECTOR 1","MUNICIPIUL BUCUREŞTI",179132,"BUCUREŞTI SECTORUL 1","ȘCOALA GIMNAZIALĂ ”NICOLAE TITULESCU”",94,"Alegeri Prezidentiale",1,1429,930,813,116,1,910,20,1600,670,627,283
42,"MUNICIPIUL BUCUREŞTI - SECTOR 1","MUNICIPIUL BUCUREŞTI",179132,"BUCUREŞTI SECTORUL 1","LICEUL TEORETIC ”ALEXANDRU VLAHUŢĂ”",95,"Alegeri Prezidentiale",1,1168,792,568,149,75,776,16,1300,508,553,223
42,"MUNICIPIUL BUCUREŞTI - SECTOR 1","MUNICIPIUL BUCUREŞTI",179132,"BUCUREŞTI SECTORUL 1","LICEUL TEORETIC ”ALEXANDRU VLAHUŢĂ”",96,"Alegeri Prezidentiale",1,1415,939,787,72,80,911,28,1608,669,609,302
42,"MUNICIPIUL BUCUREŞTI - SECTOR 1","MUNICIPIUL BUCUREŞTI",179132,"BUCUREŞTI SECTORUL 1","LICEUL TEORETIC ”ALEXANDRU VLAHUŢĂ”",97,"Alegeri Prezidentiale",1,1227,719,590,54,75,706,13,1608,889,462,244
42,"MUNICIPIUL BUCUREŞTI - SECTOR 1","MUNICIPIUL BUCUREŞTI",179132,"BUCUREŞTI SECTORUL 1","ŞCOALA GIMNAZIALĂ ”ELENA VĂCĂRESCU”",98,"Alegeri Prezidentiale",1,1171,667,500,166,1,646,21,1300,633,433,213
42,"MUNICIPIUL BUCUREŞTI - SECTOR 1","MUNICIPIUL BUCUREŞTI",179132,"BUCUREŞTI SECTORUL 1","COLEGIUL GERMAN ”GOETHE”",99,"Alegeri Prezidentiale",1,913,536,471,63,2,522,14,1000,464,358,164
42,"MUNICIPIUL BUCUREŞTI - SECTOR 1","MUNICIPIUL BUCUREŞTI",179132,"BUCUREŞTI SECTORUL 1","COLEGIUL GERMAN ”GOETHE”",100,"Alegeri Prezidentiale",1,778,471,381,90,0,457,14,900,429,331,126
42,"MUNICIPIUL BUCUREŞTI - SECTOR 1","MUNICIPIUL BUCUREŞTI",179132,"BUCUREŞTI SECTORUL 1","COLEGIUL GERMAN ”GOETHE”",101,"Alegeri Prezidentiale",1,884,462,418,44,0,455,7,1000,538,308,147
42,"MUNICIPIUL BUCUREŞTI - SECTOR 1","MUNICIPIUL BUCUREŞTI",179132,"BUCUREŞTI SECTORUL 1","LICEUL TEORETIC BILINGV ”MIGUEL DE CERVANTES”",102,"Alegeri Prezidentiale",1,992,539,425,112,2,531,8,1100,561,375,156
42,"MUNICIPIUL BUCUREŞTI - SECTOR 1","MUNICIPIUL BUCUREŞTI",179132,"BUCUREŞTI SECTORUL 1","LICEUL TEORETIC BILINGV ”MIGUEL DE CERVANTES”",103,"Alegeri Prezidentiale",1,980,596,449,147,0,575,21,1100,504,414,161
42,"MUNICIPIUL BUCUREŞTI - SECTOR 1","MUNICIPIUL BUCUREŞTI",179132,"BUCUREŞTI SECTORUL 1","ȘCOALA GIMNAZIALĂ ”URUGUAY”",104,"Alegeri Prezidentiale",2,1043,515,466,49,0,505,10,1400,885,353,152
42,"MUNICIPIUL BUCUREŞTI - SECTOR 1","MUNICIPIUL BUCUREŞTI",179132,"BUCUREŞTI SECTORUL 1","ȘCOALA GIMNAZIALĂ ”URUGUAY”",105,"Alegeri Prezidentiale",1,1230,580,445,135,0,570,10,1500,920,375,195
42,"MUNICIPIUL BUCUREŞTI - SECTOR 1","MUNICIPIUL BUCUREŞTI",179132,"BUCUREŞTI SECTORUL 1","ŞCOALA GIMNAZIALĂ ”URUGUAY”",106,"Alegeri Prezidentiale",1,907,537,434,100,3,531,6,1200,663,365,166
42,"MUNICIPIUL BUCUREŞTI - SECTOR 1","MUNICIPIUL BUCUREŞTI",179132,"BUCUREŞTI SECTORUL 1","ŞCOALA GIMNAZIALĂ ”URUGUAY”",107,"Alegeri Prezidentiale",1,1388,772,702,66,4,751,21,1500,728,523,228
42,"MUNICIPIUL BUCUREŞTI - SECTOR 1","MUNICIPIUL BUCUREŞTI",179132,"BUCUREŞTI SECTORUL 1","CLUBUL SPORTIV ŞCOLAR NR.5",108,"Alegeri Prezidentiale",1,1034,589,452,137,0,574,15,1200,611,407,167
42,"MUNICIPIUL BUCUREŞTI - SECTOR 1","MUNICIPIUL BUCUREŞTI",179132,"BUCUREŞTI SECTORUL 1","CLUBUL SPORTIV ŞCOLAR NR.5",109,"Alegeri Prezidentiale",1,995,428,354,74,0,422,6,1200,772,284,138
42,"MUNICIPIUL BUCUREŞTI - SECTOR 1","MUNICIPIUL BUCUREŞTI",179132,"BUCUREŞTI SECTORUL 1","ŞCOALA GIMNAZIALĂ ”SFINŢII VOIEVOZI”",110,"Alegeri Prezidentiale",2,984,707,455,252,0,696,11,1200,493,469,227
42,"MUNICIPIUL BUCUREŞTI - SECTOR 1","MUNICIPIUL BUCUREŞTI",179132,"BUCUREŞTI SECTORUL 1","ŞCOALA GIMNAZIALĂ ”SFINŢII VOIEVOZI”",111,"Alegeri Prezidentiale",2,942,713,401,312,0,688,25,1100,387,539,149
42,"MUNICIPIUL BUCUREŞTI - SECTOR 1","MUNICIPIUL BUCUREŞTI",179132,"BUCUREŞTI SECTORUL 1","ŞCOALA GIMNAZIALĂ ”SFINŢII VOIEVOZI”",112,"Alegeri Prezidentiale",1,1012,648,464,184,0,636,12,1200,552,449,187
42,"MUNICIPIUL BUCUREŞTI - SECTOR 1","MUNICIPIUL BUCUREŞTI",179132,"BUCUREŞTI SECTORUL 1","ŞCOALA GIMNAZIALĂ ”SFINŢII VOIEVOZI”",113,"Alegeri Prezidentiale",2,1451,790,694,94,2,771,19,1600,810,489,282
42,"MUNICIPIUL BUCUREŞTI - SECTOR 1","MUNICIPIUL BUCUREŞTI",179132,"BUCUREŞTI SECTORUL 1","ŞCOALA GIMNAZIALĂ ”SFINŢII VOIEVOZI”",114,"Alegeri Prezidentiale",1,1000,530,401,65,64,519,11,1200,670,351,168
42,"MUNICIPIUL BUCUREŞTI - SECTOR 1","MUNICIPIUL BUCUREŞTI",179132,"BUCUREŞTI SECTORUL 1","COLEGIUL NAŢIONAL ”ION NECULCE”",115,"Alegeri Prezidentiale",1,1463,978,799,179,0,957,21,1500,522,676,281
42,"MUNICIPIUL BUCUREŞTI - SECTOR 1","MUNICIPIUL BUCUREŞTI",179132,"BUCUREŞTI SECTORUL 1","COLEGIUL NAŢIONAL ”ION NECULCE”",116,"Alegeri Prezidentiale",1,1421,799,653,146,0,781,18,1500,701,559,222
42,"MUNICIPIUL BUCUREŞTI - SECTOR 1","MUNICIPIUL BUCUREŞTI",179132,"BUCUREŞTI SECTORUL 1","COLEGIUL NAŢIONAL ”ION NECULCE”",117,"Alegeri Prezidentiale",2,1648,1165,869,112,184,1152,13,1600,435,760,392
42,"MUNICIPIUL BUCUREŞTI - SECTOR 1","MUNICIPIUL BUCUREŞTI",179132,"BUCUREŞTI SECTORUL 1","COLEGIUL NAŢIONAL ”ION NECULCE”",118,"Alegeri Prezidentiale",1,1493,877,796,68,13,859,18,1500,623,636,223
42,"MUNICIPIUL BUCUREŞTI - SECTOR 1","MUNICIPIUL BUCUREŞTI",179132,"BUCUREŞTI SECTORUL 1","COLEGIUL NAŢIONAL ”ION NECULCE”",119,"Alegeri Prezidentiale",1,1446,713,659,54,0,702,11,1400,687,486,216
42,"MUNICIPIUL BUCUREŞTI - SECTOR 1","MUNICIPIUL BUCUREŞTI",179132,"BUCUREŞTI SECTORUL 1","ŞCOALA GIMNAZIALĂ ”GEO BOGZA”",120,"Alegeri Prezidentiale",1,1100,640,539,100,1,627,13,1200,560,450,177
42,"MUNICIPIUL BUCUREŞTI - SECTOR 1","MUNICIPIUL BUCUREŞTI",179132,"BUCUREŞTI SECTORUL 1","ŞCOALA GIMNAZIALĂ ”GEO BOGZA”",121,"Alegeri Prezidentiale",1,1150,711,611,100,0,693,18,1200,489,458,235
42,"MUNICIPIUL BUCUREŞTI - SECTOR 1","MUNICIPIUL BUCUREŞTI",179132,"BUCUREŞTI SECTORUL 1","ŞCOALA GIMNAZIALĂ ”GEO BOGZA”",122,"Alegeri Prezidentiale",1,877,599,529,69,1,576,23,1000,401,386,190
42,"MUNICIPIUL BUCUREŞTI - SECTOR 1","MUNICIPIUL BUCUREŞTI",179132,"BUCUREŞTI SECTORUL 1","ŞCOALA GIMNAZIALĂ ”PETRE ISPIRESCU”",123,"Alegeri Prezidentiale",1,1372,836,761,75,0,815,21,1400,564,554,261
42,"MUNICIPIUL BUCUREŞTI - SECTOR 1","MUNICIPIUL BUCUREŞTI",179132,"BUCUREŞTI SECTORUL 1","ŞCOALA GIMNAZIALĂ ”PETRE ISPIRESCU”",124,"Alegeri Prezidentiale",1,1385,826,769,55,2,806,20,1400,574,554,252
42,"MUNICIPIUL BUCUREŞTI - SECTOR 1","MUNICIPIUL BUCUREŞTI",179132,"BUCUREŞTI SECTORUL 1","ŞCOALA GIMNAZIALĂ ”PETRE ISPIRESCU”",125,"Alegeri Prezidentiale",1,1326,791,734,57,0,768,23,1300,509,533,235
42,"MUNICIPIUL BUCUREŞTI - SECTOR 1","MUNICIPIUL BUCUREŞTI",179132,"BUCUREŞTI SECTORUL 1","ŞCOALA GIMNAZIALĂ ”PETRE ISPIRESCU”",126,"Alegeri Prezidentiale",1,1061,707,603,103,1,685,22,1099,392,491,194
42,"MUNICIPIUL BUCUREŞTI - SECTOR 1","MUNICIPIUL BUCUREŞTI",179132,"BUCUREŞTI SECTORUL 1","ŞCOALA GIMNAZIALĂ ”PETRE ISPIRESCU”",127,"Alegeri Prezidentiale",1,1040,580,516,64,0,562,18,1100,520,383,179
42,"MUNICIPIUL BUCUREŞTI - SECTOR 1","MUNICIPIUL BUCUREŞTI",179132,"BUCUREŞTI SECTORUL 1","ŞCOALA GIMNAZIALĂ ”SF.NICOLAE”",128,"Alegeri Prezidentiale",1,1454,862,715,146,1,841,21,1500,638,604,237
42,"MUNICIPIUL BUCUREŞTI - SECTOR 1","MUNICIPIUL BUCUREŞTI",179132,"BUCUREŞTI SECTORUL 1","ŞCOALA GIMNAZIALĂ ”SF.NICOLAE”",129,"Alegeri Prezidentiale",1,1231,687,595,92,0,672,15,1300,613,485,187
42,"MUNICIPIUL BUCUREŞTI - SECTOR 1","MUNICIPIUL BUCUREŞTI",179132,"BUCUREŞTI SECTORUL 1","COLEGIUL NAŢIONAL ”AUREL VLAICU”",130,"Alegeri Prezidentiale",1,1263,856,722,134,0,834,22,1400,544,617,217
42,"MUNICIPIUL BUCUREŞTI - SECTOR 1","MUNICIPIUL BUCUREŞTI",179132,"BUCUREŞTI SECTORUL 1","COLEGIUL NAŢIONAL ”AUREL VLAICU”",131,"Alegeri Prezidentiale",1,1192,769,695,71,3,752,17,1300,531,512,240
42,"MUNICIPIUL BUCUREŞTI - SECTOR 1","MUNICIPIUL BUCUREŞTI",179132,"BUCUREŞTI SECTORUL 1","COLEGIUL NAŢIONAL ”AUREL VLAICU”",132,"Alegeri Prezidentiale",1,870,510,467,42,1,494,16,1000,490,345,149
42,"MUNICIPIUL BUCUREŞTI - SECTOR 1","MUNICIPIUL BUCUREŞTI",179132,"BUCUREŞTI SECTORUL 1","COLEGIUL TEHNIC MECANIC ”GRIVIŢA”",133,"Alegeri Prezidentiale",1,1126,640,517,123,0,628,12,1200,560,419,209
42,"MUNICIPIUL BUCUREŞTI - SECTOR 1","MUNICIPIUL BUCUREŞTI",179132,"BUCUREŞTI SECTORUL 1","COLEGIUL TEHNIC MECANIC ”GRIVIŢA”",134,"Alegeri Prezidentiale",1,1450,863,710,153,0,843,20,1600,737,557,286
42,"MUNICIPIUL BUCUREŞTI - SECTOR 1","MUNICIPIUL BUCUREŞTI",179132,"BUCUREŞTI SECTORUL 1","COLEGIUL TEHNIC MECANIC ”GRIVIŢA”",135,"Alegeri Prezidentiale",1,1280,722,599,84,39,693,28,1400,678,461,232
42,"MUNICIPIUL BUCUREŞTI - SECTOR 1","MUNICIPIUL BUCUREŞTI",179132,"BUCUREŞTI SECTORUL 1","COLEGIUL TEHNIC FEROVIAR ”MIHAI I”",136,"Alegeri Prezidentiale",1,1223,621,537,84,0,609,12,1300,679,370,239
42,"MUNICIPIUL BUCUREŞTI - SECTOR 1","MUNICIPIUL BUCUREŞTI",179132,"BUCUREŞTI SECTORUL 1","COLEGIUL TEHNIC FEROVIAR ”MIHAI I”",137,"Alegeri Prezidentiale",1,1185,569,524,45,0,554,15,1300,731,328,226
42,"MUNICIPIUL BUCUREŞTI - SECTOR 1","MUNICIPIUL BUCUREŞTI",179132,"BUCUREŞTI SECTORUL 1","ŞCOALA GIMNAZIALĂ NR.162",138,"Alegeri Prezidentiale",1,1259,647,590,57,0,636,11,1400,753,374,262
42,"MUNICIPIUL BUCUREŞTI - SECTOR 1","MUNICIPIUL BUCUREŞTI",179132,"BUCUREŞTI SECTORUL 1","ŞCOALA GIMNAZIALĂ NR.162",139,"Alegeri Prezidentiale",1,1586,841,779,62,0,824,17,1700,859,488,336
42,"MUNICIPIUL BUCUREŞTI - SECTOR 1","MUNICIPIUL BUCUREŞTI",179132,"BUCUREŞTI SECTORUL 1","ŞCOALA GIMNAZIALĂ ”ALEXANDRU COSTESCU” NR.182",140,"Alegeri Prezidentiale",2,1589,917,835,82,0,898,19,1700,783,606,292
42,"MUNICIPIUL BUCUREŞTI - SECTOR 1","MUNICIPIUL BUCUREŞTI",179132,"BUCUREŞTI SECTORUL 1","ŞCOALA GIMNAZIALĂ ”ALEXANDRU COSTESCU” NR.182",141,"Alegeri Prezidentiale",1,1847,1058,958,99,1,1038,20,1900,842,758,280
42,"MUNICIPIUL BUCUREŞTI - SECTOR 1","MUNICIPIUL BUCUREŞTI",179132,"BUCUREŞTI SECTORUL 1","ŞCOALA GIMNAZIALĂ ”ALEXANDRU COSTESCU” NR.182",142,"Alegeri Prezidentiale",1,1459,868,796,71,1,853,15,1592,724,570,283
42,"MUNICIPIUL BUCUREŞTI - SECTOR 1","MUNICIPIUL BUCUREŞTI",179132,"BUCUREŞTI SECTORUL 1","ȘCOALA GIMNAZIALĂ ”ALEXANDRU COSTESCU” NR.182",143,"Alegeri Prezidentiale",1,1506,774,707,67,0,754,20,1600,826,496,258
42,"MUNICIPIUL BUCUREŞTI - SECTOR 1","MUNICIPIUL BUCUREŞTI",179132,"BUCUREŞTI SECTORUL 1","ŞCOALA GIMNAZIALĂ NR.183",144,"Alegeri Prezidentiale",1,1362,642,592,50,0,628,14,1492,850,404,224
42,"MUNICIPIUL BUCUREŞTI - SECTOR 1","MUNICIPIUL BUCUREŞTI",179132,"BUCUREŞTI SECTORUL 1","ŞCOALA GIMNAZIALĂ NR.183",145,"Alegeri Prezidentiale",1,1318,605,536,69,0,586,19,1400,795,352,234
42,"MUNICIPIUL BUCUREŞTI - SECTOR 1","MUNICIPIUL BUCUREŞTI",179132,"BUCUREŞTI SECTORUL 1","ŞCOALA GIMNAZIALĂ NR.183",146,"Alegeri Prezidentiale",1,1240,616,553,63,0,603,13,1300,684,382,221
42,"MUNICIPIUL BUCUREŞTI - SECTOR 1","MUNICIPIUL BUCUREŞTI",179132,"BUCUREŞTI SECTORUL 1","ŞCOALA GIMNAZIALĂ NR.183",147,"Alegeri Prezidentiale",1,1473,684,653,31,0,667,17,1500,816,415,252
42,"MUNICIPIUL BUCUREŞTI - SECTOR 1","MUNICIPIUL BUCUREŞTI",179132,"BUCUREŞTI SECTORUL 1","ŞCOALA GIMNAZIALĂ NR.183",148,"Alegeri Prezidentiale",1,1187,625,595,30,0,611,14,1200,575,422,189
42,"MUNICIPIUL BUCUREŞTI - SECTOR 1","MUNICIPIUL BUCUREŞTI",179132,"BUCUREŞTI SECTORUL 1","ŞCOALA GIMNAZIALĂ NR.183",149,"Alegeri Prezidentiale",2,1696,925,880,44,1,900,25,1700,775,602,298
42,"MUNICIPIUL BUCUREŞTI - SECTOR 1","MUNICIPIUL BUCUREŞTI",179132,"BUCUREŞTI SECTORUL 1","ȘCOALA GIMNAZIALĂ NR.183",150,"Alegeri Prezidentiale",1,1514,752,726,26,0,730,22,1500,748,466,264
42,"MUNICIPIUL BUCUREŞTI - SECTOR 1","MUNICIPIUL BUCUREŞTI",179132,"BUCUREŞTI SECTORUL 1","ŞCOALA GIMNAZIALĂ NR.153",151,"Alegeri Prezidentiale",1,1516,523,498,25,0,515,8,1500,977,312,203
42,"MUNICIPIUL BUCUREŞTI - SECTOR 1","MUNICIPIUL BUCUREŞTI",179132,"BUCUREŞTI SECTORUL 1","ŞCOALA GIMNAZIALĂ NR.184",152,"Alegeri Prezidentiale",1,1409,638,606,31,1,622,16,1500,862,392,230
42,"MUNICIPIUL BUCUREŞTI - SECTOR 1","MUNICIPIUL BUCUREŞTI",179132,"BUCUREŞTI SECTORUL 1","ŞCOALA GIMNAZIALĂ NR.184",153,"Alegeri Prezidentiale",1,1734,775,740,35,0,762,13,1801,1026,511,251
42,"MUNICIPIUL BUCUREŞTI - SECTOR 1","MUNICIPIUL BUCUREŞTI",179132,"BUCUREŞTI SECTORUL 1","ŞCOALA GIMNAZIALĂ NR.184",154,"Alegeri Prezidentiale",1,1315,599,569,30,0,582,17,1400,801,364,218
42,"MUNICIPIUL BUCUREŞTI - SECTOR 1","MUNICIPIUL BUCUREŞTI",179132,"BUCUREŞTI SECTORUL 1","ŞCOALA GIMNAZIALĂ NR.184",155,"Alegeri Prezidentiale",1,1305,693,597,96,0,673,20,1400,707,430,243
42,"MUNICIPIUL BUCUREŞTI - SECTOR 1","MUNICIPIUL BUCUREŞTI",179132,"BUCUREŞTI SECTORUL 1","ȘCOALA GIMNAZIALĂ NR.184",156,"Alegeri Prezidentiale",1,1625,879,820,57,2,864,15,1700,821,569,295
42,"MUNICIPIUL BUCUREŞTI - SECTOR 1","MUNICIPIUL BUCUREŞTI",179132,"BUCUREŞTI SECTORUL 1","ŞCOALA GIMNAZIALĂ NR.181",157,"Alegeri Prezidentiale",1,1196,699,663,36,0,682,17,1309,610,424,258
42,"MUNICIPIUL BUCUREŞTI - SECTOR 1","MUNICIPIUL BUCUREŞTI",179132,"BUCUREŞTI SECTORUL 1","ŞCOALA GIMNAZIALĂ NR.181",158,"Alegeri Prezidentiale",1,1437,693,648,45,0,676,17,1500,807,411,265
42,"MUNICIPIUL BUCUREŞTI - SECTOR 1","MUNICIPIUL BUCUREŞTI",179132,"BUCUREŞTI SECTORUL 1","ŞCOALA GIMNAZIALĂ NR.181",159,"Alegeri Prezidentiale",1,1326,790,676,114,0,781,9,1400,610,499,282
42,"MUNICIPIUL BUCUREŞTI - SECTOR 1","MUNICIPIUL BUCUREŞTI",179132,"BUCUREŞTI SECTORUL 1","ŞCOALA GIMNAZIALĂ NR.181",160,"Alegeri Prezidentiale",1,1051,521,508,13,0,514,7,1100,579,319,195
42,"MUNICIPIUL BUCUREŞTI - SECTOR 1","MUNICIPIUL BUCUREŞTI",179132,"BUCUREŞTI SECTORUL 1","SCOALA GIMNAZIALĂ NR. 192",161,"Alegeri Prezidentiale",1,1743,1095,929,166,0,1069,26,1700,605,757,312
42,"MUNICIPIUL BUCUREŞTI - SECTOR 1","MUNICIPIUL BUCUREŞTI",179132,"BUCUREŞTI SECTORUL 1","ȘCOALA GIMNAZIALĂ NR.192",162,"Alegeri Prezidentiale",1,1396,881,706,165,10,860,21,1500,619,640,220
42,"MUNICIPIUL BUCUREŞTI - SECTOR 1","MUNICIPIUL BUCUREŞTI",179132,"BUCUREŞTI SECTORUL 1","ŞCOALA GIMNAZIALĂ NR.192",163,"Alegeri Prezidentiale",1,1472,897,726,169,2,880,17,1600,703,579,301
42,"MUNICIPIUL BUCUREŞTI - SECTOR 1","MUNICIPIUL BUCUREŞTI",179132,"BUCUREŞTI SECTORUL 1","ACADEMIA DE POLIȚIE ”ALEXANDRU IOAN CUZA”",164,"Alegeri Prezidentiale",1,858,1233,433,800,0,1208,25,1400,167,1002,206
42,"MUNICIPIUL BUCUREŞTI - SECTOR 1","MUNICIPIUL BUCUREŞTI",179132,"BUCUREŞTI SECTORUL 1","ACADEMIA DE POLIȚIE ”ALEXANDRU IOAN CUZA”",165,"Alegeri Prezidentiale",1,1993,1384,1087,296,1,1361,23,2000,616,1170,191
42,"MUNICIPIUL BUCUREŞTI - SECTOR 1","MUNICIPIUL BUCUREŞTI",179132,"BUCUREŞTI SECTORUL 1","COLEGIUL TEHNOLOGIC ”VIACESLAV HARNAJ”",166,"Alegeri Prezidentiale",2,1270,789,697,88,4,772,17,1310,521,522,250
43,"MUNICIPIUL BUCUREŞTI - SECTOR 2","MUNICIPIUL BUCUREŞTI",179132,"BUCUREŞTI SECTORUL 2","ŞCOALA GIMNAZIALĂ NR. 28",167,"Alegeri Prezidentiale",1,1624,1069,808,230,31,1041,28,1800,731,721,320
43,"MUNICIPIUL BUCUREŞTI - SECTOR 2","MUNICIPIUL BUCUREŞTI",179132,"BUCUREŞTI SECTORUL 2","ŞCOALA GIMNAZIALĂ NR. 28",168,"Alegeri Prezidentiale",1,1164,955,620,200,135,934,21,1600,645,726,208
43,"MUNICIPIUL BUCUREŞTI - SECTOR 2","MUNICIPIUL BUCUREŞTI",179132,"BUCUREŞTI SECTORUL 2","ŞCOALA GIMNAZIALĂ NR. 28",169,"Alegeri Prezidentiale",1,1355,1014,681,131,202,997,17,1600,586,607,390
43,"MUNICIPIUL BUCUREŞTI - SECTOR 2","MUNICIPIUL BUCUREŞTI",179132,"BUCUREŞTI SECTORUL 2","ŞCOALA GIMNAZIALĂ ”MARIA ROSETTI”",170,"Alegeri Prezidentiale",2,1712,1102,933,168,1,1069,33,1800,698,788,281
43,"MUNICIPIUL BUCUREŞTI - SECTOR 2","MUNICIPIUL BUCUREŞTI",179132,"BUCUREŞTI SECTORUL 2","ŞCOALA GIMNAZIALĂ ”MARIA ROSETTI”",171,"Alegeri Prezidentiale",1,920,585,487,98,0,575,10,963,378,401,174
43,"MUNICIPIUL BUCUREŞTI - SECTOR 2","MUNICIPIUL BUCUREŞTI",179132,"BUCUREŞTI SECTORUL 2","ŞCOALA GIMNAZIALĂ ”MARIA ROSETTI”",172,"Alegeri Prezidentiale",1,929,579,441,135,3,571,8,1000,421,424,147
43,"MUNICIPIUL BUCUREŞTI - SECTOR 2","MUNICIPIUL BUCUREŞTI",179132,"BUCUREŞTI SECTORUL 2","LICEUL TEORETIC ”C.A. ROSETTI ”",173,"Alegeri Prezidentiale",1,1055,722,547,174,1,692,30,1200,478,494,198
43,"MUNICIPIUL BUCUREŞTI - SECTOR 2","MUNICIPIUL BUCUREŞTI",179132,"BUCUREŞTI SECTORUL 2","LICEUL TEORETIC ”C.A. ROSETTI ”",174,"Alegeri Prezidentiale",1,1645,939,863,74,2,922,17,1800,861,653,269
43,"MUNICIPIUL BUCUREŞTI - SECTOR 2","MUNICIPIUL BUCUREŞTI",179132,"BUCUREŞTI SECTORUL 2","LICEUL TEORETIC ”C.A. ROSETTI ”",175,"Alegeri Prezidentiale",1,1524,820,731,89,0,799,21,1600,780,561,238
43,"MUNICIPIUL BUCUREŞTI - SECTOR 2","MUNICIPIUL BUCUREŞTI",179132,"BUCUREŞTI SECTORUL 2","LICEUL TEORETIC ”TRAIAN”",176,"Alegeri Prezidentiale",1,1864,1101,944,152,5,1075,26,2200,1099,741,334
43,"MUNICIPIUL BUCUREŞTI - SECTOR 2","MUNICIPIUL BUCUREŞTI",179132,"BUCUREŞTI SECTORUL 2","LICEUL TEORETIC ”TRAIAN”",177,"Alegeri Prezidentiale",1,1872,1025,931,93,1,997,28,2000,975,696,301
43,"MUNICIPIUL BUCUREŞTI - SECTOR 2","MUNICIPIUL BUCUREŞTI",179132,"BUCUREŞTI SECTORUL 2","LICEUL TEORETIC ”TRAIAN”",178,"Alegeri Prezidentiale",1,1876,1010,938,72,0,985,25,2000,990,652,333
43,"MUNICIPIUL BUCUREŞTI - SECTOR 2","MUNICIPIUL BUCUREŞTI",179132,"BUCUREŞTI SECTORUL 2","LICEUL TEORETIC ”TRAIAN”",179,"Alegeri Prezidentiale",1,1878,1107,1011,96,0,1083,24,2000,893,707,376
43,"MUNICIPIUL BUCUREŞTI - SECTOR 2","MUNICIPIUL BUCUREŞTI",179132,"BUCUREŞTI SECTORUL 2","ŞCOALA GIMNAZIALĂ NR. 31",180,"Alegeri Prezidentiale",2,1524,1183,759,424,0,1165,18,1600,417,804,361
43,"MUNICIPIUL BUCUREŞTI - SECTOR 2","MUNICIPIUL BUCUREŞTI",179132,"BUCUREŞTI SECTORUL 2","ŞCOALA GIMNAZIALĂ NR. 31",181,"Alegeri Prezidentiale",1,1932,1078,926,152,0,1060,18,2000,922,720,340
43,"MUNICIPIUL BUCUREŞTI - SECTOR 2","MUNICIPIUL BUCUREŞTI",179132,"BUCUREŞTI SECTORUL 2","ŞCOALA GIMNAZIALĂ NR. 31",182,"Alegeri Prezidentiale",2,1713,993,853,138,2,964,29,1800,807,656,308
43,"MUNICIPIUL BUCUREŞTI - SECTOR 2","MUNICIPIUL BUCUREŞTI",179132,"BUCUREŞTI SECTORUL 2","ŞCOALA GIMNAZIALĂ NR. 31",183,"Alegeri Prezidentiale",1,1677,907,783,124,0,881,26,1800,893,621,260
43,"MUNICIPIUL BUCUREŞTI - SECTOR 2","MUNICIPIUL BUCUREŞTI",179132,"BUCUREŞTI SECTORUL 2","ŞCOALA GIMNAZIALĂ NR. 31",184,"Alegeri Prezidentiale",1,1830,1186,833,353,0,1162,24,2000,814,902,260
43,"MUNICIPIUL BUCUREŞTI - SECTOR 2","MUNICIPIUL BUCUREŞTI",179132,"BUCUREŞTI SECTORUL 2","UNIVERSITATEA TEHNICĂ DE CONSTRUCŢII BUCUREŞTI",185,"Alegeri Prezidentiale",1,1751,1088,957,96,35,1067,21,2000,912,740,327
43,"MUNICIPIUL BUCUREŞTI - SECTOR 2","MUNICIPIUL BUCUREŞTI",179132,"BUCUREŞTI SECTORUL 2","UNIVERSITATEA TEHNICĂ DE CONSTRUCŢII BUCUREŞTI",186,"Alegeri Prezidentiale",1,1762,906,764,142,0,886,20,2000,1094,585,301
43,"MUNICIPIUL BUCUREŞTI - SECTOR 2","MUNICIPIUL BUCUREŞTI",179132,"BUCUREŞTI SECTORUL 2","UNIVERSITATEA TEHNICĂ DE CONSTRUCŢII BUCUREŞTI",187,"Alegeri Prezidentiale",1,1626,888,701,186,1,873,15,1800,912,638,235
43,"MUNICIPIUL BUCUREŞTI - SECTOR 2","MUNICIPIUL BUCUREŞTI",179132,"BUCUREŞTI SECTORUL 2","UNIVERSITATEA TEHNICĂ DE CONSTRUCŢII BUCUREŞTI",188,"Alegeri Prezidentiale",1,1688,924,812,112,0,907,17,2000,1076,657,250
43,"MUNICIPIUL BUCUREŞTI - SECTOR 2","MUNICIPIUL BUCUREŞTI",179132,"BUCUREŞTI SECTORUL 2","UNIVERSITATEA TEHNICĂ DE CONSTRUCŢII BUCUREŞTI",189,"Alegeri Prezidentiale",2,1783,986,871,115,0,959,27,2000,1014,671,288
43,"MUNICIPIUL BUCUREŞTI - SECTOR 2","MUNICIPIUL BUCUREŞTI",179132,"BUCUREŞTI SECTORUL 2","UNIVERSITATEA TEHNICĂ DE CONSTRUCŢII BUCUREŞTI",190,"Alegeri Prezidentiale",1,1889,916,859,57,0,896,20,2000,1084,596,300
43,"MUNICIPIUL BUCUREŞTI - SECTOR 2","MUNICIPIUL BUCUREŞTI",179132,"BUCUREŞTI SECTORUL 2","UNIVERSITATEA TEHNICĂ DE CONSTRUCŢII BUCUREŞTI",191,"Alegeri Prezidentiale",1,1580,741,702,39,0,729,12,1792,1051,505,224
43,"MUNICIPIUL BUCUREŞTI - SECTOR 2","MUNICIPIUL BUCUREŞTI",179132,"BUCUREŞTI SECTORUL 2","UNIVERSITATEA TEHNICĂ DE CONSTRUCŢII BUCUREŞTI",192,"Alegeri Prezidentiale",2,1316,609,492,117,0,590,19,1600,991,420,170
43,"MUNICIPIUL BUCUREŞTI - SECTOR 2","MUNICIPIUL BUCUREŞTI",179132,"BUCUREŞTI SECTORUL 2","UNIVERSITATEA TEHNICĂ DE CONSTRUCŢII BUCUREŞTI",193,"Alegeri Prezidentiale",1,1679,973,837,136,0,947,26,2000,1027,660,287
43,"MUNICIPIUL BUCUREŞTI - SECTOR 2","MUNICIPIUL BUCUREŞTI",179132,"BUCUREŞTI SECTORUL 2","UNIVERSITATEA TEHNICĂ DE CONSTRUCŢII BUCUREŞTI",194,"Alegeri Prezidentiale",1,1710,766,649,117,0,748,18,2000,1234,516,232
43,"MUNICIPIUL BUCUREŞTI - SECTOR 2","MUNICIPIUL BUCUREŞTI",179132,"BUCUREŞTI SECTORUL 2","LICEUL TEHNOLOGIC CONSTANTIN BRÂNCUŞI",195,"Alegeri Prezidentiale",1,1034,800,442,358,0,791,9,1400,600,606,185
43,"MUNICIPIUL BUCUREŞTI - SECTOR 2","MUNICIPIUL BUCUREŞTI",179132,"BUCUREŞTI SECTORUL 2","ŞCOALA GIMNAZIALĂ NR. 27",196,"Alegeri Prezidentiale",1,1540,885,662,222,1,862,23,1800,915,587,275
43,"MUNICIPIUL BUCUREŞTI - SECTOR 2","MUNICIPIUL BUCUREŞTI",179132,"BUCUREŞTI SECTORUL 2","ŞCOALA GIMNAZIALĂ NR. 27",197,"Alegeri Prezidentiale",1,1529,1027,779,248,0,1006,21,1600,573,696,310
43,"MUNICIPIUL BUCUREŞTI - SECTOR 2","MUNICIPIUL BUCUREŞTI",179132,"BUCUREŞTI SECTORUL 2","ŞCOALA GIMNAZIALĂ NR. 27",198,"Alegeri Prezidentiale",1,1256,851,613,238,0,833,18,1400,549,588,245
43,"MUNICIPIUL BUCUREŞTI - SECTOR 2","MUNICIPIUL BUCUREŞTI",179132,"BUCUREŞTI SECTORUL 2","ŞCOALA GIMNAZIALĂ NR. 27",199,"Alegeri Prezidentiale",1,1331,806,664,142,0,782,24,1400,594,553,229
43,"MUNICIPIUL BUCUREŞTI - SECTOR 2","MUNICIPIUL BUCUREŞTI",179132,"BUCUREŞTI SECTORUL 2","ŞCOALA GIMNAZIALĂ NR. 27",200,"Alegeri Prezidentiale",1,1061,647,545,102,0,631,16,1200,553,459,172
43,"MUNICIPIUL BUCUREŞTI - SECTOR 2","MUNICIPIUL BUCUREŞTI",179132,"BUCUREŞTI SECTORUL 2","ŞCOALA GIMNAZIALĂ ”GRIGORE GHICA VOIEVOD”",201,"Alegeri Prezidentiale",1,1757,1006,891,115,0,984,22,2000,994,679,305
43,"MUNICIPIUL BUCUREŞTI - SECTOR 2","MUNICIPIUL BUCUREŞTI",179132,"BUCUREŞTI SECTORUL 2","ŞCOALA GIMNAZIALĂ ”GRIGORE GHICA VOIEVOD”",202,"Alegeri Prezidentiale",1,1543,933,788,145,0,911,22,1600,667,624,287
43,"MUNICIPIUL BUCUREŞTI - SECTOR 2","MUNICIPIUL BUCUREŞTI",179132,"BUCUREŞTI SECTORUL 2","ŞCOALA GIMNAZIALĂ ”GRIGORE GHICA VOIEVOD”",203,"Alegeri Prezidentiale",1,1873,1027,881,146,0,1009,18,2000,973,632,377
43,"MUNICIPIUL BUCUREŞTI - SECTOR 2","MUNICIPIUL BUCUREŞTI",179132,"BUCUREŞTI SECTORUL 2","ŞCOALA GIMNAZIALĂ ”GRIGORE GHICA VOIEVOD”",204,"Alegeri Prezidentiale",1,1843,959,833,126,0,935,24,2000,1041,620,315
43,"MUNICIPIUL BUCUREŞTI - SECTOR 2","MUNICIPIUL BUCUREŞTI",179132,"BUCUREŞTI SECTORUL 2","ŞCOALA GIMNAZIALĂ ”GRIGORE GHICA VOIEVOD”",205,"Alegeri Prezidentiale",1,1643,928,859,69,0,908,20,1800,872,597,311
43,"MUNICIPIUL BUCUREŞTI - SECTOR 2","MUNICIPIUL BUCUREŞTI",179132,"BUCUREŞTI SECTORUL 2","ŞCOALA GIMNAZIALĂ ”GRIGORE GHICA VOIEVOD”",206,"Alegeri Prezidentiale",1,1446,716,666,50,0,696,20,1600,884,465,231
43,"MUNICIPIUL BUCUREŞTI - SECTOR 2","MUNICIPIUL BUCUREŞTI",179132,"BUCUREŞTI SECTORUL 2","ŞCOALA GIMNAZIALĂ ”GRIGORE GHICA VOIEVOD”",207,"Alegeri Prezidentiale",1,1701,747,692,52,3,726,21,1800,1053,465,261
43,"MUNICIPIUL BUCUREŞTI - SECTOR 2","MUNICIPIUL BUCUREŞTI",179132,"BUCUREŞTI SECTORUL 2","GRĂDINIŢA NR. 233",208,"Alegeri Prezidentiale",1,1402,753,699,53,1,723,30,1592,839,494,229
43,"MUNICIPIUL BUCUREŞTI - SECTOR 2","MUNICIPIUL BUCUREŞTI",179132,"BUCUREŞTI SECTORUL 2","GRĂDINIŢA NR. 233",209,"Alegeri Prezidentiale",1,1263,827,674,152,1,802,25,1400,573,570,232
43,"MUNICIPIUL BUCUREŞTI - SECTOR 2","MUNICIPIUL BUCUREŞTI",179132,"BUCUREŞTI SECTORUL 2","ŞCOALA GIMNAZIALĂ NR. 39",210,"Alegeri Prezidentiale",1,1637,977,885,91,1,955,22,1801,824,637,318
43,"MUNICIPIUL BUCUREŞTI - SECTOR 2","MUNICIPIUL BUCUREŞTI",179132,"BUCUREŞTI SECTORUL 2","ŞCOALA GIMNAZIALĂ NR. 39",211,"Alegeri Prezidentiale",1,1377,831,704,126,1,811,20,1400,569,522,289
43,"MUNICIPIUL BUCUREŞTI - SECTOR 2","MUNICIPIUL BUCUREŞTI",179132,"BUCUREŞTI SECTORUL 2","ŞCOALA GIMNAZIALĂ NR. 39",212,"Alegeri Prezidentiale",2,1640,736,652,73,11,720,16,1792,1056,469,251
43,"MUNICIPIUL BUCUREŞTI - SECTOR 2","MUNICIPIUL BUCUREŞTI",179132,"BUCUREŞTI SECTORUL 2","ŞCOALA GIMNAZIALĂ NR. 39",213,"Alegeri Prezidentiale",1,1520,820,711,109,0,795,25,1600,780,542,253
43,"MUNICIPIUL BUCUREŞTI - SECTOR 2","MUNICIPIUL BUCUREŞTI",179132,"BUCUREŞTI SECTORUL 2","ŞCOALA GIMNAZIALĂ NR. 39",214,"Alegeri Prezidentiale",1,1581,859,799,60,0,845,14,1600,741,564,281
43,"MUNICIPIUL BUCUREŞTI - SECTOR 2","MUNICIPIUL BUCUREŞTI",179132,"BUCUREŞTI SECTORUL 2","ŞCOALA GIMNAZIALĂ NR. 39",215,"Alegeri Prezidentiale",1,1661,777,724,53,0,761,16,1808,1031,499,262
43,"MUNICIPIUL BUCUREŞTI - SECTOR 2","MUNICIPIUL BUCUREŞTI",179132,"BUCUREŞTI SECTORUL 2","ŞCOALA GIMNAZIALĂ NR. 39",216,"Alegeri Prezidentiale",1,1572,754,697,57,0,735,19,1600,846,460,275
43,"MUNICIPIUL BUCUREŞTI - SECTOR 2","MUNICIPIUL BUCUREŞTI",179132,"BUCUREŞTI SECTORUL 2","ŞCOALA GIMNAZIALĂ NR. 40",217,"Alegeri Prezidentiale",2,1719,792,690,102,0,770,22,2000,1208,513,257
43,"MUNICIPIUL BUCUREŞTI - SECTOR 2","MUNICIPIUL BUCUREŞTI",179132,"BUCUREŞTI SECTORUL 2","ŞCOALA GIMNAZIALĂ NR. 40",218,"Alegeri Prezidentiale",1,1735,896,847,49,0,876,20,1800,904,539,337
43,"MUNICIPIUL BUCUREŞTI - SECTOR 2","MUNICIPIUL BUCUREŞTI",179132,"BUCUREŞTI SECTORUL 2","ŞCOALA GIMNAZIALĂ NR. 40",219,"Alegeri Prezidentiale",1,1727,871,848,23,0,851,20,1800,929,539,312
43,"MUNICIPIUL BUCUREŞTI - SECTOR 2","MUNICIPIUL BUCUREŞTI",179132,"BUCUREŞTI SECTORUL 2","ŞCOALA GIMNAZIALĂ NR. 40",220,"Alegeri Prezidentiale",2,1625,773,734,39,0,751,22,1800,1027,469,282
43,"MUNICIPIUL BUCUREŞTI - SECTOR 2","MUNICIPIUL BUCUREŞTI",179132,"BUCUREŞTI SECTORUL 2","ŞCOALA GIMNAZIALĂ NR. 40",221,"Alegeri Prezidentiale",1,1956,963,937,26,0,943,20,2000,1037,602,341
43,"MUNICIPIUL BUCUREŞTI - SECTOR 2","MUNICIPIUL BUCUREŞTI",179132,"BUCUREŞTI SECTORUL 2","ŞCOALA GIMNAZIALĂ NR. 40",222,"Alegeri Prezidentiale",1,1916,857,819,37,1,837,20,2000,1143,543,294
43,"MUNICIPIUL BUCUREŞTI - SECTOR 2","MUNICIPIUL BUCUREŞTI",179132,"BUCUREŞTI SECTORUL 2","ŞCOALA GIMNAZIALĂ NR. 41",223,"Alegeri Prezidentiale",1,1687,819,756,62,1,807,12,1800,981,473,334
43,"MUNICIPIUL BUCUREŞTI - SECTOR 2","MUNICIPIUL BUCUREŞTI",179132,"BUCUREŞTI SECTORUL 2","ŞCOALA GIMNAZIALĂ NR. 41",224,"Alegeri Prezidentiale",1,1941,879,807,72,0,867,12,2000,1121,553,314
43,"MUNICIPIUL BUCUREŞTI - SECTOR 2","MUNICIPIUL BUCUREŞTI",179132,"BUCUREŞTI SECTORUL 2","ŞCOALA GIMNAZIALĂ NR. 41",225,"Alegeri Prezidentiale",1,1933,1002,939,62,1,980,22,2000,998,642,338
43,"MUNICIPIUL BUCUREŞTI - SECTOR 2","MUNICIPIUL BUCUREŞTI",179132,"BUCUREŞTI SECTORUL 2","ŞCOALA GIMNAZIALĂ NR. 32",226,"Alegeri Prezidentiale",1,1734,894,785,109,0,872,22,2000,1106,536,336
43,"MUNICIPIUL BUCUREŞTI - SECTOR 2","MUNICIPIUL BUCUREŞTI",179132,"BUCUREŞTI SECTORUL 2","ŞCOALA GIMNAZIALĂ NR. 32",227,"Alegeri Prezidentiale",1,1671,1008,826,0,182,986,22,1800,792,649,337
43,"MUNICIPIUL BUCUREŞTI - SECTOR 2","MUNICIPIUL BUCUREŞTI",179132,"BUCUREŞTI SECTORUL 2","ŞCOALA GIMNAZIALĂ NR. 32",228,"Alegeri Prezidentiale",1,1752,916,780,25,111,898,18,2007,1091,557,341
43,"MUNICIPIUL BUCUREŞTI - SECTOR 2","MUNICIPIUL BUCUREŞTI",179132,"BUCUREŞTI SECTORUL 2","ŞCOALA GIMNAZIALĂ NR. 32",229,"Alegeri Prezidentiale",2,1760,1088,823,36,229,1071,17,2000,912,647,424
43,"MUNICIPIUL BUCUREŞTI - SECTOR 2","MUNICIPIUL BUCUREŞTI",179132,"BUCUREŞTI SECTORUL 2","ŞCOALA GIMNAZIALĂ NR. 32",230,"Alegeri Prezidentiale",1,1249,692,571,121,0,673,19,1400,708,459,214
43,"MUNICIPIUL BUCUREŞTI - SECTOR 2","MUNICIPIUL BUCUREŞTI",179132,"BUCUREŞTI SECTORUL 2","COLEGIUL NAŢIONAL ”VICTOR BABEŞ”",231,"Alegeri Prezidentiale",1,1791,950,762,187,1,931,19,2000,1050,604,327
43,"MUNICIPIUL BUCUREŞTI - SECTOR 2","MUNICIPIUL BUCUREŞTI",179132,"BUCUREŞTI SECTORUL 2","COLEGIUL NAŢIONAL ”VICTOR BABEŞ”",232,"Alegeri Prezidentiale",1,1740,819,747,72,0,806,13,2000,1181,535,271
43,"MUNICIPIUL BUCUREŞTI - SECTOR 2","MUNICIPIUL BUCUREŞTI",179132,"BUCUREŞTI SECTORUL 2","COLEGIUL NAŢIONAL ”VICTOR BABEŞ”",233,"Alegeri Prezidentiale",1,2024,987,942,45,0,949,38,2200,1213,606,343
43,"MUNICIPIUL BUCUREŞTI - SECTOR 2","MUNICIPIUL BUCUREŞTI",179132,"BUCUREŞTI SECTORUL 2","COLEGIUL NAŢIONAL ”VICTOR BABEŞ”",234,"Alegeri Prezidentiale",2,2025,869,834,34,1,858,11,2199,1330,564,294
43,"MUNICIPIUL BUCUREŞTI - SECTOR 2","MUNICIPIUL BUCUREŞTI",179132,"BUCUREŞTI SECTORUL 2","ŞCOALA GIMNAZIALĂ NR. 25 ( FOSTA GRĂDINITĂ NR. 11)",235,"Alegeri Prezidentiale",2,1749,895,797,98,0,876,19,2000,1105,565,311
43,"MUNICIPIUL BUCUREŞTI - SECTOR 2","MUNICIPIUL BUCUREŞTI",179132,"BUCUREŞTI SECTORUL 2","ŞCOALA GIMNAZIALĂ NR. 25 ( FOSTA GRĂDINITĂ NR. 11)",236,"Alegeri Prezidentiale",1,1599,781,716,65,0,773,8,1800,1019,485,288
43,"MUNICIPIUL BUCUREŞTI - SECTOR 2","MUNICIPIUL BUCUREŞTI",179132,"BUCUREŞTI SECTORUL 2","ŞCOALA GIMNAZIALĂ NR. 145",237,"Alegeri Prezidentiale",1,2064,981,837,144,0,952,29,2200,1219,673,279
43,"MUNICIPIUL BUCUREŞTI - SECTOR 2","MUNICIPIUL BUCUREŞTI",179132,"BUCUREŞTI SECTORUL 2","ŞCOALA GIMNAZIALĂ NR. 145",238,"Alegeri Prezidentiale",1,1585,757,731,26,0,745,12,1600,843,485,260
43,"MUNICIPIUL BUCUREŞTI - SECTOR 2","MUNICIPIUL BUCUREŞTI",179132,"BUCUREŞTI SECTORUL 2","ŞCOALA GIMNAZIALĂ NR. 145",239,"Alegeri Prezidentiale",1,1686,766,731,35,0,741,25,1800,1034,458,283
43,"MUNICIPIUL BUCUREŞTI - SECTOR 2","MUNICIPIUL BUCUREŞTI",179132,"BUCUREŞTI SECTORUL 2","ŞCOALA GIMNAZIALĂ NR. 145",240,"Alegeri Prezidentiale",1,1795,668,633,35,0,655,13,2000,1332,420,235
43,"MUNICIPIUL BUCUREŞTI - SECTOR 2","MUNICIPIUL BUCUREŞTI",179132,"BUCUREŞTI SECTORUL 2","ŞCOALA GIMNAZIALĂ NR. 145",241,"Alegeri Prezidentiale",1,1652,844,752,90,2,825,19,1800,956,587,238
43,"MUNICIPIUL BUCUREŞTI - SECTOR 2","MUNICIPIUL BUCUREŞTI",179132,"BUCUREŞTI SECTORUL 2","ŞCOALA GIMNAZIALĂ NR. 145",242,"Alegeri Prezidentiale",1,1658,847,758,89,0,831,16,1800,953,570,261
43,"MUNICIPIUL BUCUREŞTI - SECTOR 2","MUNICIPIUL BUCUREŞTI",179132,"BUCUREŞTI SECTORUL 2","ŞCOALA GIMNAZIALĂ NR. 145",243,"Alegeri Prezidentiale",2,1767,781,735,46,0,767,14,1800,1019,470,297
43,"MUNICIPIUL BUCUREŞTI - SECTOR 2","MUNICIPIUL BUCUREŞTI",179132,"BUCUREŞTI SECTORUL 2","ŞCOALA GIMNAZIALĂ NR. 145",244,"Alegeri Prezidentiale",1,1566,515,495,20,0,507,8,1600,1085,312,195
43,"MUNICIPIUL BUCUREŞTI - SECTOR 2","MUNICIPIUL BUCUREŞTI",179132,"BUCUREŞTI SECTORUL 2","ŞCOALA GIMNAZIALĂ NR. 62",245,"Alegeri Prezidentiale",1,1629,853,732,121,0,828,25,1401,548,482,346
43,"MUNICIPIUL BUCUREŞTI - SECTOR 2","MUNICIPIUL BUCUREŞTI",179132,"BUCUREŞTI SECTORUL 2","ŞCOALA GIMNAZIALĂ NR. 62",246,"Alegeri Prezidentiale",1,1339,569,538,31,0,555,14,1400,831,323,232
43,"MUNICIPIUL BUCUREŞTI - SECTOR 2","MUNICIPIUL BUCUREŞTI",179132,"BUCUREŞTI SECTORUL 2","ŞCOALA GIMNAZIALĂ NR. 62",247,"Alegeri Prezidentiale",1,1319,742,701,39,2,725,17,1400,658,451,274
43,"MUNICIPIUL BUCUREŞTI - SECTOR 2","MUNICIPIUL BUCUREŞTI",179132,"BUCUREŞTI SECTORUL 2","ŞCOALA GIMNAZIALĂ NR. 62",248,"Alegeri Prezidentiale",2,1570,811,764,45,2,786,25,1600,789,485,301
43,"MUNICIPIUL BUCUREŞTI - SECTOR 2","MUNICIPIUL BUCUREŞTI",179132,"BUCUREŞTI SECTORUL 2","ŞCOALA GIMNAZIALĂ NR. 62",249,"Alegeri Prezidentiale",1,1472,666,643,21,2,646,20,1600,934,415,231
43,"MUNICIPIUL BUCUREŞTI - SECTOR 2","MUNICIPIUL BUCUREŞTI",179132,"BUCUREŞTI SECTORUL 2","ŞCOALA GIMNAZIALĂ NR. 62",250,"Alegeri Prezidentiale",1,1303,717,678,39,0,705,12,1400,683,408,297
43,"MUNICIPIUL BUCUREŞTI - SECTOR 2","MUNICIPIUL BUCUREŞTI",179132,"BUCUREŞTI SECTORUL 2","ŞCOALA GIMNAZIALĂ NR. 62",251,"Alegeri Prezidentiale",1,1123,577,518,59,0,568,9,1208,631,360,208
43,"MUNICIPIUL BUCUREŞTI - SECTOR 2","MUNICIPIUL BUCUREŞTI",179132,"BUCUREŞTI SECTORUL 2","LICEUL TEHNOLOGIC ”SF. PANTELIMON”",252,"Alegeri Prezidentiale",1,1834,1042,968,73,1,1021,21,1998,956,662,359
43,"MUNICIPIUL BUCUREŞTI - SECTOR 2","MUNICIPIUL BUCUREŞTI",179132,"BUCUREŞTI SECTORUL 2","LICEUL TEHNOLOGIC ”SF. PANTELIMON”",253,"Alegeri Prezidentiale",1,1306,779,706,73,0,764,15,1400,621,526,238
43,"MUNICIPIUL BUCUREŞTI - SECTOR 2","MUNICIPIUL BUCUREŞTI",179132,"BUCUREŞTI SECTORUL 2","LICEUL TEHNOLOGIC ”SF. PANTELIMON”",254,"Alegeri Prezidentiale",1,1341,718,666,52,0,708,10,1400,682,417,291
43,"MUNICIPIUL BUCUREŞTI - SECTOR 2","MUNICIPIUL BUCUREŞTI",179132,"BUCUREŞTI SECTORUL 2","LICEUL TEHNOLOGIC ”SF. PANTELIMON”",255,"Alegeri Prezidentiale",2,1607,830,790,40,0,809,21,1800,970,575,234
43,"MUNICIPIUL BUCUREŞTI - SECTOR 2","MUNICIPIUL BUCUREŞTI",179132,"BUCUREŞTI SECTORUL 2","ŞCOALA GIMNAZIALĂ NR. 51",256,"Alegeri Prezidentiale",1,1463,944,774,170,0,921,23,1808,864,620,301
43,"MUNICIPIUL BUCUREŞTI - SECTOR 2","MUNICIPIUL BUCUREŞTI",179132,"BUCUREŞTI SECTORUL 2","ŞCOALA GIMNAZIALĂ NR. 51",257,"Alegeri Prezidentiale",1,1531,691,572,118,1,680,11,1600,909,451,229
43,"MUNICIPIUL BUCUREŞTI - SECTOR 2","MUNICIPIUL BUCUREŞTI",179132,"BUCUREŞTI SECTORUL 2","ŞCOALA GIMNAZIALĂ NR. 51",258,"Alegeri Prezidentiale",1,1365,773,699,74,0,766,7,1400,627,454,312
43,"MUNICIPIUL BUCUREŞTI - SECTOR 2","MUNICIPIUL BUCUREŞTI",179132,"BUCUREŞTI SECTORUL 2","GRADINIŢA NR. 280",259,"Alegeri Prezidentiale",1,1298,771,646,125,0,752,19,1600,829,528,224
43,"MUNICIPIUL BUCUREŞTI - SECTOR 2","MUNICIPIUL BUCUREŞTI",179132,"BUCUREŞTI SECTORUL 2","GRADINIŢA NR. 280",260,"Alegeri Prezidentiale",2,1875,952,854,90,8,938,14,1999,1047,663,275
43,"MUNICIPIUL BUCUREŞTI - SECTOR 2","MUNICIPIUL BUCUREŞTI",179132,"BUCUREŞTI SECTORUL 2","ŞCOALA GIMNAZIALĂ NR. 77",261,"Alegeri Prezidentiale",1,1442,688,638,50,0,679,9,1600,912,439,240
43,"MUNICIPIUL BUCUREŞTI - SECTOR 2","MUNICIPIUL BUCUREŞTI",179132,"BUCUREŞTI SECTORUL 2","ŞCOALA GIMNAZIALĂ NR. 77",262,"Alegeri Prezidentiale",1,1433,786,758,28,0,772,14,1600,814,496,276
43,"MUNICIPIUL BUCUREŞTI - SECTOR 2","MUNICIPIUL BUCUREŞTI",179132,"BUCUREŞTI SECTORUL 2","ŞCOALA GIMNAZIALĂ NR. 77",263,"Alegeri Prezidentiale",1,1549,885,801,84,0,865,20,1600,715,558,307
43,"MUNICIPIUL BUCUREŞTI - SECTOR 2","MUNICIPIUL BUCUREŞTI",179132,"BUCUREŞTI SECTORUL 2","ŞCOALA GIMNAZIALĂ NR. 77",264,"Alegeri Prezidentiale",1,1555,966,865,101,0,944,22,1800,834,638,306
43,"MUNICIPIUL BUCUREŞTI - SECTOR 2","MUNICIPIUL BUCUREŞTI",179132,"BUCUREŞTI SECTORUL 2","ŞCOALA GIMNAZIALĂ NR. 77",265,"Alegeri Prezidentiale",2,2018,1109,960,40,109,1074,35,2200,1091,620,454
43,"MUNICIPIUL BUCUREŞTI - SECTOR 2","MUNICIPIUL BUCUREŞTI",179132,"BUCUREŞTI SECTORUL 2","ŞCOALA GIMNAZIALĂ NR. 77",266,"Alegeri Prezidentiale",1,1529,777,741,36,0,763,14,1600,823,464,299
43,"MUNICIPIUL BUCUREŞTI - SECTOR 2","MUNICIPIUL BUCUREŞTI",179132,"BUCUREŞTI SECTORUL 2","LICEUL TEORETIC ”LUCIAN BLAGA”",267,"Alegeri Prezidentiale",1,1666,787,771,16,0,776,11,1800,1013,497,279
43,"MUNICIPIUL BUCUREŞTI - SECTOR 2","MUNICIPIUL BUCUREŞTI",179132,"BUCUREŞTI SECTORUL 2","LICEUL TEORETIC ”LUCIAN BLAGA”",268,"Alegeri Prezidentiale",1,1839,611,560,51,0,603,8,2000,1389,372,231
43,"MUNICIPIUL BUCUREŞTI - SECTOR 2","MUNICIPIUL BUCUREŞTI",179132,"BUCUREŞTI SECTORUL 2","LICEUL TEORETIC ”LUCIAN BLAGA”",269,"Alegeri Prezidentiale",1,1828,1025,889,136,0,1004,21,2000,975,623,381
43,"MUNICIPIUL BUCUREŞTI - SECTOR 2","MUNICIPIUL BUCUREŞTI",179132,"BUCUREŞTI SECTORUL 2","LICEUL TEORETIC ”LUCIAN BLAGA”",270,"Alegeri Prezidentiale",1,1839,841,770,71,0,814,27,2000,1159,476,338
43,"MUNICIPIUL BUCUREŞTI - SECTOR 2","MUNICIPIUL BUCUREŞTI",179132,"BUCUREŞTI SECTORUL 2","LICEUL TEORETIC ”LUCIAN BLAGA”",271,"Alegeri Prezidentiale",1,1897,850,799,51,0,815,35,2000,1150,506,309
43,"MUNICIPIUL BUCUREŞTI - SECTOR 2","MUNICIPIUL BUCUREŞTI",179132,"BUCUREŞTI SECTORUL 2","ŞCOALA GIMNAZIALĂ NR. 66",272,"Alegeri Prezidentiale",1,1759,852,799,53,0,838,14,2000,1148,503,335
43,"MUNICIPIUL BUCUREŞTI - SECTOR 2","MUNICIPIUL BUCUREŞTI",179132,"BUCUREŞTI SECTORUL 2","ŞCOALA GIMNAZIALĂ NR. 66",273,"Alegeri Prezidentiale",1,1215,734,605,75,54,713,21,1600,866,421,292
43,"MUNICIPIUL BUCUREŞTI - SECTOR 2","MUNICIPIUL BUCUREŞTI",179132,"BUCUREŞTI SECTORUL 2","ŞCOALA GIMNAZIALĂ NR. 66",274,"Alegeri Prezidentiale",1,1590,701,665,36,0,684,17,1600,899,427,257
43,"MUNICIPIUL BUCUREŞTI - SECTOR 2","MUNICIPIUL BUCUREŞTI",179132,"BUCUREŞTI SECTORUL 2","ŞCOALA GIMNAZIALĂ NR. 66",275,"Alegeri Prezidentiale",1,1324,724,689,35,0,710,14,1392,668,447,263
43,"MUNICIPIUL BUCUREŞTI - SECTOR 2","MUNICIPIUL BUCUREŞTI",179132,"BUCUREŞTI SECTORUL 2","ŞCOALA GIMNAZIALĂ NR. 66",276,"Alegeri Prezidentiale",1,1828,835,810,25,0,813,22,2000,1165,513,300
43,"MUNICIPIUL BUCUREŞTI - SECTOR 2","MUNICIPIUL BUCUREŞTI",179132,"BUCUREŞTI SECTORUL 2","GRADINIŢA NR. 189",277,"Alegeri Prezidentiale",2,1030,570,522,47,1,563,7,1200,630,344,219
43,"MUNICIPIUL BUCUREŞTI - SECTOR 2","MUNICIPIUL BUCUREŞTI",179132,"BUCUREŞTI SECTORUL 2","GRADINIŢA NR. 189",278,"Alegeri Prezidentiale",2,1023,570,548,22,0,562,8,1200,630,336,226
43,"MUNICIPIUL BUCUREŞTI - SECTOR 2","MUNICIPIUL BUCUREŞTI",179132,"BUCUREŞTI SECTORUL 2","COLEGUL TEHNIC ”DIMITRIE LEONIDA”",279,"Alegeri Prezidentiale",1,1044,680,556,123,1,674,6,1192,512,466,208
43,"MUNICIPIUL BUCUREŞTI - SECTOR 2","MUNICIPIUL BUCUREŞTI",179132,"BUCUREŞTI SECTORUL 2","COLEGUL TEHNIC ”DIMITRIE LEONIDA”",280,"Alegeri Prezidentiale",1,1362,859,726,133,0,843,16,1400,541,552,291
43,"MUNICIPIUL BUCUREŞTI - SECTOR 2","MUNICIPIUL BUCUREŞTI",179132,"BUCUREŞTI SECTORUL 2","ŞCOALA GIMNAZIALĂ ”PETRE GHELMEZ”",281,"Alegeri Prezidentiale",1,1636,894,807,87,0,873,21,1800,906,573,300
43,"MUNICIPIUL BUCUREŞTI - SECTOR 2","MUNICIPIUL BUCUREŞTI",179132,"BUCUREŞTI SECTORUL 2","ŞCOALA GIMNAZIALĂ ”PETRE GHELMEZ”",282,"Alegeri Prezidentiale",1,1722,889,837,52,0,855,34,1800,911,511,344
43,"MUNICIPIUL BUCUREŞTI - SECTOR 2","MUNICIPIUL BUCUREŞTI",179132,"BUCUREŞTI SECTORUL 2","ŞCOALA GIMNAZIALĂ ”PETRE GHELMEZ”",283,"Alegeri Prezidentiale",1,1642,1000,894,105,1,975,25,1800,800,751,224
43,"MUNICIPIUL BUCUREŞTI - SECTOR 2","MUNICIPIUL BUCUREŞTI",179132,"BUCUREŞTI SECTORUL 2","ŞCOALA GIMNAZIALĂ ”PETRE GHELMEZ”",284,"Alegeri Prezidentiale",1,1307,700,623,77,0,682,18,1400,700,411,271
43,"MUNICIPIUL BUCUREŞTI - SECTOR 2","MUNICIPIUL BUCUREŞTI",179132,"BUCUREŞTI SECTORUL 2","ŞCOALA GIMNAZIALĂ ”PETRE GHELMEZ”",285,"Alegeri Prezidentiale",1,1698,896,848,48,0,881,15,1800,904,523,358
43,"MUNICIPIUL BUCUREŞTI - SECTOR 2","MUNICIPIUL BUCUREŞTI",179132,"BUCUREŞTI SECTORUL 2","ŞCOALA GIMNAZIALĂ ”PETRE GHELMEZ”",286,"Alegeri Prezidentiale",1,1524,898,813,84,1,871,27,1616,718,602,269
43,"MUNICIPIUL BUCUREŞTI - SECTOR 2","MUNICIPIUL BUCUREŞTI",179132,"BUCUREŞTI SECTORUL 2","ŞCOALA GIMNAZIALĂ NR. 4",287,"Alegeri Prezidentiale",2,1657,1000,893,106,1,980,20,1800,800,623,357
43,"MUNICIPIUL BUCUREŞTI - SECTOR 2","MUNICIPIUL BUCUREŞTI",179132,"BUCUREŞTI SECTORUL 2","ŞCOALA GIMNAZIALĂ NR. 4",288,"Alegeri Prezidentiale",1,1683,941,850,91,0,908,33,1800,859,574,334
43,"MUNICIPIUL BUCUREŞTI - SECTOR 2","MUNICIPIUL BUCUREŞTI",179132,"BUCUREŞTI SECTORUL 2","ŞCOALA GIMNAZIALĂ NR. 4",289,"Alegeri Prezidentiale",2,1798,964,892,72,0,938,26,2000,1036,607,331
43,"MUNICIPIUL BUCUREŞTI - SECTOR 2","MUNICIPIUL BUCUREŞTI",179132,"BUCUREŞTI SECTORUL 2","ŞCOALA GIMNAZIALĂ NR. 4",290,"Alegeri Prezidentiale",2,1910,1024,965,59,0,998,26,2000,976,662,336
43,"MUNICIPIUL BUCUREŞTI - SECTOR 2","MUNICIPIUL BUCUREŞTI",179132,"BUCUREŞTI SECTORUL 2","ŞCOALA GIMNAZIALĂ NR. 4",291,"Alegeri Prezidentiale",1,1442,765,722,43,0,753,12,1600,835,473,280
43,"MUNICIPIUL BUCUREŞTI - SECTOR 2","MUNICIPIUL BUCUREŞTI",179132,"BUCUREŞTI SECTORUL 2","ŞCOALA GIMNAZIALĂ NR. 25",292,"Alegeri Prezidentiale",1,1777,996,880,114,2,976,20,2000,1004,625,351
43,"MUNICIPIUL BUCUREŞTI - SECTOR 2","MUNICIPIUL BUCUREŞTI",179132,"BUCUREŞTI SECTORUL 2","ŞCOALA GIMNAZIALĂ NR. 25",293,"Alegeri Prezidentiale",1,1901,990,881,109,0,960,30,2000,1010,650,310
43,"MUNICIPIUL BUCUREŞTI - SECTOR 2","MUNICIPIUL BUCUREŞTI",179132,"BUCUREŞTI SECTORUL 2","ŞCOALA GIMNAZIALĂ NR. 25",294,"Alegeri Prezidentiale",1,1821,907,854,53,0,892,15,1992,1085,564,328
43,"MUNICIPIUL BUCUREŞTI - SECTOR 2","MUNICIPIUL BUCUREŞTI",179132,"BUCUREŞTI SECTORUL 2","ŞCOALA GIMNAZIALĂ NR. 25",295,"Alegeri Prezidentiale",2,2116,1154,1082,72,0,1133,21,2200,1046,851,282
43,"MUNICIPIUL BUCUREŞTI - SECTOR 2","MUNICIPIUL BUCUREŞTI",179132,"BUCUREŞTI SECTORUL 2","ŞCOALA GIMNAZIALĂ ”FERDINAND I” (FOSTA ȘCOALĂ NR. 64)",296,"Alegeri Prezidentiale",1,1452,794,712,82,0,782,12,1600,806,495,287
43,"MUNICIPIUL BUCUREŞTI - SECTOR 2","MUNICIPIUL BUCUREŞTI",179132,"BUCUREŞTI SECTORUL 2","ŞCOALA GIMNAZIALĂ ”FERDINAND I” (FOSTA ȘCOALĂ NR. 64)",297,"Alegeri Prezidentiale",1,1394,750,679,68,3,729,21,1600,850,480,249
43,"MUNICIPIUL BUCUREŞTI - SECTOR 2","MUNICIPIUL BUCUREŞTI",179132,"BUCUREŞTI SECTORUL 2","ŞCOALA GIMNAZIALĂ ”FERDINAND I” (FOSTA ȘCOALĂ NR. 64)",298,"Alegeri Prezidentiale",1,1197,690,570,120,0,670,20,1200,510,438,232
43,"MUNICIPIUL BUCUREŞTI - SECTOR 2","MUNICIPIUL BUCUREŞTI",179132,"BUCUREŞTI SECTORUL 2","ŞCOALA GIMNAZIALĂ ”FERDINAND I” (FOSTA ȘCOALĂ NR. 64)",299,"Alegeri Prezidentiale",1,1854,849,803,46,0,834,15,2000,1151,552,282
43,"MUNICIPIUL BUCUREŞTI - SECTOR 2","MUNICIPIUL BUCUREŞTI",179132,"BUCUREŞTI SECTORUL 2","ŞCOALA GIMNAZIALĂ ”FERDINAND I” (FOSTA ȘCOALĂ NR. 64)",300,"Alegeri Prezidentiale",1,1410,686,559,127,0,676,10,1600,914,420,256
43,"MUNICIPIUL BUCUREŞTI - SECTOR 2","MUNICIPIUL BUCUREŞTI",179132,"BUCUREŞTI SECTORUL 2","LICEUL TEHNOLOGIC ELECTRONICA INDUSTRIALĂ",301,"Alegeri Prezidentiale",1,1581,904,804,100,0,882,22,1600,696,578,304
43,"MUNICIPIUL BUCUREŞTI - SECTOR 2","MUNICIPIUL BUCUREŞTI",179132,"BUCUREŞTI SECTORUL 2","LICEUL TEHNOLOGIC ELECTRONICA INDUSTRIALĂ",302,"Alegeri Prezidentiale",2,1498,748,698,50,0,743,5,1600,852,470,273
43,"MUNICIPIUL BUCUREŞTI - SECTOR 2","MUNICIPIUL BUCUREŞTI",179132,"BUCUREŞTI SECTORUL 2","LICEUL TEHNOLOGIC ELECTRONICA INDUSTRIALĂ",303,"Alegeri Prezidentiale",1,1216,617,583,34,0,608,9,1400,783,401,207
43,"MUNICIPIUL BUCUREŞTI - SECTOR 2","MUNICIPIUL BUCUREŞTI",179132,"BUCUREŞTI SECTORUL 2","COLEGIUL NAŢIONAL ”IULIA HAŞDEU”",304,"Alegeri Prezidentiale",1,1365,1032,709,322,1,1011,21,1600,568,675,336
43,"MUNICIPIUL BUCUREŞTI - SECTOR 2","MUNICIPIUL BUCUREŞTI",179132,"BUCUREŞTI SECTORUL 2","COLEGIUL NAŢIONAL ”IULIA HAŞDEU”",305,"Alegeri Prezidentiale",1,1395,954,644,310,0,935,19,1400,446,684,251
43,"MUNICIPIUL BUCUREŞTI - SECTOR 2","MUNICIPIUL BUCUREŞTI",179132,"BUCUREŞTI SECTORUL 2","COLEGIUL NAŢIONAL ”IULIA HAŞDEU”",306,"Alegeri Prezidentiale",1,1509,1007,739,267,1,979,28,1600,593,696,283
43,"MUNICIPIUL BUCUREŞTI - SECTOR 2","MUNICIPIUL BUCUREŞTI",179132,"BUCUREŞTI SECTORUL 2","LICEUL TEHNOLOGIC ”I.C. BRĂTIANU” (FOST LICEUL TEHNOLOGIC MECANICĂ FINĂ)",307,"Alegeri Prezidentiale",2,1388,804,735,69,0,783,21,1591,787,554,229
43,"MUNICIPIUL BUCUREŞTI - SECTOR 2","MUNICIPIUL BUCUREŞTI",179132,"BUCUREŞTI SECTORUL 2","LICEUL TEHNOLOGIC ”I.C. BRĂTIANU” (FOST LICEUL TEHNOLOGIC MECANICĂ FINĂ)",308,"Alegeri Prezidentiale",1,1174,747,616,131,0,735,12,1200,453,487,248
43,"MUNICIPIUL BUCUREŞTI - SECTOR 2","MUNICIPIUL BUCUREŞTI",179132,"BUCUREŞTI SECTORUL 2","LICEUL TEHNOLOGIC ”I.C. BRĂTIANU” (FOST LICEUL TEHNOLOGIC MECANICĂ FINĂ)",309,"Alegeri Prezidentiale",1,1057,590,507,83,0,568,22,1200,610,397,171
43,"MUNICIPIUL BUCUREŞTI - SECTOR 2","MUNICIPIUL BUCUREŞTI",179132,"BUCUREŞTI SECTORUL 2","LICEUL TEHNOLOGIC ”I.C. BRĂTIANU” (FOST LICEUL TEHNOLOGIC MECANICĂ FINĂ)",310,"Alegeri Prezidentiale",1,1633,888,807,81,0,872,16,1800,912,603,269
43,"MUNICIPIUL BUCUREŞTI - SECTOR 2","MUNICIPIUL BUCUREŞTI",179132,"BUCUREŞTI SECTORUL 2","CLUB SPORTIV ŞCOLAR NR. 2",311,"Alegeri Prezidentiale",1,1555,1096,775,321,0,1073,23,1800,704,773,300
43,"MUNICIPIUL BUCUREŞTI - SECTOR 2","MUNICIPIUL BUCUREŞTI",179132,"BUCUREŞTI SECTORUL 2","CLUB SPORTIV ŞCOLAR NR. 2",312,"Alegeri Prezidentiale",1,1406,918,733,185,0,899,19,1600,682,641,258
43,"MUNICIPIUL BUCUREŞTI - SECTOR 2","MUNICIPIUL BUCUREŞTI",179132,"BUCUREŞTI SECTORUL 2","GRĂDINIȚA CLOPOȚEL (FOSTA GRADINIŢA NR. 201)",313,"Alegeri Prezidentiale",1,1385,824,721,103,0,802,22,1600,776,533,269
43,"MUNICIPIUL BUCUREŞTI - SECTOR 2","MUNICIPIUL BUCUREŞTI",179132,"BUCUREŞTI SECTORUL 2","GRĂDINIȚA CLOPOȚEL (FOSTA GRADINIŢA NR. 201)",314,"Alegeri Prezidentiale",1,1578,954,879,74,1,929,25,1800,846,576,353
43,"MUNICIPIUL BUCUREŞTI - SECTOR 2","MUNICIPIUL BUCUREŞTI",179132,"BUCUREŞTI SECTORUL 2","GRĂDINIȚA CLOPOȚEL (FOSTA GRADINIŢA NR. 201)",315,"Alegeri Prezidentiale",1,1343,755,674,81,0,729,26,1600,845,503,226
43,"MUNICIPIUL BUCUREŞTI - SECTOR 2","MUNICIPIUL BUCUREŞTI",179132,"BUCUREŞTI SECTORUL 2","GRĂDINIȚA CLOPOȚEL (FOSTA GRADINIŢA NR. 201)",316,"Alegeri Prezidentiale",1,1254,744,655,89,0,739,5,1400,656,507,232
43,"MUNICIPIUL BUCUREŞTI - SECTOR 2","MUNICIPIUL BUCUREŞTI",179132,"BUCUREŞTI SECTORUL 2","COLEGIUL NAŢIONAL ”EMIL RACOVIŢĂ”",317,"Alegeri Prezidentiale",1,1463,985,777,207,1,963,22,1800,815,646,317
43,"MUNICIPIUL BUCUREŞTI - SECTOR 2","MUNICIPIUL BUCUREŞTI",179132,"BUCUREŞTI SECTORUL 2","COLEGIUL NAŢIONAL ”EMIL RACOVIŢĂ”",318,"Alegeri Prezidentiale",1,1061,812,569,155,88,787,25,1399,587,563,224
43,"MUNICIPIUL BUCUREŞTI - SECTOR 2","MUNICIPIUL BUCUREŞTI",179132,"BUCUREŞTI SECTORUL 2","COLEGIUL NAŢIONAL ”EMIL RACOVIŢĂ”",319,"Alegeri Prezidentiale",2,1803,1056,866,153,37,1029,27,2000,944,740,289
43,"MUNICIPIUL BUCUREŞTI - SECTOR 2","MUNICIPIUL BUCUREŞTI",179132,"BUCUREŞTI SECTORUL 2","GRĂDINIŢA LUMINIȚA (FOSTA GRADINITA NR. 16)",320,"Alegeri Prezidentiale",1,1255,879,687,192,0,858,21,1400,521,602,256
43,"MUNICIPIUL BUCUREŞTI - SECTOR 2","MUNICIPIUL BUCUREŞTI",179132,"BUCUREŞTI SECTORUL 2","GRĂDINIŢA LUMINIȚA (FOSTA GRADINITA NR. 16)",321,"Alegeri Prezidentiale",1,1197,778,685,93,0,763,15,1400,622,560,203
43,"MUNICIPIUL BUCUREŞTI - SECTOR 2","MUNICIPIUL BUCUREŞTI",179132,"BUCUREŞTI SECTORUL 2","GRĂDINIŢA NR. 256",322,"Alegeri Prezidentiale",1,1539,926,845,78,3,904,22,1584,658,639,265
43,"MUNICIPIUL BUCUREŞTI - SECTOR 2","MUNICIPIUL BUCUREŞTI",179132,"BUCUREŞTI SECTORUL 2","ŞCOALA GIMNAZIALĂ NR. 49",323,"Alegeri Prezidentiale",1,1192,848,703,144,1,839,9,1408,560,604,235
43,"MUNICIPIUL BUCUREŞTI - SECTOR 2","MUNICIPIUL BUCUREŞTI",179132,"BUCUREŞTI SECTORUL 2","ŞCOALA GIMNAZIALĂ NR. 49",324,"Alegeri Prezidentiale",1,1158,826,676,149,1,811,15,1400,574,583,228
43,"MUNICIPIUL BUCUREŞTI - SECTOR 2","MUNICIPIUL BUCUREŞTI",179132,"BUCUREŞTI SECTORUL 2","ŞCOALA GIMNAZIALĂ NR. 46",325,"Alegeri Prezidentiale",1,1436,886,702,184,0,862,24,1600,714,594,268
43,"MUNICIPIUL BUCUREŞTI - SECTOR 2","MUNICIPIUL BUCUREŞTI",179132,"BUCUREŞTI SECTORUL 2","ŞCOALA GIMNAZIALĂ NR. 46",326,"Alegeri Prezidentiale",1,1536,904,726,175,3,886,18,1600,696,581,305
43,"MUNICIPIUL BUCUREŞTI - SECTOR 2","MUNICIPIUL BUCUREŞTI",179132,"BUCUREŞTI SECTORUL 2","ŞCOALA GIMNAZIALĂ NR. 46",327,"Alegeri Prezidentiale",1,1569,932,841,91,0,914,18,1600,668,564,350
43,"MUNICIPIUL BUCUREŞTI - SECTOR 2","MUNICIPIUL BUCUREŞTI",179132,"BUCUREŞTI SECTORUL 2","ŞCOALA GIMNAZIALĂ NR. 46",328,"Alegeri Prezidentiale",1,1841,1146,1066,80,0,1113,33,2000,854,714,399
43,"MUNICIPIUL BUCUREŞTI - SECTOR 2","MUNICIPIUL BUCUREŞTI",179132,"BUCUREŞTI SECTORUL 2","ŞCOALA GIMNAZIALĂ TUDOR ARGHEZI (FOSTA ȘCOALĂ NR. 19)",329,"Alegeri Prezidentiale",1,1047,693,488,204,1,675,18,1200,507,488,187
43,"MUNICIPIUL BUCUREŞTI - SECTOR 2","MUNICIPIUL BUCUREŞTI",179132,"BUCUREŞTI SECTORUL 2","ŞCOALA GIMNAZIALĂ TUDOR ARGHEZI (FOSTA ȘCOALĂ NR. 19)",330,"Alegeri Prezidentiale",2,904,557,432,123,2,543,14,991,434,405,138
43,"MUNICIPIUL BUCUREŞTI - SECTOR 2","MUNICIPIUL BUCUREŞTI",179132,"BUCUREŞTI SECTORUL 2","COLEGIUL NAŢIONAL ”SPIRU HARET”",331,"Alegeri Prezidentiale",2,1151,840,505,266,69,826,14,1400,560,614,212
43,"MUNICIPIUL BUCUREŞTI - SECTOR 2","MUNICIPIUL BUCUREŞTI",179132,"BUCUREŞTI SECTORUL 2","COLEGIUL NAŢIONAL ”SPIRU HARET”",332,"Alegeri Prezidentiale",1,1144,627,522,103,2,599,28,1392,765,426,173
43,"MUNICIPIUL BUCUREŞTI - SECTOR 2","MUNICIPIUL BUCUREŞTI",179132,"BUCUREŞTI SECTORUL 2","COLEGIUL NAŢIONAL ”CANTEMIR VODĂ”",333,"Alegeri Prezidentiale",1,951,768,451,222,95,754,14,1000,232,558,196
43,"MUNICIPIUL BUCUREŞTI - SECTOR 2","MUNICIPIUL BUCUREŞTI",179132,"BUCUREŞTI SECTORUL 2","COLEGIUL NAŢIONAL ”CANTEMIR VODĂ”",334,"Alegeri Prezidentiale",1,1170,707,595,64,48,677,30,1400,693,476,201
43,"MUNICIPIUL BUCUREŞTI - SECTOR 2","MUNICIPIUL BUCUREŞTI",179132,"BUCUREŞTI SECTORUL 2","COLEGIUL NAŢIONAL ”CANTEMIR VODĂ”",335,"Alegeri Prezidentiale",1,1208,643,547,94,2,621,22,1400,757,406,215
43,"MUNICIPIUL BUCUREŞTI - SECTOR 2","MUNICIPIUL BUCUREŞTI",179132,"BUCUREŞTI SECTORUL 2","COLEGIUL NAŢIONAL ”CANTEMIR VODĂ”",336,"Alegeri Prezidentiale",1,1512,787,719,68,0,771,16,1600,813,514,257
43,"MUNICIPIUL BUCUREŞTI - SECTOR 2","MUNICIPIUL BUCUREŞTI",179132,"BUCUREŞTI SECTORUL 2","ŞCOALA GIMNAZIALĂ NR. 24",337,"Alegeri Prezidentiale",1,1768,1025,834,189,2,1004,21,2000,975,718,286
43,"MUNICIPIUL BUCUREŞTI - SECTOR 2","MUNICIPIUL BUCUREŞTI",179132,"BUCUREŞTI SECTORUL 2","ŞCOALA GIMNAZIALĂ NR. 24",338,"Alegeri Prezidentiale",1,1557,948,784,157,7,929,19,1600,652,640,289
43,"MUNICIPIUL BUCUREŞTI - SECTOR 2","MUNICIPIUL BUCUREŞTI",179132,"BUCUREŞTI SECTORUL 2","ŞCOALA GIMNAZIALĂ NR. 24",339,"Alegeri Prezidentiale",1,1383,737,616,121,0,709,28,1400,663,501,208
43,"MUNICIPIUL BUCUREŞTI - SECTOR 2","MUNICIPIUL BUCUREŞTI",179132,"BUCUREŞTI SECTORUL 2","ŞCOALA GIMNAZIALĂ NR. 24",340,"Alegeri Prezidentiale",1,1387,741,647,92,2,723,18,1600,859,502,221
43,"MUNICIPIUL BUCUREŞTI - SECTOR 2","MUNICIPIUL BUCUREŞTI",179132,"BUCUREŞTI SECTORUL 2","ȘCOALA GIMNAZIALĂ ”MAICA DOMNULUI” (FOSTA ŞCOALA NR. 26)",341,"Alegeri Prezidentiale",1,1182,602,530,72,0,592,10,1400,798,391,201
43,"MUNICIPIUL BUCUREŞTI - SECTOR 2","MUNICIPIUL BUCUREŞTI",179132,"BUCUREŞTI SECTORUL 2","ȘCOALA GIMNAZIALĂ ”MAICA DOMNULUI” (FOSTA ŞCOALA NR. 26)",342,"Alegeri Prezidentiale",1,1324,774,710,64,0,757,17,1400,626,487,270
43,"MUNICIPIUL BUCUREŞTI - SECTOR 2","MUNICIPIUL BUCUREŞTI",179132,"BUCUREŞTI SECTORUL 2","ŞCOALA PROFESIONALĂ SPECIALĂ NR. 3",343,"Alegeri Prezidentiale",1,1543,810,700,110,0,795,15,1600,790,528,267
43,"MUNICIPIUL BUCUREŞTI - SECTOR 2","MUNICIPIUL BUCUREŞTI",179132,"BUCUREŞTI SECTORUL 2","ŞCOALA PROFESIONALĂ SPECIALĂ NR. 3",344,"Alegeri Prezidentiale",1,1313,622,570,52,0,609,13,1400,778,427,182
43,"MUNICIPIUL BUCUREŞTI - SECTOR 2","MUNICIPIUL BUCUREŞTI",179132,"BUCUREŞTI SECTORUL 2","ŞCOALA GIMNAZIALĂ NR. 307",345,"Alegeri Prezidentiale",1,1341,934,738,195,1,904,30,1400,466,657,247
43,"MUNICIPIUL BUCUREŞTI - SECTOR 2","MUNICIPIUL BUCUREŞTI",179132,"BUCUREŞTI SECTORUL 2","ŞCOALA GIMNAZIALĂ NR. 307",346,"Alegeri Prezidentiale",1,1025,708,440,267,1,693,15,1200,492,504,189
43,"MUNICIPIUL BUCUREŞTI - SECTOR 2","MUNICIPIUL BUCUREŞTI",179132,"BUCUREŞTI SECTORUL 2","ŞCOALA GIMNAZIALĂ NR. 307",347,"Alegeri Prezidentiale",1,1449,996,761,234,1,972,24,1600,604,672,300
43,"MUNICIPIUL BUCUREŞTI - SECTOR 2","MUNICIPIUL BUCUREŞTI",179132,"BUCUREŞTI SECTORUL 2","ŞCOALA GIMNAZIALĂ NR. 71",348,"Alegeri Prezidentiale",1,1345,684,591,92,1,674,10,1600,916,468,206
43,"MUNICIPIUL BUCUREŞTI - SECTOR 2","MUNICIPIUL BUCUREŞTI",179132,"BUCUREŞTI SECTORUL 2","ŞCOALA GIMNAZIALĂ NR. 71",349,"Alegeri Prezidentiale",1,1241,726,570,156,0,714,12,1400,674,484,230
43,"MUNICIPIUL BUCUREŞTI - SECTOR 2","MUNICIPIUL BUCUREŞTI",179132,"BUCUREŞTI SECTORUL 2","COLEGIUL ECONOMIC ”A.D. XENOPOL”",350,"Alegeri Prezidentiale",1,1203,653,563,89,1,637,16,1581,928,465,172
43,"MUNICIPIUL BUCUREŞTI - SECTOR 2","MUNICIPIUL BUCUREŞTI",179132,"BUCUREŞTI SECTORUL 2","COLEGIUL ECONOMIC ”A.D. XENOPOL”",351,"Alegeri Prezidentiale",1,952,483,425,58,0,473,10,1000,517,348,125
43,"MUNICIPIUL BUCUREŞTI - SECTOR 2","MUNICIPIUL BUCUREŞTI",179132,"BUCUREŞTI SECTORUL 2","COLEGIUL ECONOMIC ”A.D. XENOPOL”",352,"Alegeri Prezidentiale",2,1328,665,593,72,0,655,10,1600,935,468,187
43,"MUNICIPIUL BUCUREŞTI - SECTOR 2","MUNICIPIUL BUCUREŞTI",179132,"BUCUREŞTI SECTORUL 2","COLEGIUL ECONOMIC ”A.D. XENOPOL”",353,"Alegeri Prezidentiale",2,1465,753,684,69,0,744,9,1608,855,488,256
43,"MUNICIPIUL BUCUREŞTI - SECTOR 2","MUNICIPIUL BUCUREŞTI",179132,"BUCUREŞTI SECTORUL 2","DIRECȚIA PUBLICĂ DE EVIDENȚĂ PERSOANE ȘI STARE CIVILĂ SECTOR 2",354,"Alegeri Prezidentiale",2,1412,834,724,109,1,817,17,1600,766,604,213
43,"MUNICIPIUL BUCUREŞTI - SECTOR 2","MUNICIPIUL BUCUREŞTI",179132,"BUCUREŞTI SECTORUL 2","DIRECȚIA PUBLICĂ DE EVIDENȚĂ PERSOANE ȘI STARE CIVILĂ SECTOR 2",355,"Alegeri Prezidentiale",1,1682,890,784,105,1,872,18,1800,910,643,229
43,"MUNICIPIUL BUCUREŞTI - SECTOR 2","MUNICIPIUL BUCUREŞTI",179132,"BUCUREŞTI SECTORUL 2","ŞCOALA GIMNAZIALĂ ”MAICA DOMNULUI” (FOSTA ȘCOALĂ NR. 50)",356,"Alegeri Prezidentiale",1,1448,939,815,123,1,919,20,1800,861,630,289
43,"MUNICIPIUL BUCUREŞTI - SECTOR 2","MUNICIPIUL BUCUREŞTI",179132,"BUCUREŞTI SECTORUL 2","ŞCOALA GIMNAZIALĂ ”MAICA DOMNULUI” (FOSTA ȘCOALĂ NR. 50)",357,"Alegeri Prezidentiale",1,1528,965,814,151,0,943,22,1600,635,662,281
43,"MUNICIPIUL BUCUREŞTI - SECTOR 2","MUNICIPIUL BUCUREŞTI",179132,"BUCUREŞTI SECTORUL 2","ŞCOALA GIMNAZIALĂ ”MAICA DOMNULUI” (FOSTA ȘCOALĂ NR. 50)",358,"Alegeri Prezidentiale",1,1742,957,804,153,0,939,18,1800,843,602,337
43,"MUNICIPIUL BUCUREŞTI - SECTOR 2","MUNICIPIUL BUCUREŞTI",179132,"BUCUREŞTI SECTORUL 2","COLEGIUL NAŢIONAL ”MIHAI VITEAZUL”",359,"Alegeri Prezidentiale",1,1654,1029,745,165,119,1009,20,1800,771,727,282
43,"MUNICIPIUL BUCUREŞTI - SECTOR 2","MUNICIPIUL BUCUREŞTI",179132,"BUCUREŞTI SECTORUL 2","COLEGIUL NAŢIONAL ”MIHAI VITEAZUL”",360,"Alegeri Prezidentiale",1,1432,921,687,154,80,897,24,1600,679,605,292
43,"MUNICIPIUL BUCUREŞTI - SECTOR 2","MUNICIPIUL BUCUREŞTI",179132,"BUCUREŞTI SECTORUL 2","ŞCOALA GIMNAZIALĂ NR. 56",361,"Alegeri Prezidentiale",1,1398,884,740,144,0,863,21,1600,716,652,211
43,"MUNICIPIUL BUCUREŞTI - SECTOR 2","MUNICIPIUL BUCUREŞTI",179132,"BUCUREŞTI SECTORUL 2","ŞCOALA GIMNAZIALĂ NR. 56",362,"Alegeri Prezidentiale",1,1201,649,582,67,0,631,18,1400,751,420,211
43,"MUNICIPIUL BUCUREŞTI - SECTOR 2","MUNICIPIUL BUCUREŞTI",179132,"BUCUREŞTI SECTORUL 2","ŞCOALA GIMNAZIALĂ NR. 85",363,"Alegeri Prezidentiale",1,1019,544,525,19,0,532,12,1200,656,367,165
43,"MUNICIPIUL BUCUREŞTI - SECTOR 2","MUNICIPIUL BUCUREŞTI",179132,"BUCUREŞTI SECTORUL 2","ŞCOALA GIMNAZIALĂ NR. 85",364,"Alegeri Prezidentiale",1,1266,615,573,42,0,608,7,1400,785,412,196
43,"MUNICIPIUL BUCUREŞTI - SECTOR 2","MUNICIPIUL BUCUREŞTI",179132,"BUCUREŞTI SECTORUL 2","ŞCOALA GIMNAZIALĂ NR. 85",365,"Alegeri Prezidentiale",1,1207,706,611,92,3,685,21,1400,694,457,228
43,"MUNICIPIUL BUCUREŞTI - SECTOR 2","MUNICIPIUL BUCUREŞTI",179132,"BUCUREŞTI SECTORUL 2","ŞCOALA GIMNAZIALĂ NR. 85",366,"Alegeri Prezidentiale",1,1112,698,605,93,0,686,12,1200,502,472,214
43,"MUNICIPIUL BUCUREŞTI - SECTOR 2","MUNICIPIUL BUCUREŞTI",179132,"BUCUREŞTI SECTORUL 2","LICEUL TEORETIC ”WALDORF” - GRADINIȚA NR. 113",367,"Alegeri Prezidentiale",1,1261,653,546,107,0,641,12,1400,747,419,222
43,"MUNICIPIUL BUCUREŞTI - SECTOR 2","MUNICIPIUL BUCUREŞTI",179132,"BUCUREŞTI SECTORUL 2","LICEUL TEORETIC ”WALDORF” - GRADINIȚA NR. 113",368,"Alegeri Prezidentiale",1,1809,871,792,79,0,853,18,1900,1029,614,239
44,"MUNICIPIUL BUCUREŞTI - SECTOR 3","MUNICIPIUL BUCUREŞTI",179132,"BUCUREŞTI SECTORUL 3","ŞCOALA SUPERIOARĂ COMERCIALĂ ”NICOLAE KRETZULESCU”;",369,"Alegeri Prezidentiale",1,982,414,326,87,1,402,12,1077,663,275,127
44,"MUNICIPIUL BUCUREŞTI - SECTOR 3","MUNICIPIUL BUCUREŞTI",179132,"BUCUREŞTI SECTORUL 3","ŞCOALA SUPERIOARĂ COMERCIALĂ ”NICOLAE KRETZULESCU”;",370,"Alegeri Prezidentiale",1,819,277,232,23,22,265,12,898,621,166,99
44,"MUNICIPIUL BUCUREŞTI - SECTOR 3","MUNICIPIUL BUCUREŞTI",179132,"BUCUREŞTI SECTORUL 3","ŞCOALA SUPERIOARĂ COMERCIALĂ ”NICOLAE KRETZULESCU”;",371,"Alegeri Prezidentiale",1,821,554,329,58,167,544,10,901,347,320,224
44,"MUNICIPIUL BUCUREŞTI - SECTOR 3","MUNICIPIUL BUCUREŞTI",179132,"BUCUREŞTI SECTORUL 3","ŞCOALA SUPERIOARĂ COMERCIALĂ ”NICOLAE KRETZULESCU”;",372,"Alegeri Prezidentiale",1,1171,505,382,122,1,486,19,1293,788,316,170
44,"MUNICIPIUL BUCUREŞTI - SECTOR 3","MUNICIPIUL BUCUREŞTI",179132,"BUCUREŞTI SECTORUL 3","ŞCOALA SUPERIOARĂ COMERCIALĂ ”NICOLAE KRETZULESCU”;",373,"Alegeri Prezidentiale",1,1089,455,408,47,0,442,13,1203,748,297,145
44,"MUNICIPIUL BUCUREŞTI - SECTOR 3","MUNICIPIUL BUCUREŞTI",179132,"BUCUREŞTI SECTORUL 3","ŞCOALA SUPERIOARĂ COMERCIALĂ ”NICOLAE KRETZULESCU”;",374,"Alegeri Prezidentiale",1,1426,686,614,71,1,675,11,1564,878,468,207
44,"MUNICIPIUL BUCUREŞTI - SECTOR 3","MUNICIPIUL BUCUREŞTI",179132,"BUCUREŞTI SECTORUL 3","ŞCOALA GIMNAZIALĂ ”BARBU DELAVRANCEA”",375,"Alegeri Prezidentiale",1,1784,934,855,77,2,914,20,1957,1023,601,313
44,"MUNICIPIUL BUCUREŞTI - SECTOR 3","MUNICIPIUL BUCUREŞTI",179132,"BUCUREŞTI SECTORUL 3","ŞCOALA GIMNAZIALĂ ”BARBU DELAVRANCEA”",376,"Alegeri Prezidentiale",1,2046,101,16,85,0,94,7,2244,2143,70,24
44,"MUNICIPIUL BUCUREŞTI - SECTOR 3","MUNICIPIUL BUCUREŞTI",179132,"BUCUREŞTI SECTORUL 3","ȘCOALA GIMNAZIALĂ ”BARBU DELAVRANCEA”",377,"Alegeri Prezidentiale",1,1924,123,4,119,0,118,5,2110,1987,91,27
44,"MUNICIPIUL BUCUREŞTI - SECTOR 3","MUNICIPIUL BUCUREŞTI",179132,"BUCUREŞTI SECTORUL 3","ŞCOALA GIMNAZIALĂ ”BARBU DELAVRANCEA”",378,"Alegeri Prezidentiale",1,2060,98,11,87,0,92,6,2252,2154,76,16
44,"MUNICIPIUL BUCUREŞTI - SECTOR 3","MUNICIPIUL BUCUREŞTI",179132,"BUCUREŞTI SECTORUL 3","ŞCOALA GIMNAZIALĂ ”BARBU DELAVRANCEA”",379,"Alegeri Prezidentiale",1,2040,86,22,33,31,86,0,2230,2144,56,30
44,"MUNICIPIUL BUCUREŞTI - SECTOR 3","MUNICIPIUL BUCUREŞTI",179132,"BUCUREŞTI SECTORUL 3","COLEGIUL NAŢIONAL ”MATEI BASARAB”;",380,"Alegeri Prezidentiale",1,2091,190,5,185,0,186,4,2294,2104,149,37
44,"MUNICIPIUL BUCUREŞTI - SECTOR 3","MUNICIPIUL BUCUREŞTI",179132,"BUCUREŞTI SECTORUL 3","COLEGIUL NAŢIONAL ”MATEI BASARAB”;",381,"Alegeri Prezidentiale",1,1941,834,754,79,1,808,26,2129,1295,517,291
44,"MUNICIPIUL BUCUREŞTI - SECTOR 3","MUNICIPIUL BUCUREŞTI",179132,"BUCUREŞTI SECTORUL 3","COLEGIUL NAŢIONAL ”MATEI BASARAB”;",382,"Alegeri Prezidentiale",1,1930,766,716,50,0,744,22,2116,1350,477,267
44,"MUNICIPIUL BUCUREŞTI - SECTOR 3","MUNICIPIUL BUCUREŞTI",179132,"BUCUREŞTI SECTORUL 3","COLEGIUL NAŢIONAL ”MATEI BASARAB”;",383,"Alegeri Prezidentiale",1,1899,896,884,12,0,873,23,2083,1187,554,319
44,"MUNICIPIUL BUCUREŞTI - SECTOR 3","MUNICIPIUL BUCUREŞTI",179132,"BUCUREŞTI SECTORUL 3","COLEGIUL NAȚIONAL ”MATEI BASARAB”",384,"Alegeri Prezidentiale",2,2022,82,2,80,0,81,1,2218,2136,69,12
44,"MUNICIPIUL BUCUREŞTI - SECTOR 3","MUNICIPIUL BUCUREŞTI",179132,"BUCUREŞTI SECTORUL 3","COLEGIUL NAȚIONAL ”MATEI BASARAB”",385,"Alegeri Prezidentiale",1,2046,50,8,42,0,48,2,2244,2194,40,8
44,"MUNICIPIUL BUCUREŞTI - SECTOR 3","MUNICIPIUL BUCUREŞTI",179132,"BUCUREŞTI SECTORUL 3","COLEGIUL NAȚIONAL ”MATEI BASARAB”",386,"Alegeri Prezidentiale",1,2094,39,9,30,0,38,1,2298,2259,32,6
44,"MUNICIPIUL BUCUREŞTI - SECTOR 3","MUNICIPIUL BUCUREŞTI",179132,"BUCUREŞTI SECTORUL 3","ŞCOALA GIMNAZIALĂ SPECIALĂ NR.5;",387,"Alegeri Prezidentiale",1,1319,734,637,96,1,711,23,1447,713,456,255
44,"MUNICIPIUL BUCUREŞTI - SECTOR 3","MUNICIPIUL BUCUREŞTI",179132,"BUCUREŞTI SECTORUL 3","ŞCOALA GIMNAZIALĂ SPECIALĂ NR.5;",388,"Alegeri Prezidentiale",1,1498,729,646,83,0,709,20,1643,914,472,237
44,"MUNICIPIUL BUCUREŞTI - SECTOR 3","MUNICIPIUL BUCUREŞTI",179132,"BUCUREŞTI SECTORUL 3","ŞCOALA GIMNAZIALĂ SPECIALĂ NR.5;",389,"Alegeri Prezidentiale",1,1063,617,538,79,0,596,21,1166,549,403,193
44,"MUNICIPIUL BUCUREŞTI - SECTOR 3","MUNICIPIUL BUCUREŞTI",179132,"BUCUREŞTI SECTORUL 3","ŞCOALA GIMNAZIALĂ SPECIALĂ NR.5;",390,"Alegeri Prezidentiale",1,1340,769,638,130,1,750,19,1462,693,530,220
44,"MUNICIPIUL BUCUREŞTI - SECTOR 3","MUNICIPIUL BUCUREŞTI",179132,"BUCUREŞTI SECTORUL 3","ŞCOALA GIMNAZIALĂ SPECIALĂ NR.5;",391,"Alegeri Prezidentiale",1,1271,724,580,144,0,710,14,1394,670,504,206
44,"MUNICIPIUL BUCUREŞTI - SECTOR 3","MUNICIPIUL BUCUREŞTI",179132,"BUCUREŞTI SECTORUL 3","ŞCOALA GIMNAZIALĂ SPECIALĂ NR.5;",392,"Alegeri Prezidentiale",1,1592,797,639,158,0,785,12,1746,949,605,180
44,"MUNICIPIUL BUCUREŞTI - SECTOR 3","MUNICIPIUL BUCUREŞTI",179132,"BUCUREŞTI SECTORUL 3","ŞCOALA GIMNAZIALĂ SPECIALĂ NR.5;",393,"Alegeri Prezidentiale",1,1186,591,463,127,1,575,16,1293,702,416,159
44,"MUNICIPIUL BUCUREŞTI - SECTOR 3","MUNICIPIUL BUCUREŞTI",179132,"BUCUREŞTI SECTORUL 3","ŞCOALA GIMNAZIALĂ ”CEZAR BOLLIAC”;",394,"Alegeri Prezidentiale",1,1476,889,729,159,1,866,23,1619,730,627,239
44,"MUNICIPIUL BUCUREŞTI - SECTOR 3","MUNICIPIUL BUCUREŞTI",179132,"BUCUREŞTI SECTORUL 3","ŞCOALA GIMNAZIALĂ ”CEZAR BOLLIAC”;",395,"Alegeri Prezidentiale",1,1455,953,718,235,0,934,19,1580,627,679,255
44,"MUNICIPIUL BUCUREŞTI - SECTOR 3","MUNICIPIUL BUCUREŞTI",179132,"BUCUREŞTI SECTORUL 3","ŞCOALA GIMNAZIALĂ ”CEZAR BOLLIAC”;",396,"Alegeri Prezidentiale",1,1377,894,728,166,0,870,24,1511,617,614,256
44,"MUNICIPIUL BUCUREŞTI - SECTOR 3","MUNICIPIUL BUCUREŞTI",179132,"BUCUREŞTI SECTORUL 3","ŞCOALA GIMNAZIALĂ ”CEZAR BOLLIAC”;",397,"Alegeri Prezidentiale",1,1473,964,794,170,0,937,27,1624,660,670,267
44,"MUNICIPIUL BUCUREŞTI - SECTOR 3","MUNICIPIUL BUCUREŞTI",179132,"BUCUREŞTI SECTORUL 3","ŞCOALA GIMNAZIALĂ ”CEZAR BOLLIAC”;",398,"Alegeri Prezidentiale",1,1276,818,720,98,0,795,23,1417,599,522,273
44,"MUNICIPIUL BUCUREŞTI - SECTOR 3","MUNICIPIUL BUCUREŞTI",179132,"BUCUREŞTI SECTORUL 3","ŞCOALA GIMNAZIALĂ ”CEZAR BOLLIAC”;",399,"Alegeri Prezidentiale",1,1615,933,858,75,0,913,20,1772,839,673,240
44,"MUNICIPIUL BUCUREŞTI - SECTOR 3","MUNICIPIUL BUCUREŞTI",179132,"BUCUREŞTI SECTORUL 3","ŞCOALA GIMNAZIALĂ ”CEZAR BOLLIAC”;",400,"Alegeri Prezidentiale",1,1463,829,772,56,1,809,20,1605,776,561,248
44,"MUNICIPIUL BUCUREŞTI - SECTOR 3","MUNICIPIUL BUCUREŞTI",179132,"BUCUREŞTI SECTORUL 3","ŞCOALA GIMNAZIALĂ ”CEZAR BOLLIAC”;",401,"Alegeri Prezidentiale",1,1473,882,840,42,0,864,18,1616,734,598,266
44,"MUNICIPIUL BUCUREŞTI - SECTOR 3","MUNICIPIUL BUCUREŞTI",179132,"BUCUREŞTI SECTORUL 3","ŞCOALA GIMNAZIALĂ NR.80;",402,"Alegeri Prezidentiale",1,1302,1272,675,597,0,1247,25,1436,164,920,327
44,"MUNICIPIUL BUCUREŞTI - SECTOR 3","MUNICIPIUL BUCUREŞTI",179132,"BUCUREŞTI SECTORUL 3","ŞCOALA GIMNAZIALĂ NR.80;",403,"Alegeri Prezidentiale",1,1229,827,551,276,0,810,17,1340,513,592,218
44,"MUNICIPIUL BUCUREŞTI - SECTOR 3","MUNICIPIUL BUCUREŞTI",179132,"BUCUREŞTI SECTORUL 3","ŞCOALA GIMNAZIALĂ NR.80;",404,"Alegeri Prezidentiale",1,1772,1051,874,177,0,1021,30,1944,893,738,283
44,"MUNICIPIUL BUCUREŞTI - SECTOR 3","MUNICIPIUL BUCUREŞTI",179132,"BUCUREŞTI SECTORUL 3","ŞCOALA GIMNAZIALĂ NR.80;",405,"Alegeri Prezidentiale",1,1533,986,822,164,0,961,25,1682,696,661,300
44,"MUNICIPIUL BUCUREŞTI - SECTOR 3","MUNICIPIUL BUCUREŞTI",179132,"BUCUREŞTI SECTORUL 3","ŞCOALA GIMNAZIALĂ NR.80;",406,"Alegeri Prezidentiale",1,1042,602,506,94,2,586,16,1143,541,402,184
44,"MUNICIPIUL BUCUREŞTI - SECTOR 3","MUNICIPIUL BUCUREŞTI",179132,"BUCUREŞTI SECTORUL 3","ŞCOALA GIMNAZIALĂ NR.80;",407,"Alegeri Prezidentiale",1,1017,568,504,64,0,562,6,1123,555,374,188
44,"MUNICIPIUL BUCUREŞTI - SECTOR 3","MUNICIPIUL BUCUREŞTI",179132,"BUCUREŞTI SECTORUL 3","ŞCOALA GIMNAZIALĂ NR.80;",408,"Alegeri Prezidentiale",1,864,510,442,68,0,502,8,956,446,385,117
44,"MUNICIPIUL BUCUREŞTI - SECTOR 3","MUNICIPIUL BUCUREŞTI",179132,"BUCUREŞTI SECTORUL 3","ŞCOALA GIMNAZIALĂ NR.80;",409,"Alegeri Prezidentiale",1,1059,614,533,81,0,597,17,1162,548,434,163
44,"MUNICIPIUL BUCUREŞTI - SECTOR 3","MUNICIPIUL BUCUREŞTI",179132,"BUCUREŞTI SECTORUL 3","ŞCOALA GIMNAZIALĂ NR.81;",410,"Alegeri Prezidentiale",1,1813,1188,963,225,0,1169,19,1988,800,789,380
44,"MUNICIPIUL BUCUREŞTI - SECTOR 3","MUNICIPIUL BUCUREŞTI",179132,"BUCUREŞTI SECTORUL 3","ŞCOALA GIMNAZIALĂ NR.81;",411,"Alegeri Prezidentiale",2,1557,999,682,314,3,976,23,1708,709,721,255
44,"MUNICIPIUL BUCUREŞTI - SECTOR 3","MUNICIPIUL BUCUREŞTI",179132,"BUCUREŞTI SECTORUL 3","ŞCOALA GIMNAZIALĂ NR.81;",412,"Alegeri Prezidentiale",1,1365,975,763,212,0,951,24,1497,522,709,242
44,"MUNICIPIUL BUCUREŞTI - SECTOR 3","MUNICIPIUL BUCUREŞTI",179132,"BUCUREŞTI SECTORUL 3","ŞCOALA GIMNAZIALĂ NR.81;",413,"Alegeri Prezidentiale",1,1101,771,567,204,0,759,12,1208,437,543,216
44,"MUNICIPIUL BUCUREŞTI - SECTOR 3","MUNICIPIUL BUCUREŞTI",179132,"BUCUREŞTI SECTORUL 3","ŞCOALA GIMNAZIALĂ NR.81;",414,"Alegeri Prezidentiale",2,1741,1115,995,120,0,1091,24,1910,795,769,322
44,"MUNICIPIUL BUCUREŞTI - SECTOR 3","MUNICIPIUL BUCUREŞTI",179132,"BUCUREŞTI SECTORUL 3","ŞCOALA GIMNAZIALĂ NR.81;",415,"Alegeri Prezidentiale",1,1313,813,611,202,0,794,19,1440,627,555,239
44,"MUNICIPIUL BUCUREŞTI - SECTOR 3","MUNICIPIUL BUCUREŞTI",179132,"BUCUREŞTI SECTORUL 3","ŞCOALA GIMNAZIALĂ NR.81;",416,"Alegeri Prezidentiale",1,1449,866,789,77,0,846,20,1590,724,544,302
44,"MUNICIPIUL BUCUREŞTI - SECTOR 3","MUNICIPIUL BUCUREŞTI",179132,"BUCUREŞTI SECTORUL 3","ŞCOALA GIMNAZIALĂ NR.81;",417,"Alegeri Prezidentiale",1,1357,880,690,190,0,864,16,1488,608,635,229
44,"MUNICIPIUL BUCUREŞTI - SECTOR 3","MUNICIPIUL BUCUREŞTI",179132,"BUCUREŞTI SECTORUL 3","ŞCOALA GIMNAZIALĂ NR.81;",418,"Alegeri Prezidentiale",1,1184,897,666,231,0,867,30,1299,402,639,228
44,"MUNICIPIUL BUCUREŞTI - SECTOR 3","MUNICIPIUL BUCUREŞTI",179132,"BUCUREŞTI SECTORUL 3","COLEGIUL TEHNIC ”MIHAI BRAVU”;",419,"Alegeri Prezidentiale",1,1473,647,511,136,0,637,10,1616,969,449,188
44,"MUNICIPIUL BUCUREŞTI - SECTOR 3","MUNICIPIUL BUCUREŞTI",179132,"BUCUREŞTI SECTORUL 3","COLEGIUL TEHNIC ”MIHAI BRAVU”;",420,"Alegeri Prezidentiale",1,1536,822,740,82,0,802,20,1677,855,560,242
44,"MUNICIPIUL BUCUREŞTI - SECTOR 3","MUNICIPIUL BUCUREŞTI",179132,"BUCUREŞTI SECTORUL 3","COLEGIUL TEHNIC ”MIHAI BRAVU”;",421,"Alegeri Prezidentiale",1,1326,747,634,113,0,736,11,1463,716,514,222
44,"MUNICIPIUL BUCUREŞTI - SECTOR 3","MUNICIPIUL BUCUREŞTI",179132,"BUCUREŞTI SECTORUL 3","COLEGIUL TEHNIC ”MIHAI BRAVU”;",422,"Alegeri Prezidentiale",1,1538,946,786,160,0,924,22,1679,733,637,287
44,"MUNICIPIUL BUCUREŞTI - SECTOR 3","MUNICIPIUL BUCUREŞTI",179132,"BUCUREŞTI SECTORUL 3","COLEGIUL TEHNIC ”MIHAI BRAVU”;",423,"Alegeri Prezidentiale",1,1064,812,479,332,1,802,10,1167,355,574,228
44,"MUNICIPIUL BUCUREŞTI - SECTOR 3","MUNICIPIUL BUCUREŞTI",179132,"BUCUREŞTI SECTORUL 3","COLEGIUL TEHNIC ”MIHAI BRAVU”;",424,"Alegeri Prezidentiale",1,1545,786,739,47,0,779,7,1695,909,529,250
44,"MUNICIPIUL BUCUREŞTI - SECTOR 3","MUNICIPIUL BUCUREŞTI",179132,"BUCUREŞTI SECTORUL 3","COLEGIUL TEHNIC ”MIHAI BRAVU”;",425,"Alegeri Prezidentiale",1,1299,713,652,61,0,698,15,1425,712,492,206
44,"MUNICIPIUL BUCUREŞTI - SECTOR 3","MUNICIPIUL BUCUREŞTI",179132,"BUCUREŞTI SECTORUL 3","COLEGIUL TEHNIC ”MIHAI BRAVU”;",426,"Alegeri Prezidentiale",1,1163,705,595,110,0,688,17,1266,561,465,223
44,"MUNICIPIUL BUCUREŞTI - SECTOR 3","MUNICIPIUL BUCUREŞTI",179132,"BUCUREŞTI SECTORUL 3","COLEGIUL TEHNIC ”MIHAI BRAVU”;",427,"Alegeri Prezidentiale",1,1256,825,608,215,2,797,28,1385,560,557,240
44,"MUNICIPIUL BUCUREŞTI - SECTOR 3","MUNICIPIUL BUCUREŞTI",179132,"BUCUREŞTI SECTORUL 3","COLEGIUL TEHNIC ”MIHAI BRAVU”;",428,"Alegeri Prezidentiale",1,1280,807,673,134,0,793,14,1404,597,519,274
44,"MUNICIPIUL BUCUREŞTI - SECTOR 3","MUNICIPIUL BUCUREŞTI",179132,"BUCUREŞTI SECTORUL 3","COLEGIUL TEHNIC ”MIHAI BRAVU”;",429,"Alegeri Prezidentiale",1,1207,729,589,139,1,710,19,1323,594,517,193
44,"MUNICIPIUL BUCUREŞTI - SECTOR 3","MUNICIPIUL BUCUREŞTI",179132,"BUCUREŞTI SECTORUL 3","COLEGIUL TEHNIC ”MIHAI BRAVU”;",430,"Alegeri Prezidentiale",1,1395,709,656,53,0,701,8,1522,813,452,249
44,"MUNICIPIUL BUCUREŞTI - SECTOR 3","MUNICIPIUL BUCUREŞTI",179132,"BUCUREŞTI SECTORUL 3","COLEGIUL TEHNIC ”MIHAI BRAVU”;",431,"Alegeri Prezidentiale",1,1125,601,552,49,0,586,15,1234,633,394,192
44,"MUNICIPIUL BUCUREŞTI - SECTOR 3","MUNICIPIUL BUCUREŞTI",179132,"BUCUREŞTI SECTORUL 3","ŞCOALA GIMNAZIALĂ NR.95;",432,"Alegeri Prezidentiale",1,1460,885,687,196,2,865,20,1602,717,619,246
44,"MUNICIPIUL BUCUREŞTI - SECTOR 3","MUNICIPIUL BUCUREŞTI",179132,"BUCUREŞTI SECTORUL 3","ŞCOALA GIMNAZIALĂ NR.95;",433,"Alegeri Prezidentiale",1,1937,1298,972,324,2,1265,33,2150,852,1022,243
44,"MUNICIPIUL BUCUREŞTI - SECTOR 3","MUNICIPIUL BUCUREŞTI",179132,"BUCUREŞTI SECTORUL 3","ŞCOALA GIMNAZIALĂ NR.95;",434,"Alegeri Prezidentiale",1,1352,670,501,169,0,654,16,1483,813,464,190
44,"MUNICIPIUL BUCUREŞTI - SECTOR 3","MUNICIPIUL BUCUREŞTI",179132,"BUCUREŞTI SECTORUL 3","ŞCOALA GIMNAZIALĂ NR.95;",435,"Alegeri Prezidentiale",1,955,589,467,122,0,574,15,1048,459,406,168
44,"MUNICIPIUL BUCUREŞTI - SECTOR 3","MUNICIPIUL BUCUREŞTI",179132,"BUCUREŞTI SECTORUL 3","ŞCOALA GIMNAZIALĂ NR.95;",436,"Alegeri Prezidentiale",1,1502,829,691,138,0,813,16,1648,819,590,223
44,"MUNICIPIUL BUCUREŞTI - SECTOR 3","MUNICIPIUL BUCUREŞTI",179132,"BUCUREŞTI SECTORUL 3","ŞCOALA GIMNAZIALĂ NR.95;",437,"Alegeri Prezidentiale",1,1453,629,534,95,0,618,11,1594,965,433,185
44,"MUNICIPIUL BUCUREŞTI - SECTOR 3","MUNICIPIUL BUCUREŞTI",179132,"BUCUREŞTI SECTORUL 3","ŞCOALA GIMNAZIALĂ NR.95;",438,"Alegeri Prezidentiale",1,1351,744,690,54,0,729,15,1482,738,549,180
44,"MUNICIPIUL BUCUREŞTI - SECTOR 3","MUNICIPIUL BUCUREŞTI",179132,"BUCUREŞTI SECTORUL 3","ŞCOALA GIMNAZIALĂ NR.95;",439,"Alegeri Prezidentiale",1,1357,782,723,59,0,766,16,1505,723,543,223
44,"MUNICIPIUL BUCUREŞTI - SECTOR 3","MUNICIPIUL BUCUREŞTI",179132,"BUCUREŞTI SECTORUL 3","ŞCOALA GIMNAZIALĂ NR.95;",440,"Alegeri Prezidentiale",1,1741,1005,915,89,1,979,26,1918,913,716,263
44,"MUNICIPIUL BUCUREŞTI - SECTOR 3","MUNICIPIUL BUCUREŞTI",179132,"BUCUREŞTI SECTORUL 3","ŞCOALA GIMNAZIALĂ NR.95;",441,"Alegeri Prezidentiale",1,1554,908,793,115,0,885,23,1705,797,631,254
44,"MUNICIPIUL BUCUREŞTI - SECTOR 3","MUNICIPIUL BUCUREŞTI",179132,"BUCUREŞTI SECTORUL 3","ŞCOALA GIMNAZIALĂ NR.84",442,"Alegeri Prezidentiale",1,1530,971,780,191,0,936,35,1678,707,672,264
44,"MUNICIPIUL BUCUREŞTI - SECTOR 3","MUNICIPIUL BUCUREŞTI",179132,"BUCUREŞTI SECTORUL 3","ŞCOALA GIMNAZIALĂ NR.84",443,"Alegeri Prezidentiale",1,1439,656,484,172,0,642,14,1579,923,467,175
44,"MUNICIPIUL BUCUREŞTI - SECTOR 3","MUNICIPIUL BUCUREŞTI",179132,"BUCUREŞTI SECTORUL 3","ŞCOALA GIMNAZIALĂ NR.84",444,"Alegeri Prezidentiale",1,1266,659,596,63,0,644,15,1398,739,425,219
44,"MUNICIPIUL BUCUREŞTI - SECTOR 3","MUNICIPIUL BUCUREŞTI",179132,"BUCUREŞTI SECTORUL 3","ŞCOALA GIMNAZIALĂ NR.84",445,"Alegeri Prezidentiale",1,1445,848,682,166,0,825,23,1577,729,540,285
44,"MUNICIPIUL BUCUREŞTI - SECTOR 3","MUNICIPIUL BUCUREŞTI",179132,"BUCUREŞTI SECTORUL 3","ŞCOALA GIMNAZIALĂ NR.84",446,"Alegeri Prezidentiale",1,1381,929,741,188,0,911,18,1514,585,588,323
44,"MUNICIPIUL BUCUREŞTI - SECTOR 3","MUNICIPIUL BUCUREŞTI",179132,"BUCUREŞTI SECTORUL 3","ŞCOALA GIMNAZIALĂ NR.84;",447,"Alegeri Prezidentiale",1,1186,660,545,115,0,640,20,1301,641,441,199
44,"MUNICIPIUL BUCUREŞTI - SECTOR 3","MUNICIPIUL BUCUREŞTI",179132,"BUCUREŞTI SECTORUL 3","ŞCOALA GIMNAZIALĂ NR.86;",448,"Alegeri Prezidentiale",1,1340,746,692,53,1,731,15,1462,716,536,195
44,"MUNICIPIUL BUCUREŞTI - SECTOR 3","MUNICIPIUL BUCUREŞTI",179132,"BUCUREŞTI SECTORUL 3","ŞCOALA GIMNAZIALĂ NR.86;",449,"Alegeri Prezidentiale",1,1702,985,905,80,0,960,25,1867,882,693,267
44,"MUNICIPIUL BUCUREŞTI - SECTOR 3","MUNICIPIUL BUCUREŞTI",179132,"BUCUREŞTI SECTORUL 3","ŞCOALA GIMNAZIALĂ NR.86;",450,"Alegeri Prezidentiale",1,1613,937,860,77,0,919,18,1769,832,615,304
44,"MUNICIPIUL BUCUREŞTI - SECTOR 3","MUNICIPIUL BUCUREŞTI",179132,"BUCUREŞTI SECTORUL 3","ŞCOALA GIMNAZIALĂ NR.86;",451,"Alegeri Prezidentiale",1,1647,964,798,166,0,947,17,1807,843,663,284
44,"MUNICIPIUL BUCUREŞTI - SECTOR 3","MUNICIPIUL BUCUREŞTI",179132,"BUCUREŞTI SECTORUL 3","ŞCOALA GIMNAZIALĂ NR.86;",452,"Alegeri Prezidentiale",1,1587,887,747,140,0,862,25,1741,854,637,225
44,"MUNICIPIUL BUCUREŞTI - SECTOR 3","MUNICIPIUL BUCUREŞTI",179132,"BUCUREŞTI SECTORUL 3","ŞCOALA GIMNAZIALĂ NR.86;",453,"Alegeri Prezidentiale",1,1320,805,672,132,1,783,22,1448,643,563,220
44,"MUNICIPIUL BUCUREŞTI - SECTOR 3","MUNICIPIUL BUCUREŞTI",179132,"BUCUREŞTI SECTORUL 3","ŞCOALA GIMNAZIALĂ NR.86;",454,"Alegeri Prezidentiale",1,1612,1000,797,200,3,978,22,1768,768,724,254
44,"MUNICIPIUL BUCUREŞTI - SECTOR 3","MUNICIPIUL BUCUREŞTI",179132,"BUCUREŞTI SECTORUL 3","ŞCOALA GIMNAZIALĂ ”LEONARDO DA VINCI”;",455,"Alegeri Prezidentiale",2,1575,1030,816,85,129,1014,16,1728,698,718,296
44,"MUNICIPIUL BUCUREŞTI - SECTOR 3","MUNICIPIUL BUCUREŞTI",179132,"BUCUREŞTI SECTORUL 3","ŞCOALA GIMNAZIALĂ ”LEONARDO DA VINCI”;",456,"Alegeri Prezidentiale",1,1366,791,622,167,2,782,9,1499,708,574,208
44,"MUNICIPIUL BUCUREŞTI - SECTOR 3","MUNICIPIUL BUCUREŞTI",179132,"BUCUREŞTI SECTORUL 3","ŞCOALA GIMNAZIALĂ ”LEONARDO DA VINCI”;",457,"Alegeri Prezidentiale",1,1507,970,757,212,1,946,24,1653,683,684,262
44,"MUNICIPIUL BUCUREŞTI - SECTOR 3","MUNICIPIUL BUCUREŞTI",179132,"BUCUREŞTI SECTORUL 3","ŞCOALA GIMNAZIALĂ ”LEONARDO DA VINCI”;",458,"Alegeri Prezidentiale",1,1237,823,663,159,1,800,23,1357,534,556,244
44,"MUNICIPIUL BUCUREŞTI - SECTOR 3","MUNICIPIUL BUCUREŞTI",179132,"BUCUREŞTI SECTORUL 3","ŞCOALA GIMNAZIALĂ ”LEONARDO DA VINCI”;",459,"Alegeri Prezidentiale",1,1208,833,689,144,0,803,30,1325,492,590,213
44,"MUNICIPIUL BUCUREŞTI - SECTOR 3","MUNICIPIUL BUCUREŞTI",179132,"BUCUREŞTI SECTORUL 3","ŞCOALA GIMNAZIALĂ ”LEONARDO DA VINCI”;",460,"Alegeri Prezidentiale",1,1073,676,581,95,0,666,10,1177,501,470,196
44,"MUNICIPIUL BUCUREŞTI - SECTOR 3","MUNICIPIUL BUCUREŞTI",179132,"BUCUREŞTI SECTORUL 3","ŞCOALA GIMNAZIALĂ ”LEONARDO DA VINCI”;",461,"Alegeri Prezidentiale",1,1049,635,592,43,0,619,16,1151,516,373,246
44,"MUNICIPIUL BUCUREŞTI - SECTOR 3","MUNICIPIUL BUCUREŞTI",179132,"BUCUREŞTI SECTORUL 3","ŞCOALA GIMNAZIALĂ ”LEONARDO DA VINCI”;",462,"Alegeri Prezidentiale",1,1009,550,516,34,0,537,13,1107,557,367,170
44,"MUNICIPIUL BUCUREŞTI - SECTOR 3","MUNICIPIUL BUCUREŞTI",179132,"BUCUREŞTI SECTORUL 3","ŞCOALA GIMNAZIALĂ ”LEONARDO DA VINCI”;",463,"Alegeri Prezidentiale",1,1198,614,592,20,2,600,14,1298,684,413,187
44,"MUNICIPIUL BUCUREŞTI - SECTOR 3","MUNICIPIUL BUCUREŞTI",179132,"BUCUREŞTI SECTORUL 3","LICEUL TEORETIC ”BENJAMIN FRANKLIN”;",464,"Alegeri Prezidentiale",1,1249,704,636,68,0,682,22,1270,566,496,186
44,"MUNICIPIUL BUCUREŞTI - SECTOR 3","MUNICIPIUL BUCUREŞTI",179132,"BUCUREŞTI SECTORUL 3","LICEUL TEORETIC ”BENJAMIN FRANKLIN”;",465,"Alegeri Prezidentiale",1,1182,707,632,75,0,676,31,1297,590,482,194
44,"MUNICIPIUL BUCUREŞTI - SECTOR 3","MUNICIPIUL BUCUREŞTI",179132,"BUCUREŞTI SECTORUL 3","LICEUL TEORETIC ”BENJAMIN FRANKLIN”;",466,"Alegeri Prezidentiale",1,945,570,518,52,0,566,4,1037,467,381,185
44,"MUNICIPIUL BUCUREŞTI - SECTOR 3","MUNICIPIUL BUCUREŞTI",179132,"BUCUREŞTI SECTORUL 3","LICEUL TEORETIC ”BENJAMIN FRANKLIN”;",467,"Alegeri Prezidentiale",1,1086,682,601,81,0,665,17,1191,509,436,229
44,"MUNICIPIUL BUCUREŞTI - SECTOR 3","MUNICIPIUL BUCUREŞTI",179132,"BUCUREŞTI SECTORUL 3","ŞCOALA GIMNAZIALĂ ”ALEXANDRU IOAN CUZA”;",468,"Alegeri Prezidentiale",1,1198,702,632,70,0,688,14,1314,612,445,243
44,"MUNICIPIUL BUCUREŞTI - SECTOR 3","MUNICIPIUL BUCUREŞTI",179132,"BUCUREŞTI SECTORUL 3","ŞCOALA GIMNAZIALĂ ”ALEXANDRU IOAN CUZA”;",469,"Alegeri Prezidentiale",1,1338,805,698,107,0,795,10,1468,663,508,287
44,"MUNICIPIUL BUCUREŞTI - SECTOR 3","MUNICIPIUL BUCUREŞTI",179132,"BUCUREŞTI SECTORUL 3","ŞCOALA GIMNAZIALĂ ”ALEXANDRU IOAN CUZA”;",470,"Alegeri Prezidentiale",1,1613,836,770,66,0,825,11,1769,933,517,308
44,"MUNICIPIUL BUCUREŞTI - SECTOR 3","MUNICIPIUL BUCUREŞTI",179132,"BUCUREŞTI SECTORUL 3","ŞCOALA GIMNAZIALĂ ”ALEXANDRU IOAN CUZA”;",471,"Alegeri Prezidentiale",1,1256,689,642,47,0,669,20,1371,682,503,166
44,"MUNICIPIUL BUCUREŞTI - SECTOR 3","MUNICIPIUL BUCUREŞTI",179132,"BUCUREŞTI SECTORUL 3","ŞCOALA GIMNAZIALĂ ”ALEXANDRU IOAN CUZA”;",472,"Alegeri Prezidentiale",1,1006,584,519,65,0,572,12,1112,528,398,174
44,"MUNICIPIUL BUCUREŞTI - SECTOR 3","MUNICIPIUL BUCUREŞTI",179132,"BUCUREŞTI SECTORUL 3","COLEGIUL TEHNIC ”ANGHEL SALIGNY”;",473,"Alegeri Prezidentiale",1,1167,762,577,185,0,745,17,1272,510,487,258
44,"MUNICIPIUL BUCUREŞTI - SECTOR 3","MUNICIPIUL BUCUREŞTI",179132,"BUCUREŞTI SECTORUL 3","COLEGIUL TEHNIC ”ANGHEL SALIGNY”;",474,"Alegeri Prezidentiale",1,1060,742,559,182,1,719,23,1166,424,529,190
44,"MUNICIPIUL BUCUREŞTI - SECTOR 3","MUNICIPIUL BUCUREŞTI",179132,"BUCUREŞTI SECTORUL 3","ŞCOALA GIMNAZIALĂ NR.88",475,"Alegeri Prezidentiale",1,1376,870,702,168,0,847,23,1509,639,616,231
44,"MUNICIPIUL BUCUREŞTI - SECTOR 3","MUNICIPIUL BUCUREŞTI",179132,"BUCUREŞTI SECTORUL 3","ŞCOALA GIMNAZIALĂ NR.88",476,"Alegeri Prezidentiale",1,1405,931,766,163,2,911,20,1556,625,656,255
44,"MUNICIPIUL BUCUREŞTI - SECTOR 3","MUNICIPIUL BUCUREŞTI",179132,"BUCUREŞTI SECTORUL 3","ŞCOALA GIMNAZIALĂ NR.88",477,"Alegeri Prezidentiale",1,1296,850,694,156,0,834,16,1422,572,584,250
44,"MUNICIPIUL BUCUREŞTI - SECTOR 3","MUNICIPIUL BUCUREŞTI",179132,"BUCUREŞTI SECTORUL 3","ŞCOALA GIMNAZIALĂ NR.88",478,"Alegeri Prezidentiale",1,1443,890,786,102,2,857,33,1583,693,567,290
44,"MUNICIPIUL BUCUREŞTI - SECTOR 3","MUNICIPIUL BUCUREŞTI",179132,"BUCUREŞTI SECTORUL 3","ŞCOALA GIMNAZIALĂ NR.88",479,"Alegeri Prezidentiale",1,1480,887,829,57,1,874,13,1624,737,615,259
44,"MUNICIPIUL BUCUREŞTI - SECTOR 3","MUNICIPIUL BUCUREŞTI",179132,"BUCUREŞTI SECTORUL 3","ŞCOALA GIMNAZIALĂ NR.88",480,"Alegeri Prezidentiale",1,1279,727,683,44,0,714,13,1403,676,492,222
44,"MUNICIPIUL BUCUREŞTI - SECTOR 3","MUNICIPIUL BUCUREŞTI",179132,"BUCUREŞTI SECTORUL 3","ŞCOALA GIMNAZIALĂ ”MIHAI BOTEZ”;",481,"Alegeri Prezidentiale",1,1376,1057,709,347,1,1042,15,1509,452,787,255
44,"MUNICIPIUL BUCUREŞTI - SECTOR 3","MUNICIPIUL BUCUREŞTI",179132,"BUCUREŞTI SECTORUL 3","ŞCOALA GIMNAZIALĂ ”MIHAI BOTEZ”;",482,"Alegeri Prezidentiale",1,1286,900,618,282,0,875,25,1411,511,622,253
44,"MUNICIPIUL BUCUREŞTI - SECTOR 3","MUNICIPIUL BUCUREŞTI",179132,"BUCUREŞTI SECTORUL 3","ŞCOALA GIMNAZIALĂ ”MIHAI BOTEZ”;",483,"Alegeri Prezidentiale",1,1358,769,631,138,0,751,18,1490,721,499,252
44,"MUNICIPIUL BUCUREŞTI - SECTOR 3","MUNICIPIUL BUCUREŞTI",179132,"BUCUREŞTI SECTORUL 3","ŞCOALA GIMNAZIALĂ ”MIHAI BOTEZ”;",484,"Alegeri Prezidentiale",1,1912,1003,937,66,0,990,13,2097,1094,697,293
44,"MUNICIPIUL BUCUREŞTI - SECTOR 3","MUNICIPIUL BUCUREŞTI",179132,"BUCUREŞTI SECTORUL 3","ŞCOALA GIMNAZIALĂ ”MIHAI BOTEZ”;",485,"Alegeri Prezidentiale",1,1392,753,669,83,1,737,16,1527,774,497,240
44,"MUNICIPIUL BUCUREŞTI - SECTOR 3","MUNICIPIUL BUCUREŞTI",179132,"BUCUREŞTI SECTORUL 3","ŞCOALA GIMNAZIALĂ ”MIHAI BOTEZ”;",486,"Alegeri Prezidentiale",1,1340,811,676,135,0,793,18,1470,659,542,251
44,"MUNICIPIUL BUCUREŞTI - SECTOR 3","MUNICIPIUL BUCUREŞTI",179132,"BUCUREŞTI SECTORUL 3","ŞCOALA GIMNAZIALĂ ”MIHAI BOTEZ”;",487,"Alegeri Prezidentiale",1,1357,819,689,130,0,805,14,1497,678,525,280
44,"MUNICIPIUL BUCUREŞTI - SECTOR 3","MUNICIPIUL BUCUREŞTI",179132,"BUCUREŞTI SECTORUL 3","ŞCOALA GIMNAZIALĂ ”MIHAI BOTEZ”;",488,"Alegeri Prezidentiale",1,1353,698,653,45,0,679,19,1484,786,466,213
44,"MUNICIPIUL BUCUREŞTI - SECTOR 3","MUNICIPIUL BUCUREŞTI",179132,"BUCUREŞTI SECTORUL 3","ŞCOALA GIMNAZIALĂ ”MIHAI BOTEZ”;",489,"Alegeri Prezidentiale",1,1477,760,710,49,1,744,16,1620,860,451,293
44,"MUNICIPIUL BUCUREŞTI - SECTOR 3","MUNICIPIUL BUCUREŞTI",179132,"BUCUREŞTI SECTORUL 3","ŞCOALA GIMNAZIALĂ ”MIHAI BOTEZ”;",490,"Alegeri Prezidentiale",1,1476,763,719,43,1,749,14,1627,864,480,269
44,"MUNICIPIUL BUCUREŞTI - SECTOR 3","MUNICIPIUL BUCUREŞTI",179132,"BUCUREŞTI SECTORUL 3","ŞCOALA GIMNAZIALĂ ”MIHAI BOTEZ”;",491,"Alegeri Prezidentiale",1,1122,586,501,85,0,574,12,1223,637,373,201
44,"MUNICIPIUL BUCUREŞTI - SECTOR 3","MUNICIPIUL BUCUREŞTI",179132,"BUCUREŞTI SECTORUL 3","LICEUL TEORETIC ”DANTE ALIGHIERI”;",492,"Alegeri Prezidentiale",1,1427,791,749,42,0,773,18,1557,766,506,267
44,"MUNICIPIUL BUCUREŞTI - SECTOR 3","MUNICIPIUL BUCUREŞTI",179132,"BUCUREŞTI SECTORUL 3","LICEUL TEORETIC ”DANTE ALIGHIERI”;",493,"Alegeri Prezidentiale",1,1386,825,742,83,0,804,21,1520,695,533,271
44,"MUNICIPIUL BUCUREŞTI - SECTOR 3","MUNICIPIUL BUCUREŞTI",179132,"BUCUREŞTI SECTORUL 3","LICEUL TEORETIC ”DANTE ALIGHIERI”;",494,"Alegeri Prezidentiale",1,1091,760,576,183,1,741,19,1147,387,540,201
44,"MUNICIPIUL BUCUREŞTI - SECTOR 3","MUNICIPIUL BUCUREŞTI",179132,"BUCUREŞTI SECTORUL 3","LICEUL TEORETIC ”DANTE ALIGHIERI”;",495,"Alegeri Prezidentiale",1,1090,694,598,96,0,673,21,1188,494,456,217
44,"MUNICIPIUL BUCUREŞTI - SECTOR 3","MUNICIPIUL BUCUREŞTI",179132,"BUCUREŞTI SECTORUL 3","LICEUL TEORETIC ”DANTE ALIGHIERI”;",496,"Alegeri Prezidentiale",1,1236,734,664,70,0,720,14,1356,622,522,198
44,"MUNICIPIUL BUCUREŞTI - SECTOR 3","MUNICIPIUL BUCUREŞTI",179132,"BUCUREŞTI SECTORUL 3","ŞCOALA GIMNAZIALĂ NR.195;",497,"Alegeri Prezidentiale",1,1224,914,715,199,0,900,14,1343,429,699,201
44,"MUNICIPIUL BUCUREŞTI - SECTOR 3","MUNICIPIUL BUCUREŞTI",179132,"BUCUREŞTI SECTORUL 3","ŞCOALA GIMNAZIALĂ NR.195;",498,"Alegeri Prezidentiale",1,1160,829,703,126,0,808,21,1273,444,591,217
44,"MUNICIPIUL BUCUREŞTI - SECTOR 3","MUNICIPIUL BUCUREŞTI",179132,"BUCUREŞTI SECTORUL 3","ŞCOALA GIMNAZIALĂ NR.195;",499,"Alegeri Prezidentiale",1,1150,719,648,70,1,690,29,1262,543,494,196
44,"MUNICIPIUL BUCUREŞTI - SECTOR 3","MUNICIPIUL BUCUREŞTI",179132,"BUCUREŞTI SECTORUL 3","ŞCOALA GIMNAZIALĂ NR.195;",500,"Alegeri Prezidentiale",1,1005,586,521,65,0,574,12,1102,516,410,164
44,"MUNICIPIUL BUCUREŞTI - SECTOR 3","MUNICIPIUL BUCUREŞTI",179132,"BUCUREŞTI SECTORUL 3","ŞCOALA GIMNAZIALĂ NR.195;",501,"Alegeri Prezidentiale",1,1047,582,534,48,0,564,18,1149,567,395,169
44,"MUNICIPIUL BUCUREŞTI - SECTOR 3","MUNICIPIUL BUCUREŞTI",179132,"BUCUREŞTI SECTORUL 3","LICEUL TEHNOLOGIC ”ELIE RADU”;",502,"Alegeri Prezidentiale",1,1417,761,554,207,0,742,19,1554,793,521,221
44,"MUNICIPIUL BUCUREŞTI - SECTOR 3","MUNICIPIUL BUCUREŞTI",179132,"BUCUREŞTI SECTORUL 3","LICEUL TEHNOLOGIC ”ELIE RADU”;",503,"Alegeri Prezidentiale",1,1454,723,667,56,0,700,23,1595,872,449,251
44,"MUNICIPIUL BUCUREŞTI - SECTOR 3","MUNICIPIUL BUCUREŞTI",179132,"BUCUREŞTI SECTORUL 3","LICEUL TEHNOLOGIC ”ELIE RADU”;",504,"Alegeri Prezidentiale",1,1016,682,454,227,1,667,15,1115,433,488,179
44,"MUNICIPIUL BUCUREŞTI - SECTOR 3","MUNICIPIUL BUCUREŞTI",179132,"BUCUREŞTI SECTORUL 3","LICEUL TEHNOLOGIC ”ELIE RADU”;",505,"Alegeri Prezidentiale",1,1621,725,641,84,0,702,23,1778,1053,479,223
44,"MUNICIPIUL BUCUREŞTI - SECTOR 3","MUNICIPIUL BUCUREŞTI",179132,"BUCUREŞTI SECTORUL 3","LICEUL TEHNOLOGIC ”ELIE RADU”;",506,"Alegeri Prezidentiale",1,1462,632,566,66,0,620,12,1604,972,372,248
44,"MUNICIPIUL BUCUREŞTI - SECTOR 3","MUNICIPIUL BUCUREŞTI",179132,"BUCUREŞTI SECTORUL 3","LICEUL TEORETIC BILINGV ”DECEBAL”;",507,"Alegeri Prezidentiale",1,1133,592,525,67,0,583,9,1243,651,348,235
44,"MUNICIPIUL BUCUREŞTI - SECTOR 3","MUNICIPIUL BUCUREŞTI",179132,"BUCUREŞTI SECTORUL 3","LICEUL TEORETIC BILINGV ”DECEBAL”;",508,"Alegeri Prezidentiale",1,1410,765,593,172,0,744,21,1547,782,500,244
44,"MUNICIPIUL BUCUREŞTI - SECTOR 3","MUNICIPIUL BUCUREŞTI",179132,"BUCUREŞTI SECTORUL 3","LICEUL TEORETIC BILINGV ”DECEBAL”;",509,"Alegeri Prezidentiale",1,1457,652,554,98,0,637,15,1598,946,405,232
44,"MUNICIPIUL BUCUREŞTI - SECTOR 3","MUNICIPIUL BUCUREŞTI",179132,"BUCUREŞTI SECTORUL 3","LICEUL TEORETIC BILINGV ”DECEBAL”;",510,"Alegeri Prezidentiale",1,1398,578,482,96,0,563,15,1534,956,402,161
44,"MUNICIPIUL BUCUREŞTI - SECTOR 3","MUNICIPIUL BUCUREŞTI",179132,"BUCUREŞTI SECTORUL 3","ŞCOALA GIMNAZIALĂ NR.54;",511,"Alegeri Prezidentiale",1,1010,715,506,209,0,705,10,1116,401,532,173
44,"MUNICIPIUL BUCUREŞTI - SECTOR 3","MUNICIPIUL BUCUREŞTI",179132,"BUCUREŞTI SECTORUL 3","ŞCOALA GIMNAZIALĂ NR.54;",512,"Alegeri Prezidentiale",1,1353,821,667,154,0,803,18,1484,663,561,242
44,"MUNICIPIUL BUCUREŞTI - SECTOR 3","MUNICIPIUL BUCUREŞTI",179132,"BUCUREŞTI SECTORUL 3","ŞCOALA GIMNAZIALĂ NR.54;",513,"Alegeri Prezidentiale",1,1510,813,687,126,0,794,19,1664,851,579,215
44,"MUNICIPIUL BUCUREŞTI - SECTOR 3","MUNICIPIUL BUCUREŞTI",179132,"BUCUREŞTI SECTORUL 3","ŞCOALA GIMNAZIALĂ NR.54;",514,"Alegeri Prezidentiale",1,1375,877,769,108,0,853,24,1508,631,554,299
44,"MUNICIPIUL BUCUREŞTI - SECTOR 3","MUNICIPIUL BUCUREŞTI",179132,"BUCUREŞTI SECTORUL 3","ŞCOALA GIMNAZIALĂ NR.54;",515,"Alegeri Prezidentiale",1,1293,684,627,57,0,665,19,1418,734,444,221
44,"MUNICIPIUL BUCUREŞTI - SECTOR 3","MUNICIPIUL BUCUREŞTI",179132,"BUCUREŞTI SECTORUL 3","ŞCOALA GIMNAZIALĂ NR.54;",516,"Alegeri Prezidentiale",1,1123,606,554,52,0,584,22,1232,626,378,206
44,"MUNICIPIUL BUCUREŞTI - SECTOR 3","MUNICIPIUL BUCUREŞTI",179132,"BUCUREŞTI SECTORUL 3","ŞCOALA GIMNAZIALĂ NR.54;",517,"Alegeri Prezidentiale",1,1338,662,627,34,1,647,15,1468,806,454,193
44,"MUNICIPIUL BUCUREŞTI - SECTOR 3","MUNICIPIUL BUCUREŞTI",179132,"BUCUREŞTI SECTORUL 3","ŞCOALA GIMNAZIALĂ NR.54;",518,"Alegeri Prezidentiale",1,1196,581,551,30,0,571,10,1320,739,388,183
44,"MUNICIPIUL BUCUREŞTI - SECTOR 3","MUNICIPIUL BUCUREŞTI",179132,"BUCUREŞTI SECTORUL 3","ŞCOALA GIMNAZIALĂ NR.54;",519,"Alegeri Prezidentiale",1,1219,625,602,23,0,610,15,1333,708,356,254
44,"MUNICIPIUL BUCUREŞTI - SECTOR 3","MUNICIPIUL BUCUREŞTI",179132,"BUCUREŞTI SECTORUL 3","ŞCOALA GIMNAZIALĂ NR.54;",520,"Alegeri Prezidentiale",1,1460,705,672,33,0,695,10,1602,897,470,225
44,"MUNICIPIUL BUCUREŞTI - SECTOR 3","MUNICIPIUL BUCUREŞTI",179132,"BUCUREŞTI SECTORUL 3","ŞCOALA GIMNAZIALĂ ”NICOLAE LABIŞ”;",521,"Alegeri Prezidentiale",1,1485,864,752,112,0,837,27,1629,765,590,247
44,"MUNICIPIUL BUCUREŞTI - SECTOR 3","MUNICIPIUL BUCUREŞTI",179132,"BUCUREŞTI SECTORUL 3","ŞCOALA GIMNAZIALĂ ”NICOLAE LABIŞ”;",522,"Alegeri Prezidentiale",1,1194,670,568,102,0,658,12,1310,640,466,192
44,"MUNICIPIUL BUCUREŞTI - SECTOR 3","MUNICIPIUL BUCUREŞTI",179132,"BUCUREŞTI SECTORUL 3","ŞCOALA GIMNAZIALĂ ”NICOLAE LABIŞ”;",523,"Alegeri Prezidentiale",1,1745,951,838,113,0,932,19,1914,963,686,246
44,"MUNICIPIUL BUCUREŞTI - SECTOR 3","MUNICIPIUL BUCUREŞTI",179132,"BUCUREŞTI SECTORUL 3","ŞCOALA GIMNAZIALĂ ”NICOLAE LABIŞ”;",524,"Alegeri Prezidentiale",1,1408,849,733,116,0,832,17,1553,704,573,259
44,"MUNICIPIUL BUCUREŞTI - SECTOR 3","MUNICIPIUL BUCUREŞTI",179132,"BUCUREŞTI SECTORUL 3","ŞCOALA GIMNAZIALĂ ”NICOLAE LABIŞ”;",525,"Alegeri Prezidentiale",1,1600,934,833,101,0,915,19,1755,821,670,245
44,"MUNICIPIUL BUCUREŞTI - SECTOR 3","MUNICIPIUL BUCUREŞTI",179132,"BUCUREŞTI SECTORUL 3","ŞCOALA GIMNAZIALĂ ”NICOLAE LABIŞ”;",526,"Alegeri Prezidentiale",1,1647,867,820,46,1,856,11,1799,932,600,256
44,"MUNICIPIUL BUCUREŞTI - SECTOR 3","MUNICIPIUL BUCUREŞTI",179132,"BUCUREŞTI SECTORUL 3","ŞCOALA GIMNAZIALĂ ”NICOLAE LABIŞ”;",527,"Alegeri Prezidentiale",1,1184,689,656,32,1,673,16,1307,618,477,196
44,"MUNICIPIUL BUCUREŞTI - SECTOR 3","MUNICIPIUL BUCUREŞTI",179132,"BUCUREŞTI SECTORUL 3","ŞCOALA GIMNAZIALĂ ”NICOLAE LABIŞ”;",528,"Alegeri Prezidentiale",1,1232,742,712,29,1,730,12,1352,610,480,250
44,"MUNICIPIUL BUCUREŞTI - SECTOR 3","MUNICIPIUL BUCUREŞTI",179132,"BUCUREŞTI SECTORUL 3","ŞCOALA GIMNAZIALĂ NR.92;",529,"Alegeri Prezidentiale",1,2008,1102,972,130,0,1079,23,2203,1101,785,294
44,"MUNICIPIUL BUCUREŞTI - SECTOR 3","MUNICIPIUL BUCUREŞTI",179132,"BUCUREŞTI SECTORUL 3","ŞCOALA GIMNAZIALĂ NR.92;",530,"Alegeri Prezidentiale",1,1410,835,724,108,3,815,20,1547,712,547,268
44,"MUNICIPIUL BUCUREŞTI - SECTOR 3","MUNICIPIUL BUCUREŞTI",179132,"BUCUREŞTI SECTORUL 3","ŞCOALA GIMNAZIALĂ NR.92;",531,"Alegeri Prezidentiale",1,1955,1178,1068,110,0,1147,31,2147,969,847,300
44,"MUNICIPIUL BUCUREŞTI - SECTOR 3","MUNICIPIUL BUCUREŞTI",179132,"BUCUREŞTI SECTORUL 3","ŞCOALA GIMNAZIALĂ NR.92;",532,"Alegeri Prezidentiale",1,1360,797,714,83,0,771,26,1492,695,527,244
44,"MUNICIPIUL BUCUREŞTI - SECTOR 3","MUNICIPIUL BUCUREŞTI",179132,"BUCUREŞTI SECTORUL 3","ŞCOALA GIMNAZIALĂ NR.92;",533,"Alegeri Prezidentiale",1,1095,669,546,122,1,646,23,1201,532,402,244
44,"MUNICIPIUL BUCUREŞTI - SECTOR 3","MUNICIPIUL BUCUREŞTI",179132,"BUCUREŞTI SECTORUL 3","ŞCOALA GIMNAZIALĂ NR.92;",534,"Alegeri Prezidentiale",1,1677,880,829,50,1,857,23,1840,960,570,287
44,"MUNICIPIUL BUCUREŞTI - SECTOR 3","MUNICIPIUL BUCUREŞTI",179132,"BUCUREŞTI SECTORUL 3","ŞCOALA GIMNAZIALĂ NR.92;",535,"Alegeri Prezidentiale",1,1506,794,734,60,0,778,16,1652,858,515,263
44,"MUNICIPIUL BUCUREŞTI - SECTOR 3","MUNICIPIUL BUCUREŞTI",179132,"BUCUREŞTI SECTORUL 3","ŞCOALA GIMNAZIALĂ NR.92;",536,"Alegeri Prezidentiale",1,1345,747,713,34,0,733,14,1475,728,434,299
44,"MUNICIPIUL BUCUREŞTI - SECTOR 3","MUNICIPIUL BUCUREŞTI",179132,"BUCUREŞTI SECTORUL 3","ŞCOALA GIMNAZIALĂ NR.92;",537,"Alegeri Prezidentiale",1,1457,771,740,31,0,754,17,1598,827,474,280
44,"MUNICIPIUL BUCUREŞTI - SECTOR 3","MUNICIPIUL BUCUREŞTI",179132,"BUCUREŞTI SECTORUL 3","ŞCOALA GIMNAZIALĂ NR.20;",538,"Alegeri Prezidentiale",1,1428,845,728,117,0,830,15,1571,726,590,240
44,"MUNICIPIUL BUCUREŞTI - SECTOR 3","MUNICIPIUL BUCUREŞTI",179132,"BUCUREŞTI SECTORUL 3","ŞCOALA GIMNAZIALĂ NR.20;",539,"Alegeri Prezidentiale",1,1797,1083,930,142,11,1062,21,1971,888,771,291
44,"MUNICIPIUL BUCUREŞTI - SECTOR 3","MUNICIPIUL BUCUREŞTI",179132,"BUCUREŞTI SECTORUL 3","ŞCOALA GIMNAZIALĂ NR.20;",540,"Alegeri Prezidentiale",1,1999,1266,1121,145,0,1238,28,2193,927,929,309
44,"MUNICIPIUL BUCUREŞTI - SECTOR 3","MUNICIPIUL BUCUREŞTI",179132,"BUCUREŞTI SECTORUL 3","ŞCOALA GIMNAZIALĂ NR.20;",541,"Alegeri Prezidentiale",1,1373,853,722,131,0,843,10,1506,653,569,274
44,"MUNICIPIUL BUCUREŞTI - SECTOR 3","MUNICIPIUL BUCUREŞTI",179132,"BUCUREŞTI SECTORUL 3","ŞCOALA GIMNAZIALĂ NR.20;",542,"Alegeri Prezidentiale",1,1412,820,737,83,0,811,9,1549,729,501,310
44,"MUNICIPIUL BUCUREŞTI - SECTOR 3","MUNICIPIUL BUCUREŞTI",179132,"BUCUREŞTI SECTORUL 3","ŞCOALA GIMNAZIALĂ NR.20;",543,"Alegeri Prezidentiale",1,1432,798,750,47,1,780,18,1571,773,538,242
44,"MUNICIPIUL BUCUREŞTI - SECTOR 3","MUNICIPIUL BUCUREŞTI",179132,"BUCUREŞTI SECTORUL 3","COLEGIUL TEHNIC ”COSTIN D. NENIŢESCU”;",544,"Alegeri Prezidentiale",1,2055,960,660,300,0,937,23,2254,1294,764,173
44,"MUNICIPIUL BUCUREŞTI - SECTOR 3","MUNICIPIUL BUCUREŞTI",179132,"BUCUREŞTI SECTORUL 3","COLEGIUL TEHNIC ”COSTIN D. NENIŢESCU”;",545,"Alegeri Prezidentiale",1,1788,1102,828,274,0,1078,24,1961,859,703,375
44,"MUNICIPIUL BUCUREŞTI - SECTOR 3","MUNICIPIUL BUCUREŞTI",179132,"BUCUREŞTI SECTORUL 3","COLEGIUL TEHNIC ”COSTIN D. NENIŢESCU”;",546,"Alegeri Prezidentiale",1,1782,1247,924,323,0,1226,21,1955,708,854,372
44,"MUNICIPIUL BUCUREŞTI - SECTOR 3","MUNICIPIUL BUCUREŞTI",179132,"BUCUREŞTI SECTORUL 3","COLEGIUL TEHNIC ”COSTIN D. NENIŢESCU”;",547,"Alegeri Prezidentiale",1,1488,920,745,174,1,892,28,1632,712,621,271
44,"MUNICIPIUL BUCUREŞTI - SECTOR 3","MUNICIPIUL BUCUREŞTI",179132,"BUCUREŞTI SECTORUL 3","COLEGIUL TEHNIC ”COSTIN D. NENIŢESCU”;",548,"Alegeri Prezidentiale",1,1984,1292,1059,233,0,1261,31,2176,884,956,305
44,"MUNICIPIUL BUCUREŞTI - SECTOR 3","MUNICIPIUL BUCUREŞTI",179132,"BUCUREŞTI SECTORUL 3","ŞCOALA GIMNAZIALĂ NR.112;",549,"Alegeri Prezidentiale",1,1210,778,604,173,1,754,24,1327,549,497,257
44,"MUNICIPIUL BUCUREŞTI - SECTOR 3","MUNICIPIUL BUCUREŞTI",179132,"BUCUREŞTI SECTORUL 3","ŞCOALA GIMNAZIALĂ NR.112;",550,"Alegeri Prezidentiale",1,1162,874,594,280,0,854,20,1267,393,603,251
44,"MUNICIPIUL BUCUREŞTI - SECTOR 3","MUNICIPIUL BUCUREŞTI",179132,"BUCUREŞTI SECTORUL 3","ŞCOALA GIMNAZIALĂ NR.112;",551,"Alegeri Prezidentiale",1,1243,674,584,90,0,660,14,1364,690,437,223
44,"MUNICIPIUL BUCUREŞTI - SECTOR 3","MUNICIPIUL BUCUREŞTI",179132,"BUCUREŞTI SECTORUL 3","ŞCOALA GIMNAZIALĂ NR.112;",552,"Alegeri Prezidentiale",1,1550,921,811,110,0,905,16,1692,771,593,312
44,"MUNICIPIUL BUCUREŞTI - SECTOR 3","MUNICIPIUL BUCUREŞTI",179132,"BUCUREŞTI SECTORUL 3","ŞCOALA GIMNAZIALĂ NR.112;",553,"Alegeri Prezidentiale",1,1195,721,664,57,0,708,13,1311,590,437,271
44,"MUNICIPIUL BUCUREŞTI - SECTOR 3","MUNICIPIUL BUCUREŞTI",179132,"BUCUREŞTI SECTORUL 3","ŞCOALA GIMNAZIALĂ NR.112;",554,"Alegeri Prezidentiale",1,1214,689,642,46,1,673,16,1332,643,443,230
44,"MUNICIPIUL BUCUREŞTI - SECTOR 3","MUNICIPIUL BUCUREŞTI",179132,"BUCUREŞTI SECTORUL 3","ŞCOALA GIMNAZIALĂ NR.112;",555,"Alegeri Prezidentiale",1,1156,592,558,34,0,585,7,1268,676,389,196
44,"MUNICIPIUL BUCUREŞTI - SECTOR 3","MUNICIPIUL BUCUREŞTI",179132,"BUCUREŞTI SECTORUL 3","ŞCOALA GIMNAZIALĂ NR.112;",556,"Alegeri Prezidentiale",1,1118,573,551,22,0,564,9,1226,653,341,223
44,"MUNICIPIUL BUCUREŞTI - SECTOR 3","MUNICIPIUL BUCUREŞTI",179132,"BUCUREŞTI SECTORUL 3","ŞCOALA GIMNAZIALĂ NR.112;",557,"Alegeri Prezidentiale",1,1283,665,639,26,0,650,15,1407,742,402,248
44,"MUNICIPIUL BUCUREŞTI - SECTOR 3","MUNICIPIUL BUCUREŞTI",179132,"BUCUREŞTI SECTORUL 3","ŞCOALA GIMNAZIALĂ NR.112;",558,"Alegeri Prezidentiale",1,1171,512,490,22,0,499,13,1284,772,311,188
44,"MUNICIPIUL BUCUREŞTI - SECTOR 3","MUNICIPIUL BUCUREŞTI",179132,"BUCUREŞTI SECTORUL 3","ŞCOALA GIMNAZIALĂ NR.200;",559,"Alegeri Prezidentiale",1,1598,1148,849,299,0,1126,22,1753,605,760,366
44,"MUNICIPIUL BUCUREŞTI - SECTOR 3","MUNICIPIUL BUCUREŞTI",179132,"BUCUREŞTI SECTORUL 3","ŞCOALA GIMNAZIALĂ NR.200;",560,"Alegeri Prezidentiale",2,1560,920,781,138,1,898,22,1701,781,620,278
44,"MUNICIPIUL BUCUREŞTI - SECTOR 3","MUNICIPIUL BUCUREŞTI",179132,"BUCUREŞTI SECTORUL 3","ŞCOALA GIMNAZIALĂ NR.200;",561,"Alegeri Prezidentiale",1,1399,751,632,79,40,736,15,1535,784,498,238
44,"MUNICIPIUL BUCUREŞTI - SECTOR 3","MUNICIPIUL BUCUREŞTI",179132,"BUCUREŞTI SECTORUL 3","ŞCOALA GIMNAZIALĂ NR.200;",562,"Alegeri Prezidentiale",1,1517,746,702,42,2,722,24,1664,918,471,251
44,"MUNICIPIUL BUCUREŞTI - SECTOR 3","MUNICIPIUL BUCUREŞTI",179132,"BUCUREŞTI SECTORUL 3","ŞCOALA GIMNAZIALĂ NR.200;",563,"Alegeri Prezidentiale",1,1444,690,643,47,0,670,20,1584,894,433,237
44,"MUNICIPIUL BUCUREŞTI - SECTOR 3","MUNICIPIUL BUCUREŞTI",179132,"BUCUREŞTI SECTORUL 3","ŞCOALA GIMNAZIALĂ NR.200;",564,"Alegeri Prezidentiale",1,1359,635,608,27,0,623,12,1491,856,422,201
44,"MUNICIPIUL BUCUREŞTI - SECTOR 3","MUNICIPIUL BUCUREŞTI",179132,"BUCUREŞTI SECTORUL 3","ŞCOALA GIMNAZIALĂ NR.200;",565,"Alegeri Prezidentiale",1,1923,1153,1096,57,0,1124,29,2111,958,856,268
44,"MUNICIPIUL BUCUREŞTI - SECTOR 3","MUNICIPIUL BUCUREŞTI",179132,"BUCUREŞTI SECTORUL 3","ŞCOALA GIMNAZIALĂ ”FEDERICO GARCIA LORCA”;",566,"Alegeri Prezidentiale",1,1183,619,560,59,0,601,18,1298,679,418,183
44,"MUNICIPIUL BUCUREŞTI - SECTOR 3","MUNICIPIUL BUCUREŞTI",179132,"BUCUREŞTI SECTORUL 3","ŞCOALA GIMNAZIALĂ ”FEDERICO GARCIA LORCA”;",567,"Alegeri Prezidentiale",1,1036,690,555,135,0,668,22,1136,446,487,181
44,"MUNICIPIUL BUCUREŞTI - SECTOR 3","MUNICIPIUL BUCUREŞTI",179132,"BUCUREŞTI SECTORUL 3","ŞCOALA GIMNAZIALĂ ”FEDERICO GARCIA LORCA”;",568,"Alegeri Prezidentiale",1,1218,711,661,48,2,690,21,1336,625,431,259
44,"MUNICIPIUL BUCUREŞTI - SECTOR 3","MUNICIPIUL BUCUREŞTI",179132,"BUCUREŞTI SECTORUL 3","ŞCOALA GIMNAZIALĂ ”FEDERICO GARCIA LORCA”;",569,"Alegeri Prezidentiale",1,1549,986,923,62,1,975,11,1699,713,694,281
44,"MUNICIPIUL BUCUREŞTI - SECTOR 3","MUNICIPIUL BUCUREŞTI",179132,"BUCUREŞTI SECTORUL 3","ŞCOALA GIMNAZIALĂ ”FEDERICO GARCIA LORCA”;",570,"Alegeri Prezidentiale",1,1348,746,662,84,0,731,15,1479,733,525,206
44,"MUNICIPIUL BUCUREŞTI - SECTOR 3","MUNICIPIUL BUCUREŞTI",179132,"BUCUREŞTI SECTORUL 3","ŞCOALA GIMNAZIALĂ ”FEDERICO GARCIA LORCA”;",571,"Alegeri Prezidentiale",1,1247,671,606,64,1,657,14,1368,697,443,214
44,"MUNICIPIUL BUCUREŞTI - SECTOR 3","MUNICIPIUL BUCUREŞTI",179132,"BUCUREŞTI SECTORUL 3","ŞCOALA GIMNAZIALĂ ”FEDERICO GARCIA LORCA”;",572,"Alegeri Prezidentiale",1,1380,735,680,53,2,726,9,1514,779,517,209
44,"MUNICIPIUL BUCUREŞTI - SECTOR 3","MUNICIPIUL BUCUREŞTI",179132,"BUCUREŞTI SECTORUL 3","ŞCOALA GIMNAZIALĂ ”MEXIC”;",573,"Alegeri Prezidentiale",1,1972,1107,982,124,1,1081,26,2163,1056,709,372
44,"MUNICIPIUL BUCUREŞTI - SECTOR 3","MUNICIPIUL BUCUREŞTI",179132,"BUCUREŞTI SECTORUL 3","ŞCOALA GIMNAZIALĂ ”MEXIC”;",574,"Alegeri Prezidentiale",2,1753,991,843,148,0,966,25,1923,932,611,355
44,"MUNICIPIUL BUCUREŞTI - SECTOR 3","MUNICIPIUL BUCUREŞTI",179132,"BUCUREŞTI SECTORUL 3","ŞCOALA GIMNAZIALĂ ”MEXIC”;",575,"Alegeri Prezidentiale",1,1768,968,825,143,0,951,17,1939,971,696,255
44,"MUNICIPIUL BUCUREŞTI - SECTOR 3","MUNICIPIUL BUCUREŞTI",179132,"BUCUREŞTI SECTORUL 3","ŞCOALA GIMNAZIALĂ ”MEXIC”;",576,"Alegeri Prezidentiale",1,1944,411,278,133,0,402,9,2133,1722,287,115
44,"MUNICIPIUL BUCUREŞTI - SECTOR 3","MUNICIPIUL BUCUREŞTI",179132,"BUCUREŞTI SECTORUL 3","ŞCOALA GIMNAZIALĂ ”MEXIC”;",577,"Alegeri Prezidentiale",1,1747,787,738,49,0,769,18,1916,1129,464,305
44,"MUNICIPIUL BUCUREŞTI - SECTOR 3","MUNICIPIUL BUCUREŞTI",179132,"BUCUREŞTI SECTORUL 3","ŞCOALA GIMNAZIALĂ ”MEXIC”;",578,"Alegeri Prezidentiale",1,1866,923,901,22,0,902,21,2047,1124,568,334
44,"MUNICIPIUL BUCUREŞTI - SECTOR 3","MUNICIPIUL BUCUREŞTI",179132,"BUCUREŞTI SECTORUL 3","ŞCOALA GIMNAZIALĂ ”MEXIC”;",579,"Alegeri Prezidentiale",1,1772,809,779,30,0,780,29,1952,1143,526,254
44,"MUNICIPIUL BUCUREŞTI - SECTOR 3","MUNICIPIUL BUCUREŞTI",179132,"BUCUREŞTI SECTORUL 3","ŞCOALA GIMNAZIALĂ ”MEXIC”;",580,"Alegeri Prezidentiale",1,1838,936,885,51,0,914,22,2016,1080,564,350
44,"MUNICIPIUL BUCUREŞTI - SECTOR 3","MUNICIPIUL BUCUREŞTI",179132,"BUCUREŞTI SECTORUL 3","ŞCOALA GIMNAZIALĂ ”LIVIU REBREANU”;",581,"Alegeri Prezidentiale",1,1351,814,701,94,19,806,8,1482,668,534,272
44,"MUNICIPIUL BUCUREŞTI - SECTOR 3","MUNICIPIUL BUCUREŞTI",179132,"BUCUREŞTI SECTORUL 3","ŞCOALA GIMNAZIALĂ ”LIVIU REBREANU”;",582,"Alegeri Prezidentiale",1,1031,567,533,34,0,552,15,1131,564,370,182
44,"MUNICIPIUL BUCUREŞTI - SECTOR 3","MUNICIPIUL BUCUREŞTI",179132,"BUCUREŞTI SECTORUL 3","LICEUL TEORETIC ”AL. I. CUZA”;",583,"Alegeri Prezidentiale",1,1350,679,637,42,0,661,18,1473,794,460,201
44,"MUNICIPIUL BUCUREŞTI - SECTOR 3","MUNICIPIUL BUCUREŞTI",179132,"BUCUREŞTI SECTORUL 3","LICEUL TEORETIC ”AL. I. CUZA”;",584,"Alegeri Prezidentiale",1,1315,785,713,70,2,768,17,1443,658,529,239
44,"MUNICIPIUL BUCUREŞTI - SECTOR 3","MUNICIPIUL BUCUREŞTI",179132,"BUCUREŞTI SECTORUL 3","LICEUL TEORETIC ”AL. I. CUZA”;",585,"Alegeri Prezidentiale",1,1266,860,747,113,0,841,19,1389,529,580,261
44,"MUNICIPIUL BUCUREŞTI - SECTOR 3","MUNICIPIUL BUCUREŞTI",179132,"BUCUREŞTI SECTORUL 3","LICEUL TEORETIC ”AL. I. CUZA”;",586,"Alegeri Prezidentiale",1,1319,926,674,251,1,903,23,1447,521,630,273
44,"MUNICIPIUL BUCUREŞTI - SECTOR 3","MUNICIPIUL BUCUREŞTI",179132,"BUCUREŞTI SECTORUL 3","LICEUL TEORETIC ”AL. I. CUZA”;",587,"Alegeri Prezidentiale",1,1292,859,712,146,1,841,18,1425,566,595,246
44,"MUNICIPIUL BUCUREŞTI - SECTOR 3","MUNICIPIUL BUCUREŞTI",179132,"BUCUREŞTI SECTORUL 3","LICEUL TEORETIC ”AL. I. CUZA”;",588,"Alegeri Prezidentiale",1,1459,863,773,89,1,847,16,1601,738,600,247
44,"MUNICIPIUL BUCUREŞTI - SECTOR 3","MUNICIPIUL BUCUREŞTI",179132,"BUCUREŞTI SECTORUL 3","LICEUL TEORETIC ”NICHITA STĂNESCU”;",589,"Alegeri Prezidentiale",1,1149,750,530,220,0,739,11,1257,507,495,244
44,"MUNICIPIUL BUCUREŞTI - SECTOR 3","MUNICIPIUL BUCUREŞTI",179132,"BUCUREŞTI SECTORUL 3","LICEUL TEORETIC ”NICHITA STĂNESCU”;",590,"Alegeri Prezidentiale",1,977,632,450,182,0,616,16,1071,439,430,186
44,"MUNICIPIUL BUCUREŞTI - SECTOR 3","MUNICIPIUL BUCUREŞTI",179132,"BUCUREŞTI SECTORUL 3","LICEUL TEORETIC ”NICHITA STĂNESCU”;",591,"Alegeri Prezidentiale",1,1916,770,635,135,0,749,21,2102,1332,508,241
44,"MUNICIPIUL BUCUREŞTI - SECTOR 3","MUNICIPIUL BUCUREŞTI",179132,"BUCUREŞTI SECTORUL 3","LICEUL TEORETIC ”NICHITA STĂNESCU”;",592,"Alegeri Prezidentiale",1,1089,671,551,120,0,659,12,1195,524,508,151
44,"MUNICIPIUL BUCUREŞTI - SECTOR 3","MUNICIPIUL BUCUREŞTI",179132,"BUCUREŞTI SECTORUL 3","LICEUL TEORETIC ”NICHITA STĂNESCU”;",593,"Alegeri Prezidentiale",1,1348,744,666,78,0,719,25,1479,735,453,266
44,"MUNICIPIUL BUCUREŞTI - SECTOR 3","MUNICIPIUL BUCUREŞTI",179132,"BUCUREŞTI SECTORUL 3","LICEUL TEORETIC ”NICHITA STĂNESCU”;",594,"Alegeri Prezidentiale",1,1459,736,664,72,0,714,22,1601,865,466,248
44,"MUNICIPIUL BUCUREŞTI - SECTOR 3","MUNICIPIUL BUCUREŞTI",179132,"BUCUREŞTI SECTORUL 3","ŞCOALA GIMNAZIALĂ ”VOIEVOD NEAGOE BASARAB”;",595,"Alegeri Prezidentiale",1,1380,809,736,73,0,784,25,1514,705,508,276
44,"MUNICIPIUL BUCUREŞTI - SECTOR 3","MUNICIPIUL BUCUREŞTI",179132,"BUCUREŞTI SECTORUL 3","ŞCOALA GIMNAZIALĂ ”VOIEVOD NEAGOE BASARAB”;",596,"Alegeri Prezidentiale",1,1225,640,550,90,0,628,12,1344,704,431,197
44,"MUNICIPIUL BUCUREŞTI - SECTOR 3","MUNICIPIUL BUCUREŞTI",179132,"BUCUREŞTI SECTORUL 3","ŞCOALA GIMNAZIALĂ ”VOIEVOD NEAGOE BASARAB”;",597,"Alegeri Prezidentiale",1,1561,891,809,82,0,869,22,1704,813,639,230
44,"MUNICIPIUL BUCUREŞTI - SECTOR 3","MUNICIPIUL BUCUREŞTI",179132,"BUCUREŞTI SECTORUL 3","ŞCOALA GIMNAZIALĂ ”VOIEVOD NEAGOE BASARAB”;",598,"Alegeri Prezidentiale",1,1326,711,673,36,2,686,25,1445,734,460,226
44,"MUNICIPIUL BUCUREŞTI - SECTOR 3","MUNICIPIUL BUCUREŞTI",179132,"BUCUREŞTI SECTORUL 3","ŞCOALA GIMNAZIALĂ NR.149;",599,"Alegeri Prezidentiale",1,1506,902,792,110,0,887,15,1652,750,578,309
44,"MUNICIPIUL BUCUREŞTI - SECTOR 3","MUNICIPIUL BUCUREŞTI",179132,"BUCUREŞTI SECTORUL 3","ŞCOALA GIMNAZIALĂ NR.149;",600,"Alegeri Prezidentiale",1,1762,965,869,96,0,949,16,1933,968,643,306
44,"MUNICIPIUL BUCUREŞTI - SECTOR 3","MUNICIPIUL BUCUREŞTI",179132,"BUCUREŞTI SECTORUL 3","ŞCOALA GIMNAZIALĂ NR.149;",601,"Alegeri Prezidentiale",1,1413,790,731,59,0,772,18,1542,752,494,278
44,"MUNICIPIUL BUCUREŞTI - SECTOR 3","MUNICIPIUL BUCUREŞTI",179132,"BUCUREŞTI SECTORUL 3","ŞCOALA GIMNAZIALĂ NR. 82;",602,"Alegeri Prezidentiale",1,1787,1059,932,126,1,1027,32,1960,901,746,281
44,"MUNICIPIUL BUCUREŞTI - SECTOR 3","MUNICIPIUL BUCUREŞTI",179132,"BUCUREŞTI SECTORUL 3","ŞCOALA GIMNAZIALĂ NR. 82;",603,"Alegeri Prezidentiale",1,1342,995,679,305,11,975,20,1472,477,668,307
44,"MUNICIPIUL BUCUREŞTI - SECTOR 3","MUNICIPIUL BUCUREŞTI",179132,"BUCUREŞTI SECTORUL 3","ŞCOALA GIMNAZIALĂ NR. 82;",604,"Alegeri Prezidentiale",1,1423,863,696,167,0,844,19,1560,697,570,274
44,"MUNICIPIUL BUCUREŞTI - SECTOR 3","MUNICIPIUL BUCUREŞTI",179132,"BUCUREŞTI SECTORUL 3","ŞCOALA GIMNAZIALĂ NR. 82;",605,"Alegeri Prezidentiale",1,1507,832,757,74,1,807,25,1661,829,558,249
44,"MUNICIPIUL BUCUREŞTI - SECTOR 3","MUNICIPIUL BUCUREŞTI",179132,"BUCUREŞTI SECTORUL 3","ŞCOALA GIMNAZIALĂ NR. 82;",606,"Alegeri Prezidentiale",1,1267,729,671,58,0,715,14,1390,661,474,241
44,"MUNICIPIUL BUCUREŞTI - SECTOR 3","MUNICIPIUL BUCUREŞTI",179132,"BUCUREŞTI SECTORUL 3","ŞCOALA GIMNAZIALĂ NR. 82;",607,"Alegeri Prezidentiale",1,1786,1085,975,110,0,1065,20,1966,881,823,242
44,"MUNICIPIUL BUCUREŞTI - SECTOR 3","MUNICIPIUL BUCUREŞTI",179132,"BUCUREŞTI SECTORUL 3","ŞCOALA GIMNAZIALĂ NR. 82;",608,"Alegeri Prezidentiale",1,1322,784,713,71,0,770,14,1450,666,498,272
44,"MUNICIPIUL BUCUREŞTI - SECTOR 3","MUNICIPIUL BUCUREŞTI",179132,"BUCUREŞTI SECTORUL 3","ŞCOALA GIMNAZIALĂ NR. 82;",609,"Alegeri Prezidentiale",1,1708,933,867,66,0,911,22,1875,942,633,278
44,"MUNICIPIUL BUCUREŞTI - SECTOR 3","MUNICIPIUL BUCUREŞTI",179132,"BUCUREŞTI SECTORUL 3","ŞCOALA GIMNAZIALĂ NR.116;",610,"Alegeri Prezidentiale",2,2015,1347,1106,241,0,1316,31,2210,863,983,333
44,"MUNICIPIUL BUCUREŞTI - SECTOR 3","MUNICIPIUL BUCUREŞTI",179132,"BUCUREŞTI SECTORUL 3","ŞCOALA GIMNAZIALĂ NR.116;",611,"Alegeri Prezidentiale",1,2088,1288,1045,243,0,1265,23,2291,1003,1024,241
44,"MUNICIPIUL BUCUREŞTI - SECTOR 3","MUNICIPIUL BUCUREŞTI",179132,"BUCUREŞTI SECTORUL 3","ŞCOALA GIMNAZIALĂ NR.116;",612,"Alegeri Prezidentiale",1,1557,847,748,99,0,828,19,1708,861,485,343
44,"MUNICIPIUL BUCUREŞTI - SECTOR 3","MUNICIPIUL BUCUREŞTI",179132,"BUCUREŞTI SECTORUL 3","ŞCOALA GIMNAZIALĂ NR.116;",613,"Alegeri Prezidentiale",1,1508,739,709,29,1,722,17,1654,915,460,262
44,"MUNICIPIUL BUCUREŞTI - SECTOR 3","MUNICIPIUL BUCUREŞTI",179132,"BUCUREŞTI SECTORUL 3","ŞCOALA GIMNAZIALĂ NR.116;",614,"Alegeri Prezidentiale",1,1411,721,693,28,0,703,18,1556,835,455,248
44,"MUNICIPIUL BUCUREŞTI - SECTOR 3","MUNICIPIUL BUCUREŞTI",179132,"BUCUREŞTI SECTORUL 3","ŞCOALA GIMNAZIALĂ NR.116;",615,"Alegeri Prezidentiale",1,1778,885,851,34,0,859,26,1950,1065,571,288
44,"MUNICIPIUL BUCUREŞTI - SECTOR 3","MUNICIPIUL BUCUREŞTI",179132,"BUCUREŞTI SECTORUL 3","ŞCOALA GIMNAZIALĂ NR.116;",616,"Alegeri Prezidentiale",1,1826,842,794,48,0,813,29,2003,1161,556,257
44,"MUNICIPIUL BUCUREŞTI - SECTOR 3","MUNICIPIUL BUCUREŞTI",179132,"BUCUREŞTI SECTORUL 3","ŞCOALA GIMNAZIALĂ NR.55;",617,"Alegeri Prezidentiale",1,2341,166,73,93,0,162,4,2568,2402,110,52
44,"MUNICIPIUL BUCUREŞTI - SECTOR 3","MUNICIPIUL BUCUREŞTI",179132,"BUCUREŞTI SECTORUL 3","ŞCOALA GIMNAZIALĂ NR.55;",618,"Alegeri Prezidentiale",1,1781,39,15,24,0,39,0,1954,1915,24,15
44,"MUNICIPIUL BUCUREŞTI - SECTOR 3","MUNICIPIUL BUCUREŞTI",179132,"BUCUREŞTI SECTORUL 3","ŞCOALA GIMNAZIALĂ NR.55;",619,"Alegeri Prezidentiale",1,1981,263,230,33,0,257,6,2173,1910,166,91
44,"MUNICIPIUL BUCUREŞTI - SECTOR 3","MUNICIPIUL BUCUREŞTI",179132,"BUCUREŞTI SECTORUL 3","ŞCOALA GIMNAZIALĂ NR.55;",620,"Alegeri Prezidentiale",1,1745,264,211,53,0,255,9,1914,1650,142,113
44,"MUNICIPIUL BUCUREŞTI - SECTOR 3","MUNICIPIUL BUCUREŞTI",179132,"BUCUREŞTI SECTORUL 3","ŞCOALA GIMNAZIALĂ NR.55;",621,"Alegeri Prezidentiale",1,1847,173,154,19,0,168,5,2026,1853,106,62
44,"MUNICIPIUL BUCUREŞTI - SECTOR 3","MUNICIPIUL BUCUREŞTI",179132,"BUCUREŞTI SECTORUL 3","ŞCOALA GIMNAZIALĂ NR.55;",622,"Alegeri Prezidentiale",1,1845,381,348,33,0,371,10,2024,1643,244,127
44,"MUNICIPIUL BUCUREŞTI - SECTOR 3","MUNICIPIUL BUCUREŞTI",179132,"BUCUREŞTI SECTORUL 3","ŞCOALA GIMNAZIALĂ NR.55;",623,"Alegeri Prezidentiale",1,2111,414,385,29,0,404,10,2315,1901,256,148
44,"MUNICIPIUL BUCUREŞTI - SECTOR 3","MUNICIPIUL BUCUREŞTI",179132,"BUCUREŞTI SECTORUL 3","ŞCOALA GIMNAZIALĂ NR.55;",624,"Alegeri Prezidentiale",3,1726,471,463,8,0,456,15,1893,1422,300,156
44,"MUNICIPIUL BUCUREŞTI - SECTOR 3","MUNICIPIUL BUCUREŞTI",179132,"BUCUREŞTI SECTORUL 3","ŞCOALA GIMNAZIALĂ NR.55;",625,"Alegeri Prezidentiale",1,1770,368,351,17,0,365,3,1942,1574,208,157
44,"MUNICIPIUL BUCUREŞTI - SECTOR 3","MUNICIPIUL BUCUREŞTI",179132,"BUCUREŞTI SECTORUL 3","ŞCOALA GIMNAZIALĂ NR.55;",626,"Alegeri Prezidentiale",1,2142,426,413,13,0,422,4,2350,1924,228,194
44,"MUNICIPIUL BUCUREŞTI - SECTOR 3","MUNICIPIUL BUCUREŞTI",179132,"BUCUREŞTI SECTORUL 3","ŞCOALA GIMNAZIALĂ NR.55;",627,"Alegeri Prezidentiale",1,1942,31,15,16,0,30,1,2132,2101,25,5
44,"MUNICIPIUL BUCUREŞTI - SECTOR 3","MUNICIPIUL BUCUREŞTI",179132,"BUCUREŞTI SECTORUL 3","ŞCOALA GIMNAZIALĂ NR.55;",628,"Alegeri Prezidentiale",1,1882,107,96,11,0,105,2,2065,1958,54,51
44,"MUNICIPIUL BUCUREŞTI - SECTOR 3","MUNICIPIUL BUCUREŞTI",179132,"BUCUREŞTI SECTORUL 3","ŞCOALA GIMNAZIALĂ NR.55;",629,"Alegeri Prezidentiale",1,2000,36,25,11,0,35,1,2195,2159,29,6
44,"MUNICIPIUL BUCUREŞTI - SECTOR 3","MUNICIPIUL BUCUREŞTI",179132,"BUCUREŞTI SECTORUL 3","ŞCOALA GIMNAZIALĂ NR.55;",630,"Alegeri Prezidentiale",1,1830,142,129,13,0,137,5,2008,1866,86,51
44,"MUNICIPIUL BUCUREŞTI - SECTOR 3","MUNICIPIUL BUCUREŞTI",179132,"BUCUREŞTI SECTORUL 3","ŞCOALA GIMNAZIALĂ NR.55;",631,"Alegeri Prezidentiale",1,3015,117,111,6,0,116,1,3307,3190,87,29
44,"MUNICIPIUL BUCUREŞTI - SECTOR 3","MUNICIPIUL BUCUREŞTI",179132,"BUCUREŞTI SECTORUL 3","ŞCOALA GIMNAZIALĂ NR.55;",632,"Alegeri Prezidentiale",1,1722,311,301,10,0,305,6,1889,1578,183,122
44,"MUNICIPIUL BUCUREŞTI - SECTOR 3","MUNICIPIUL BUCUREŞTI",179132,"BUCUREŞTI SECTORUL 3","ŞCOALA GIMNAZIALĂ NR.55;",633,"Alegeri Prezidentiale",1,1809,644,627,17,0,633,11,1984,1340,431,202
44,"MUNICIPIUL BUCUREŞTI - SECTOR 3","MUNICIPIUL BUCUREŞTI",179132,"BUCUREŞTI SECTORUL 3","ŞCOALA GIMNAZIALĂ NR.55;",634,"Alegeri Prezidentiale",1,1678,630,610,19,1,612,18,1841,1211,359,253
44,"MUNICIPIUL BUCUREŞTI - SECTOR 3","MUNICIPIUL BUCUREŞTI",179132,"BUCUREŞTI SECTORUL 3","ŞCOALA GIMNAZIALĂ NR.55;",635,"Alegeri Prezidentiale",1,1726,61,16,45,0,61,0,1893,1832,40,21
44,"MUNICIPIUL BUCUREŞTI - SECTOR 3","MUNICIPIUL BUCUREŞTI",179132,"BUCUREŞTI SECTORUL 3","ŞCOALA GIMNAZIALĂ NR.47;",636,"Alegeri Prezidentiale",1,3228,76,51,25,0,72,4,3541,3465,55,17
44,"MUNICIPIUL BUCUREŞTI - SECTOR 3","MUNICIPIUL BUCUREŞTI",179132,"BUCUREŞTI SECTORUL 3","ŞCOALA GIMNAZIALĂ NR.47;",637,"Alegeri Prezidentiale",1,2897,194,176,18,0,188,6,3178,2984,113,75
44,"MUNICIPIUL BUCUREŞTI - SECTOR 3","MUNICIPIUL BUCUREŞTI",179132,"BUCUREŞTI SECTORUL 3","ŞCOALA GIMNAZIALĂ NR.47;",638,"Alegeri Prezidentiale",1,2883,116,105,11,0,114,2,3163,3047,56,58
44,"MUNICIPIUL BUCUREŞTI - SECTOR 3","MUNICIPIUL BUCUREŞTI",179132,"BUCUREŞTI SECTORUL 3","ŞCOALA GIMNAZIALĂ NR.47;",639,"Alegeri Prezidentiale",1,2262,87,79,8,0,86,1,2481,2394,67,19
44,"MUNICIPIUL BUCUREŞTI - SECTOR 3","MUNICIPIUL BUCUREŞTI",179132,"BUCUREŞTI SECTORUL 3","ŞCOALA GIMNAZIALĂ NR.47;",640,"Alegeri Prezidentiale",1,2689,206,191,15,0,198,8,2950,2744,129,69
44,"MUNICIPIUL BUCUREŞTI - SECTOR 3","MUNICIPIUL BUCUREŞTI",179132,"BUCUREŞTI SECTORUL 3","ŞCOALA GIMNAZIALĂ NR.47;",641,"Alegeri Prezidentiale",1,2262,89,79,10,0,87,2,2481,2392,48,39
44,"MUNICIPIUL BUCUREŞTI - SECTOR 3","MUNICIPIUL BUCUREŞTI",179132,"BUCUREŞTI SECTORUL 3","ŞCOALA GIMNAZIALĂ NR.47;",642,"Alegeri Prezidentiale",1,2191,173,158,15,0,167,6,2404,2231,100,67
44,"MUNICIPIUL BUCUREŞTI - SECTOR 3","MUNICIPIUL BUCUREŞTI",179132,"BUCUREŞTI SECTORUL 3","ŞCOALA GIMNAZIALĂ NR.47;",643,"Alegeri Prezidentiale",1,3261,32,22,10,0,31,1,3577,3545,13,18
44,"MUNICIPIUL BUCUREŞTI - SECTOR 3","MUNICIPIUL BUCUREŞTI",179132,"BUCUREŞTI SECTORUL 3","ȘCOALA GIMNAZIALĂ NR.47;",644,"Alegeri Prezidentiale",1,1854,246,228,18,0,236,10,2034,1788,147,89
44,"MUNICIPIUL BUCUREŞTI - SECTOR 3","MUNICIPIUL BUCUREŞTI",179132,"BUCUREŞTI SECTORUL 3","ŞCOALA GIMNAZIALĂ NR.47;",645,"Alegeri Prezidentiale",1,1990,441,420,21,0,436,5,2183,1742,285,151
44,"MUNICIPIUL BUCUREŞTI - SECTOR 3","MUNICIPIUL BUCUREŞTI",179132,"BUCUREŞTI SECTORUL 3","ŞCOALA GIMNAZIALĂ NR.78;",646,"Alegeri Prezidentiale",1,1841,444,383,60,1,438,6,2010,1566,272,166
44,"MUNICIPIUL BUCUREŞTI - SECTOR 3","MUNICIPIUL BUCUREŞTI",179132,"BUCUREŞTI SECTORUL 3","ŞCOALA GIMNAZIALĂ NR.78;",647,"Alegeri Prezidentiale",1,1974,696,690,6,0,681,15,2165,1469,427,254
44,"MUNICIPIUL BUCUREŞTI - SECTOR 3","MUNICIPIUL BUCUREŞTI",179132,"BUCUREŞTI SECTORUL 3","ŞCOALA GIMNAZIALĂ NR.78;",648,"Alegeri Prezidentiale",1,1992,130,115,15,0,130,0,2193,2063,83,47
44,"MUNICIPIUL BUCUREŞTI - SECTOR 3","MUNICIPIUL BUCUREŞTI",179132,"BUCUREŞTI SECTORUL 3","ŞCOALA GIMNAZIALĂ NR.78;",649,"Alegeri Prezidentiale",1,1882,183,170,13,0,180,3,2065,1882,109,71
44,"MUNICIPIUL BUCUREŞTI - SECTOR 3","MUNICIPIUL BUCUREŞTI",179132,"BUCUREŞTI SECTORUL 3","ŞCOALA GIMNAZIALĂ NR.78;",650,"Alegeri Prezidentiale",1,1952,224,215,9,0,219,5,2141,1917,133,86
44,"MUNICIPIUL BUCUREŞTI - SECTOR 3","MUNICIPIUL BUCUREŞTI",179132,"BUCUREŞTI SECTORUL 3","ŞCOALA GIMNAZIALĂ NR.78;",651,"Alegeri Prezidentiale",1,1848,407,392,15,0,400,7,2027,1620,245,155
44,"MUNICIPIUL BUCUREŞTI - SECTOR 3","MUNICIPIUL BUCUREŞTI",179132,"BUCUREŞTI SECTORUL 3","ŞCOALA GIMNAZIALĂ NR.78;",652,"Alegeri Prezidentiale",1,3060,39,9,30,0,39,0,3357,3318,37,2
44,"MUNICIPIUL BUCUREŞTI - SECTOR 3","MUNICIPIUL BUCUREŞTI",179132,"BUCUREŞTI SECTORUL 3","ŞCOALA GIMNAZIALĂ NR.78;",653,"Alegeri Prezidentiale",1,2589,25,5,20,0,24,1,2840,2815,19,5
44,"MUNICIPIUL BUCUREŞTI - SECTOR 3","MUNICIPIUL BUCUREŞTI",179132,"BUCUREŞTI SECTORUL 3","ŞCOALA GIMNAZIALĂ NR.67;",654,"Alegeri Prezidentiale",1,1558,727,689,38,0,708,19,1709,982,479,229
44,"MUNICIPIUL BUCUREŞTI - SECTOR 3","MUNICIPIUL BUCUREŞTI",179132,"BUCUREŞTI SECTORUL 3","ŞCOALA GIMNAZIALĂ NR.67;",655,"Alegeri Prezidentiale",1,1756,850,800,50,0,832,18,1905,1055,549,283
45,"MUNICIPIUL BUCUREŞTI - SECTOR 4","MUNICIPIUL BUCUREŞTI",179132,"BUCUREŞTI SECTORUL 4","COLEGIUL NAŢIONAL ”MIHAI EMINESCU”",656,"Alegeri Prezidentiale",1,1612,1001,783,217,1,979,22,1781,780,632,347
45,"MUNICIPIUL BUCUREŞTI - SECTOR 4","MUNICIPIUL BUCUREŞTI",179132,"BUCUREŞTI SECTORUL 4","COLEGIUL NAŢIONAL ”MIHAI EMINESCU”",657,"Alegeri Prezidentiale",1,1362,886,611,263,12,857,29,1500,614,605,252
45,"MUNICIPIUL BUCUREŞTI - SECTOR 4","MUNICIPIUL BUCUREŞTI",179132,"BUCUREŞTI SECTORUL 4","COLEGIUL NAŢIONAL ”MIHAI EMINESCU”",658,"Alegeri Prezidentiale",1,1084,563,470,93,0,551,12,1200,637,367,184
45,"MUNICIPIUL BUCUREŞTI - SECTOR 4","MUNICIPIUL BUCUREŞTI",179132,"BUCUREŞTI SECTORUL 4","COLEGIUL NAȚIONAL DE ARTE ”DINU LIPATTI”",659,"Alegeri Prezidentiale",1,1155,699,531,168,0,679,20,1200,501,465,214
45,"MUNICIPIUL BUCUREŞTI - SECTOR 4","MUNICIPIUL BUCUREŞTI",179132,"BUCUREŞTI SECTORUL 4","LICEUL NAȚIONAL DE ARTE ”DINU LIPATTI”",660,"Alegeri Prezidentiale",1,1266,708,625,83,0,688,20,1400,692,496,192
45,"MUNICIPIUL BUCUREŞTI - SECTOR 4","MUNICIPIUL BUCUREŞTI",179132,"BUCUREŞTI SECTORUL 4","ŞCOALA GIMNAZIALĂ ”IENĂCHIŢĂ VĂCĂRESCU”",661,"Alegeri Prezidentiale",1,1098,685,526,159,0,668,17,1200,515,457,211
45,"MUNICIPIUL BUCUREŞTI - SECTOR 4","MUNICIPIUL BUCUREŞTI",179132,"BUCUREŞTI SECTORUL 4","ŞCOALA GIMNAZIALĂ ”IENĂCHIŢĂ VĂCĂRESCU”",662,"Alegeri Prezidentiale",1,1164,708,554,154,0,686,22,1192,484,477,209
45,"MUNICIPIUL BUCUREŞTI - SECTOR 4","MUNICIPIUL BUCUREŞTI",179132,"BUCUREŞTI SECTORUL 4","ŞCOALA GIMNAZIALĂ ”IENĂCHIŢĂ VĂCĂRESCU”",663,"Alegeri Prezidentiale",1,1120,721,575,145,1,709,12,1110,389,472,237
45,"MUNICIPIUL BUCUREŞTI - SECTOR 4","MUNICIPIUL BUCUREŞTI",179132,"BUCUREŞTI SECTORUL 4","ŞCOALA GIMNAZIALĂ ”IENĂCHIŢĂ VĂCĂRESCU”",664,"Alegeri Prezidentiale",1,1506,798,694,104,0,784,14,1600,802,550,234
45,"MUNICIPIUL BUCUREŞTI - SECTOR 4","MUNICIPIUL BUCUREŞTI",179132,"BUCUREŞTI SECTORUL 4","ŞCOALA GIMNAZIALĂ NR. 79",665,"Alegeri Prezidentiale",1,946,506,441,63,2,489,17,1000,494,286,203
45,"MUNICIPIUL BUCUREŞTI - SECTOR 4","MUNICIPIUL BUCUREŞTI",179132,"BUCUREŞTI SECTORUL 4","ŞCOALA GIMNAZIALĂ NR. 79",666,"Alegeri Prezidentiale",1,1017,650,523,126,1,631,19,1100,450,424,207
45,"MUNICIPIUL BUCUREŞTI - SECTOR 4","MUNICIPIUL BUCUREŞTI",179132,"BUCUREŞTI SECTORUL 4","ŞCOALA GIMNAZIALĂ NR. 79",667,"Alegeri Prezidentiale",1,1343,757,610,106,41,738,19,1400,643,528,210
45,"MUNICIPIUL BUCUREŞTI - SECTOR 4","MUNICIPIUL BUCUREŞTI",179132,"BUCUREŞTI SECTORUL 4","COLEGIUL NAŢIONAL ION CREANGĂ",668,"Alegeri Prezidentiale",1,1304,814,585,229,0,801,13,1400,586,581,220
45,"MUNICIPIUL BUCUREŞTI - SECTOR 4","MUNICIPIUL BUCUREŞTI",179132,"BUCUREŞTI SECTORUL 4","COLEGIUL NAŢIONAL ION CREANGĂ",669,"Alegeri Prezidentiale",1,1026,554,466,88,0,537,17,1092,538,372,165
45,"MUNICIPIUL BUCUREŞTI - SECTOR 4","MUNICIPIUL BUCUREŞTI",179132,"BUCUREŞTI SECTORUL 4","COLEGIUL TEHNIC GRIGORE CERCHEZ",670,"Alegeri Prezidentiale",1,1027,682,530,152,0,662,20,1100,418,482,180
45,"MUNICIPIUL BUCUREŞTI - SECTOR 4","MUNICIPIUL BUCUREŞTI",179132,"BUCUREŞTI SECTORUL 4","COLEGIUL TEHNIC GRIGORE CERCHEZ",671,"Alegeri Prezidentiale",1,1356,819,647,148,24,799,20,1500,681,553,246
45,"MUNICIPIUL BUCUREŞTI - SECTOR 4","MUNICIPIUL BUCUREŞTI",179132,"BUCUREŞTI SECTORUL 4","COLEGIUL NAŢIONAL GH.ŞINCAI",672,"Alegeri Prezidentiale",1,1138,916,604,312,0,888,28,1300,384,674,214
45,"MUNICIPIUL BUCUREŞTI - SECTOR 4","MUNICIPIUL BUCUREŞTI",179132,"BUCUREŞTI SECTORUL 4","COLEGIUL NAŢIONAL GH.ŞINCAI",673,"Alegeri Prezidentiale",1,1160,1058,623,434,1,1033,25,1300,242,819,214
45,"MUNICIPIUL BUCUREŞTI - SECTOR 4","MUNICIPIUL BUCUREŞTI",179132,"BUCUREŞTI SECTORUL 4","COLEGIUL NAŢIONAL GH.ŞINCAI",674,"Alegeri Prezidentiale",1,1228,917,687,230,0,900,17,1300,383,632,268
45,"MUNICIPIUL BUCUREŞTI - SECTOR 4","MUNICIPIUL BUCUREŞTI",179132,"BUCUREŞTI SECTORUL 4","COLEGIUL NAŢIONAL GH.ŞINCAI",675,"Alegeri Prezidentiale",1,1059,779,544,235,0,768,11,1200,421,549,219
45,"MUNICIPIUL BUCUREŞTI - SECTOR 4","MUNICIPIUL BUCUREŞTI",179132,"BUCUREŞTI SECTORUL 4","COLEGIUL NAŢIONAL GH.ŞINCAI",676,"Alegeri Prezidentiale",1,1436,859,763,96,0,841,18,1600,741,584,257
45,"MUNICIPIUL BUCUREŞTI - SECTOR 4","MUNICIPIUL BUCUREŞTI",179132,"BUCUREŞTI SECTORUL 4","ŞCOALA GIMNAZIALĂ NR. 97",677,"Alegeri Prezidentiale",1,1255,1061,707,353,1,1041,20,1400,339,768,273
45,"MUNICIPIUL BUCUREŞTI - SECTOR 4","MUNICIPIUL BUCUREŞTI",179132,"BUCUREŞTI SECTORUL 4","ŞCOALA GIMNAZIALĂ NR. 97",678,"Alegeri Prezidentiale",1,1355,894,739,155,0,871,23,1492,598,607,264
45,"MUNICIPIUL BUCUREŞTI - SECTOR 4","MUNICIPIUL BUCUREŞTI",179132,"BUCUREŞTI SECTORUL 4","ŞCOALA GIMNAZIALĂ NR. 97",679,"Alegeri Prezidentiale",1,1317,875,759,116,0,859,16,1400,525,614,245
45,"MUNICIPIUL BUCUREŞTI - SECTOR 4","MUNICIPIUL BUCUREŞTI",179132,"BUCUREŞTI SECTORUL 4","ŞCOALA GIMNAZIALĂ NR. 97",680,"Alegeri Prezidentiale",1,1232,826,695,131,0,807,19,1300,474,610,197
45,"MUNICIPIUL BUCUREŞTI - SECTOR 4","MUNICIPIUL BUCUREŞTI",179132,"BUCUREŞTI SECTORUL 4","ŞCOALA GIMNAZIALĂ NR. 97",681,"Alegeri Prezidentiale",1,1024,760,556,204,0,746,14,1100,340,553,193
45,"MUNICIPIUL BUCUREŞTI - SECTOR 4","MUNICIPIUL BUCUREŞTI",179132,"BUCUREŞTI SECTORUL 4","ȘCOALA GIMNAZIALĂ NR. 97",682,"Alegeri Prezidentiale",1,1150,768,607,161,0,745,23,1199,431,508,237
45,"MUNICIPIUL BUCUREŞTI - SECTOR 4","MUNICIPIUL BUCUREŞTI",179132,"BUCUREŞTI SECTORUL 4","ȘCOALA GIMNAZIALĂ NR. 97",683,"Alegeri Prezidentiale",1,1418,1011,756,254,1,995,16,1508,497,744,251
45,"MUNICIPIUL BUCUREŞTI - SECTOR 4","MUNICIPIUL BUCUREŞTI",179132,"BUCUREŞTI SECTORUL 4","ȘCOALA GIMNAZIALĂ NR. 97",684,"Alegeri Prezidentiale",1,1035,710,539,171,0,694,16,1099,389,488,206
45,"MUNICIPIUL BUCUREŞTI - SECTOR 4","MUNICIPIUL BUCUREŞTI",179132,"BUCUREŞTI SECTORUL 4","ȘCOALA GIMNAZIALĂ NR. 97",685,"Alegeri Prezidentiale",1,980,659,539,120,0,639,20,1100,441,427,212
45,"MUNICIPIUL BUCUREŞTI - SECTOR 4","MUNICIPIUL BUCUREŞTI",179132,"BUCUREŞTI SECTORUL 4","ȘCOALA GIMNAZIALĂ NR. 190",686,"Alegeri Prezidentiale",1,1560,969,801,168,0,951,18,1708,739,684,267
45,"MUNICIPIUL BUCUREŞTI - SECTOR 4","MUNICIPIUL BUCUREŞTI",179132,"BUCUREŞTI SECTORUL 4","ȘCOALA GIMNAZIALĂ NR. 190",687,"Alegeri Prezidentiale",1,1336,792,688,104,0,778,14,1400,608,519,259
45,"MUNICIPIUL BUCUREŞTI - SECTOR 4","MUNICIPIUL BUCUREŞTI",179132,"BUCUREŞTI SECTORUL 4","ȘCOALA GIMNAZIALĂ NR. 190",688,"Alegeri Prezidentiale",1,1191,761,628,133,0,748,13,1300,539,510,238
45,"MUNICIPIUL BUCUREŞTI - SECTOR 4","MUNICIPIUL BUCUREŞTI",179132,"BUCUREŞTI SECTORUL 4","ȘCOALA GIMNAZIALĂ NR. 190",689,"Alegeri Prezidentiale",1,1396,954,814,140,0,927,27,1500,546,636,291
45,"MUNICIPIUL BUCUREŞTI - SECTOR 4","MUNICIPIUL BUCUREŞTI",179132,"BUCUREŞTI SECTORUL 4","ȘCOALA GIMNAZIALĂ NR. 190",690,"Alegeri Prezidentiale",1,1546,946,854,92,0,926,20,1692,746,632,294
45,"MUNICIPIUL BUCUREŞTI - SECTOR 4","MUNICIPIUL BUCUREŞTI",179132,"BUCUREŞTI SECTORUL 4","ŞCOALA GIMNAZIALĂ NR. 190",691,"Alegeri Prezidentiale",1,1714,1080,870,210,0,1057,23,1900,820,681,376
45,"MUNICIPIUL BUCUREŞTI - SECTOR 4","MUNICIPIUL BUCUREŞTI",179132,"BUCUREŞTI SECTORUL 4","ŞCOALA GIMNAZIALĂ NR. 190",692,"Alegeri Prezidentiale",1,1350,1058,705,352,1,1030,28,1500,442,712,318
45,"MUNICIPIUL BUCUREŞTI - SECTOR 4","MUNICIPIUL BUCUREŞTI",179132,"BUCUREŞTI SECTORUL 4","ŞCOALA GIMNAZIALĂ NR. 190",693,"Alegeri Prezidentiale",1,1290,908,660,248,0,889,19,1400,492,655,234
45,"MUNICIPIUL BUCUREŞTI - SECTOR 4","MUNICIPIUL BUCUREŞTI",179132,"BUCUREŞTI SECTORUL 4","ŞCOALA GIMNAZIALĂ NR. 190",694,"Alegeri Prezidentiale",1,1440,854,686,168,0,832,22,1600,746,540,292
45,"MUNICIPIUL BUCUREŞTI - SECTOR 4","MUNICIPIUL BUCUREŞTI",179132,"BUCUREŞTI SECTORUL 4","ŞCOALA GIMNAZIALĂ NR. 190",695,"Alegeri Prezidentiale",1,1326,658,597,60,1,638,20,1500,842,407,231
45,"MUNICIPIUL BUCUREŞTI - SECTOR 4","MUNICIPIUL BUCUREŞTI",179132,"BUCUREŞTI SECTORUL 4","ŞCOALA GIMNAZIALĂ NR. 190",696,"Alegeri Prezidentiale",1,1173,580,526,53,1,572,8,1307,727,427,145
45,"MUNICIPIUL BUCUREŞTI - SECTOR 4","MUNICIPIUL BUCUREŞTI",179132,"BUCUREŞTI SECTORUL 4","ŞCOALA GIMNAZIALĂ NR. 190",697,"Alegeri Prezidentiale",1,1322,725,670,55,0,705,20,1500,775,474,231
45,"MUNICIPIUL BUCUREŞTI - SECTOR 4","MUNICIPIUL BUCUREŞTI",179132,"BUCUREŞTI SECTORUL 4","ŞCOALA GIMNAZIALĂ NR. 190",698,"Alegeri Prezidentiale",1,1749,1042,927,71,44,1026,16,1900,858,699,327
45,"MUNICIPIUL BUCUREŞTI - SECTOR 4","MUNICIPIUL BUCUREŞTI",179132,"BUCUREŞTI SECTORUL 4","ŞCOALA GIMNAZIALĂ NR. 190",699,"Alegeri Prezidentiale",2,1675,993,895,98,0,965,28,1800,807,685,280
45,"MUNICIPIUL BUCUREŞTI - SECTOR 4","MUNICIPIUL BUCUREŞTI",179132,"BUCUREŞTI SECTORUL 4","ŞCOALA GIMNAZIALĂ NR. 190",700,"Alegeri Prezidentiale",1,1335,725,582,143,0,712,13,1500,775,521,191
45,"MUNICIPIUL BUCUREŞTI - SECTOR 4","MUNICIPIUL BUCUREŞTI",179132,"BUCUREŞTI SECTORUL 4","ȘCOALA GIMNAZIALĂ NR. 190",701,"Alegeri Prezidentiale",1,1248,669,537,132,0,656,13,1392,723,458,198
45,"MUNICIPIUL BUCUREŞTI - SECTOR 4","MUNICIPIUL BUCUREŞTI",179132,"BUCUREŞTI SECTORUL 4","LICEUL TEHNOLOGIC DACIA",702,"Alegeri Prezidentiale",1,1827,1094,895,199,0,1070,24,2000,906,771,299
45,"MUNICIPIUL BUCUREŞTI - SECTOR 4","MUNICIPIUL BUCUREŞTI",179132,"BUCUREŞTI SECTORUL 4","LICEUL TEHNOLOGIC DACIA",703,"Alegeri Prezidentiale",1,1682,895,724,170,1,875,20,1900,1005,626,249
45,"MUNICIPIUL BUCUREŞTI - SECTOR 4","MUNICIPIUL BUCUREŞTI",179132,"BUCUREŞTI SECTORUL 4","LICEUL TEHNOLOGIC DACIA",704,"Alegeri Prezidentiale",1,1740,921,785,136,0,905,16,1892,971,673,232
45,"MUNICIPIUL BUCUREŞTI - SECTOR 4","MUNICIPIUL BUCUREŞTI",179132,"BUCUREŞTI SECTORUL 4","LICEUL TEHNOLOGIC DACIA",705,"Alegeri Prezidentiale",1,2017,1104,926,178,0,1085,19,2100,996,865,220
45,"MUNICIPIUL BUCUREŞTI - SECTOR 4","MUNICIPIUL BUCUREŞTI",179132,"BUCUREŞTI SECTORUL 4","LICEUL TEHNOLOGIC DACIA",706,"Alegeri Prezidentiale",1,1600,696,563,133,0,685,11,1691,995,501,184
45,"MUNICIPIUL BUCUREŞTI - SECTOR 4","MUNICIPIUL BUCUREŞTI",179132,"BUCUREŞTI SECTORUL 4","LICEUL TEHNOLOGIC DACIA",707,"Alegeri Prezidentiale",1,1715,620,509,111,0,610,10,1900,1280,374,236
45,"MUNICIPIUL BUCUREŞTI - SECTOR 4","MUNICIPIUL BUCUREŞTI",179132,"BUCUREŞTI SECTORUL 4","LICEUL TEHNOLOGIC DACIA",708,"Alegeri Prezidentiale",1,1689,678,624,54,0,664,14,1900,1222,389,275
45,"MUNICIPIUL BUCUREŞTI - SECTOR 4","MUNICIPIUL BUCUREŞTI",179132,"BUCUREŞTI SECTORUL 4","LICEUL TEHNOLOGIC DACIA",709,"Alegeri Prezidentiale",1,1776,909,837,71,1,877,32,1900,991,686,191
45,"MUNICIPIUL BUCUREŞTI - SECTOR 4","MUNICIPIUL BUCUREŞTI",179132,"BUCUREŞTI SECTORUL 4","GRĂDINIȚA PANSELUȚA",710,"Alegeri Prezidentiale",1,1373,799,711,88,0,787,12,1500,701,509,278
45,"MUNICIPIUL BUCUREŞTI - SECTOR 4","MUNICIPIUL BUCUREŞTI",179132,"BUCUREŞTI SECTORUL 4","GRĂDINIȚA PANSELUȚA",711,"Alegeri Prezidentiale",2,1712,933,850,83,0,917,16,1900,967,596,321
45,"MUNICIPIUL BUCUREŞTI - SECTOR 4","MUNICIPIUL BUCUREŞTI",179132,"BUCUREŞTI SECTORUL 4","GRĂDINIȚA PANSELUȚA",712,"Alegeri Prezidentiale",1,1739,885,791,94,0,868,17,1900,1015,541,327
45,"MUNICIPIUL BUCUREŞTI - SECTOR 4","MUNICIPIUL BUCUREŞTI",179132,"BUCUREŞTI SECTORUL 4","GRĂDINIȚA PANSELUȚA",713,"Alegeri Prezidentiale",1,1190,671,603,67,1,651,20,1300,629,409,242
45,"MUNICIPIUL BUCUREŞTI - SECTOR 4","MUNICIPIUL BUCUREŞTI",179132,"BUCUREŞTI SECTORUL 4","ȘCOALA GIMNAZIALĂ NR. 133",714,"Alegeri Prezidentiale",1,1864,992,854,138,0,959,33,2200,1208,604,355
45,"MUNICIPIUL BUCUREŞTI - SECTOR 4","MUNICIPIUL BUCUREŞTI",179132,"BUCUREŞTI SECTORUL 4","ȘCOALA GIMNAZIALĂ NR. 133",715,"Alegeri Prezidentiale",1,1582,940,699,24,217,915,25,1800,860,565,350
45,"MUNICIPIUL BUCUREŞTI - SECTOR 4","MUNICIPIUL BUCUREŞTI",179132,"BUCUREŞTI SECTORUL 4","ŞCOALA GIMNAZIALĂ NR. 133",716,"Alegeri Prezidentiale",1,1603,1162,768,204,190,1140,22,1792,630,711,429
45,"MUNICIPIUL BUCUREŞTI - SECTOR 4","MUNICIPIUL BUCUREŞTI",179132,"BUCUREŞTI SECTORUL 4","ŞCOALA GIMNAZIALĂ NR. 133",717,"Alegeri Prezidentiale",1,1554,978,834,144,0,941,37,1800,822,635,306
45,"MUNICIPIUL BUCUREŞTI - SECTOR 4","MUNICIPIUL BUCUREŞTI",179132,"BUCUREŞTI SECTORUL 4","ŞCOALA GIMNAZIALĂ NR. 133",718,"Alegeri Prezidentiale",1,1500,872,794,78,0,855,17,1800,928,508,347
45,"MUNICIPIUL BUCUREŞTI - SECTOR 4","MUNICIPIUL BUCUREŞTI",179132,"BUCUREŞTI SECTORUL 4","ŞCOALA GIMNAZIALĂ NR. 133",719,"Alegeri Prezidentiale",1,1606,927,781,146,0,908,19,1947,1020,558,350
45,"MUNICIPIUL BUCUREŞTI - SECTOR 4","MUNICIPIUL BUCUREŞTI",179132,"BUCUREŞTI SECTORUL 4","ŞCOALA GIMNAZIALĂ NR. 133",720,"Alegeri Prezidentiale",1,1603,865,780,27,58,841,24,1900,1035,489,352
45,"MUNICIPIUL BUCUREŞTI - SECTOR 4","MUNICIPIUL BUCUREŞTI",179132,"BUCUREŞTI SECTORUL 4","ŞCOALA GIMNAZIALĂ NR. 133",721,"Alegeri Prezidentiale",1,1501,835,796,39,0,808,27,1700,865,502,306
45,"MUNICIPIUL BUCUREŞTI - SECTOR 4","MUNICIPIUL BUCUREŞTI",179132,"BUCUREŞTI SECTORUL 4","ŞCOALA GIMNAZIALĂ G-RAL EREMIA GRIGORESCU",722,"Alegeri Prezidentiale",1,1816,1164,927,96,141,1135,29,2100,936,697,438
45,"MUNICIPIUL BUCUREŞTI - SECTOR 4","MUNICIPIUL BUCUREŞTI",179132,"BUCUREŞTI SECTORUL 4","ŞCOALA GIMNAZIALĂ G-RAL EREMIA GRIGORESCU",723,"Alegeri Prezidentiale",1,1698,1092,855,206,31,1061,31,2000,908,677,384
45,"MUNICIPIUL BUCUREŞTI - SECTOR 4","MUNICIPIUL BUCUREŞTI",179132,"BUCUREŞTI SECTORUL 4","ŞCOALA GIMNAZIALĂ G-RAL EREMIA GRIGORESCU",724,"Alegeri Prezidentiale",1,1777,1245,938,235,72,1217,28,2000,755,806,411
45,"MUNICIPIUL BUCUREŞTI - SECTOR 4","MUNICIPIUL BUCUREŞTI",179132,"BUCUREŞTI SECTORUL 4","ŞCOALA GIMNAZIALĂ G-RAL EREMIA GRIGORESCU",725,"Alegeri Prezidentiale",1,1975,1339,898,338,103,1307,32,2192,853,954,353
45,"MUNICIPIUL BUCUREŞTI - SECTOR 4","MUNICIPIUL BUCUREŞTI",179132,"BUCUREŞTI SECTORUL 4","ŞCOALA GIMNAZIALĂ G-RAL EREMIA GRIGORESCU",726,"Alegeri Prezidentiale",1,1849,1093,905,188,0,1072,21,2092,999,709,363
45,"MUNICIPIUL BUCUREŞTI - SECTOR 4","MUNICIPIUL BUCUREŞTI",179132,"BUCUREŞTI SECTORUL 4","ŞCOALA GIMNAZIALĂ G-RAL EREMIA GRIGORESCU",727,"Alegeri Prezidentiale",1,1857,1097,891,204,2,1079,18,2100,1003,752,327
45,"MUNICIPIUL BUCUREŞTI - SECTOR 4","MUNICIPIUL BUCUREŞTI",179132,"BUCUREŞTI SECTORUL 4","ŞCOALA GIMNAZIALĂ G-RAL EREMIA GRIGORESCU",728,"Alegeri Prezidentiale",1,1691,1061,815,170,76,1037,24,2000,939,655,382
45,"MUNICIPIUL BUCUREŞTI - SECTOR 4","MUNICIPIUL BUCUREŞTI",179132,"BUCUREŞTI SECTORUL 4","ŞCOALA GIMNAZIALĂ NR. 113",729,"Alegeri Prezidentiale",1,1777,1228,952,276,0,1188,40,1900,672,782,406
45,"MUNICIPIUL BUCUREŞTI - SECTOR 4","MUNICIPIUL BUCUREŞTI",179132,"BUCUREŞTI SECTORUL 4","ŞCOALA GIMNAZIALĂ NR. 113",730,"Alegeri Prezidentiale",1,1867,1042,934,108,0,1018,24,2000,958,677,341
45,"MUNICIPIUL BUCUREŞTI - SECTOR 4","MUNICIPIUL BUCUREŞTI",179132,"BUCUREŞTI SECTORUL 4","ŞCOALA GIMNAZIALĂ NR. 113",731,"Alegeri Prezidentiale",1,1761,1016,920,96,0,990,26,1900,884,652,338
45,"MUNICIPIUL BUCUREŞTI - SECTOR 4","MUNICIPIUL BUCUREŞTI",179132,"BUCUREŞTI SECTORUL 4","ŞCOALA GIMNAZIALĂ NR. 113",732,"Alegeri Prezidentiale",1,1786,1070,981,89,0,1044,26,2000,930,700,344
45,"MUNICIPIUL BUCUREŞTI - SECTOR 4","MUNICIPIUL BUCUREŞTI",179132,"BUCUREŞTI SECTORUL 4","ŞCOALA GIMNAZIALĂ NR. 113",733,"Alegeri Prezidentiale",1,1882,1003,936,67,0,985,18,2000,997,665,320
45,"MUNICIPIUL BUCUREŞTI - SECTOR 4","MUNICIPIUL BUCUREŞTI",179132,"BUCUREŞTI SECTORUL 4","ŞCOALA GIMNAZIALĂ NR. 113",734,"Alegeri Prezidentiale",1,1853,1061,983,77,1,1036,25,2000,939,707,329
45,"MUNICIPIUL BUCUREŞTI - SECTOR 4","MUNICIPIUL BUCUREŞTI",179132,"BUCUREŞTI SECTORUL 4","ŞCOALA GIMNAZIALĂ ”MĂRŢIŞOR”",735,"Alegeri Prezidentiale",1,1747,1113,830,283,0,1077,36,1900,787,761,316
45,"MUNICIPIUL BUCUREŞTI - SECTOR 4","MUNICIPIUL BUCUREŞTI",179132,"BUCUREŞTI SECTORUL 4","ŞCOALA GIMNAZIALĂ ”MĂRŢIŞOR”",736,"Alegeri Prezidentiale",1,1752,1047,879,168,0,1024,23,1905,858,762,262
45,"MUNICIPIUL BUCUREŞTI - SECTOR 4","MUNICIPIUL BUCUREŞTI",179132,"BUCUREŞTI SECTORUL 4","ŞCOALA GIMNAZIALĂ ”MĂRŢIŞOR”",737,"Alegeri Prezidentiale",1,1713,1050,954,96,0,1021,29,1892,842,751,270
45,"MUNICIPIUL BUCUREŞTI - SECTOR 4","MUNICIPIUL BUCUREŞTI",179132,"BUCUREŞTI SECTORUL 4","ŞCOALA GIMNAZIALĂ ”MĂRŢIŞOR”",738,"Alegeri Prezidentiale",1,1367,779,707,72,0,765,14,1500,721,535,230
45,"MUNICIPIUL BUCUREŞTI - SECTOR 4","MUNICIPIUL BUCUREŞTI",179132,"BUCUREŞTI SECTORUL 4","ŞCOALA GIMNAZIALĂ ”MĂRŢIŞOR”",739,"Alegeri Prezidentiale",1,1660,946,821,125,0,913,33,1800,854,589,324
45,"MUNICIPIUL BUCUREŞTI - SECTOR 4","MUNICIPIUL BUCUREŞTI",179132,"BUCUREŞTI SECTORUL 4","ŞCOALA GIMNAZIALĂ NR. 96",740,"Alegeri Prezidentiale",1,947,527,482,45,0,518,9,1000,473,333,185
45,"MUNICIPIUL BUCUREŞTI - SECTOR 4","MUNICIPIUL BUCUREŞTI",179132,"BUCUREŞTI SECTORUL 4","ŞCOALA GIMNAZIALĂ NR. 96",741,"Alegeri Prezidentiale",1,1180,716,581,135,0,700,16,1300,584,458,242
45,"MUNICIPIUL BUCUREŞTI - SECTOR 4","MUNICIPIUL BUCUREŞTI",179132,"BUCUREŞTI SECTORUL 4","ŞCOALA GIMNAZIALĂ NR. 96",742,"Alegeri Prezidentiale",1,1095,587,540,46,1,567,20,1200,613,381,186
45,"MUNICIPIUL BUCUREŞTI - SECTOR 4","MUNICIPIUL BUCUREŞTI",179132,"BUCUREŞTI SECTORUL 4","ŞCOALA GIMNAZIALĂ NR. 96",743,"Alegeri Prezidentiale",1,1607,892,840,52,0,870,22,1700,808,556,314
45,"MUNICIPIUL BUCUREŞTI - SECTOR 4","MUNICIPIUL BUCUREŞTI",179132,"BUCUREŞTI SECTORUL 4","ŞCOALA GIMNAZIALĂ NR. 96",744,"Alegeri Prezidentiale",1,1206,692,624,68,0,669,23,1300,608,426,243
45,"MUNICIPIUL BUCUREŞTI - SECTOR 4","MUNICIPIUL BUCUREŞTI",179132,"BUCUREŞTI SECTORUL 4","COLEGIUL NAŢIONAL OCTAV ONICESCU",745,"Alegeri Prezidentiale",1,1739,1059,905,154,0,1022,37,1893,834,694,328
45,"MUNICIPIUL BUCUREŞTI - SECTOR 4","MUNICIPIUL BUCUREŞTI",179132,"BUCUREŞTI SECTORUL 4","COLEGIUL NAŢIONAL OCTAV ONICESCU",746,"Alegeri Prezidentiale",1,1192,823,619,204,0,792,31,1300,477,535,257
45,"MUNICIPIUL BUCUREŞTI - SECTOR 4","MUNICIPIUL BUCUREŞTI",179132,"BUCUREŞTI SECTORUL 4","COLEGIUL NAŢIONAL OCTAV ONICESCU",747,"Alegeri Prezidentiale",1,1482,765,702,63,0,745,20,1300,535,452,293
45,"MUNICIPIUL BUCUREŞTI - SECTOR 4","MUNICIPIUL BUCUREŞTI",179132,"BUCUREŞTI SECTORUL 4","COLEGIUL NAŢIONAL OCTAV ONICESCU",748,"Alegeri Prezidentiale",1,1352,793,740,53,0,777,16,1600,807,516,261
45,"MUNICIPIUL BUCUREŞTI - SECTOR 4","MUNICIPIUL BUCUREŞTI",179132,"BUCUREŞTI SECTORUL 4","ŞCOALA GIMNAZIALĂ NR. 108",749,"Alegeri Prezidentiale",1,1331,827,723,104,0,808,19,1500,673,547,261
45,"MUNICIPIUL BUCUREŞTI - SECTOR 4","MUNICIPIUL BUCUREŞTI",179132,"BUCUREŞTI SECTORUL 4","ŞCOALA GIMNAZIALĂ NR. 108",750,"Alegeri Prezidentiale",1,1347,834,745,89,0,810,24,1408,574,506,304
45,"MUNICIPIUL BUCUREŞTI - SECTOR 4","MUNICIPIUL BUCUREŞTI",179132,"BUCUREŞTI SECTORUL 4","ŞCOALA GIMNAZIALĂ NR. 108",751,"Alegeri Prezidentiale",1,1462,816,775,41,0,798,18,1600,784,504,294
45,"MUNICIPIUL BUCUREŞTI - SECTOR 4","MUNICIPIUL BUCUREŞTI",179132,"BUCUREŞTI SECTORUL 4","ŞCOALA GIMNAZIALĂ NR. 108",752,"Alegeri Prezidentiale",1,1508,834,794,40,0,812,22,1600,766,555,257
45,"MUNICIPIUL BUCUREŞTI - SECTOR 4","MUNICIPIUL BUCUREŞTI",179132,"BUCUREŞTI SECTORUL 4","ŞCOALA GIMNAZIALĂ NR. 108",753,"Alegeri Prezidentiale",1,1324,666,636,30,0,650,16,1408,742,402,248
45,"MUNICIPIUL BUCUREŞTI - SECTOR 4","MUNICIPIUL BUCUREŞTI",179132,"BUCUREŞTI SECTORUL 4","ŞCOALA GIMNAZIALĂ AVRAM IANCU",754,"Alegeri Prezidentiale",1,1868,1127,982,145,0,1098,29,2000,873,750,348
45,"MUNICIPIUL BUCUREŞTI - SECTOR 4","MUNICIPIUL BUCUREŞTI",179132,"BUCUREŞTI SECTORUL 4","ŞCOALA GIMNAZIALĂ AVRAM IANCU",755,"Alegeri Prezidentiale",1,1355,809,715,93,1,781,28,1500,691,529,252
45,"MUNICIPIUL BUCUREŞTI - SECTOR 4","MUNICIPIUL BUCUREŞTI",179132,"BUCUREŞTI SECTORUL 4","ŞCOALA GIMNAZIALĂ AVRAM IANCU",756,"Alegeri Prezidentiale",1,1247,677,626,51,0,656,21,1309,632,447,209
45,"MUNICIPIUL BUCUREŞTI - SECTOR 4","MUNICIPIUL BUCUREŞTI",179132,"BUCUREŞTI SECTORUL 4","ŞCOALA GIMNAZIALĂ AVRAM IANCU",757,"Alegeri Prezidentiale",1,1912,901,851,50,0,885,16,2100,1199,624,261
45,"MUNICIPIUL BUCUREŞTI - SECTOR 4","MUNICIPIUL BUCUREŞTI",179132,"BUCUREŞTI SECTORUL 4","ŞCOALA GIMNAZIALĂ AVRAM IANCU",758,"Alegeri Prezidentiale",1,1467,836,799,35,2,817,19,1600,764,536,281
45,"MUNICIPIUL BUCUREŞTI - SECTOR 4","MUNICIPIUL BUCUREŞTI",179132,"BUCUREŞTI SECTORUL 4","GRĂDINIȚA VISTA",759,"Alegeri Prezidentiale",1,1712,1061,904,157,0,1034,27,1792,731,878,156
45,"MUNICIPIUL BUCUREŞTI - SECTOR 4","MUNICIPIUL BUCUREŞTI",179132,"BUCUREŞTI SECTORUL 4","GRĂDINIȚA VISTA",760,"Alegeri Prezidentiale",1,1620,861,733,128,0,845,16,1800,939,638,207
45,"MUNICIPIUL BUCUREŞTI - SECTOR 4","MUNICIPIUL BUCUREŞTI",179132,"BUCUREŞTI SECTORUL 4","ŞCOALA GIMNAZIALĂ NR. 189",761,"Alegeri Prezidentiale",1,974,615,415,200,0,606,9,1100,485,407,199
45,"MUNICIPIUL BUCUREŞTI - SECTOR 4","MUNICIPIUL BUCUREŞTI",179132,"BUCUREŞTI SECTORUL 4","ŞCOALA GIMNAZIALĂ NR. 189",762,"Alegeri Prezidentiale",1,1334,709,651,57,1,691,18,1500,791,475,216
45,"MUNICIPIUL BUCUREŞTI - SECTOR 4","MUNICIPIUL BUCUREŞTI",179132,"BUCUREŞTI SECTORUL 4","ŞCOALA GIMNAZIALĂ NR. 189",763,"Alegeri Prezidentiale",1,1868,881,829,52,0,858,23,2100,1219,573,285
45,"MUNICIPIUL BUCUREŞTI - SECTOR 4","MUNICIPIUL BUCUREŞTI",179132,"BUCUREŞTI SECTORUL 4","ŞCOALA GIMNAZIALĂ NR. 189",764,"Alegeri Prezidentiale",1,1502,773,744,29,0,756,17,1700,927,486,270
45,"MUNICIPIUL BUCUREŞTI - SECTOR 4","MUNICIPIUL BUCUREŞTI",179132,"BUCUREŞTI SECTORUL 4","ȘCOALA GIMNAZIALĂ NR. 189",765,"Alegeri Prezidentiale",1,1276,661,598,63,0,645,16,1408,747,415,230
45,"MUNICIPIUL BUCUREŞTI - SECTOR 4","MUNICIPIUL BUCUREŞTI",179132,"BUCUREŞTI SECTORUL 4","ȘCOALA GIMNAZIALĂ NR. 189",766,"Alegeri Prezidentiale",1,1003,536,495,41,0,524,12,1100,564,354,170
45,"MUNICIPIUL BUCUREŞTI - SECTOR 4","MUNICIPIUL BUCUREŞTI",179132,"BUCUREŞTI SECTORUL 4","ȘCOALA GIMNAZIALĂ NR. 189",767,"Alegeri Prezidentiale",1,1421,795,762,33,0,779,16,1608,813,500,279
45,"MUNICIPIUL BUCUREŞTI - SECTOR 4","MUNICIPIUL BUCUREŞTI",179132,"BUCUREŞTI SECTORUL 4","ŞCOALA GIMNAZIALĂ EMIL RACOVIŢĂ",768,"Alegeri Prezidentiale",1,1597,983,758,225,0,971,12,1806,823,721,250
45,"MUNICIPIUL BUCUREŞTI - SECTOR 4","MUNICIPIUL BUCUREŞTI",179132,"BUCUREŞTI SECTORUL 4","ŞCOALA GIMNAZIALĂ EMIL RACOVIŢĂ",769,"Alegeri Prezidentiale",1,1762,1004,889,114,1,983,21,1900,896,619,364
45,"MUNICIPIUL BUCUREŞTI - SECTOR 4","MUNICIPIUL BUCUREŞTI",179132,"BUCUREŞTI SECTORUL 4","ŞCOALA GIMNAZIALĂ EMIL RACOVIŢĂ",770,"Alegeri Prezidentiale",1,1660,832,740,92,0,812,20,1800,968,547,265
45,"MUNICIPIUL BUCUREŞTI - SECTOR 4","MUNICIPIUL BUCUREŞTI",179132,"BUCUREŞTI SECTORUL 4","ŞCOALA GIMNAZIALĂ EMIL RACOVIŢĂ",771,"Alegeri Prezidentiale",1,1552,808,755,53,0,789,19,1692,884,525,264
45,"MUNICIPIUL BUCUREŞTI - SECTOR 4","MUNICIPIUL BUCUREŞTI",179132,"BUCUREŞTI SECTORUL 4","ŞCOALA GIMNAZIALĂ NR. 194",772,"Alegeri Prezidentiale",1,1007,538,504,34,0,523,15,1100,562,353,170
45,"MUNICIPIUL BUCUREŞTI - SECTOR 4","MUNICIPIUL BUCUREŞTI",179132,"BUCUREŞTI SECTORUL 4","ŞCOALA GIMNAZIALĂ NR. 194",773,"Alegeri Prezidentiale",2,911,544,443,101,0,524,20,1000,456,340,184
45,"MUNICIPIUL BUCUREŞTI - SECTOR 4","MUNICIPIUL BUCUREŞTI",179132,"BUCUREŞTI SECTORUL 4","ŞCOALA GIMNAZIALĂ NR. 194",774,"Alegeri Prezidentiale",1,1254,782,635,147,0,758,24,1300,518,512,246
45,"MUNICIPIUL BUCUREŞTI - SECTOR 4","MUNICIPIUL BUCUREŞTI",179132,"BUCUREŞTI SECTORUL 4","ŞCOALA GIMNAZIALĂ NR. 194",775,"Alegeri Prezidentiale",1,1548,765,727,38,0,739,26,1700,935,465,274
45,"MUNICIPIUL BUCUREŞTI - SECTOR 4","MUNICIPIUL BUCUREŞTI",179132,"BUCUREŞTI SECTORUL 4","ŞCOALA GIMNAZIALĂ NR. 194",776,"Alegeri Prezidentiale",1,1116,616,561,55,0,600,16,1200,584,377,223
45,"MUNICIPIUL BUCUREŞTI - SECTOR 4","MUNICIPIUL BUCUREŞTI",179132,"BUCUREŞTI SECTORUL 4","ŞCOALA GIMNAZIALĂ NR. 194",777,"Alegeri Prezidentiale",2,1179,651,611,30,10,636,15,1300,649,408,228
45,"MUNICIPIUL BUCUREŞTI - SECTOR 4","MUNICIPIUL BUCUREŞTI",179132,"BUCUREŞTI SECTORUL 4","ȘCOALA GIMNAZIALĂ NR. 194",778,"Alegeri Prezidentiale",1,999,481,465,16,0,473,8,1100,619,309,164
45,"MUNICIPIUL BUCUREŞTI - SECTOR 4","MUNICIPIUL BUCUREŞTI",179132,"BUCUREŞTI SECTORUL 4","ȘCOALA GIMNAZIALĂ NR. 194",779,"Alegeri Prezidentiale",1,1111,571,543,27,1,547,24,1200,629,357,190
45,"MUNICIPIUL BUCUREŞTI - SECTOR 4","MUNICIPIUL BUCUREŞTI",179132,"BUCUREŞTI SECTORUL 4","ŞCOALA GIMNAZIALĂ ”GEORGE BACOVIA”",780,"Alegeri Prezidentiale",1,1470,844,764,80,0,825,19,1600,756,556,269
45,"MUNICIPIUL BUCUREŞTI - SECTOR 4","MUNICIPIUL BUCUREŞTI",179132,"BUCUREŞTI SECTORUL 4","ŞCOALA GIMNAZIALĂ ”GEORGE BACOVIA”",781,"Alegeri Prezidentiale",1,1301,782,711,71,0,762,20,1400,618,527,235
45,"MUNICIPIUL BUCUREŞTI - SECTOR 4","MUNICIPIUL BUCUREŞTI",179132,"BUCUREŞTI SECTORUL 4","ŞCOALA GIMNAZIALĂ ”GEORGE BACOVIA”",782,"Alegeri Prezidentiale",1,1865,1037,935,102,0,1011,26,2103,1066,710,301
45,"MUNICIPIUL BUCUREŞTI - SECTOR 4","MUNICIPIUL BUCUREŞTI",179132,"BUCUREŞTI SECTORUL 4","ŞCOALA GIMNAZIALĂ ”GEORGE BACOVIA”",783,"Alegeri Prezidentiale",1,1847,938,857,81,0,917,21,2000,1062,609,308
45,"MUNICIPIUL BUCUREŞTI - SECTOR 4","MUNICIPIUL BUCUREŞTI",179132,"BUCUREŞTI SECTORUL 4","ŞCOALA GIMNAZIALĂ ”GEORGE BACOVIA”",784,"Alegeri Prezidentiale",1,1757,1034,863,171,0,1003,31,1900,866,681,322
45,"MUNICIPIUL BUCUREŞTI - SECTOR 4","MUNICIPIUL BUCUREŞTI",179132,"BUCUREŞTI SECTORUL 4","ŞCOALA GIMNAZIALĂ ”GEORGE BACOVIA”",785,"Alegeri Prezidentiale",1,1641,947,895,52,0,923,24,1800,853,644,279
45,"MUNICIPIUL BUCUREŞTI - SECTOR 4","MUNICIPIUL BUCUREŞTI",179132,"BUCUREŞTI SECTORUL 4","ŞCOALA GIMNAZIALĂ ”GEORGE BACOVIA”",786,"Alegeri Prezidentiale",1,1747,983,891,92,0,962,21,1900,917,690,272
45,"MUNICIPIUL BUCUREŞTI - SECTOR 4","MUNICIPIUL BUCUREŞTI",179132,"BUCUREŞTI SECTORUL 4","GRĂDINIŢA ”CIUPERCUTA”",787,"Alegeri Prezidentiale",1,1124,745,646,98,1,731,14,1200,455,480,251
45,"MUNICIPIUL BUCUREŞTI - SECTOR 4","MUNICIPIUL BUCUREŞTI",179132,"BUCUREŞTI SECTORUL 4","GRĂDINIŢA ”CIUPERCUTA”",788,"Alegeri Prezidentiale",1,1340,623,545,77,1,607,16,1409,786,403,204
45,"MUNICIPIUL BUCUREŞTI - SECTOR 4","MUNICIPIUL BUCUREŞTI",179132,"BUCUREŞTI SECTORUL 4","ŞCOALA GIMNAZIALĂ ”ŞERBAN VODĂ”",789,"Alegeri Prezidentiale",1,1683,762,657,105,0,750,12,1800,1038,513,237
45,"MUNICIPIUL BUCUREŞTI - SECTOR 4","MUNICIPIUL BUCUREŞTI",179132,"BUCUREŞTI SECTORUL 4","ŞCOALA GIMNAZIALĂ ”ŞERBAN VODĂ”",790,"Alegeri Prezidentiale",1,1781,945,881,64,0,916,29,2000,1055,595,321
45,"MUNICIPIUL BUCUREŞTI - SECTOR 4","MUNICIPIUL BUCUREŞTI",179132,"BUCUREŞTI SECTORUL 4","ŞCOALA GIMNAZIALĂ ”ŞERBAN VODĂ”",791,"Alegeri Prezidentiale",1,1530,758,729,29,0,731,27,1700,942,463,268
45,"MUNICIPIUL BUCUREŞTI - SECTOR 4","MUNICIPIUL BUCUREŞTI",179132,"BUCUREŞTI SECTORUL 4","ŞCOALA GIMNAZIALĂ ”ŞERBAN VODĂ”",792,"Alegeri Prezidentiale",1,1411,698,670,28,0,685,13,1600,902,440,245
45,"MUNICIPIUL BUCUREŞTI - SECTOR 4","MUNICIPIUL BUCUREŞTI",179132,"BUCUREŞTI SECTORUL 4","ŞCOALA GIMNAZIALĂ ”ŞERBAN VODĂ”",793,"Alegeri Prezidentiale",1,1431,798,723,75,0,776,22,1600,802,538,238
45,"MUNICIPIUL BUCUREŞTI - SECTOR 4","MUNICIPIUL BUCUREŞTI",179132,"BUCUREŞTI SECTORUL 4","GRĂDINIŢA ”ALBĂ CA ZAPADA ŞI PITICII”",794,"Alegeri Prezidentiale",1,1384,628,603,25,0,612,16,1450,822,412,200
45,"MUNICIPIUL BUCUREŞTI - SECTOR 4","MUNICIPIUL BUCUREŞTI",179132,"BUCUREŞTI SECTORUL 4","GRĂDINIŢA ”ALBĂ CA ZAPADA ŞI PITICII”",795,"Alegeri Prezidentiale",1,1200,573,512,61,0,557,16,1300,727,351,206
45,"MUNICIPIUL BUCUREŞTI - SECTOR 4","MUNICIPIUL BUCUREŞTI",179132,"BUCUREŞTI SECTORUL 4","GRĂDINIŢA ”PITICOT”",796,"Alegeri Prezidentiale",1,1522,789,715,74,0,767,22,1700,911,484,283
45,"MUNICIPIUL BUCUREŞTI - SECTOR 4","MUNICIPIUL BUCUREŞTI",179132,"BUCUREŞTI SECTORUL 4","GRĂDINIŢA ”PITICOT”",797,"Alegeri Prezidentiale",1,1405,774,735,39,0,756,18,1600,826,480,276
45,"MUNICIPIUL BUCUREŞTI - SECTOR 4","MUNICIPIUL BUCUREŞTI",179132,"BUCUREŞTI SECTORUL 4","ŞCOALA GIMNAZIALĂ NR. 308",798,"Alegeri Prezidentiale",1,1329,735,692,43,0,705,30,1500,765,460,245
45,"MUNICIPIUL BUCUREŞTI - SECTOR 4","MUNICIPIUL BUCUREŞTI",179132,"BUCUREŞTI SECTORUL 4","ŞCOALA GIMNAZIALĂ NR. 308",799,"Alegeri Prezidentiale",1,1227,694,661,33,0,674,20,1300,606,378,296
45,"MUNICIPIUL BUCUREŞTI - SECTOR 4","MUNICIPIUL BUCUREŞTI",179132,"BUCUREŞTI SECTORUL 4","ŞCOALA GIMNAZIALĂ NR. 308",800,"Alegeri Prezidentiale",1,1447,679,655,24,0,659,20,1600,921,397,262
45,"MUNICIPIUL BUCUREŞTI - SECTOR 4","MUNICIPIUL BUCUREŞTI",179132,"BUCUREŞTI SECTORUL 4","ŞCOALA GIMNAZIALĂ NR. 308",801,"Alegeri Prezidentiale",2,1533,730,686,44,0,707,23,1750,1020,436,271
45,"MUNICIPIUL BUCUREŞTI - SECTOR 4","MUNICIPIUL BUCUREŞTI",179132,"BUCUREŞTI SECTORUL 4","ŞCOALA GIMNAZIALĂ NR. 165",802,"Alegeri Prezidentiale",1,1820,860,743,117,0,839,21,2000,1140,531,308
45,"MUNICIPIUL BUCUREŞTI - SECTOR 4","MUNICIPIUL BUCUREŞTI",179132,"BUCUREŞTI SECTORUL 4","ŞCOALA GIMNAZIALĂ NR. 165",803,"Alegeri Prezidentiale",1,1896,951,851,99,1,921,30,2100,1149,607,314
45,"MUNICIPIUL BUCUREŞTI - SECTOR 4","MUNICIPIUL BUCUREŞTI",179132,"BUCUREŞTI SECTORUL 4","ŞCOALA GIMNAZIALĂ NR. 165",804,"Alegeri Prezidentiale",1,1662,751,672,79,0,734,17,1800,1049,460,274
45,"MUNICIPIUL BUCUREŞTI - SECTOR 4","MUNICIPIUL BUCUREŞTI",179132,"BUCUREŞTI SECTORUL 4","ŞCOALA GIMNAZIALĂ NR. 165",805,"Alegeri Prezidentiale",1,1860,774,710,64,0,760,14,2100,1326,459,301
45,"MUNICIPIUL BUCUREŞTI - SECTOR 4","MUNICIPIUL BUCUREŞTI",179132,"BUCUREŞTI SECTORUL 4","ŞCOALA GIMNAZIALĂ NR. 165",806,"Alegeri Prezidentiale",1,1652,788,746,42,0,766,22,1800,1012,485,281
45,"MUNICIPIUL BUCUREŞTI - SECTOR 4","MUNICIPIUL BUCUREŞTI",179132,"BUCUREŞTI SECTORUL 4","ŞCOALA GIMNAZIALĂ NR. 165",807,"Alegeri Prezidentiale",1,1874,888,850,37,1,873,15,2100,1212,538,335
45,"MUNICIPIUL BUCUREŞTI - SECTOR 4","MUNICIPIUL BUCUREŞTI",179132,"BUCUREŞTI SECTORUL 4","ŞCOALA GIMNAZIALĂ NR. 165",808,"Alegeri Prezidentiale",1,1711,726,697,29,0,708,18,1899,1173,483,225
45,"MUNICIPIUL BUCUREŞTI - SECTOR 4","MUNICIPIUL BUCUREŞTI",179132,"BUCUREŞTI SECTORUL 4","ŞCOALA GIMNAZIALĂ NR. 165",809,"Alegeri Prezidentiale",2,1777,861,825,36,0,845,16,2000,1139,568,277
45,"MUNICIPIUL BUCUREŞTI - SECTOR 4","MUNICIPIUL BUCUREŞTI",179132,"BUCUREŞTI SECTORUL 4","ŞCOALA GIMNAZIALĂ NR. 165",810,"Alegeri Prezidentiale",1,1607,630,611,19,0,621,9,1800,1170,391,230
45,"MUNICIPIUL BUCUREŞTI - SECTOR 4","MUNICIPIUL BUCUREŞTI",179132,"BUCUREŞTI SECTORUL 4","ŞCOALA GIMNAZIALĂ NR. 119",811,"Alegeri Prezidentiale",1,1195,480,432,48,0,470,10,1300,820,254,216
45,"MUNICIPIUL BUCUREŞTI - SECTOR 4","MUNICIPIUL BUCUREŞTI",179132,"BUCUREŞTI SECTORUL 4","ŞCOALA GIMNAZIALĂ NR. 119",812,"Alegeri Prezidentiale",1,1989,837,795,42,0,824,13,2200,1363,546,278
45,"MUNICIPIUL BUCUREŞTI - SECTOR 4","MUNICIPIUL BUCUREŞTI",179132,"BUCUREŞTI SECTORUL 4","ŞCOALA GIMNAZIALĂ NR. 119",813,"Alegeri Prezidentiale",1,1918,1013,979,34,0,991,22,2100,1087,620,371
45,"MUNICIPIUL BUCUREŞTI - SECTOR 4","MUNICIPIUL BUCUREŞTI",179132,"BUCUREŞTI SECTORUL 4","ŞCOALA GIMNAZIALĂ NR. 119",814,"Alegeri Prezidentiale",1,1904,908,884,24,0,883,25,2000,1092,561,322
45,"MUNICIPIUL BUCUREŞTI - SECTOR 4","MUNICIPIUL BUCUREŞTI",179132,"BUCUREŞTI SECTORUL 4","ŞCOALA GIMNAZIALĂ NR. 119",815,"Alegeri Prezidentiale",1,1915,1024,937,87,0,994,30,2107,1083,589,405
45,"MUNICIPIUL BUCUREŞTI - SECTOR 4","MUNICIPIUL BUCUREŞTI",179132,"BUCUREŞTI SECTORUL 4","ŞCOALA GIMNAZIALĂ NR. 119",816,"Alegeri Prezidentiale",1,1959,939,842,97,0,911,28,2100,1161,601,310
45,"MUNICIPIUL BUCUREŞTI - SECTOR 4","MUNICIPIUL BUCUREŞTI",179132,"BUCUREŞTI SECTORUL 4","ȘCOALA GIMNAZIALĂ NR. 119",817,"Alegeri Prezidentiale",1,1321,650,607,43,0,638,12,1400,750,409,229
45,"MUNICIPIUL BUCUREŞTI - SECTOR 4","MUNICIPIUL BUCUREŞTI",179132,"BUCUREŞTI SECTORUL 4","ȘCOALA GIMNAZIALĂ NR. 119",818,"Alegeri Prezidentiale",1,1296,600,583,17,0,589,11,1400,800,370,219
45,"MUNICIPIUL BUCUREŞTI - SECTOR 4","MUNICIPIUL BUCUREŞTI",179132,"BUCUREŞTI SECTORUL 4","ŞCOALA GIMNAZIALĂ GEORGE TOPÂRCEANU",819,"Alegeri Prezidentiale",1,1503,725,667,57,1,699,26,1600,875,433,266
45,"MUNICIPIUL BUCUREŞTI - SECTOR 4","MUNICIPIUL BUCUREŞTI",179132,"BUCUREŞTI SECTORUL 4","ŞCOALA GIMNAZIALĂ GEORGE TOPÂRCEANU",820,"Alegeri Prezidentiale",1,1468,810,736,73,1,797,13,1600,790,458,339
45,"MUNICIPIUL BUCUREŞTI - SECTOR 4","MUNICIPIUL BUCUREŞTI",179132,"BUCUREŞTI SECTORUL 4","ŞCOALA GIMNAZIALĂ GEORGE TOPÂRCEANU",821,"Alegeri Prezidentiale",1,1413,666,618,48,0,652,14,1600,934,409,243
45,"MUNICIPIUL BUCUREŞTI - SECTOR 4","MUNICIPIUL BUCUREŞTI",179132,"BUCUREŞTI SECTORUL 4","ŞCOALA GIMNAZIALĂ GEORGE TOPÂRCEANU",822,"Alegeri Prezidentiale",1,1597,851,794,57,0,833,18,1799,948,536,297
45,"MUNICIPIUL BUCUREŞTI - SECTOR 4","MUNICIPIUL BUCUREŞTI",179132,"BUCUREŞTI SECTORUL 4","ŞCOALA GIMNAZIALĂ NR. 129",823,"Alegeri Prezidentiale",1,1382,758,714,43,1,737,21,1500,742,509,228
45,"MUNICIPIUL BUCUREŞTI - SECTOR 4","MUNICIPIUL BUCUREŞTI",179132,"BUCUREŞTI SECTORUL 4","ŞCOALA GIMNAZIALĂ NR. 129",824,"Alegeri Prezidentiale",1,1536,890,822,68,0,871,19,1700,810,551,320
45,"MUNICIPIUL BUCUREŞTI - SECTOR 4","MUNICIPIUL BUCUREŞTI",179132,"BUCUREŞTI SECTORUL 4","ŞCOALA GIMNAZIALĂ NR. 129",825,"Alegeri Prezidentiale",1,1672,927,871,56,0,909,18,1800,873,563,346
45,"MUNICIPIUL BUCUREŞTI - SECTOR 4","MUNICIPIUL BUCUREŞTI",179132,"BUCUREŞTI SECTORUL 4","ŞCOALA GIMNAZIALĂ NR. 129",826,"Alegeri Prezidentiale",1,1672,905,872,29,4,880,25,1800,895,546,334
45,"MUNICIPIUL BUCUREŞTI - SECTOR 4","MUNICIPIUL BUCUREŞTI",179132,"BUCUREŞTI SECTORUL 4","LICEUL TEHNOLOGIC ”MIRCEA VULCĂNESCU”",827,"Alegeri Prezidentiale",1,1399,759,630,129,0,738,21,1500,741,490,248
45,"MUNICIPIUL BUCUREŞTI - SECTOR 4","MUNICIPIUL BUCUREŞTI",179132,"BUCUREŞTI SECTORUL 4","LICEUL TEHNOLOGIC ”MIRCEA VULCĂNESCU”",828,"Alegeri Prezidentiale",1,1381,845,740,105,0,821,24,1492,647,550,271
45,"MUNICIPIUL BUCUREŞTI - SECTOR 4","MUNICIPIUL BUCUREŞTI",179132,"BUCUREŞTI SECTORUL 4","ŞCOALA GIMNAZIALĂ ”IONEL TEODOREANU”",829,"Alegeri Prezidentiale",1,1283,707,661,34,12,689,18,1600,893,431,258
45,"MUNICIPIUL BUCUREŞTI - SECTOR 4","MUNICIPIUL BUCUREŞTI",179132,"BUCUREŞTI SECTORUL 4","ŞCOALA GIMNAZIALĂ ”IONEL TEODOREANU”",830,"Alegeri Prezidentiale",1,1411,810,732,78,0,796,14,1700,890,473,323
45,"MUNICIPIUL BUCUREŞTI - SECTOR 4","MUNICIPIUL BUCUREŞTI",179132,"BUCUREŞTI SECTORUL 4","ŞCOALA GIMNAZIALĂ ”IONEL TEODOREANU”",831,"Alegeri Prezidentiale",1,1530,800,732,68,0,786,14,1900,1100,509,277
45,"MUNICIPIUL BUCUREŞTI - SECTOR 4","MUNICIPIUL BUCUREŞTI",179132,"BUCUREŞTI SECTORUL 4","ŞCOALA GIMNAZIALĂ ”IONEL TEODOREANU”",832,"Alegeri Prezidentiale",1,1736,725,684,41,0,713,12,1800,1075,440,273
45,"MUNICIPIUL BUCUREŞTI - SECTOR 4","MUNICIPIUL BUCUREŞTI",179132,"BUCUREŞTI SECTORUL 4","ŞCOALA GIMNAZIALĂ ”IONEL TEODOREANU”",833,"Alegeri Prezidentiale",1,1674,664,640,24,0,651,13,1700,1036,362,289
45,"MUNICIPIUL BUCUREŞTI - SECTOR 4","MUNICIPIUL BUCUREŞTI",179132,"BUCUREŞTI SECTORUL 4","ŞCOALA GIMNAZIALĂ ”IONEL TEODOREANU”",834,"Alegeri Prezidentiale",1,1544,794,768,26,0,775,19,1700,906,447,328
45,"MUNICIPIUL BUCUREŞTI - SECTOR 4","MUNICIPIUL BUCUREŞTI",179132,"BUCUREŞTI SECTORUL 4","ŞCOALA GIMNAZIALĂ NR. 99",835,"Alegeri Prezidentiale",1,1578,888,781,107,0,870,18,2000,1112,542,328
45,"MUNICIPIUL BUCUREŞTI - SECTOR 4","MUNICIPIUL BUCUREŞTI",179132,"BUCUREŞTI SECTORUL 4","ŞCOALA GIMNAZIALĂ NR. 99",836,"Alegeri Prezidentiale",1,1839,971,854,117,0,949,22,1700,729,594,355
45,"MUNICIPIUL BUCUREŞTI - SECTOR 4","MUNICIPIUL BUCUREŞTI",179132,"BUCUREŞTI SECTORUL 4","ŞCOALA GIMNAZIALĂ NR. 99",837,"Alegeri Prezidentiale",1,1547,763,700,63,0,751,12,1991,1228,445,306
45,"MUNICIPIUL BUCUREŞTI - SECTOR 4","MUNICIPIUL BUCUREŞTI",179132,"BUCUREŞTI SECTORUL 4","ŞCOALA GIMNAZIALĂ NR. 99",838,"Alegeri Prezidentiale",1,1804,868,785,83,0,848,20,2000,1132,550,298
45,"MUNICIPIUL BUCUREŞTI - SECTOR 4","MUNICIPIUL BUCUREŞTI",179132,"BUCUREŞTI SECTORUL 4","GRĂDINIȚA GRAND ARENA",839,"Alegeri Prezidentiale",1,1491,1199,818,381,0,1173,26,1600,401,911,262
46,"MUNICIPIUL BUCUREŞTI - SECTOR 5","MUNICIPIUL BUCUREŞTI",179132,"BUCUREŞTI SECTORUL 5","ȘCOALA GIMNAZIALĂ NR.134",840,"Alegeri Prezidentiale",1,1832,740,662,78,0,730,10,1900,1160,408,322
46,"MUNICIPIUL BUCUREŞTI - SECTOR 5","MUNICIPIUL BUCUREŞTI",179132,"BUCUREŞTI SECTORUL 5","ȘCOALA GIMNAZIALĂ NR.134",841,"Alegeri Prezidentiale",1,1788,738,696,42,0,714,24,1800,1062,433,281
46,"MUNICIPIUL BUCUREŞTI - SECTOR 5","MUNICIPIUL BUCUREŞTI",179132,"BUCUREŞTI SECTORUL 5","ȘCOALA GIMNAZIALĂ NR.134",842,"Alegeri Prezidentiale",1,1424,622,596,26,0,608,14,1500,878,355,253
46,"MUNICIPIUL BUCUREŞTI - SECTOR 5","MUNICIPIUL BUCUREŞTI",179132,"BUCUREŞTI SECTORUL 5","ȘCOALA GIMNAZIALĂ NR.134",843,"Alegeri Prezidentiale",1,1384,504,473,31,0,490,14,1400,896,299,191
46,"MUNICIPIUL BUCUREŞTI - SECTOR 5","MUNICIPIUL BUCUREŞTI",179132,"BUCUREŞTI SECTORUL 5","ȘCOALA GIMNAZIALĂ NR.134",844,"Alegeri Prezidentiale",1,1516,662,648,14,0,642,20,1600,938,399,243
46,"MUNICIPIUL BUCUREŞTI - SECTOR 5","MUNICIPIUL BUCUREŞTI",179132,"BUCUREŞTI SECTORUL 5","ȘCOALA GIMNAZIALĂ NR.134",845,"Alegeri Prezidentiale",1,1533,651,636,15,0,636,15,1600,949,358,278
46,"MUNICIPIUL BUCUREŞTI - SECTOR 5","MUNICIPIUL BUCUREŞTI",179132,"BUCUREŞTI SECTORUL 5","ȘCOALA GIMNAZIALĂ NR.134",846,"Alegeri Prezidentiale",1,1979,743,720,23,0,731,12,2000,1257,406,325
46,"MUNICIPIUL BUCUREŞTI - SECTOR 5","MUNICIPIUL BUCUREŞTI",179132,"BUCUREŞTI SECTORUL 5","ȘCOALA GIMNAZIALĂ NR.134",847,"Alegeri Prezidentiale",1,1752,575,559,16,0,563,12,1800,1225,322,241
46,"MUNICIPIUL BUCUREŞTI - SECTOR 5","MUNICIPIUL BUCUREŞTI",179132,"BUCUREŞTI SECTORUL 5","ȘCOALA GIMNAZIALĂ NR.134",848,"Alegeri Prezidentiale",1,1135,326,309,17,0,319,7,1200,874,185,134
46,"MUNICIPIUL BUCUREŞTI - SECTOR 5","MUNICIPIUL BUCUREŞTI",179132,"BUCUREŞTI SECTORUL 5","ȘCOALA GIMNAZIALĂ NR.134",849,"Alegeri Prezidentiale",1,1760,586,563,23,0,575,11,1800,1214,379,196
46,"MUNICIPIUL BUCUREŞTI - SECTOR 5","MUNICIPIUL BUCUREŞTI",179132,"BUCUREŞTI SECTORUL 5","ȘCOALA GIMNAZIALĂ NR.134",850,"Alegeri Prezidentiale",1,1545,531,511,20,0,517,14,1600,1069,280,237
46,"MUNICIPIUL BUCUREŞTI - SECTOR 5","MUNICIPIUL BUCUREŞTI",179132,"BUCUREŞTI SECTORUL 5","COLEGIUL TEHNIC ENERGETIC",851,"Alegeri Prezidentiale",2,1268,647,586,60,1,633,14,1300,653,401,232
46,"MUNICIPIUL BUCUREŞTI - SECTOR 5","MUNICIPIUL BUCUREŞTI",179132,"BUCUREŞTI SECTORUL 5","COLEGIUL TEHNIC ENERGETIC",852,"Alegeri Prezidentiale",1,1365,822,684,137,1,793,29,1400,578,479,314
46,"MUNICIPIUL BUCUREŞTI - SECTOR 5","MUNICIPIUL BUCUREŞTI",179132,"BUCUREŞTI SECTORUL 5","COLEGIUL TEHNIC ENERGETIC",853,"Alegeri Prezidentiale",2,1012,550,490,58,2,535,15,1100,550,338,197
46,"MUNICIPIUL BUCUREŞTI - SECTOR 5","MUNICIPIUL BUCUREŞTI",179132,"BUCUREŞTI SECTORUL 5","COLEGIUL TEHNIC ENERGETIC",854,"Alegeri Prezidentiale",2,1059,535,490,45,0,522,13,1100,565,332,190
46,"MUNICIPIUL BUCUREŞTI - SECTOR 5","MUNICIPIUL BUCUREŞTI",179132,"BUCUREŞTI SECTORUL 5","ȘCOALA GIMNAZIALĂ NR.136",855,"Alegeri Prezidentiale",1,1923,653,593,60,0,638,15,2000,1347,376,262
46,"MUNICIPIUL BUCUREŞTI - SECTOR 5","MUNICIPIUL BUCUREŞTI",179132,"BUCUREŞTI SECTORUL 5","ȘCOALA GIMNAZIALĂ NR.136",856,"Alegeri Prezidentiale",1,1291,432,378,54,0,426,6,1400,968,210,216
46,"MUNICIPIUL BUCUREŞTI - SECTOR 5","MUNICIPIUL BUCUREŞTI",179132,"BUCUREŞTI SECTORUL 5","ȘCOALA GIMNAZIALĂ NR.136",857,"Alegeri Prezidentiale",1,1862,472,423,48,1,457,15,1900,1428,222,235
46,"MUNICIPIUL BUCUREŞTI - SECTOR 5","MUNICIPIUL BUCUREŞTI",179132,"BUCUREŞTI SECTORUL 5","ȘCOALA GIMNAZIALĂ NR.136",858,"Alegeri Prezidentiale",1,1285,455,431,24,0,444,11,1300,845,234,210
46,"MUNICIPIUL BUCUREŞTI - SECTOR 5","MUNICIPIUL BUCUREŞTI",179132,"BUCUREŞTI SECTORUL 5","ȘCOALA GIMNAZIALĂ NR.136",859,"Alegeri Prezidentiale",1,1558,580,546,34,0,570,10,1592,1012,300,270
46,"MUNICIPIUL BUCUREŞTI - SECTOR 5","MUNICIPIUL BUCUREŞTI",179132,"BUCUREŞTI SECTORUL 5","ȘCOALA GIMNAZIALĂ NR.136",860,"Alegeri Prezidentiale",1,1475,553,530,23,0,541,12,1500,947,305,236
46,"MUNICIPIUL BUCUREŞTI - SECTOR 5","MUNICIPIUL BUCUREŞTI",179132,"BUCUREŞTI SECTORUL 5","ȘCOALA GIMNAZIALĂ NR.136",861,"Alegeri Prezidentiale",1,1456,558,533,24,1,544,14,1500,942,280,264
46,"MUNICIPIUL BUCUREŞTI - SECTOR 5","MUNICIPIUL BUCUREŞTI",179132,"BUCUREŞTI SECTORUL 5","ȘCOALA GIMNAZIALĂ NR.2",862,"Alegeri Prezidentiale",1,1234,540,462,78,0,534,6,1300,760,306,228
46,"MUNICIPIUL BUCUREŞTI - SECTOR 5","MUNICIPIUL BUCUREŞTI",179132,"BUCUREŞTI SECTORUL 5","ȘCOALA GIMNAZIALĂ NR.2",863,"Alegeri Prezidentiale",1,1404,571,531,40,0,564,7,1500,929,310,254
46,"MUNICIPIUL BUCUREŞTI - SECTOR 5","MUNICIPIUL BUCUREŞTI",179132,"BUCUREŞTI SECTORUL 5","ȘCOALA GIMNAZIALĂ NR.2",864,"Alegeri Prezidentiale",1,1225,486,461,25,0,473,13,1300,814,295,178
46,"MUNICIPIUL BUCUREŞTI - SECTOR 5","MUNICIPIUL BUCUREŞTI",179132,"BUCUREŞTI SECTORUL 5","ȘCOALA GIMNAZIALĂ NR.2",865,"Alegeri Prezidentiale",1,1020,419,406,12,1,407,12,1100,681,240,167
46,"MUNICIPIUL BUCUREŞTI - SECTOR 5","MUNICIPIUL BUCUREŞTI",179132,"BUCUREŞTI SECTORUL 5","ȘCOALA GIMNAZIALĂ NR.2",866,"Alegeri Prezidentiale",1,1426,575,550,25,0,563,12,1500,925,342,221
46,"MUNICIPIUL BUCUREŞTI - SECTOR 5","MUNICIPIUL BUCUREŞTI",179132,"BUCUREŞTI SECTORUL 5","ȘCOALA GIMNAZIALĂ NR.188",867,"Alegeri Prezidentiale",1,958,490,429,61,0,479,11,1000,510,305,174
46,"MUNICIPIUL BUCUREŞTI - SECTOR 5","MUNICIPIUL BUCUREŞTI",179132,"BUCUREŞTI SECTORUL 5","ȘCOALA GIMNAZIALĂ NR.188",868,"Alegeri Prezidentiale",1,1301,735,613,122,0,720,15,1400,665,490,230
46,"MUNICIPIUL BUCUREŞTI - SECTOR 5","MUNICIPIUL BUCUREŞTI",179132,"BUCUREŞTI SECTORUL 5","ȘCOALA GIMNAZIALĂ NR.188",869,"Alegeri Prezidentiale",1,906,539,460,79,0,525,14,1000,461,324,201
46,"MUNICIPIUL BUCUREŞTI - SECTOR 5","MUNICIPIUL BUCUREŞTI",179132,"BUCUREŞTI SECTORUL 5","ȘCOALA GIMNAZIALĂ NR.188",870,"Alegeri Prezidentiale",1,1026,481,453,28,0,472,9,1100,619,296,176
46,"MUNICIPIUL BUCUREŞTI - SECTOR 5","MUNICIPIUL BUCUREŞTI",179132,"BUCUREŞTI SECTORUL 5","ȘCOALA GIMNAZIALĂ NR.188",871,"Alegeri Prezidentiale",2,811,404,383,21,0,393,11,900,496,270,123
46,"MUNICIPIUL BUCUREŞTI - SECTOR 5","MUNICIPIUL BUCUREŞTI",179132,"BUCUREŞTI SECTORUL 5","ȘCOALA GIMNAZIALĂ ”LUCEAFĂRUL”",872,"Alegeri Prezidentiale",1,1122,682,572,110,0,657,25,1200,518,383,274
46,"MUNICIPIUL BUCUREŞTI - SECTOR 5","MUNICIPIUL BUCUREŞTI",179132,"BUCUREŞTI SECTORUL 5","ȘCOALA GIMNAZIALĂ ”LUCEAFĂRUL”",873,"Alegeri Prezidentiale",1,1140,675,561,114,0,647,28,1200,525,407,240
46,"MUNICIPIUL BUCUREŞTI - SECTOR 5","MUNICIPIUL BUCUREŞTI",179132,"BUCUREŞTI SECTORUL 5","ȘCOALA GIMNAZIALĂ ”LUCEAFĂRUL”",874,"Alegeri Prezidentiale",1,1055,610,485,125,0,593,17,1100,490,375,218
46,"MUNICIPIUL BUCUREŞTI - SECTOR 5","MUNICIPIUL BUCUREŞTI",179132,"BUCUREŞTI SECTORUL 5","ȘCOALA GIMNAZIALĂ ”LUCEAFĂRUL”",875,"Alegeri Prezidentiale",1,1250,816,616,200,0,791,25,1300,484,541,250
46,"MUNICIPIUL BUCUREŞTI - SECTOR 5","MUNICIPIUL BUCUREŞTI",179132,"BUCUREŞTI SECTORUL 5","ȘCOALA GIMNAZIALĂ ”LUCEAFĂRUL”",876,"Alegeri Prezidentiale",1,1343,792,651,141,0,776,16,1400,608,577,199
46,"MUNICIPIUL BUCUREŞTI - SECTOR 5","MUNICIPIUL BUCUREŞTI",179132,"BUCUREŞTI SECTORUL 5","ȘCOALA GIMNAZIALĂ ”LUCEAFĂRUL”",877,"Alegeri Prezidentiale",2,1410,711,614,96,1,691,20,1500,789,432,259
46,"MUNICIPIUL BUCUREŞTI - SECTOR 5","MUNICIPIUL BUCUREŞTI",179132,"BUCUREŞTI SECTORUL 5","ȘCOALA GIMNAZIALĂ ”LUCEAFĂRUL”",878,"Alegeri Prezidentiale",1,1108,638,547,91,0,626,12,1200,562,395,231
46,"MUNICIPIUL BUCUREŞTI - SECTOR 5","MUNICIPIUL BUCUREŞTI",179132,"BUCUREŞTI SECTORUL 5","ȘCOALA GIMNAZIALĂ NR.135",879,"Alegeri Prezidentiale",2,1016,602,532,70,0,579,23,1100,498,356,223
46,"MUNICIPIUL BUCUREŞTI - SECTOR 5","MUNICIPIUL BUCUREŞTI",179132,"BUCUREŞTI SECTORUL 5","ȘCOALA GIMNAZIALĂ NR.135",880,"Alegeri Prezidentiale",2,1311,762,694,67,1,746,16,1400,638,486,260
46,"MUNICIPIUL BUCUREŞTI - SECTOR 5","MUNICIPIUL BUCUREŞTI",179132,"BUCUREŞTI SECTORUL 5","ȘCOALA GIMNAZIALĂ NR.135",881,"Alegeri Prezidentiale",1,1305,583,538,45,0,571,12,1400,817,347,224
46,"MUNICIPIUL BUCUREŞTI - SECTOR 5","MUNICIPIUL BUCUREŞTI",179132,"BUCUREŞTI SECTORUL 5","ȘCOALA GIMNAZIALĂ NR.135",882,"Alegeri Prezidentiale",1,1715,853,801,52,0,838,15,1800,947,525,313
46,"MUNICIPIUL BUCUREŞTI - SECTOR 5","MUNICIPIUL BUCUREŞTI",179132,"BUCUREŞTI SECTORUL 5","ȘCOALA GIMNAZIALĂ NR.127",883,"Alegeri Prezidentiale",2,1100,520,475,45,0,507,13,1200,680,322,185
46,"MUNICIPIUL BUCUREŞTI - SECTOR 5","MUNICIPIUL BUCUREŞTI",179132,"BUCUREŞTI SECTORUL 5","ȘCOALA GIMNAZIALĂ NR.127",884,"Alegeri Prezidentiale",2,1111,561,475,86,0,544,17,1200,639,332,212
46,"MUNICIPIUL BUCUREŞTI - SECTOR 5","MUNICIPIUL BUCUREŞTI",179132,"BUCUREŞTI SECTORUL 5","ȘCOALA GIMNAZIALĂ NR.127",885,"Alegeri Prezidentiale",1,1411,633,570,63,0,620,13,1500,867,378,242
46,"MUNICIPIUL BUCUREŞTI - SECTOR 5","MUNICIPIUL BUCUREŞTI",179132,"BUCUREŞTI SECTORUL 5","ȘCOALA GIMNAZIALĂ NR.127",886,"Alegeri Prezidentiale",1,1233,555,512,43,0,539,16,1300,745,330,209
46,"MUNICIPIUL BUCUREŞTI - SECTOR 5","MUNICIPIUL BUCUREŞTI",179132,"BUCUREŞTI SECTORUL 5","ȘCOALA GIMNAZIALĂ NR.127",887,"Alegeri Prezidentiale",1,1156,456,438,18,0,445,11,1200,744,280,165
46,"MUNICIPIUL BUCUREŞTI - SECTOR 5","MUNICIPIUL BUCUREŞTI",179132,"BUCUREŞTI SECTORUL 5","ȘCOALA GIMNAZIALĂ NR.127",888,"Alegeri Prezidentiale",1,1173,467,448,19,0,457,10,1200,733,291,166
46,"MUNICIPIUL BUCUREŞTI - SECTOR 5","MUNICIPIUL BUCUREŞTI",179132,"BUCUREŞTI SECTORUL 5","ȘCOALA GIMNAZIALĂ NR.127",889,"Alegeri Prezidentiale",1,1399,341,317,24,0,336,5,1500,1159,168,168
46,"MUNICIPIUL BUCUREŞTI - SECTOR 5","MUNICIPIUL BUCUREŞTI",179132,"BUCUREŞTI SECTORUL 5","ȘCOALA GIMNAZIALĂ NR.127",890,"Alegeri Prezidentiale",1,1868,772,737,35,0,756,16,1900,1128,439,317
46,"MUNICIPIUL BUCUREŞTI - SECTOR 5","MUNICIPIUL BUCUREŞTI",179132,"BUCUREŞTI SECTORUL 5","ȘCOALA GIMNAZIALĂ NR.127",891,"Alegeri Prezidentiale",1,1809,795,774,20,1,778,17,1900,1105,441,337
46,"MUNICIPIUL BUCUREŞTI - SECTOR 5","MUNICIPIUL BUCUREŞTI",179132,"BUCUREŞTI SECTORUL 5","ȘCOALA GIMNAZIALĂ NR.127",892,"Alegeri Prezidentiale",1,2027,990,933,57,0,973,17,2100,1110,672,301
46,"MUNICIPIUL BUCUREŞTI - SECTOR 5","MUNICIPIUL BUCUREŞTI",179132,"BUCUREŞTI SECTORUL 5","ȘCOALA GIMNAZIALĂ NR.127",893,"Alegeri Prezidentiale",1,1821,818,793,23,2,795,23,1900,1082,441,354
46,"MUNICIPIUL BUCUREŞTI - SECTOR 5","MUNICIPIUL BUCUREŞTI",179132,"BUCUREŞTI SECTORUL 5","ȘCOALA GIMNAZIALĂ NR.127",894,"Alegeri Prezidentiale",1,1966,897,867,30,0,881,16,2000,1103,531,350
46,"MUNICIPIUL BUCUREŞTI - SECTOR 5","MUNICIPIUL BUCUREŞTI",179132,"BUCUREŞTI SECTORUL 5","GRĂDINIȚA ”PARADISUL VERDE”",895,"Alegeri Prezidentiale",1,1734,446,395,39,12,433,13,1800,1354,263,170
46,"MUNICIPIUL BUCUREŞTI - SECTOR 5","MUNICIPIUL BUCUREŞTI",179132,"BUCUREŞTI SECTORUL 5","GRĂDINIȚA ”PARADISUL VERDE”",896,"Alegeri Prezidentiale",1,1471,473,447,25,1,463,10,1500,1027,246,217
46,"MUNICIPIUL BUCUREŞTI - SECTOR 5","MUNICIPIUL BUCUREŞTI",179132,"BUCUREŞTI SECTORUL 5","GRĂDINIȚA ”PARADISUL VERDE”",897,"Alegeri Prezidentiale",1,1272,548,516,32,0,535,13,1400,852,315,220
46,"MUNICIPIUL BUCUREŞTI - SECTOR 5","MUNICIPIUL BUCUREŞTI",179132,"BUCUREŞTI SECTORUL 5","GRĂDINIȚA ”PARADISUL VERDE”",898,"Alegeri Prezidentiale",1,1590,584,555,29,0,573,11,1700,1116,344,229
46,"MUNICIPIUL BUCUREŞTI - SECTOR 5","MUNICIPIUL BUCUREŞTI",179132,"BUCUREŞTI SECTORUL 5","ȘCOALA GIMNAZIALĂ ”GEORGE CĂLINESCU”",899,"Alegeri Prezidentiale",1,1385,572,522,50,0,555,17,1500,928,326,229
46,"MUNICIPIUL BUCUREŞTI - SECTOR 5","MUNICIPIUL BUCUREŞTI",179132,"BUCUREŞTI SECTORUL 5","ȘCOALA GIMNAZIALĂ ”GEORGE CĂLINESCU”",900,"Alegeri Prezidentiale",1,1216,541,496,44,1,535,6,1300,759,290,245
46,"MUNICIPIUL BUCUREŞTI - SECTOR 5","MUNICIPIUL BUCUREŞTI",179132,"BUCUREŞTI SECTORUL 5","ȘCOALA GIMNAZIALĂ ”GEORGE CĂLINESCU”",901,"Alegeri Prezidentiale",1,1522,659,628,31,0,642,17,1600,941,362,280
46,"MUNICIPIUL BUCUREŞTI - SECTOR 5","MUNICIPIUL BUCUREŞTI",179132,"BUCUREŞTI SECTORUL 5","ȘCOALA GIMNAZIALĂ ”GEORGE CĂLINESCU”",902,"Alegeri Prezidentiale",1,1645,712,680,32,0,693,19,1700,988,418,275
46,"MUNICIPIUL BUCUREŞTI - SECTOR 5","MUNICIPIUL BUCUREŞTI",179132,"BUCUREŞTI SECTORUL 5","ȘCOALA GIMNAZIALĂ ”GEORGE CĂLINESCU”",903,"Alegeri Prezidentiale",1,1617,721,693,28,0,709,12,1700,979,423,286
46,"MUNICIPIUL BUCUREŞTI - SECTOR 5","MUNICIPIUL BUCUREŞTI",179132,"BUCUREŞTI SECTORUL 5","GRĂDINIȚA NR.244",904,"Alegeri Prezidentiale",1,1633,661,619,42,0,647,14,1700,1039,359,288
46,"MUNICIPIUL BUCUREŞTI - SECTOR 5","MUNICIPIUL BUCUREŞTI",179132,"BUCUREŞTI SECTORUL 5","GRĂDINIȚA NR.244",905,"Alegeri Prezidentiale",2,1694,636,615,21,0,625,11,1792,1156,315,310
46,"MUNICIPIUL BUCUREŞTI - SECTOR 5","MUNICIPIUL BUCUREŞTI",179132,"BUCUREŞTI SECTORUL 5","ȘCOALA GIMNAZIALĂ ”PETRACHE POENARU”",906,"Alegeri Prezidentiale",2,1374,633,501,132,0,622,11,1500,867,385,237
46,"MUNICIPIUL BUCUREŞTI - SECTOR 5","MUNICIPIUL BUCUREŞTI",179132,"BUCUREŞTI SECTORUL 5","ȘCOALA GIMNAZIALĂ ”PETRACHE POENARU”",907,"Alegeri Prezidentiale",1,2040,1051,1002,49,0,1028,23,2100,1049,756,272
46,"MUNICIPIUL BUCUREŞTI - SECTOR 5","MUNICIPIUL BUCUREŞTI",179132,"BUCUREŞTI SECTORUL 5","ȘCOALA GIMNAZIALĂ ”PETRACHE POENARU”",908,"Alegeri Prezidentiale",1,1589,694,643,51,0,681,13,1692,998,384,297
46,"MUNICIPIUL BUCUREŞTI - SECTOR 5","MUNICIPIUL BUCUREŞTI",179132,"BUCUREŞTI SECTORUL 5","ȘCOALA GIMNAZIALĂ ”PETRACHE POENARU”",909,"Alegeri Prezidentiale",1,1296,514,478,36,0,508,6,1400,886,275,233
46,"MUNICIPIUL BUCUREŞTI - SECTOR 5","MUNICIPIUL BUCUREŞTI",179132,"BUCUREŞTI SECTORUL 5","ȘCOALA GIMNAZIALĂ ”PETRACHE POENARU”",910,"Alegeri Prezidentiale",1,1639,584,554,30,0,573,11,1700,1116,347,226
46,"MUNICIPIUL BUCUREŞTI - SECTOR 5","MUNICIPIUL BUCUREŞTI",179132,"BUCUREŞTI SECTORUL 5","ȘCOALA GIMNAZIALĂ ”PETRACHE POENARU”",911,"Alegeri Prezidentiale",1,1517,567,552,15,0,554,13,1600,1033,314,240
46,"MUNICIPIUL BUCUREŞTI - SECTOR 5","MUNICIPIUL BUCUREŞTI",179132,"BUCUREŞTI SECTORUL 5","ȘCOALA GIMNAZIALĂ ”PETRACHE POENARU”",912,"Alegeri Prezidentiale",1,1636,755,730,25,0,739,16,1700,945,463,276
46,"MUNICIPIUL BUCUREŞTI - SECTOR 5","MUNICIPIUL BUCUREŞTI",179132,"BUCUREŞTI SECTORUL 5","ȘCOALA GIMNAZIALĂ ”PRINCIPESA MARGARETA”",913,"Alegeri Prezidentiale",1,996,607,564,43,0,589,18,1092,485,415,174
46,"MUNICIPIUL BUCUREŞTI - SECTOR 5","MUNICIPIUL BUCUREŞTI",179132,"BUCUREŞTI SECTORUL 5","ȘCOALA GIMNAZIALĂ ”PRINCIPESA MARGARETA”",914,"Alegeri Prezidentiale",1,1208,472,413,59,0,462,10,1300,828,290,172
46,"MUNICIPIUL BUCUREŞTI - SECTOR 5","MUNICIPIUL BUCUREŞTI",179132,"BUCUREŞTI SECTORUL 5","ȘCOALA GIMNAZIALĂ ”PRINCIPESA MARGARETA”",915,"Alegeri Prezidentiale",1,1731,538,418,120,0,533,5,1800,1262,328,205
46,"MUNICIPIUL BUCUREŞTI - SECTOR 5","MUNICIPIUL BUCUREŞTI",179132,"BUCUREŞTI SECTORUL 5","ȘCOALA GIMNAZIALĂ ”PRINCIPESA MARGARETA”",916,"Alegeri Prezidentiale",1,1138,611,544,67,0,600,11,1200,589,392,208
46,"MUNICIPIUL BUCUREŞTI - SECTOR 5","MUNICIPIUL BUCUREŞTI",179132,"BUCUREŞTI SECTORUL 5","GRĂDINIȚA NR.168",917,"Alegeri Prezidentiale",1,1142,649,511,99,39,639,10,1400,751,453,186
46,"MUNICIPIUL BUCUREŞTI - SECTOR 5","MUNICIPIUL BUCUREŞTI",179132,"BUCUREŞTI SECTORUL 5","GRĂDINIȚA NR.168",918,"Alegeri Prezidentiale",3,905,601,422,131,48,592,9,1200,599,397,195
46,"MUNICIPIUL BUCUREŞTI - SECTOR 5","MUNICIPIUL BUCUREŞTI",179132,"BUCUREŞTI SECTORUL 5","CLUBUL COPIILOR SECTOR 5",919,"Alegeri Prezidentiale",1,1320,859,657,202,0,839,20,1600,741,565,274
46,"MUNICIPIUL BUCUREŞTI - SECTOR 5","MUNICIPIUL BUCUREŞTI",179132,"BUCUREŞTI SECTORUL 5","CLUBUL COPIILOR SECTOR 5",920,"Alegeri Prezidentiale",1,1345,877,672,205,0,859,18,1600,723,529,330
46,"MUNICIPIUL BUCUREŞTI - SECTOR 5","MUNICIPIUL BUCUREŞTI",179132,"BUCUREŞTI SECTORUL 5","ȘCOALA GIMNAZIALĂ NR.280",921,"Alegeri Prezidentiale",1,1393,860,712,148,0,834,26,1492,632,543,291
46,"MUNICIPIUL BUCUREŞTI - SECTOR 5","MUNICIPIUL BUCUREŞTI",179132,"BUCUREŞTI SECTORUL 5","ȘCOALA GIMNAZIALĂ NR.280",922,"Alegeri Prezidentiale",1,1150,619,519,100,0,608,11,1300,681,363,245
46,"MUNICIPIUL BUCUREŞTI - SECTOR 5","MUNICIPIUL BUCUREŞTI",179132,"BUCUREŞTI SECTORUL 5","ȘCOALA GIMNAZIALĂ NR.280",923,"Alegeri Prezidentiale",1,1018,540,482,58,0,524,16,1200,660,343,181
46,"MUNICIPIUL BUCUREŞTI - SECTOR 5","MUNICIPIUL BUCUREŞTI",179132,"BUCUREŞTI SECTORUL 5","ȘCOALA GIMNAZIALĂ NR.280",924,"Alegeri Prezidentiale",1,1107,607,539,68,0,584,23,1300,693,409,175
46,"MUNICIPIUL BUCUREŞTI - SECTOR 5","MUNICIPIUL BUCUREŞTI",179132,"BUCUREŞTI SECTORUL 5","ȘCOALA GIMNAZIALĂ NR.280",925,"Alegeri Prezidentiale",1,949,513,469,44,0,495,18,1000,487,309,186
46,"MUNICIPIUL BUCUREŞTI - SECTOR 5","MUNICIPIUL BUCUREŞTI",179132,"BUCUREŞTI SECTORUL 5","ȘCOALA GIMNAZIALĂ NR.280",926,"Alegeri Prezidentiale",1,1270,638,608,30,0,628,10,1400,762,378,250
46,"MUNICIPIUL BUCUREŞTI - SECTOR 5","MUNICIPIUL BUCUREŞTI",179132,"BUCUREŞTI SECTORUL 5","ȘCOALA GIMNAZIALĂ NR.280",927,"Alegeri Prezidentiale",1,1228,580,553,27,0,570,10,1300,720,340,230
46,"MUNICIPIUL BUCUREŞTI - SECTOR 5","MUNICIPIUL BUCUREŞTI",179132,"BUCUREŞTI SECTORUL 5","ȘCOALA GIMNAZIALĂ NR.280",928,"Alegeri Prezidentiale",1,1090,531,506,25,0,522,9,1200,669,301,221
46,"MUNICIPIUL BUCUREŞTI - SECTOR 5","MUNICIPIUL BUCUREŞTI",179132,"BUCUREŞTI SECTORUL 5","LICEUL TEHNOLOGIC ”DIMITRIE GUSTI”",929,"Alegeri Prezidentiale",1,1266,887,685,202,0,866,21,1300,413,590,276
46,"MUNICIPIUL BUCUREŞTI - SECTOR 5","MUNICIPIUL BUCUREŞTI",179132,"BUCUREŞTI SECTORUL 5","LICEUL TEHNOLOGIC ”DIMITRIE GUSTI”",930,"Alegeri Prezidentiale",1,1256,698,624,74,0,681,17,1308,610,456,225
46,"MUNICIPIUL BUCUREŞTI - SECTOR 5","MUNICIPIUL BUCUREŞTI",179132,"BUCUREŞTI SECTORUL 5","LICEUL TEHNOLOGIC ”DIMITRIE GUSTI”",931,"Alegeri Prezidentiale",1,1234,685,601,84,0,667,18,1300,615,449,218
46,"MUNICIPIUL BUCUREŞTI - SECTOR 5","MUNICIPIUL BUCUREŞTI",179132,"BUCUREŞTI SECTORUL 5","GRĂDINIȚA NR.205",932,"Alegeri Prezidentiale",1,1370,778,704,74,0,759,19,1392,614,448,311
46,"MUNICIPIUL BUCUREŞTI - SECTOR 5","MUNICIPIUL BUCUREŞTI",179132,"BUCUREŞTI SECTORUL 5","GRĂDINIȚA NR.205",933,"Alegeri Prezidentiale",1,1118,611,534,77,0,599,12,1192,581,326,273
46,"MUNICIPIUL BUCUREŞTI - SECTOR 5","MUNICIPIUL BUCUREŞTI",179132,"BUCUREŞTI SECTORUL 5","GRĂDINIȚA NR.205",934,"Alegeri Prezidentiale",1,1299,740,614,126,0,724,16,1400,660,492,232
46,"MUNICIPIUL BUCUREŞTI - SECTOR 5","MUNICIPIUL BUCUREŞTI",179132,"BUCUREŞTI SECTORUL 5","GRĂDINIȚA NR.205",935,"Alegeri Prezidentiale",1,1040,611,550,61,0,593,18,1100,489,341,252
46,"MUNICIPIUL BUCUREŞTI - SECTOR 5","MUNICIPIUL BUCUREŞTI",179132,"BUCUREŞTI SECTORUL 5","GRĂDINIȚA NR.205",936,"Alegeri Prezidentiale",1,1154,609,544,64,1,593,16,1200,591,393,200
46,"MUNICIPIUL BUCUREŞTI - SECTOR 5","MUNICIPIUL BUCUREŞTI",179132,"BUCUREŞTI SECTORUL 5","LICEUL TEORETIC ”DIMITRIE BOLINTINEANU”",937,"Alegeri Prezidentiale",1,1071,580,535,44,1,569,11,1200,620,353,216
46,"MUNICIPIUL BUCUREŞTI - SECTOR 5","MUNICIPIUL BUCUREŞTI",179132,"BUCUREŞTI SECTORUL 5","LICEUL TEORETIC ”DIMITRIE BOLINTINEANU”",938,"Alegeri Prezidentiale",1,940,542,466,75,1,525,17,1100,558,320,205
46,"MUNICIPIUL BUCUREŞTI - SECTOR 5","MUNICIPIUL BUCUREŞTI",179132,"BUCUREŞTI SECTORUL 5","LICEUL TEORETIC ”DIMITRIE BOLINTINEANU”",939,"Alegeri Prezidentiale",1,1122,695,557,138,0,684,11,1400,705,502,182
46,"MUNICIPIUL BUCUREŞTI - SECTOR 5","MUNICIPIUL BUCUREŞTI",179132,"BUCUREŞTI SECTORUL 5","LICEUL TEORETIC ”DIMITRIE BOLINTINEANU”",940,"Alegeri Prezidentiale",1,1303,781,606,173,2,761,20,1500,719,436,325
46,"MUNICIPIUL BUCUREŞTI - SECTOR 5","MUNICIPIUL BUCUREŞTI",179132,"BUCUREŞTI SECTORUL 5","LICEUL TEORETIC ”DIMITRIE BOLINTINEANU”",941,"Alegeri Prezidentiale",1,1229,746,606,140,0,727,19,1300,554,446,281
46,"MUNICIPIUL BUCUREŞTI - SECTOR 5","MUNICIPIUL BUCUREŞTI",179132,"BUCUREŞTI SECTORUL 5","LICEUL TEORETIC ”DIMITRIE BOLINTINEANU”",942,"Alegeri Prezidentiale",1,1419,649,553,96,0,632,17,1600,951,401,231
46,"MUNICIPIUL BUCUREŞTI - SECTOR 5","MUNICIPIUL BUCUREŞTI",179132,"BUCUREŞTI SECTORUL 5","LICEUL TEORETIC ”DIMITRIE BOLINTINEANU”",943,"Alegeri Prezidentiale",1,1241,685,615,69,1,674,11,1300,615,424,250
46,"MUNICIPIUL BUCUREŞTI - SECTOR 5","MUNICIPIUL BUCUREŞTI",179132,"BUCUREŞTI SECTORUL 5","LICEUL TEORETIC ”DIMITRIE BOLINTINEANU”",944,"Alegeri Prezidentiale",1,1224,595,521,74,0,585,10,1300,705,353,232
46,"MUNICIPIUL BUCUREŞTI - SECTOR 5","MUNICIPIUL BUCUREŞTI",179132,"BUCUREŞTI SECTORUL 5","LICEUL TEORETIC ”DIMITRIE BOLINTINEANU”",945,"Alegeri Prezidentiale",1,905,494,440,54,0,486,8,1100,606,270,216
46,"MUNICIPIUL BUCUREŞTI - SECTOR 5","MUNICIPIUL BUCUREŞTI",179132,"BUCUREŞTI SECTORUL 5","FACULTATEA DE DREPT",946,"Alegeri Prezidentiale",1,629,660,317,342,1,640,20,1200,540,497,143
46,"MUNICIPIUL BUCUREŞTI - SECTOR 5","MUNICIPIUL BUCUREŞTI",179132,"BUCUREŞTI SECTORUL 5","FACULTATEA DE DREPT",947,"Alegeri Prezidentiale",2,605,580,235,345,0,564,16,1192,612,470,94
46,"MUNICIPIUL BUCUREŞTI - SECTOR 5","MUNICIPIUL BUCUREŞTI",179132,"BUCUREŞTI SECTORUL 5","FACULTATEA DE DREPT",948,"Alegeri Prezidentiale",1,593,535,233,301,1,518,17,1200,665,395,123
46,"MUNICIPIUL BUCUREŞTI - SECTOR 5","MUNICIPIUL BUCUREŞTI",179132,"BUCUREŞTI SECTORUL 5","COLEGIUL NAȚIONAL ”GHEORGHE LAZĂR”",949,"Alegeri Prezidentiale",1,692,604,365,238,1,590,14,1200,596,438,152
46,"MUNICIPIUL BUCUREŞTI - SECTOR 5","MUNICIPIUL BUCUREŞTI",179132,"BUCUREŞTI SECTORUL 5","COLEGIUL NAȚIONAL ”GHEORGHE LAZĂR”",950,"Alegeri Prezidentiale",1,885,636,369,267,0,620,16,1408,772,443,177
46,"MUNICIPIUL BUCUREŞTI - SECTOR 5","MUNICIPIUL BUCUREŞTI",179132,"BUCUREŞTI SECTORUL 5","COLEGIUL NAȚIONAL ”GHEORGHE LAZĂR”",951,"Alegeri Prezidentiale",1,576,394,229,165,0,388,6,900,506,271,117
46,"MUNICIPIUL BUCUREŞTI - SECTOR 5","MUNICIPIUL BUCUREŞTI",179132,"BUCUREŞTI SECTORUL 5","COLEGIUL NAȚIONAL ”GHEORGHE LAZĂR”",952,"Alegeri Prezidentiale",1,732,551,323,228,0,536,15,1000,449,395,141
46,"MUNICIPIUL BUCUREŞTI - SECTOR 5","MUNICIPIUL BUCUREŞTI",179132,"BUCUREŞTI SECTORUL 5","COLEGIUL NAȚIONAL ”GHEORGHE LAZĂR”",953,"Alegeri Prezidentiale",1,616,506,249,257,0,499,7,1000,494,387,112
46,"MUNICIPIUL BUCUREŞTI - SECTOR 5","MUNICIPIUL BUCUREŞTI",179132,"BUCUREŞTI SECTORUL 5","GRĂDINȚA NR.178",954,"Alegeri Prezidentiale",1,1835,945,850,95,0,924,21,1900,955,591,333
46,"MUNICIPIUL BUCUREŞTI - SECTOR 5","MUNICIPIUL BUCUREŞTI",179132,"BUCUREŞTI SECTORUL 5","GRĂDINȚA NR.178",955,"Alegeri Prezidentiale",1,968,498,401,97,0,492,6,1292,794,315,177
46,"MUNICIPIUL BUCUREŞTI - SECTOR 5","MUNICIPIUL BUCUREŞTI",179132,"BUCUREŞTI SECTORUL 5","GRĂDINȚA NR.178",956,"Alegeri Prezidentiale",1,1924,909,834,73,2,883,26,2000,1091,555,328
46,"MUNICIPIUL BUCUREŞTI - SECTOR 5","MUNICIPIUL BUCUREŞTI",179132,"BUCUREŞTI SECTORUL 5","LICEUL TEORETIC ”ION BARBU”",957,"Alegeri Prezidentiale",1,1209,665,547,118,0,652,13,1500,835,455,197
46,"MUNICIPIUL BUCUREŞTI - SECTOR 5","MUNICIPIUL BUCUREŞTI",179132,"BUCUREŞTI SECTORUL 5","LICEUL TEORETIC ”ION BARBU”",958,"Alegeri Prezidentiale",1,1325,745,596,148,1,733,12,1592,847,470,263
46,"MUNICIPIUL BUCUREŞTI - SECTOR 5","MUNICIPIUL BUCUREŞTI",179132,"BUCUREŞTI SECTORUL 5","LICEUL TEORETIC ”ION BARBU”",959,"Alegeri Prezidentiale",1,942,599,506,91,2,581,18,1100,501,410,171
46,"MUNICIPIUL BUCUREŞTI - SECTOR 5","MUNICIPIUL BUCUREŞTI",179132,"BUCUREŞTI SECTORUL 5","LICEUL TEORETIC ”ION BARBU”",960,"Alegeri Prezidentiale",1,1054,604,564,40,0,587,17,1100,496,356,231
46,"MUNICIPIUL BUCUREŞTI - SECTOR 5","MUNICIPIUL BUCUREŞTI",179132,"BUCUREŞTI SECTORUL 5","LICEUL TEORETIC ”ION BARBU”",961,"Alegeri Prezidentiale",1,1191,657,617,40,0,643,14,1292,635,383,260
46,"MUNICIPIUL BUCUREŞTI - SECTOR 5","MUNICIPIUL BUCUREŞTI",179132,"BUCUREŞTI SECTORUL 5","LICEUL TEORETIC ”ION BARBU”",962,"Alegeri Prezidentiale",1,1837,1008,959,48,1,978,30,1900,892,636,342
46,"MUNICIPIUL BUCUREŞTI - SECTOR 5","MUNICIPIUL BUCUREŞTI",179132,"BUCUREŞTI SECTORUL 5","LICEUL TEORETIC ”ION BARBU”",963,"Alegeri Prezidentiale",1,966,587,555,31,1,573,14,1100,513,379,194
46,"MUNICIPIUL BUCUREŞTI - SECTOR 5","MUNICIPIUL BUCUREŞTI",179132,"BUCUREŞTI SECTORUL 5","LICEUL TEORETIC ”ION BARBU”",964,"Alegeri Prezidentiale",1,837,440,422,17,1,430,10,900,460,296,134
46,"MUNICIPIUL BUCUREŞTI - SECTOR 5","MUNICIPIUL BUCUREŞTI",179132,"BUCUREŞTI SECTORUL 5","LICEUL TEORETIC ”ION BARBU”",965,"Alegeri Prezidentiale",1,1263,665,623,41,1,650,15,1300,635,419,231
46,"MUNICIPIUL BUCUREŞTI - SECTOR 5","MUNICIPIUL BUCUREŞTI",179132,"BUCUREŞTI SECTORUL 5","ȘCOALA GIMNAZIALĂ NR.115",966,"Alegeri Prezidentiale",1,1413,818,686,132,0,806,12,1692,874,527,279
46,"MUNICIPIUL BUCUREŞTI - SECTOR 5","MUNICIPIUL BUCUREŞTI",179132,"BUCUREŞTI SECTORUL 5","ȘCOALA GIMNAZIALĂ NR.115",967,"Alegeri Prezidentiale",1,1171,783,601,181,1,764,19,1500,717,503,261
46,"MUNICIPIUL BUCUREŞTI - SECTOR 5","MUNICIPIUL BUCUREŞTI",179132,"BUCUREŞTI SECTORUL 5","ȘCOALA GIMNAZIALĂ NR.115",968,"Alegeri Prezidentiale",1,1348,783,677,106,0,760,23,1600,817,499,261
46,"MUNICIPIUL BUCUREŞTI - SECTOR 5","MUNICIPIUL BUCUREŞTI",179132,"BUCUREŞTI SECTORUL 5","ȘCOALA GIMNAZIALĂ NR.115",969,"Alegeri Prezidentiale",1,1156,646,597,49,0,631,15,1192,546,401,230
46,"MUNICIPIUL BUCUREŞTI - SECTOR 5","MUNICIPIUL BUCUREŞTI",179132,"BUCUREŞTI SECTORUL 5","ȘCOALA GIMNAZIALĂ NR.115",970,"Alegeri Prezidentiale",1,1142,679,588,91,0,664,15,1200,521,461,203
46,"MUNICIPIUL BUCUREŞTI - SECTOR 5","MUNICIPIUL BUCUREŞTI",179132,"BUCUREŞTI SECTORUL 5","ȘCOALA GIMNAZIALĂ NR.115",971,"Alegeri Prezidentiale",1,1176,594,563,31,0,583,11,1292,698,373,210
46,"MUNICIPIUL BUCUREŞTI - SECTOR 5","MUNICIPIUL BUCUREŞTI",179132,"BUCUREŞTI SECTORUL 5","ȘCOALA GIMNAZIALĂ ”I. G. DUCA”",972,"Alegeri Prezidentiale",1,1084,815,594,221,0,790,25,1400,585,531,259
46,"MUNICIPIUL BUCUREŞTI - SECTOR 5","MUNICIPIUL BUCUREŞTI",179132,"BUCUREŞTI SECTORUL 5","ȘCOALA GIMNAZIALĂ ”I. G. DUCA”",973,"Alegeri Prezidentiale",2,959,674,500,153,21,658,16,1300,626,462,196
46,"MUNICIPIUL BUCUREŞTI - SECTOR 5","MUNICIPIUL BUCUREŞTI",179132,"BUCUREŞTI SECTORUL 5","ȘCOALA GIMNAZIALĂ ”I. G. DUCA”",974,"Alegeri Prezidentiale",1,1059,802,546,170,86,784,18,1400,598,515,269
46,"MUNICIPIUL BUCUREŞTI - SECTOR 5","MUNICIPIUL BUCUREŞTI",179132,"BUCUREŞTI SECTORUL 5","ȘCOALA GIMNAZIALĂ ”I. G. DUCA”",975,"Alegeri Prezidentiale",2,894,632,486,89,57,618,14,992,360,391,227
46,"MUNICIPIUL BUCUREŞTI - SECTOR 5","MUNICIPIUL BUCUREŞTI",179132,"BUCUREŞTI SECTORUL 5","ȘCOALA GIMNAZIALĂ ”I. G. DUCA”",976,"Alegeri Prezidentiale",1,1014,690,595,94,1,678,12,1200,510,468,210
46,"MUNICIPIUL BUCUREŞTI - SECTOR 5","MUNICIPIUL BUCUREŞTI",179132,"BUCUREŞTI SECTORUL 5","ȘCOALA GIMNAZIALĂ NR.150",977,"Alegeri Prezidentiale",1,687,528,325,153,50,514,14,893,365,375,139
46,"MUNICIPIUL BUCUREŞTI - SECTOR 5","MUNICIPIUL BUCUREŞTI",179132,"BUCUREŞTI SECTORUL 5","ȘCOALA GIMNAZIALĂ NR.150",978,"Alegeri Prezidentiale",2,688,554,358,139,57,537,17,992,438,371,166
46,"MUNICIPIUL BUCUREŞTI - SECTOR 5","MUNICIPIUL BUCUREŞTI",179132,"BUCUREŞTI SECTORUL 5","ȘCOALA GIMNAZIALĂ NR.150",979,"Alegeri Prezidentiale",1,726,492,364,66,62,480,12,900,408,338,142
46,"MUNICIPIUL BUCUREŞTI - SECTOR 5","MUNICIPIUL BUCUREŞTI",179132,"BUCUREŞTI SECTORUL 5","ȘCOALA GIMNAZIALĂ NR.150",980,"Alegeri Prezidentiale",1,676,499,379,51,69,490,9,900,401,324,166
46,"MUNICIPIUL BUCUREŞTI - SECTOR 5","MUNICIPIUL BUCUREŞTI",179132,"BUCUREŞTI SECTORUL 5","ȘCOALA GIMNAZIALĂ NR.150",981,"Alegeri Prezidentiale",2,683,470,337,61,72,455,15,992,522,310,145
46,"MUNICIPIUL BUCUREŞTI - SECTOR 5","MUNICIPIUL BUCUREŞTI",179132,"BUCUREŞTI SECTORUL 5","ȘCOALA GIMNAZIALĂ NR.150",982,"Alegeri Prezidentiale",1,754,468,376,44,48,460,8,908,440,339,121
46,"MUNICIPIUL BUCUREŞTI - SECTOR 5","MUNICIPIUL BUCUREŞTI",179132,"BUCUREŞTI SECTORUL 5","ȘCOALA GIMNAZIALĂ NR.128",983,"Alegeri Prezidentiale",2,843,536,385,151,0,525,11,900,364,356,169
46,"MUNICIPIUL BUCUREŞTI - SECTOR 5","MUNICIPIUL BUCUREŞTI",179132,"BUCUREŞTI SECTORUL 5","ȘCOALA GIMNAZIALĂ NR.128",984,"Alegeri Prezidentiale",1,767,412,258,154,0,407,5,800,388,269,138
46,"MUNICIPIUL BUCUREŞTI - SECTOR 5","MUNICIPIUL BUCUREŞTI",179132,"BUCUREŞTI SECTORUL 5","ȘCOALA GIMNAZIALĂ NR.128",985,"Alegeri Prezidentiale",1,825,402,365,37,0,392,10,900,498,279,113
46,"MUNICIPIUL BUCUREŞTI - SECTOR 5","MUNICIPIUL BUCUREŞTI",179132,"BUCUREŞTI SECTORUL 5","ȘCOALA GIMNAZIALĂ NR.128",986,"Alegeri Prezidentiale",1,716,422,397,25,0,415,7,900,478,241,174
46,"MUNICIPIUL BUCUREŞTI - SECTOR 5","MUNICIPIUL BUCUREŞTI",179132,"BUCUREŞTI SECTORUL 5","ȘCOALA GIMNAZIALĂ NR.128",987,"Alegeri Prezidentiale",1,689,390,367,22,1,381,9,800,410,208,173
46,"MUNICIPIUL BUCUREŞTI - SECTOR 5","MUNICIPIUL BUCUREŞTI",179132,"BUCUREŞTI SECTORUL 5","ȘCOALA GIMNAZIALĂ NR.128",988,"Alegeri Prezidentiale",1,1222,683,655,26,2,675,8,1300,617,353,322
46,"MUNICIPIUL BUCUREŞTI - SECTOR 5","MUNICIPIUL BUCUREŞTI",179132,"BUCUREŞTI SECTORUL 5","ȘCOALA GIMNAZIALĂ NR.128",989,"Alegeri Prezidentiale",2,824,473,449,24,0,457,16,900,427,283,174
46,"MUNICIPIUL BUCUREŞTI - SECTOR 5","MUNICIPIUL BUCUREŞTI",179132,"BUCUREŞTI SECTORUL 5","ȘCOALA GIMNAZIALĂ NR.125",990,"Alegeri Prezidentiale",1,1675,949,838,111,0,927,22,1792,843,568,359
46,"MUNICIPIUL BUCUREŞTI - SECTOR 5","MUNICIPIUL BUCUREŞTI",179132,"BUCUREŞTI SECTORUL 5","ȘCOALA GIMNAZIALĂ NR.125",991,"Alegeri Prezidentiale",1,1801,831,763,68,0,818,13,1900,1069,459,359
46,"MUNICIPIUL BUCUREŞTI - SECTOR 5","MUNICIPIUL BUCUREŞTI",179132,"BUCUREŞTI SECTORUL 5","ȘCOALA GIMNAZIALĂ NR.125",992,"Alegeri Prezidentiale",1,1522,738,636,102,0,729,9,1592,854,423,306
46,"MUNICIPIUL BUCUREŞTI - SECTOR 5","MUNICIPIUL BUCUREŞTI",179132,"BUCUREŞTI SECTORUL 5","ȘCOALA GIMNAZIALĂ NR.131",993,"Alegeri Prezidentiale",1,1436,663,591,29,43,656,7,1600,937,362,294
46,"MUNICIPIUL BUCUREŞTI - SECTOR 5","MUNICIPIUL BUCUREŞTI",179132,"BUCUREŞTI SECTORUL 5","ȘCOALA GIMNAZIALĂ NR.131",994,"Alegeri Prezidentiale",1,1647,905,699,21,185,880,25,1900,995,416,464
46,"MUNICIPIUL BUCUREŞTI - SECTOR 5","MUNICIPIUL BUCUREŞTI",179132,"BUCUREŞTI SECTORUL 5","ȘCOALA GIMNAZIALĂ NR.131",995,"Alegeri Prezidentiale",1,1378,838,585,21,232,830,8,1708,870,352,478
46,"MUNICIPIUL BUCUREŞTI - SECTOR 5","MUNICIPIUL BUCUREŞTI",179132,"BUCUREŞTI SECTORUL 5","ȘCOALA GIMNAZIALĂ NR.131",996,"Alegeri Prezidentiale",1,1846,924,736,32,156,902,22,1900,976,454,448
46,"MUNICIPIUL BUCUREŞTI - SECTOR 5","MUNICIPIUL BUCUREŞTI",179132,"BUCUREŞTI SECTORUL 5","ȘCOALA GIMNAZIALĂ NR.131",997,"Alegeri Prezidentiale",1,1507,981,676,63,242,957,24,1608,627,422,535
46,"MUNICIPIUL BUCUREŞTI - SECTOR 5","MUNICIPIUL BUCUREŞTI",179132,"BUCUREŞTI SECTORUL 5","ȘCOALA GIMNAZIALĂ NR.131",998,"Alegeri Prezidentiale",2,1830,1115,820,75,220,1097,18,2000,885,532,565
46,"MUNICIPIUL BUCUREŞTI - SECTOR 5","MUNICIPIUL BUCUREŞTI",179132,"BUCUREŞTI SECTORUL 5","ȘCOALA GIMNAZIALĂ NR.126",999,"Alegeri Prezidentiale",3,1754,982,947,35,0,969,13,1800,818,621,348
46,"MUNICIPIUL BUCUREŞTI - SECTOR 5","MUNICIPIUL BUCUREŞTI",179132,"BUCUREŞTI SECTORUL 5","ȘCOALA GIMNAZIALĂ NR.126",1000,"Alegeri Prezidentiale",1,1357,628,608,19,1,613,15,1400,772,334,279
46,"MUNICIPIUL BUCUREŞTI - SECTOR 5","MUNICIPIUL BUCUREŞTI",179132,"BUCUREŞTI SECTORUL 5","ȘCOALA GIMNAZIALĂ NR.126",1001,"Alegeri Prezidentiale",1,1295,621,599,22,0,608,13,1392,771,332,276
46,"MUNICIPIUL BUCUREŞTI - SECTOR 5","MUNICIPIUL BUCUREŞTI",179132,"BUCUREŞTI SECTORUL 5","ȘCOALA GIMNAZIALĂ NR.126",1002,"Alegeri Prezidentiale",1,1660,637,579,57,1,624,13,1800,1163,367,257
46,"MUNICIPIUL BUCUREŞTI - SECTOR 5","MUNICIPIUL BUCUREŞTI",179132,"BUCUREŞTI SECTORUL 5","ȘCOALA GIMNAZIALĂ NR.126",1003,"Alegeri Prezidentiale",1,1170,539,502,37,0,518,21,1300,761,306,212
46,"MUNICIPIUL BUCUREŞTI - SECTOR 5","MUNICIPIUL BUCUREŞTI",179132,"BUCUREŞTI SECTORUL 5","ȘCOALA GIMNAZIALĂ NR.126",1004,"Alegeri Prezidentiale",1,1088,578,500,78,0,563,15,1200,622,314,249
46,"MUNICIPIUL BUCUREŞTI - SECTOR 5","MUNICIPIUL BUCUREŞTI",179132,"BUCUREŞTI SECTORUL 5","ȘCOALA GIMNAZIALĂ NR.126",1005,"Alegeri Prezidentiale",1,1252,625,577,48,0,614,11,1300,675,382,232
46,"MUNICIPIUL BUCUREŞTI - SECTOR 5","MUNICIPIUL BUCUREŞTI",179132,"BUCUREŞTI SECTORUL 5","ȘCOALA GIMNAZIALĂ ”MIRCEA SÂNTIMBREANU”",1006,"Alegeri Prezidentiale",1,1005,567,503,64,0,547,20,1092,525,334,213
46,"MUNICIPIUL BUCUREŞTI - SECTOR 5","MUNICIPIUL BUCUREŞTI",179132,"BUCUREŞTI SECTORUL 5","ȘCOALA GIMNAZIALĂ ”MIRCEA SÂNTIMBREANU”",1007,"Alegeri Prezidentiale",1,980,554,484,70,0,537,17,1108,554,343,194
46,"MUNICIPIUL BUCUREŞTI - SECTOR 5","MUNICIPIUL BUCUREŞTI",179132,"BUCUREŞTI SECTORUL 5","ȘCOALA GIMNAZIALĂ ”MIRCEA SÂNTIMBREANU”",1008,"Alegeri Prezidentiale",1,905,546,514,32,0,534,12,1000,454,350,184
46,"MUNICIPIUL BUCUREŞTI - SECTOR 5","MUNICIPIUL BUCUREŞTI",179132,"BUCUREŞTI SECTORUL 5","ȘCOALA GIMNAZIALĂ ”MIRCEA SÂNTIMBREANU”",1009,"Alegeri Prezidentiale",1,988,588,561,26,1,578,10,1100,512,294,284
46,"MUNICIPIUL BUCUREŞTI - SECTOR 5","MUNICIPIUL BUCUREŞTI",179132,"BUCUREŞTI SECTORUL 5","ȘCOALA GIMNAZIALĂ ”MIRCEA SÂNTIMBREANU”",1010,"Alegeri Prezidentiale",1,990,484,466,15,3,476,8,1108,624,294,182
46,"MUNICIPIUL BUCUREŞTI - SECTOR 5","MUNICIPIUL BUCUREŞTI",179132,"BUCUREŞTI SECTORUL 5","GRĂDINIȚA NR.35",1011,"Alegeri Prezidentiale",3,1159,625,527,98,0,614,11,1300,675,373,241
46,"MUNICIPIUL BUCUREŞTI - SECTOR 5","MUNICIPIUL BUCUREŞTI",179132,"BUCUREŞTI SECTORUL 5","GRĂDINIȚA NR.35",1012,"Alegeri Prezidentiale",1,1166,617,569,48,0,596,21,1300,683,363,233
46,"MUNICIPIUL BUCUREŞTI - SECTOR 5","MUNICIPIUL BUCUREŞTI",179132,"BUCUREŞTI SECTORUL 5","GRĂDINIȚA NR.35",1013,"Alegeri Prezidentiale",1,958,503,445,58,0,488,15,1100,597,263,225
46,"MUNICIPIUL BUCUREŞTI - SECTOR 5","MUNICIPIUL BUCUREŞTI",179132,"BUCUREŞTI SECTORUL 5","GRĂDINIȚA NR.35",1014,"Alegeri Prezidentiale",1,1017,506,483,23,0,483,23,1100,594,265,218
46,"MUNICIPIUL BUCUREŞTI - SECTOR 5","MUNICIPIUL BUCUREŞTI",179132,"BUCUREŞTI SECTORUL 5","GRĂDINIȚA NR.35",1015,"Alegeri Prezidentiale",1,1091,580,538,42,0,571,9,1200,620,343,228
46,"MUNICIPIUL BUCUREŞTI - SECTOR 5","MUNICIPIUL BUCUREŞTI",179132,"BUCUREŞTI SECTORUL 5","GRĂDINIȚA NR.35",1016,"Alegeri Prezidentiale",1,1071,511,487,24,0,504,7,1200,689,295,209
46,"MUNICIPIUL BUCUREŞTI - SECTOR 5","MUNICIPIUL BUCUREŞTI",179132,"BUCUREŞTI SECTORUL 5","GRĂDINIȚA NR.35",1017,"Alegeri Prezidentiale",1,1152,548,523,25,0,534,14,1300,752,290,244
46,"MUNICIPIUL BUCUREŞTI - SECTOR 5","MUNICIPIUL BUCUREŞTI",179132,"BUCUREŞTI SECTORUL 5","GRĂDINIȚA ”FLOAREA-SOARELUI”",1018,"Alegeri Prezidentiale",1,1168,607,496,111,0,595,12,1400,793,347,248
46,"MUNICIPIUL BUCUREŞTI - SECTOR 5","MUNICIPIUL BUCUREŞTI",179132,"BUCUREŞTI SECTORUL 5","GRĂDINIȚA ”FLOAREA-SOARELUI”",1019,"Alegeri Prezidentiale",1,1080,524,422,102,0,514,10,1300,776,323,191
46,"MUNICIPIUL BUCUREŞTI - SECTOR 5","MUNICIPIUL BUCUREŞTI",179132,"BUCUREŞTI SECTORUL 5","ȘCOALA GIMNAZIALĂ NR.144",1020,"Alegeri Prezidentiale",1,1762,1001,894,107,0,977,24,1900,899,661,316
46,"MUNICIPIUL BUCUREŞTI - SECTOR 5","MUNICIPIUL BUCUREŞTI",179132,"BUCUREŞTI SECTORUL 5","ȘCOALA GIMNAZIALĂ NR.144",1021,"Alegeri Prezidentiale",1,1742,1015,855,160,0,983,32,1800,785,653,330
46,"MUNICIPIUL BUCUREŞTI - SECTOR 5","MUNICIPIUL BUCUREŞTI",179132,"BUCUREŞTI SECTORUL 5","ȘCOALA GIMNAZIALĂ NR.144",1022,"Alegeri Prezidentiale",1,1715,941,822,119,0,927,14,1792,851,625,302
46,"MUNICIPIUL BUCUREŞTI - SECTOR 5","MUNICIPIUL BUCUREŞTI",179132,"BUCUREŞTI SECTORUL 5","ȘCOALA GIMNAZIALĂ NR.143",1023,"Alegeri Prezidentiale",1,1067,557,524,33,0,543,14,1200,643,333,210
46,"MUNICIPIUL BUCUREŞTI - SECTOR 5","MUNICIPIUL BUCUREŞTI",179132,"BUCUREŞTI SECTORUL 5","ȘCOALA GIMNAZIALĂ NR.143",1024,"Alegeri Prezidentiale",1,1200,632,524,108,0,623,9,1300,668,353,270
46,"MUNICIPIUL BUCUREŞTI - SECTOR 5","MUNICIPIUL BUCUREŞTI",179132,"BUCUREŞTI SECTORUL 5","ȘCOALA GIMNAZIALĂ NR.143",1025,"Alegeri Prezidentiale",3,1121,595,487,108,0,583,12,1200,605,353,230
46,"MUNICIPIUL BUCUREŞTI - SECTOR 5","MUNICIPIUL BUCUREŞTI",179132,"BUCUREŞTI SECTORUL 5","ȘCOALA GIMNAZIALĂ NR.143",1026,"Alegeri Prezidentiale",2,1132,644,578,66,0,625,19,1200,556,374,251
46,"MUNICIPIUL BUCUREŞTI - SECTOR 5","MUNICIPIUL BUCUREŞTI",179132,"BUCUREŞTI SECTORUL 5","ȘCOALA GIMNAZIALĂ NR.143",1027,"Alegeri Prezidentiale",1,993,530,499,31,0,518,12,1100,570,311,207
46,"MUNICIPIUL BUCUREŞTI - SECTOR 5","MUNICIPIUL BUCUREŞTI",179132,"BUCUREŞTI SECTORUL 5","ȘCOALA GIMNAZIALĂ NR.143",1028,"Alegeri Prezidentiale",1,1288,607,572,35,0,581,26,1400,793,346,235
46,"MUNICIPIUL BUCUREŞTI - SECTOR 5","MUNICIPIUL BUCUREŞTI",179132,"BUCUREŞTI SECTORUL 5","ȘCOALA GIMNAZIALĂ NR.143",1029,"Alegeri Prezidentiale",1,1059,543,510,33,0,532,11,1200,657,300,232
46,"MUNICIPIUL BUCUREŞTI - SECTOR 5","MUNICIPIUL BUCUREŞTI",179132,"BUCUREŞTI SECTORUL 5","ȘCOALA GIMNAZIALĂ NR.143",1030,"Alegeri Prezidentiale",1,1078,498,473,25,0,488,10,1200,702,304,184
46,"MUNICIPIUL BUCUREŞTI - SECTOR 5","MUNICIPIUL BUCUREŞTI",179132,"BUCUREŞTI SECTORUL 5","ȘCOALA GIMNAZIALĂ NR.143",1031,"Alegeri Prezidentiale",1,1266,610,586,23,1,594,16,1300,690,375,219
46,"MUNICIPIUL BUCUREŞTI - SECTOR 5","MUNICIPIUL BUCUREŞTI",179132,"BUCUREŞTI SECTORUL 5","ȘCOALA GIMNAZIALĂ NR.143",1032,"Alegeri Prezidentiale",1,1112,514,489,24,1,501,13,1200,686,318,183
46,"MUNICIPIUL BUCUREŞTI - SECTOR 5","MUNICIPIUL BUCUREŞTI",179132,"BUCUREŞTI SECTORUL 5","ȘCOALA GIMNAZIALĂ NR.143",1033,"Alegeri Prezidentiale",1,1188,560,524,36,0,552,8,1308,748,324,228
46,"MUNICIPIUL BUCUREŞTI - SECTOR 5","MUNICIPIUL BUCUREŞTI",179132,"BUCUREŞTI SECTORUL 5","ȘCOALA GIMNAZIALĂ NR.143",1034,"Alegeri Prezidentiale",1,949,392,378,14,0,384,8,992,600,243,141
46,"MUNICIPIUL BUCUREŞTI - SECTOR 5","MUNICIPIUL BUCUREŞTI",179132,"BUCUREŞTI SECTORUL 5","ȘCOALA GIMNAZIALĂ NR.143",1035,"Alegeri Prezidentiale",2,1145,485,470,15,0,475,10,1200,715,272,203
46,"MUNICIPIUL BUCUREŞTI - SECTOR 5","MUNICIPIUL BUCUREŞTI",179132,"BUCUREŞTI SECTORUL 5","ȘCOALA GIMNAZIALĂ NR.143",1036,"Alegeri Prezidentiale",1,1012,493,473,20,0,485,8,1025,532,263,222
47,"MUNICIPIUL BUCUREŞTI - SECTOR 6","MUNICIPIUL BUCUREŞTI",179132,"BUCUREŞTI SECTORUL 6","SERVICIUL STARE CIVILĂ SECTOR 6",1037,"Alegeri Prezidentiale",2,1110,589,487,100,2,579,10,1200,611,394,185
47,"MUNICIPIUL BUCUREŞTI - SECTOR 6","MUNICIPIUL BUCUREŞTI",179132,"BUCUREŞTI SECTORUL 6","SERVICIUL STARE CIVILĂ SECTOR 6",1038,"Alegeri Prezidentiale",2,1224,849,641,208,0,833,16,1292,443,601,232
47,"MUNICIPIUL BUCUREŞTI - SECTOR 6","MUNICIPIUL BUCUREŞTI",179132,"BUCUREŞTI SECTORUL 6","ŞCOALA GIMNAZIALĂ NR.311",1039,"Alegeri Prezidentiale",1,1526,940,785,155,0,913,27,1600,660,602,311
47,"MUNICIPIUL BUCUREŞTI - SECTOR 6","MUNICIPIUL BUCUREŞTI",179132,"BUCUREŞTI SECTORUL 6","ŞCOALA GIMNAZIALĂ NR.311",1040,"Alegeri Prezidentiale",1,1376,765,678,87,0,735,30,1600,835,477,258
47,"MUNICIPIUL BUCUREŞTI - SECTOR 6","MUNICIPIUL BUCUREŞTI",179132,"BUCUREŞTI SECTORUL 6","ŞCOALA GIMNAZIALĂ NR.311",1041,"Alegeri Prezidentiale",2,1496,898,813,85,0,874,24,1600,702,565,309
47,"MUNICIPIUL BUCUREŞTI - SECTOR 6","MUNICIPIUL BUCUREŞTI",179132,"BUCUREŞTI SECTORUL 6","ŞCOALA GIMNAZIALĂ NR.311",1042,"Alegeri Prezidentiale",1,1503,839,800,39,0,816,23,1600,761,537,279
47,"MUNICIPIUL BUCUREŞTI - SECTOR 6","MUNICIPIUL BUCUREŞTI",179132,"BUCUREŞTI SECTORUL 6","ŞCOALA GIMNAZIALĂ NR.311",1043,"Alegeri Prezidentiale",2,1259,726,681,45,0,708,18,1300,574,471,237
47,"MUNICIPIUL BUCUREŞTI - SECTOR 6","MUNICIPIUL BUCUREŞTI",179132,"BUCUREŞTI SECTORUL 6","ŞCOALA GIMNAZIALĂ NR.311",1044,"Alegeri Prezidentiale",1,1160,707,655,52,0,690,17,1300,593,435,255
47,"MUNICIPIUL BUCUREŞTI - SECTOR 6","MUNICIPIUL BUCUREŞTI",179132,"BUCUREŞTI SECTORUL 6","ŞCOALA GIMNAZIALĂ NR.59",1045,"Alegeri Prezidentiale",1,930,672,484,188,0,649,23,1100,428,410,239
47,"MUNICIPIUL BUCUREŞTI - SECTOR 6","MUNICIPIUL BUCUREŞTI",179132,"BUCUREŞTI SECTORUL 6","ŞCOALA GIMNAZIALĂ NR.59",1046,"Alegeri Prezidentiale",1,1208,855,669,186,0,828,27,1300,445,546,282
47,"MUNICIPIUL BUCUREŞTI - SECTOR 6","MUNICIPIUL BUCUREŞTI",179132,"BUCUREŞTI SECTORUL 6","ŞCOALA GIMNAZIALĂ NR.59",1047,"Alegeri Prezidentiale",1,1226,662,599,62,1,647,15,1300,638,411,236
47,"MUNICIPIUL BUCUREŞTI - SECTOR 6","MUNICIPIUL BUCUREŞTI",179132,"BUCUREŞTI SECTORUL 6","ŞCOALA GIMNAZIALĂ NR.59",1048,"Alegeri Prezidentiale",1,1431,828,751,77,0,806,22,1600,772,556,250
47,"MUNICIPIUL BUCUREŞTI - SECTOR 6","MUNICIPIUL BUCUREŞTI",179132,"BUCUREŞTI SECTORUL 6","ŞCOALA GIMNAZIALĂ NR.59",1049,"Alegeri Prezidentiale",2,1172,672,630,41,1,652,20,1300,628,430,222
47,"MUNICIPIUL BUCUREŞTI - SECTOR 6","MUNICIPIUL BUCUREŞTI",179132,"BUCUREŞTI SECTORUL 6","ŞCOALA GIMNAZIALĂ NR.59",1050,"Alegeri Prezidentiale",1,1268,769,673,95,1,750,19,1400,631,501,249
47,"MUNICIPIUL BUCUREŞTI - SECTOR 6","MUNICIPIUL BUCUREŞTI",179132,"BUCUREŞTI SECTORUL 6","ŞCOALA GIMNAZIALĂ ”ADRIAN PĂUNESCU”",1051,"Alegeri Prezidentiale",2,1250,785,652,133,0,765,20,1300,515,497,268
47,"MUNICIPIUL BUCUREŞTI - SECTOR 6","MUNICIPIUL BUCUREŞTI",179132,"BUCUREŞTI SECTORUL 6","ŞCOALA GIMNAZIALĂ ”ADRIAN PĂUNESCU”",1052,"Alegeri Prezidentiale",1,1353,921,694,227,0,897,24,1400,479,618,279
47,"MUNICIPIUL BUCUREŞTI - SECTOR 6","MUNICIPIUL BUCUREŞTI",179132,"BUCUREŞTI SECTORUL 6","ŞCOALA GIMNAZIALĂ ”ADRIAN PĂUNESCU”",1053,"Alegeri Prezidentiale",1,813,450,331,119,0,442,8,1000,550,315,127
47,"MUNICIPIUL BUCUREŞTI - SECTOR 6","MUNICIPIUL BUCUREŞTI",179132,"BUCUREŞTI SECTORUL 6","ŞCOALA GIMNAZIALĂ ”ADRIAN PĂUNESCU”",1054,"Alegeri Prezidentiale",1,1328,704,654,50,0,687,17,1400,696,460,227
47,"MUNICIPIUL BUCUREŞTI - SECTOR 6","MUNICIPIUL BUCUREŞTI",179132,"BUCUREŞTI SECTORUL 6","ŞCOALA GIMNAZIALĂ ”ADRIAN PĂUNESCU”",1055,"Alegeri Prezidentiale",2,1332,762,715,46,1,746,16,1400,638,511,235
47,"MUNICIPIUL BUCUREŞTI - SECTOR 6","MUNICIPIUL BUCUREŞTI",179132,"BUCUREŞTI SECTORUL 6","ŞCOALA GIMNAZIALĂ ”ADRIAN PĂUNESCU”",1056,"Alegeri Prezidentiale",2,1227,650,592,58,0,632,18,1284,634,437,195
47,"MUNICIPIUL BUCUREŞTI - SECTOR 6","MUNICIPIUL BUCUREŞTI",179132,"BUCUREŞTI SECTORUL 6","ŞCOALA GIMNAZIALĂ NR.197",1057,"Alegeri Prezidentiale",1,1540,882,833,49,0,860,22,1600,718,579,281
47,"MUNICIPIUL BUCUREŞTI - SECTOR 6","MUNICIPIUL BUCUREŞTI",179132,"BUCUREŞTI SECTORUL 6","ŞCOALA GIMNAZIALĂ NR.197",1058,"Alegeri Prezidentiale",1,1039,679,572,107,0,660,19,1100,421,464,196
47,"MUNICIPIUL BUCUREŞTI - SECTOR 6","MUNICIPIUL BUCUREŞTI",179132,"BUCUREŞTI SECTORUL 6","ŞCOALA GIMNAZIALĂ NR.197",1059,"Alegeri Prezidentiale",2,967,683,506,176,1,672,11,1100,417,458,214
47,"MUNICIPIUL BUCUREŞTI - SECTOR 6","MUNICIPIUL BUCUREŞTI",179132,"BUCUREŞTI SECTORUL 6","ŞCOALA GIMNAZIALĂ NR.197",1060,"Alegeri Prezidentiale",1,1330,831,731,99,1,804,27,1400,569,547,257
47,"MUNICIPIUL BUCUREŞTI - SECTOR 6","MUNICIPIUL BUCUREŞTI",179132,"BUCUREŞTI SECTORUL 6","ŞCOALA GIMNAZIALĂ NR.197",1061,"Alegeri Prezidentiale",1,1109,644,587,57,0,632,12,1200,556,450,182
47,"MUNICIPIUL BUCUREŞTI - SECTOR 6","MUNICIPIUL BUCUREŞTI",179132,"BUCUREŞTI SECTORUL 6","ŞCOALA GIMNAZIALĂ NR.197",1062,"Alegeri Prezidentiale",1,1050,609,582,27,0,595,14,1100,491,353,242
47,"MUNICIPIUL BUCUREŞTI - SECTOR 6","MUNICIPIUL BUCUREŞTI",179132,"BUCUREŞTI SECTORUL 6","ŞCOALA GIMNAZIALĂ NR.197",1063,"Alegeri Prezidentiale",1,896,451,419,32,0,444,7,1000,549,299,145
47,"MUNICIPIUL BUCUREŞTI - SECTOR 6","MUNICIPIUL BUCUREŞTI",179132,"BUCUREŞTI SECTORUL 6","A.D.P.D.U. SECTOR 6",1064,"Alegeri Prezidentiale",1,1155,778,586,191,1,761,17,1200,422,471,290
47,"MUNICIPIUL BUCUREŞTI - SECTOR 6","MUNICIPIUL BUCUREŞTI",179132,"BUCUREŞTI SECTORUL 6","ŞCOALA GIMNAZIALĂ NR.193",1065,"Alegeri Prezidentiale",1,1068,889,598,290,1,863,26,1192,303,625,238
47,"MUNICIPIUL BUCUREŞTI - SECTOR 6","MUNICIPIUL BUCUREŞTI",179132,"BUCUREŞTI SECTORUL 6","ŞCOALA GIMNAZIALĂ NR.193",1066,"Alegeri Prezidentiale",1,1086,904,587,317,0,878,26,1200,296,623,255
47,"MUNICIPIUL BUCUREŞTI - SECTOR 6","MUNICIPIUL BUCUREŞTI",179132,"BUCUREŞTI SECTORUL 6","ŞCOALA GIMNAZIALĂ NR.193",1067,"Alegeri Prezidentiale",1,957,712,482,230,0,699,13,1000,288,481,218
47,"MUNICIPIUL BUCUREŞTI - SECTOR 6","MUNICIPIUL BUCUREŞTI",179132,"BUCUREŞTI SECTORUL 6","ŞCOALA GIMNAZIALĂ NR.193",1068,"Alegeri Prezidentiale",1,1182,914,617,296,1,885,29,1300,386,638,247
47,"MUNICIPIUL BUCUREŞTI - SECTOR 6","MUNICIPIUL BUCUREŞTI",179132,"BUCUREŞTI SECTORUL 6","COLEGIUL NAŢIONAL ”GRIGORE MOISIL”",1069,"Alegeri Prezidentiale",1,1248,985,636,349,0,961,24,1308,323,715,246
47,"MUNICIPIUL BUCUREŞTI - SECTOR 6","MUNICIPIUL BUCUREŞTI",179132,"BUCUREŞTI SECTORUL 6","COLEGIUL NAŢIONAL ”GRIGORE MOISIL”",1070,"Alegeri Prezidentiale",1,1559,1014,828,186,0,992,22,1600,586,691,301
47,"MUNICIPIUL BUCUREŞTI - SECTOR 6","MUNICIPIUL BUCUREŞTI",179132,"BUCUREŞTI SECTORUL 6","COLEGIUL NAŢIONAL ”GRIGORE MOISIL”",1071,"Alegeri Prezidentiale",2,1207,783,602,181,0,764,18,1291,508,520,244
47,"MUNICIPIUL BUCUREŞTI - SECTOR 6","MUNICIPIUL BUCUREŞTI",179132,"BUCUREŞTI SECTORUL 6","COLEGIUL NAŢIONAL ”GRIGORE MOISIL”",1072,"Alegeri Prezidentiale",2,1085,682,555,127,0,660,22,1092,410,465,195
47,"MUNICIPIUL BUCUREŞTI - SECTOR 6","MUNICIPIUL BUCUREŞTI",179132,"BUCUREŞTI SECTORUL 6","ŞCOALA GIMNAZIALĂ NR.164",1073,"Alegeri Prezidentiale",1,1023,670,495,173,2,655,15,1100,430,420,235
47,"MUNICIPIUL BUCUREŞTI - SECTOR 6","MUNICIPIUL BUCUREŞTI",179132,"BUCUREŞTI SECTORUL 6","ŞCOALA GIMNAZIALĂ NR.164",1074,"Alegeri Prezidentiale",1,1115,711,546,164,1,691,20,1200,489,417,274
47,"MUNICIPIUL BUCUREŞTI - SECTOR 6","MUNICIPIUL BUCUREŞTI",179132,"BUCUREŞTI SECTORUL 6","ŞCOALA GIMNAZIALĂ NR.164",1075,"Alegeri Prezidentiale",1,999,543,470,73,0,535,8,1108,565,362,173
47,"MUNICIPIUL BUCUREŞTI - SECTOR 6","MUNICIPIUL BUCUREŞTI",179132,"BUCUREŞTI SECTORUL 6","COLEGIUL TEHNIC ”GHEORGHE ASACHI”",1076,"Alegeri Prezidentiale",1,1363,820,678,142,0,802,18,1400,580,566,236
47,"MUNICIPIUL BUCUREŞTI - SECTOR 6","MUNICIPIUL BUCUREŞTI",179132,"BUCUREŞTI SECTORUL 6","COLEGIUL TEHNIC ”GHEORGHE ASACHI”",1077,"Alegeri Prezidentiale",2,1111,636,545,91,0,621,15,1200,564,434,187
47,"MUNICIPIUL BUCUREŞTI - SECTOR 6","MUNICIPIUL BUCUREŞTI",179132,"BUCUREŞTI SECTORUL 6","COLEGIUL TEHNIC ”GHEORGHE ASACHI”",1078,"Alegeri Prezidentiale",1,1100,679,578,88,13,661,18,1200,521,409,252
47,"MUNICIPIUL BUCUREŞTI - SECTOR 6","MUNICIPIUL BUCUREŞTI",179132,"BUCUREŞTI SECTORUL 6","COLEGIUL TEHNIC ”GHEORGHE ASACHI”",1079,"Alegeri Prezidentiale",1,1183,624,575,48,1,608,16,1300,676,387,221
47,"MUNICIPIUL BUCUREŞTI - SECTOR 6","MUNICIPIUL BUCUREŞTI",179132,"BUCUREŞTI SECTORUL 6","LICEUL TEHNOLOGIC ”ANTIM IVIREANU”",1080,"Alegeri Prezidentiale",1,1213,736,620,116,0,713,23,1300,564,465,248
47,"MUNICIPIUL BUCUREŞTI - SECTOR 6","MUNICIPIUL BUCUREŞTI",179132,"BUCUREŞTI SECTORUL 6","LICEUL TEHNOLOGIC ”ANTIM IVIREANU”",1081,"Alegeri Prezidentiale",1,1106,729,621,108,0,711,18,1200,471,515,196
47,"MUNICIPIUL BUCUREŞTI - SECTOR 6","MUNICIPIUL BUCUREŞTI",179132,"BUCUREŞTI SECTORUL 6","LICEUL TEHNOLOGIC ”ANTIM IVIREANU”",1082,"Alegeri Prezidentiale",1,1149,699,607,92,0,679,20,1200,501,462,217
47,"MUNICIPIUL BUCUREŞTI - SECTOR 6","MUNICIPIUL BUCUREŞTI",179132,"BUCUREŞTI SECTORUL 6","LICEUL TEHNOLOGIC ”ANTIM IVIREANU”",1083,"Alegeri Prezidentiale",2,1179,647,480,167,0,627,20,1200,553,410,217
47,"MUNICIPIUL BUCUREŞTI - SECTOR 6","MUNICIPIUL BUCUREŞTI",179132,"BUCUREŞTI SECTORUL 6","LICEUL TEHNOLOGIC ”ANTIM IVIREANU”",1084,"Alegeri Prezidentiale",1,1041,600,515,85,0,584,16,1100,500,382,202
47,"MUNICIPIUL BUCUREŞTI - SECTOR 6","MUNICIPIUL BUCUREŞTI",179132,"BUCUREŞTI SECTORUL 6","LICEUL TEHNOLOGIC ”ANTIM IVIREANU”",1085,"Alegeri Prezidentiale",1,1161,626,577,49,0,609,17,1208,582,388,221
47,"MUNICIPIUL BUCUREŞTI - SECTOR 6","MUNICIPIUL BUCUREŞTI",179132,"BUCUREŞTI SECTORUL 6","LICEUL TEHNOLOGIC ”ANTIM IVIREANU”",1086,"Alegeri Prezidentiale",2,1756,1034,944,88,2,1015,19,1800,766,761,254
47,"MUNICIPIUL BUCUREŞTI - SECTOR 6","MUNICIPIUL BUCUREŞTI",179132,"BUCUREŞTI SECTORUL 6","ŞCOALA GIMNAZIALĂ NR.169 CORPI",1087,"Alegeri Prezidentiale",1,1128,714,630,84,0,694,20,1200,486,481,213
47,"MUNICIPIUL BUCUREŞTI - SECTOR 6","MUNICIPIUL BUCUREŞTI",179132,"BUCUREŞTI SECTORUL 6","ŞCOALA GIMNAZIALĂ NR.169 CORPI",1088,"Alegeri Prezidentiale",1,1120,681,596,85,0,665,16,1200,519,393,272
47,"MUNICIPIUL BUCUREŞTI - SECTOR 6","MUNICIPIUL BUCUREŞTI",179132,"BUCUREŞTI SECTORUL 6","ŞCOALA GIMNAZIALĂ NR.169 CORPI",1089,"Alegeri Prezidentiale",1,1304,765,682,83,0,744,21,1400,635,538,206
47,"MUNICIPIUL BUCUREŞTI - SECTOR 6","MUNICIPIUL BUCUREŞTI",179132,"BUCUREŞTI SECTORUL 6","ŞCOALA GIMNAZIALĂ NR.169 CORPI",1090,"Alegeri Prezidentiale",1,1294,762,701,61,0,744,18,1400,638,487,257
47,"MUNICIPIUL BUCUREŞTI - SECTOR 6","MUNICIPIUL BUCUREŞTI",179132,"BUCUREŞTI SECTORUL 6","ŞCOALA GIMNAZIALĂ NR.169 CORPI",1091,"Alegeri Prezidentiale",1,1259,717,685,32,0,701,16,1300,583,454,247
47,"MUNICIPIUL BUCUREŞTI - SECTOR 6","MUNICIPIUL BUCUREŞTI",179132,"BUCUREŞTI SECTORUL 6","ŞCOALA GIMNAZIALĂ NR.169 CORPII",1092,"Alegeri Prezidentiale",1,1389,884,782,102,0,861,23,1600,716,556,305
47,"MUNICIPIUL BUCUREŞTI - SECTOR 6","MUNICIPIUL BUCUREŞTI",179132,"BUCUREŞTI SECTORUL 6","ŞCOALA GIMNAZIALĂ NR.169 CORPII",1093,"Alegeri Prezidentiale",1,1234,775,674,100,1,755,20,1300,525,506,249
47,"MUNICIPIUL BUCUREŞTI - SECTOR 6","MUNICIPIUL BUCUREŞTI",179132,"BUCUREŞTI SECTORUL 6","ŞCOALA GIMNAZIALĂ NR.169 CORPII",1094,"Alegeri Prezidentiale",1,1173,676,622,53,1,663,13,1200,524,464,199
47,"MUNICIPIUL BUCUREŞTI - SECTOR 6","MUNICIPIUL BUCUREŞTI",179132,"BUCUREŞTI SECTORUL 6","ŞCOALA GIMNAZIALĂ NR.169 CORPII",1095,"Alegeri Prezidentiale",1,1177,642,615,26,1,623,19,1200,558,405,218
47,"MUNICIPIUL BUCUREŞTI - SECTOR 6","MUNICIPIUL BUCUREŞTI",179132,"BUCUREŞTI SECTORUL 6","COLEGIUL NAŢIONAL ”ELENA CUZA”",1096,"Alegeri Prezidentiale",2,1202,759,652,107,0,740,19,1300,541,503,237
47,"MUNICIPIUL BUCUREŞTI - SECTOR 6","MUNICIPIUL BUCUREŞTI",179132,"BUCUREŞTI SECTORUL 6","COLEGIUL NAŢIONAL ”ELENA CUZA”",1097,"Alegeri Prezidentiale",2,1052,716,600,116,0,696,20,1100,384,468,228
47,"MUNICIPIUL BUCUREŞTI - SECTOR 6","MUNICIPIUL BUCUREŞTI",179132,"BUCUREŞTI SECTORUL 6","COLEGIUL NAŢIONAL ”ELENA CUZA”",1098,"Alegeri Prezidentiale",1,1134,641,565,76,0,630,11,1200,559,431,199
47,"MUNICIPIUL BUCUREŞTI - SECTOR 6","MUNICIPIUL BUCUREŞTI",179132,"BUCUREŞTI SECTORUL 6","COLEGIUL NAŢIONAL ”ELENA CUZA”",1099,"Alegeri Prezidentiale",2,944,550,464,86,0,539,11,1000,450,349,190
47,"MUNICIPIUL BUCUREŞTI - SECTOR 6","MUNICIPIUL BUCUREŞTI",179132,"BUCUREŞTI SECTORUL 6","LICEUL TEORETIC ”EUGEN LOVINESCU”",1100,"Alegeri Prezidentiale",1,1421,935,774,161,0,916,19,1600,665,595,321
47,"MUNICIPIUL BUCUREŞTI - SECTOR 6","MUNICIPIUL BUCUREŞTI",179132,"BUCUREŞTI SECTORUL 6","LICEUL TEORETIC ”EUGEN LOVINESCU”",1101,"Alegeri Prezidentiale",1,1283,851,704,146,1,826,25,1292,441,543,283
47,"MUNICIPIUL BUCUREŞTI - SECTOR 6","MUNICIPIUL BUCUREŞTI",179132,"BUCUREŞTI SECTORUL 6","LICEUL TEORETIC ”EUGEN LOVINESCU”",1102,"Alegeri Prezidentiale",1,1574,979,846,133,0,955,24,1600,621,673,282
47,"MUNICIPIUL BUCUREŞTI - SECTOR 6","MUNICIPIUL BUCUREŞTI",179132,"BUCUREŞTI SECTORUL 6","LICEUL TEORETIC ”EUGEN LOVINESCU”",1103,"Alegeri Prezidentiale",2,1484,826,757,68,1,816,10,1600,774,554,262
47,"MUNICIPIUL BUCUREŞTI - SECTOR 6","MUNICIPIUL BUCUREŞTI",179132,"BUCUREŞTI SECTORUL 6","LICEUL TEORETIC ”EUGEN LOVINESCU”",1104,"Alegeri Prezidentiale",1,1368,840,787,53,0,808,32,1400,560,522,286
47,"MUNICIPIUL BUCUREŞTI - SECTOR 6","MUNICIPIUL BUCUREŞTI",179132,"BUCUREŞTI SECTORUL 6","LICEUL TEORETIC ”EUGEN LOVINESCU”",1105,"Alegeri Prezidentiale",1,1219,647,611,36,0,635,12,1297,650,397,238
47,"MUNICIPIUL BUCUREŞTI - SECTOR 6","MUNICIPIUL BUCUREŞTI",179132,"BUCUREŞTI SECTORUL 6","LICEUL TEORETIC ”EUGEN LOVINESCU”",1106,"Alegeri Prezidentiale",1,1166,615,581,34,0,597,18,1200,585,394,203
47,"MUNICIPIUL BUCUREŞTI - SECTOR 6","MUNICIPIUL BUCUREŞTI",179132,"BUCUREŞTI SECTORUL 6","LICEUL TEORETIC ”EUGEN LOVINESCU”",1107,"Alegeri Prezidentiale",1,1219,718,637,81,0,699,19,1292,574,456,243
47,"MUNICIPIUL BUCUREŞTI - SECTOR 6","MUNICIPIUL BUCUREŞTI",179132,"BUCUREŞTI SECTORUL 6","LICEUL TEORETIC ”EUGEN LOVINESCU”",1108,"Alegeri Prezidentiale",1,850,445,416,29,0,433,12,900,455,288,145
47,"MUNICIPIUL BUCUREŞTI - SECTOR 6","MUNICIPIUL BUCUREŞTI",179132,"BUCUREŞTI SECTORUL 6","ŞCOALA GIMNAZIALĂ NR.279",1109,"Alegeri Prezidentiale",1,1490,751,711,40,0,733,18,1600,849,562,171
47,"MUNICIPIUL BUCUREŞTI - SECTOR 6","MUNICIPIUL BUCUREŞTI",179132,"BUCUREŞTI SECTORUL 6","ŞCOALA GIMNAZIALĂ NR.279",1110,"Alegeri Prezidentiale",2,1438,843,716,127,0,826,17,1600,757,568,258
47,"MUNICIPIUL BUCUREŞTI - SECTOR 6","MUNICIPIUL BUCUREŞTI",179132,"BUCUREŞTI SECTORUL 6","ŞCOALA GIMNAZIALĂ NR.279",1111,"Alegeri Prezidentiale",2,1514,871,742,129,0,847,24,1600,729,587,260
47,"MUNICIPIUL BUCUREŞTI - SECTOR 6","MUNICIPIUL BUCUREŞTI",179132,"BUCUREŞTI SECTORUL 6","ŞCOALA GIMNAZIALĂ NR.279",1112,"Alegeri Prezidentiale",1,1876,1095,935,160,0,1073,22,1900,805,770,303
47,"MUNICIPIUL BUCUREŞTI - SECTOR 6","MUNICIPIUL BUCUREŞTI",179132,"BUCUREŞTI SECTORUL 6","ŞCOALA GIMNAZIALĂ NR.279",1113,"Alegeri Prezidentiale",1,1554,864,775,89,0,845,19,1600,736,496,349
47,"MUNICIPIUL BUCUREŞTI - SECTOR 6","MUNICIPIUL BUCUREŞTI",179132,"BUCUREŞTI SECTORUL 6","ŞCOALA GIMNAZIALĂ NR.279",1114,"Alegeri Prezidentiale",2,1405,733,688,45,0,718,15,1600,867,472,246
47,"MUNICIPIUL BUCUREŞTI - SECTOR 6","MUNICIPIUL BUCUREŞTI",179132,"BUCUREŞTI SECTORUL 6","ŞCOALA GIMNAZIALĂ NR.279",1115,"Alegeri Prezidentiale",2,1985,1105,1047,58,0,1084,21,2000,895,850,234
47,"MUNICIPIUL BUCUREŞTI - SECTOR 6","MUNICIPIUL BUCUREŞTI",179132,"BUCUREŞTI SECTORUL 6","ŞCOALA GIMNAZIALĂ SPECIALĂ ”CONSTANTIN PĂUNESCU”",1116,"Alegeri Prezidentiale",1,1711,915,830,84,1,884,31,1800,885,577,307
47,"MUNICIPIUL BUCUREŞTI - SECTOR 6","MUNICIPIUL BUCUREŞTI",179132,"BUCUREŞTI SECTORUL 6","ŞCOALA GIMNAZIALĂ SPECIALĂ ”CONSTANTIN PĂUNESCU”",1117,"Alegeri Prezidentiale",3,1510,876,787,88,1,856,18,1600,724,571,285
47,"MUNICIPIUL BUCUREŞTI - SECTOR 6","MUNICIPIUL BUCUREŞTI",179132,"BUCUREŞTI SECTORUL 6","ŞCOALA GIMNAZIALĂ SPECIALĂ PENTRU DEFICIENŢI DE AUZ ”SF. MARIA”",1118,"Alegeri Prezidentiale",1,1266,803,676,127,0,790,13,1300,497,512,278
47,"MUNICIPIUL BUCUREŞTI - SECTOR 6","MUNICIPIUL BUCUREŞTI",179132,"BUCUREŞTI SECTORUL 6","ŞCOALA GIMNAZIALĂ SPECIALĂ PENTRU DEFICIENŢI DE AUZ ”SF. MARIA”",1119,"Alegeri Prezidentiale",2,1471,798,729,69,0,778,20,1600,802,521,257
47,"MUNICIPIUL BUCUREŞTI - SECTOR 6","MUNICIPIUL BUCUREŞTI",179132,"BUCUREŞTI SECTORUL 6","ŞCOALA GIMNAZIALĂ ”SF. ANDREI”",1120,"Alegeri Prezidentiale",1,1299,793,669,121,3,783,10,1400,607,546,237
47,"MUNICIPIUL BUCUREŞTI - SECTOR 6","MUNICIPIUL BUCUREŞTI",179132,"BUCUREŞTI SECTORUL 6","ŞCOALA GIMNAZIALĂ ”SF. ANDREI”",1121,"Alegeri Prezidentiale",1,1565,958,739,219,0,937,21,1600,642,622,315
47,"MUNICIPIUL BUCUREŞTI - SECTOR 6","MUNICIPIUL BUCUREŞTI",179132,"BUCUREŞTI SECTORUL 6","ŞCOALA GIMNAZIALĂ ”SF. ANDREI”",1122,"Alegeri Prezidentiale",1,1371,865,736,129,0,841,24,1400,535,567,274
47,"MUNICIPIUL BUCUREŞTI - SECTOR 6","MUNICIPIUL BUCUREŞTI",179132,"BUCUREŞTI SECTORUL 6","ŞCOALA GIMNAZIALĂ ”SF. ANDREI”",1123,"Alegeri Prezidentiale",1,1546,876,808,68,0,847,29,1592,716,530,317
47,"MUNICIPIUL BUCUREŞTI - SECTOR 6","MUNICIPIUL BUCUREŞTI",179132,"BUCUREŞTI SECTORUL 6","ŞCOALA GIMNAZIALĂ ”SF. ANDREI”",1124,"Alegeri Prezidentiale",1,1762,966,928,38,0,946,20,1800,834,662,284
47,"MUNICIPIUL BUCUREŞTI - SECTOR 6","MUNICIPIUL BUCUREŞTI",179132,"BUCUREŞTI SECTORUL 6","ŞCOALA GIMNAZIALĂ ”SF. ANDREI”",1125,"Alegeri Prezidentiale",2,1433,713,664,49,0,700,13,1600,887,472,228
47,"MUNICIPIUL BUCUREŞTI - SECTOR 6","MUNICIPIUL BUCUREŞTI",179132,"BUCUREŞTI SECTORUL 6","ŞCOALA GIMNAZIALĂ ”SF. ANDREI”",1126,"Alegeri Prezidentiale",1,1452,871,830,40,1,844,27,1600,729,592,252
47,"MUNICIPIUL BUCUREŞTI - SECTOR 6","MUNICIPIUL BUCUREŞTI",179132,"BUCUREŞTI SECTORUL 6","ŞCOALA GIMNAZIALĂ ”SF. ANDREI”",1127,"Alegeri Prezidentiale",1,1618,1015,853,160,2,1001,14,1700,685,701,300
47,"MUNICIPIUL BUCUREŞTI - SECTOR 6","MUNICIPIUL BUCUREŞTI",179132,"BUCUREŞTI SECTORUL 6","ŞCOALA GIMNAZIALĂ ”SF. ANDREI”",1128,"Alegeri Prezidentiale",2,1612,977,864,113,0,932,45,1700,723,658,274
47,"MUNICIPIUL BUCUREŞTI - SECTOR 6","MUNICIPIUL BUCUREŞTI",179132,"BUCUREŞTI SECTORUL 6","ŞCOALA GIMNAZIALĂ ”SF. ANDREI”",1129,"Alegeri Prezidentiale",1,1584,947,853,94,0,922,25,1600,653,722,200
47,"MUNICIPIUL BUCUREŞTI - SECTOR 6","MUNICIPIUL BUCUREŞTI",179132,"BUCUREŞTI SECTORUL 6","ŞCOALA GIMNAZIALĂ NR.206",1130,"Alegeri Prezidentiale",1,1332,746,687,58,1,721,25,1400,654,449,272
47,"MUNICIPIUL BUCUREŞTI - SECTOR 6","MUNICIPIUL BUCUREŞTI",179132,"BUCUREŞTI SECTORUL 6","ŞCOALA GIMNAZIALĂ NR.206",1131,"Alegeri Prezidentiale",1,1390,748,657,91,0,733,15,1400,652,468,265
47,"MUNICIPIUL BUCUREŞTI - SECTOR 6","MUNICIPIUL BUCUREŞTI",179132,"BUCUREŞTI SECTORUL 6","ŞCOALA GIMNAZIALĂ NR.206",1132,"Alegeri Prezidentiale",1,1438,763,649,114,0,738,25,1600,837,524,214
47,"MUNICIPIUL BUCUREŞTI - SECTOR 6","MUNICIPIUL BUCUREŞTI",179132,"BUCUREŞTI SECTORUL 6","ŞCOALA GIMNAZIALĂ NR.206",1133,"Alegeri Prezidentiale",2,1296,821,720,101,0,801,20,1408,587,530,271
47,"MUNICIPIUL BUCUREŞTI - SECTOR 6","MUNICIPIUL BUCUREŞTI",179132,"BUCUREŞTI SECTORUL 6","ŞCOALA GIMNAZIALĂ NR.206",1134,"Alegeri Prezidentiale",1,1448,804,722,79,3,785,19,1600,796,540,245
47,"MUNICIPIUL BUCUREŞTI - SECTOR 6","MUNICIPIUL BUCUREŞTI",179132,"BUCUREŞTI SECTORUL 6","ŞCOALA GIMNAZIALĂ NR.206",1135,"Alegeri Prezidentiale",1,1498,796,751,43,2,781,15,1592,796,489,292
47,"MUNICIPIUL BUCUREŞTI - SECTOR 6","MUNICIPIUL BUCUREŞTI",179132,"BUCUREŞTI SECTORUL 6","ŞCOALA GIMNAZIALĂ ”SF. CONSTANTIN ŞI ELENA”",1136,"Alegeri Prezidentiale",1,1214,720,588,132,0,698,22,1300,580,468,230
47,"MUNICIPIUL BUCUREŞTI - SECTOR 6","MUNICIPIUL BUCUREŞTI",179132,"BUCUREŞTI SECTORUL 6","ŞCOALA GIMNAZIALĂ ”SF. CONSTANTIN ŞI ELENA”",1137,"Alegeri Prezidentiale",2,1500,968,719,249,0,949,19,1600,632,646,303
47,"MUNICIPIUL BUCUREŞTI - SECTOR 6","MUNICIPIUL BUCUREŞTI",179132,"BUCUREŞTI SECTORUL 6","ŞCOALA GIMNAZIALĂ ”SF. CONSTANTIN ŞI ELENA”",1138,"Alegeri Prezidentiale",1,1145,693,598,95,0,671,22,1200,507,435,236
47,"MUNICIPIUL BUCUREŞTI - SECTOR 6","MUNICIPIUL BUCUREŞTI",179132,"BUCUREŞTI SECTORUL 6","ŞCOALA GIMNAZIALĂ ”SF. CONSTANTIN ŞI ELENA”",1139,"Alegeri Prezidentiale",1,1298,760,686,72,2,748,12,1392,632,499,249
47,"MUNICIPIUL BUCUREŞTI - SECTOR 6","MUNICIPIUL BUCUREŞTI",179132,"BUCUREŞTI SECTORUL 6","ŞCOALA GIMNAZIALĂ ”SF. CONSTANTIN ŞI ELENA”",1140,"Alegeri Prezidentiale",1,1494,836,776,60,0,811,25,1600,764,557,254
47,"MUNICIPIUL BUCUREŞTI - SECTOR 6","MUNICIPIUL BUCUREŞTI",179132,"BUCUREŞTI SECTORUL 6","ŞCOALA GIMNAZIALĂ ”SF. CONSTANTIN ŞI ELENA”",1141,"Alegeri Prezidentiale",1,1004,464,422,42,0,458,6,1100,636,317,141
47,"MUNICIPIUL BUCUREŞTI - SECTOR 6","MUNICIPIUL BUCUREŞTI",179132,"BUCUREŞTI SECTORUL 6","SCOALA GIMNAZIALA SFINTII CONSTANTIN SI ELENA",1142,"Alegeri Prezidentiale",1,1739,860,789,70,1,841,19,1800,940,566,275
47,"MUNICIPIUL BUCUREŞTI - SECTOR 6","MUNICIPIUL BUCUREŞTI",179132,"BUCUREŞTI SECTORUL 6","SCOALA GIMNAZIALA SFINTII CONSTANTIN SI ELENA",1143,"Alegeri Prezidentiale",2,1736,741,683,58,0,718,23,1800,1059,505,213
47,"MUNICIPIUL BUCUREŞTI - SECTOR 6","MUNICIPIUL BUCUREŞTI",179132,"BUCUREŞTI SECTORUL 6","ŞCOALA GIMNAZIALĂ NR.309",1144,"Alegeri Prezidentiale",1,1541,1021,799,222,0,1006,15,1600,579,677,329
47,"MUNICIPIUL BUCUREŞTI - SECTOR 6","MUNICIPIUL BUCUREŞTI",179132,"BUCUREŞTI SECTORUL 6","ŞCOALA GIMNAZIALĂ NR.309",1145,"Alegeri Prezidentiale",2,1521,948,758,190,0,929,19,1600,652,642,287
47,"MUNICIPIUL BUCUREŞTI - SECTOR 6","MUNICIPIUL BUCUREŞTI",179132,"BUCUREŞTI SECTORUL 6","ŞCOALA GIMNAZIALĂ NR.309",1146,"Alegeri Prezidentiale",1,1455,880,689,190,1,857,23,1600,720,557,300
47,"MUNICIPIUL BUCUREŞTI - SECTOR 6","MUNICIPIUL BUCUREŞTI",179132,"BUCUREŞTI SECTORUL 6","ŞCOALA GIMNAZIALĂ NR.309",1147,"Alegeri Prezidentiale",2,1612,1173,751,422,0,1149,24,1700,527,800,349
47,"MUNICIPIUL BUCUREŞTI - SECTOR 6","MUNICIPIUL BUCUREŞTI",179132,"BUCUREŞTI SECTORUL 6","ŞCOALA GIMNAZIALĂ NR.309",1148,"Alegeri Prezidentiale",1,1303,944,654,290,0,915,29,1400,456,648,267
47,"MUNICIPIUL BUCUREŞTI - SECTOR 6","MUNICIPIUL BUCUREŞTI",179132,"BUCUREŞTI SECTORUL 6","ŞCOALA GIMNAZIALĂ NR.309",1149,"Alegeri Prezidentiale",1,1671,1053,821,231,1,1027,26,1700,647,731,296
47,"MUNICIPIUL BUCUREŞTI - SECTOR 6","MUNICIPIUL BUCUREŞTI",179132,"BUCUREŞTI SECTORUL 6","ŞCOALA GIMNAZIALĂ ”ION DUMITRIU”",1150,"Alegeri Prezidentiale",1,1256,718,609,108,1,700,18,1300,582,471,229
47,"MUNICIPIUL BUCUREŞTI - SECTOR 6","MUNICIPIUL BUCUREŞTI",179132,"BUCUREŞTI SECTORUL 6","ŞCOALA GIMNAZIALĂ ”ION DUMITRIU”",1151,"Alegeri Prezidentiale",1,1527,893,773,120,0,869,24,1600,707,584,285
47,"MUNICIPIUL BUCUREŞTI - SECTOR 6","MUNICIPIUL BUCUREŞTI",179132,"BUCUREŞTI SECTORUL 6","ŞCOALA GIMNAZIALĂ ”ION DUMITRIU”",1152,"Alegeri Prezidentiale",1,1230,759,599,160,0,742,17,1300,541,492,250
47,"MUNICIPIUL BUCUREŞTI - SECTOR 6","MUNICIPIUL BUCUREŞTI",179132,"BUCUREŞTI SECTORUL 6","ŞCOALA GIMNAZIALĂ ”ION DUMITRIU”",1153,"Alegeri Prezidentiale",1,1699,912,794,118,0,887,25,1800,888,590,297
47,"MUNICIPIUL BUCUREŞTI - SECTOR 6","MUNICIPIUL BUCUREŞTI",179132,"BUCUREŞTI SECTORUL 6","ŞCOALA GIMNAZIALĂ ”ION DUMITRIU”",1154,"Alegeri Prezidentiale",1,1352,754,664,90,0,741,13,1400,646,468,273
47,"MUNICIPIUL BUCUREŞTI - SECTOR 6","MUNICIPIUL BUCUREŞTI",179132,"BUCUREŞTI SECTORUL 6","ŞCOALA GIMNAZIALĂ ”ION DUMITRIU”",1155,"Alegeri Prezidentiale",2,1584,816,710,106,0,792,24,1592,776,513,279
47,"MUNICIPIUL BUCUREŞTI - SECTOR 6","MUNICIPIUL BUCUREŞTI",179132,"BUCUREŞTI SECTORUL 6","ŞCOALA GIMNAZIALĂ ”ION DUMITRIU”",1156,"Alegeri Prezidentiale",2,1296,649,591,58,0,632,17,1400,751,436,196
47,"MUNICIPIUL BUCUREŞTI - SECTOR 6","MUNICIPIUL BUCUREŞTI",179132,"BUCUREŞTI SECTORUL 6","ŞCOALA GIMNAZIALĂ ”ION DUMITRIU”",1157,"Alegeri Prezidentiale",3,1474,769,728,41,0,751,18,1600,831,499,252
47,"MUNICIPIUL BUCUREŞTI - SECTOR 6","MUNICIPIUL BUCUREŞTI",179132,"BUCUREŞTI SECTORUL 6","ŞCOALA GIMNAZIALĂ ”ION DUMITRIU”",1158,"Alegeri Prezidentiale",1,1620,833,778,55,0,810,23,1700,867,529,281
47,"MUNICIPIUL BUCUREŞTI - SECTOR 6","MUNICIPIUL BUCUREŞTI",179132,"BUCUREŞTI SECTORUL 6","ŞCOALA GIMNAZIALĂ ”ION DUMITRIU”",1159,"Alegeri Prezidentiale",1,1619,694,660,34,0,672,22,1700,1006,455,217
47,"MUNICIPIUL BUCUREŞTI - SECTOR 6","MUNICIPIUL BUCUREŞTI",179132,"BUCUREŞTI SECTORUL 6","CENTRUL EUROPEAN SECTOR 6",1160,"Alegeri Prezidentiale",2,1380,1139,672,467,0,1108,31,1600,461,777,331
47,"MUNICIPIUL BUCUREŞTI - SECTOR 6","MUNICIPIUL BUCUREŞTI",179132,"BUCUREŞTI SECTORUL 6","LICEUL TEHNOLOGIC ”PETRU PONI”",1161,"Alegeri Prezidentiale",2,1430,1240,804,436,0,1207,33,1800,560,996,211
47,"MUNICIPIUL BUCUREŞTI - SECTOR 6","MUNICIPIUL BUCUREŞTI",179132,"BUCUREŞTI SECTORUL 6","LICEUL TEHNOLOGIC ”PETRU PONI”",1162,"Alegeri Prezidentiale",1,1647,1105,691,414,0,1086,19,1800,695,842,244
47,"MUNICIPIUL BUCUREŞTI - SECTOR 6","MUNICIPIUL BUCUREŞTI",179132,"BUCUREŞTI SECTORUL 6","LICEUL TEHNOLOGIC ”PETRU PONI”",1163,"Alegeri Prezidentiale",2,1594,975,667,308,0,957,18,1805,830,766,191
47,"MUNICIPIUL BUCUREŞTI - SECTOR 6","MUNICIPIUL BUCUREŞTI",179132,"BUCUREŞTI SECTORUL 6","ŞCOALA GIMNAZIALĂ 198 REGINA MARIA",1164,"Alegeri Prezidentiale",1,1784,1067,817,250,0,1042,25,1800,733,751,291
47,"MUNICIPIUL BUCUREŞTI - SECTOR 6","MUNICIPIUL BUCUREŞTI",179132,"BUCUREŞTI SECTORUL 6","ŞCOALA GIMNAZIALĂ 198 REGINA MARIA",1165,"Alegeri Prezidentiale",2,1737,1049,859,190,0,1023,26,1800,751,710,313
47,"MUNICIPIUL BUCUREŞTI - SECTOR 6","MUNICIPIUL BUCUREŞTI",179132,"BUCUREŞTI SECTORUL 6","ŞCOALA GIMNAZIALĂ 198 REGINA MARIA",1166,"Alegeri Prezidentiale",2,1684,1049,810,239,0,1026,23,1800,751,711,315
47,"MUNICIPIUL BUCUREŞTI - SECTOR 6","MUNICIPIUL BUCUREŞTI",179132,"BUCUREŞTI SECTORUL 6","ŞCOALA GIMNAZIALĂ 198 REGINA MARIA",1167,"Alegeri Prezidentiale",2,1861,1112,870,238,4,1078,34,1900,788,769,309
47,"MUNICIPIUL BUCUREŞTI - SECTOR 6","MUNICIPIUL BUCUREŞTI",179132,"BUCUREŞTI SECTORUL 6","ŞCOALA GIMNAZIALĂ CONSTANTIN BRANCUSI",1168,"Alegeri Prezidentiale",1,1551,769,686,83,0,755,14,1600,831,514,241
47,"MUNICIPIUL BUCUREŞTI - SECTOR 6","MUNICIPIUL BUCUREŞTI",179132,"BUCUREŞTI SECTORUL 6","ŞCOALA GIMNAZIALĂ CONSTANTIN BRANCUSI",1169,"Alegeri Prezidentiale",1,1747,837,755,77,5,822,15,1800,963,595,227
47,"MUNICIPIUL BUCUREŞTI - SECTOR 6","MUNICIPIUL BUCUREŞTI",179132,"BUCUREŞTI SECTORUL 6","ŞCOALA GIMNAZIALĂ CONSTANTIN BRANCUSI",1170,"Alegeri Prezidentiale",1,1594,863,758,105,0,837,26,1700,837,592,245
47,"MUNICIPIUL BUCUREŞTI - SECTOR 6","MUNICIPIUL BUCUREŞTI",179132,"BUCUREŞTI SECTORUL 6","ŞCOALA GIMNAZIALĂ NR.198",1171,"Alegeri Prezidentiale",2,1811,962,885,77,0,948,14,1900,938,660,288
47,"MUNICIPIUL BUCUREŞTI - SECTOR 6","MUNICIPIUL BUCUREŞTI",179132,"BUCUREŞTI SECTORUL 6","ŞCOALA GIMNAZIALĂ NR.198",1172,"Alegeri Prezidentiale",1,1728,851,802,48,1,828,23,1800,949,541,287
47,"MUNICIPIUL BUCUREŞTI - SECTOR 6","MUNICIPIUL BUCUREŞTI",179132,"BUCUREŞTI SECTORUL 6","ŞCOALA GIMNAZIALĂ NR.198",1173,"Alegeri Prezidentiale",1,1460,835,699,135,1,817,17,1607,772,527,290
47,"MUNICIPIUL BUCUREŞTI - SECTOR 6","MUNICIPIUL BUCUREŞTI",179132,"BUCUREŞTI SECTORUL 6","ŞCOALA GIMNAZIALĂ NR.198",1174,"Alegeri Prezidentiale",3,1454,913,747,166,0,889,24,1600,687,621,268
47,"MUNICIPIUL BUCUREŞTI - SECTOR 6","MUNICIPIUL BUCUREŞTI",179132,"BUCUREŞTI SECTORUL 6","ŞCOALA GIMNAZIALĂ NR.198",1175,"Alegeri Prezidentiale",1,1717,845,805,40,0,833,12,1800,955,542,291
47,"MUNICIPIUL BUCUREŞTI - SECTOR 6","MUNICIPIUL BUCUREŞTI",179132,"BUCUREŞTI SECTORUL 6","ŞCOALA GIMNAZIALĂ NR.198",1176,"Alegeri Prezidentiale",1,1582,802,761,39,2,782,20,1600,798,511,271
47,"MUNICIPIUL BUCUREŞTI - SECTOR 6","MUNICIPIUL BUCUREŞTI",179132,"BUCUREŞTI SECTORUL 6","ŞCOALA GIMNAZIALĂ ”CONSTANTIN BRÂNCUŞI”",1177,"Alegeri Prezidentiale",1,1393,749,638,111,0,727,22,1600,851,499,228
47,"MUNICIPIUL BUCUREŞTI - SECTOR 6","MUNICIPIUL BUCUREŞTI",179132,"BUCUREŞTI SECTORUL 6","ŞCOALA GIMNAZIALĂ ”CONSTANTIN BRÂNCUŞI”",1178,"Alegeri Prezidentiale",1,1353,1053,697,356,0,1024,29,1600,547,763,261
47,"MUNICIPIUL BUCUREŞTI - SECTOR 6","MUNICIPIUL BUCUREŞTI",179132,"BUCUREŞTI SECTORUL 6","ŞCOALA GIMNAZIALĂ ”CONSTANTIN BRÂNCUŞI”",1179,"Alegeri Prezidentiale",1,1406,1004,704,276,24,983,21,1600,596,664,319
47,"MUNICIPIUL BUCUREŞTI - SECTOR 6","MUNICIPIUL BUCUREŞTI",179132,"BUCUREŞTI SECTORUL 6","ŞCOALA GIMNAZIALĂ ”CONSTANTIN BRÂNCUŞI”",1180,"Alegeri Prezidentiale",2,1185,732,585,144,3,719,13,1200,468,481,238
47,"MUNICIPIUL BUCUREŞTI - SECTOR 6","MUNICIPIUL BUCUREŞTI",179132,"BUCUREŞTI SECTORUL 6","ŞCOALA GIMNAZIALĂ ”CONSTANTIN BRÂNCUŞI”",1181,"Alegeri Prezidentiale",2,1518,838,809,29,0,817,21,1600,762,541,276
47,"MUNICIPIUL BUCUREŞTI - SECTOR 6","MUNICIPIUL BUCUREŞTI",179132,"BUCUREŞTI SECTORUL 6","ŞCOALA GIMNAZIALĂ ”CONSTANTIN BRÂNCUŞI”",1182,"Alegeri Prezidentiale",2,905,533,466,65,2,520,13,1000,467,337,183
47,"MUNICIPIUL BUCUREŞTI - SECTOR 6","MUNICIPIUL BUCUREŞTI",179132,"BUCUREŞTI SECTORUL 6","ŞCOALA GIMNAZIALĂ ”CONSTANTIN BRÂNCUŞI”",1183,"Alegeri Prezidentiale",1,976,551,520,30,1,532,19,1000,449,324,208
47,"MUNICIPIUL BUCUREŞTI - SECTOR 6","MUNICIPIUL BUCUREŞTI",179132,"BUCUREŞTI SECTORUL 6","ŞCOALA GIMNAZIALĂ ”REGELE MIHAI I”",1184,"Alegeri Prezidentiale",1,1425,827,737,90,0,807,20,1600,773,532,275
47,"MUNICIPIUL BUCUREŞTI - SECTOR 6","MUNICIPIUL BUCUREŞTI",179132,"BUCUREŞTI SECTORUL 6","ŞCOALA GIMNAZIALĂ ”REGELE MIHAI I”",1185,"Alegeri Prezidentiale",2,1272,791,616,174,1,769,22,1300,509,529,240
47,"MUNICIPIUL BUCUREŞTI - SECTOR 6","MUNICIPIUL BUCUREŞTI",179132,"BUCUREŞTI SECTORUL 6","ŞCOALA GIMNAZIALĂ ”REGELE MIHAI I”",1186,"Alegeri Prezidentiale",1,780,551,410,141,0,536,15,900,349,380,156
47,"MUNICIPIUL BUCUREŞTI - SECTOR 6","MUNICIPIUL BUCUREŞTI",179132,"BUCUREŞTI SECTORUL 6","ŞCOALA GIMNAZIALĂ ”REGELE MIHAI I”",1187,"Alegeri Prezidentiale",1,1026,599,519,80,0,593,6,1100,501,388,205
47,"MUNICIPIUL BUCUREŞTI - SECTOR 6","MUNICIPIUL BUCUREŞTI",179132,"BUCUREŞTI SECTORUL 6","ŞCOALA GIMNAZIALĂ NR.156",1188,"Alegeri Prezidentiale",1,1636,1233,825,408,0,1206,27,1700,467,863,343
47,"MUNICIPIUL BUCUREŞTI - SECTOR 6","MUNICIPIUL BUCUREŞTI",179132,"BUCUREŞTI SECTORUL 6","ŞCOALA GIMNAZIALĂ NR.156",1189,"Alegeri Prezidentiale",2,1781,1027,941,86,0,993,34,1900,873,705,288
47,"MUNICIPIUL BUCUREŞTI - SECTOR 6","MUNICIPIUL BUCUREŞTI",179132,"BUCUREŞTI SECTORUL 6","ŞCOALA GIMNAZIALĂ NR.156",1190,"Alegeri Prezidentiale",1,1595,970,821,149,0,946,24,1700,730,647,299
47,"MUNICIPIUL BUCUREŞTI - SECTOR 6","MUNICIPIUL BUCUREŞTI",179132,"BUCUREŞTI SECTORUL 6","ŞCOALA GIMNAZIALĂ NR.156",1191,"Alegeri Prezidentiale",1,1393,992,688,304,0,970,22,1600,608,698,272
47,"MUNICIPIUL BUCUREŞTI - SECTOR 6","MUNICIPIUL BUCUREŞTI",179132,"BUCUREŞTI SECTORUL 6","ŞCOALA GIMNAZIALĂ NR.156",1192,"Alegeri Prezidentiale",1,1509,971,747,224,0,955,16,1600,629,717,238
47,"MUNICIPIUL BUCUREŞTI - SECTOR 6","MUNICIPIUL BUCUREŞTI",179132,"BUCUREŞTI SECTORUL 6","ŞCOALA GIMNAZIALĂ NR.156",1193,"Alegeri Prezidentiale",1,1364,892,705,186,1,871,21,1400,508,595,276
47,"MUNICIPIUL BUCUREŞTI - SECTOR 6","MUNICIPIUL BUCUREŞTI",179132,"BUCUREŞTI SECTORUL 6","ŞCOALA GIMNAZIALĂ NR.156",1194,"Alegeri Prezidentiale",1,1841,961,883,78,0,943,18,1900,939,671,272
47,"MUNICIPIUL BUCUREŞTI - SECTOR 6","MUNICIPIUL BUCUREŞTI",179132,"BUCUREŞTI SECTORUL 6","ŞCOALA GIMNAZIALĂ NR.156",1195,"Alegeri Prezidentiale",2,1476,741,690,50,1,722,19,1600,859,506,216
47,"MUNICIPIUL BUCUREŞTI - SECTOR 6","MUNICIPIUL BUCUREŞTI",179132,"BUCUREŞTI SECTORUL 6","ŞCOALA GIMNAZIALĂ NR.156",1196,"Alegeri Prezidentiale",1,1479,771,709,62,0,755,16,1600,829,521,234
47,"MUNICIPIUL BUCUREŞTI - SECTOR 6","MUNICIPIUL BUCUREŞTI",179132,"BUCUREŞTI SECTORUL 6","ŞCOALA GIMNAZIALĂ NR.156",1197,"Alegeri Prezidentiale",2,1801,966,866,99,1,952,14,1900,934,707,245
47,"MUNICIPIUL BUCUREŞTI - SECTOR 6","MUNICIPIUL BUCUREŞTI",179132,"BUCUREŞTI SECTORUL 6","LICEUL TEHNOLOGIC ”COSTIN C. KIRIŢESCU”",1198,"Alegeri Prezidentiale",2,1192,637,571,66,0,626,11,1300,663,400,226
47,"MUNICIPIUL BUCUREŞTI - SECTOR 6","MUNICIPIUL BUCUREŞTI",179132,"BUCUREŞTI SECTORUL 6","LICEUL TEHNOLOGIC ”COSTIN C. KIRIŢESCU”",1199,"Alegeri Prezidentiale",1,1450,898,744,152,2,884,14,1500,602,660,224
47,"MUNICIPIUL BUCUREŞTI - SECTOR 6","MUNICIPIUL BUCUREŞTI",179132,"BUCUREŞTI SECTORUL 6","LICEUL TEHNOLOGIC ”COSTIN C. KIRIŢESCU”",1200,"Alegeri Prezidentiale",1,1292,945,644,300,1,915,30,1400,455,640,275
47,"MUNICIPIUL BUCUREŞTI - SECTOR 6","MUNICIPIUL BUCUREŞTI",179132,"BUCUREŞTI SECTORUL 6","LICEUL TEHNOLOGIC ”COSTIN C. KIRIŢESCU”",1201,"Alegeri Prezidentiale",1,1353,866,630,236,0,851,15,1400,534,577,274
47,"MUNICIPIUL BUCUREŞTI - SECTOR 6","MUNICIPIUL BUCUREŞTI",179132,"BUCUREŞTI SECTORUL 6","LICEUL TEHNOLOGIC ”COSTIN C. KIRIŢESCU”",1202,"Alegeri Prezidentiale",2,1442,743,657,86,0,718,25,1600,857,486,232
47,"MUNICIPIUL BUCUREŞTI - SECTOR 6","MUNICIPIUL BUCUREŞTI",179132,"BUCUREŞTI SECTORUL 6","LICEUL TEHNOLOGIC ”COSTIN C. KIRIŢESCU”",1203,"Alegeri Prezidentiale",1,1052,573,519,54,0,559,14,1100,527,345,214
47,"MUNICIPIUL BUCUREŞTI - SECTOR 6","MUNICIPIUL BUCUREŞTI",179132,"BUCUREŞTI SECTORUL 6","LICEUL TEHNOLOGIC ”COSTIN C. KIRIŢESCU”",1204,"Alegeri Prezidentiale",1,1201,724,657,66,1,708,16,1300,576,461,247
47,"MUNICIPIUL BUCUREŞTI - SECTOR 6","MUNICIPIUL BUCUREŞTI",179132,"BUCUREŞTI SECTORUL 6","LICEUL TEHNOLOGIC ”COSTIN C. KIRIŢESCU”",1205,"Alegeri Prezidentiale",2,1115,681,568,113,0,662,19,1200,519,436,226
47,"MUNICIPIUL BUCUREŞTI - SECTOR 6","MUNICIPIUL BUCUREŞTI",179132,"BUCUREŞTI SECTORUL 6","LICEUL TEHNOLOGIC ”COSTIN C. KIRIŢESCU”",1206,"Alegeri Prezidentiale",1,1651,878,806,72,0,853,25,1700,822,577,276
47,"MUNICIPIUL BUCUREŞTI - SECTOR 6","MUNICIPIUL BUCUREŞTI",179132,"BUCUREŞTI SECTORUL 6","LICEUL TEHNOLOGIC ”COSTIN C. KIRIŢESCU”",1207,"Alegeri Prezidentiale",1,1794,996,947,49,0,973,23,1900,904,655,318
47,"MUNICIPIUL BUCUREŞTI - SECTOR 6","MUNICIPIUL BUCUREŞTI",179132,"BUCUREŞTI SECTORUL 6","LICEUL TEHNOLOGIC ”COSTIN C. KIRIŢESCU”",1208,"Alegeri Prezidentiale",1,1824,940,896,44,0,919,21,1900,960,597,322
47,"MUNICIPIUL BUCUREŞTI - SECTOR 6","MUNICIPIUL BUCUREŞTI",179132,"BUCUREŞTI SECTORUL 6","ŞCOALA GIMNAZIALĂ NR.142",1209,"Alegeri Prezidentiale",3,1178,568,503,65,0,557,11,1300,732,362,195
47,"MUNICIPIUL BUCUREŞTI - SECTOR 6","MUNICIPIUL BUCUREŞTI",179132,"BUCUREŞTI SECTORUL 6","ŞCOALA GIMNAZIALĂ NR.142",1210,"Alegeri Prezidentiale",1,1377,766,686,79,1,746,20,1600,834,475,271
47,"MUNICIPIUL BUCUREŞTI - SECTOR 6","MUNICIPIUL BUCUREŞTI",179132,"BUCUREŞTI SECTORUL 6","ŞCOALA GIMNAZIALĂ NR.142",1211,"Alegeri Prezidentiale",1,1569,972,827,145,0,941,31,1700,728,678,263
47,"MUNICIPIUL BUCUREŞTI - SECTOR 6","MUNICIPIUL BUCUREŞTI",179132,"BUCUREŞTI SECTORUL 6","ŞCOALA GIMNAZIALĂ NR.142",1212,"Alegeri Prezidentiale",1,1533,840,707,133,0,820,20,1600,760,545,275
47,"MUNICIPIUL BUCUREŞTI - SECTOR 6","MUNICIPIUL BUCUREŞTI",179132,"BUCUREŞTI SECTORUL 6","ŞCOALA GIMNAZIALĂ NR.142",1213,"Alegeri Prezidentiale",1,1263,738,558,180,0,728,10,1400,662,520,208
47,"MUNICIPIUL BUCUREŞTI - SECTOR 6","MUNICIPIUL BUCUREŞTI",179132,"BUCUREŞTI SECTORUL 6","ŞCOALA GIMNAZIALĂ NR.142",1214,"Alegeri Prezidentiale",1,1712,1016,816,200,0,998,18,1800,784,690,308
47,"MUNICIPIUL BUCUREŞTI - SECTOR 6","MUNICIPIUL BUCUREŞTI",179132,"BUCUREŞTI SECTORUL 6","ŞCOALA GIMNAZIALĂ NR.142",1215,"Alegeri Prezidentiale",1,1484,854,678,176,0,837,17,1600,746,564,273
47,"MUNICIPIUL BUCUREŞTI - SECTOR 6","MUNICIPIUL BUCUREŞTI",179132,"BUCUREŞTI SECTORUL 6","ŞCOALA GIMNAZIALĂ NR.142",1216,"Alegeri Prezidentiale",2,1323,896,625,271,0,870,26,1393,497,581,289
47,"MUNICIPIUL BUCUREŞTI - SECTOR 6","MUNICIPIUL BUCUREŞTI",179132,"BUCUREŞTI SECTORUL 6","ŞCOALA GIMNAZIALĂ NR.142",1217,"Alegeri Prezidentiale",2,1412,778,677,101,0,765,13,1600,822,551,214
47,"MUNICIPIUL BUCUREŞTI - SECTOR 6","MUNICIPIUL BUCUREŞTI",179132,"BUCUREŞTI SECTORUL 6","ŞCOALA GIMNAZIALĂ NR.117",1218,"Alegeri Prezidentiale",1,1417,973,703,270,0,948,25,1607,634,678,270
47,"MUNICIPIUL BUCUREŞTI - SECTOR 6","MUNICIPIUL BUCUREŞTI",179132,"BUCUREŞTI SECTORUL 6","ŞCOALA GIMNAZIALĂ NR.117",1219,"Alegeri Prezidentiale",1,1495,1014,774,240,0,990,24,1600,586,702,288
47,"MUNICIPIUL BUCUREŞTI - SECTOR 6","MUNICIPIUL BUCUREŞTI",179132,"BUCUREŞTI SECTORUL 6","ŞCOALA GIMNAZIALĂ NR.117",1220,"Alegeri Prezidentiale",2,1556,1102,897,204,1,1091,11,1700,598,816,275
47,"MUNICIPIUL BUCUREŞTI - SECTOR 6","MUNICIPIUL BUCUREŞTI",179132,"BUCUREŞTI SECTORUL 6","ŞCOALA GIMNAZIALĂ NR.117",1221,"Alegeri Prezidentiale",1,1742,1224,827,397,0,1203,21,1800,576,868,335
47,"MUNICIPIUL BUCUREŞTI - SECTOR 6","MUNICIPIUL BUCUREŞTI",179132,"BUCUREŞTI SECTORUL 6","ŞCOALA GIMNAZIALĂ NR.117",1222,"Alegeri Prezidentiale",1,1610,957,685,271,1,936,21,1700,743,642,294
47,"MUNICIPIUL BUCUREŞTI - SECTOR 6","MUNICIPIUL BUCUREŞTI",179132,"BUCUREŞTI SECTORUL 6","ŞCOALA GIMNAZIALĂ NR.117",1223,"Alegeri Prezidentiale",1,1256,677,491,186,0,661,16,1300,623,450,211
47,"MUNICIPIUL BUCUREŞTI - SECTOR 6","MUNICIPIUL BUCUREŞTI",179132,"BUCUREŞTI SECTORUL 6","ŞCOALA GIMNAZIALĂ NR.117",1224,"Alegeri Prezidentiale",1,1591,905,792,113,0,885,20,1700,795,583,302
47,"MUNICIPIUL BUCUREŞTI - SECTOR 6","MUNICIPIUL BUCUREŞTI",179132,"BUCUREŞTI SECTORUL 6","LICEUL TEORETIC ”TUDOR VLADIMIRESCU”",1225,"Alegeri Prezidentiale",1,1435,1441,759,682,0,1415,26,1900,459,1089,326
47,"MUNICIPIUL BUCUREŞTI - SECTOR 6","MUNICIPIUL BUCUREŞTI",179132,"BUCUREŞTI SECTORUL 6","LICEUL TEORETIC ”TUDOR VLADIMIRESCU”",1226,"Alegeri Prezidentiale",1,1056,888,579,309,0,862,26,1600,712,660,202
47,"MUNICIPIUL BUCUREŞTI - SECTOR 6","MUNICIPIUL BUCUREŞTI",179132,"BUCUREŞTI SECTORUL 6","LICEUL TEORETIC ”TUDOR VLADIMIRESCU”",1227,"Alegeri Prezidentiale",2,1384,1228,742,486,0,1199,29,1600,372,868,331
47,"MUNICIPIUL BUCUREŞTI - SECTOR 6","MUNICIPIUL BUCUREŞTI",179132,"BUCUREŞTI SECTORUL 6","LICEUL TEORETIC ”TUDOR VLADIMIRESCU”",1228,"Alegeri Prezidentiale",1,952,987,528,459,0,961,26,1200,213,778,183
47,"MUNICIPIUL BUCUREŞTI - SECTOR 6","MUNICIPIUL BUCUREŞTI",179132,"BUCUREŞTI SECTORUL 6","LICEUL TEORETIC ”TUDOR VLADIMIRESCU”",1229,"Alegeri Prezidentiale",2,1714,1260,965,293,2,1230,30,2000,740,955,275
47,"MUNICIPIUL BUCUREŞTI - SECTOR 6","MUNICIPIUL BUCUREŞTI",179132,"BUCUREŞTI SECTORUL 6","CLUBUL SPORTIV SCOLAR NR. 5",1230,"Alegeri Prezidentiale",1,1216,1104,635,299,170,1082,22,1600,496,850,232
47,"MUNICIPIUL BUCUREŞTI - SECTOR 6","MUNICIPIUL BUCUREŞTI",179132,"BUCUREŞTI SECTORUL 6","COLEGIUL UCECOM ”SPIRU HARET”",1231,"Alegeri Prezidentiale",1,1101,1834,586,1248,0,1799,35,2400,566,1636,163
47,"MUNICIPIUL BUCUREŞTI - SECTOR 6","MUNICIPIUL BUCUREŞTI",179132,"BUCUREŞTI SECTORUL 6","COLEGIUL UCECOM ”SPIRU HARET”",1232,"Alegeri Prezidentiale",1,1009,1608,401,1207,0,1574,34,2400,792,1386,188
47,"MUNICIPIUL BUCUREŞTI - SECTOR 6","MUNICIPIUL BUCUREŞTI",179132,"BUCUREŞTI SECTORUL 6","ŞCOALA GIMNAZIALĂ NR.168",1233,"Alegeri Prezidentiale",1,1562,1088,687,349,52,1071,17,1700,612,794,277
47,"MUNICIPIUL BUCUREŞTI - SECTOR 6","MUNICIPIUL BUCUREŞTI",179132,"BUCUREŞTI SECTORUL 6","ŞCOALA GIMNAZIALĂ NR.168",1234,"Alegeri Prezidentiale",2,1679,1130,671,459,0,1098,32,1800,670,862,236
47,"MUNICIPIUL BUCUREŞTI - SECTOR 6","MUNICIPIUL BUCUREŞTI",179132,"BUCUREŞTI SECTORUL 6","ŞCOALA GIMNAZIALĂ NR.168",1235,"Alegeri Prezidentiale",1,1615,1047,753,294,0,1026,21,1800,753,780,246
47,"MUNICIPIUL BUCUREŞTI - SECTOR 6","MUNICIPIUL BUCUREŞTI",179132,"BUCUREŞTI SECTORUL 6","ŞCOALA GIMNAZIALĂ NR.168",1236,"Alegeri Prezidentiale",1,1331,931,665,266,0,906,25,1600,669,632,274
47,"MUNICIPIUL BUCUREŞTI - SECTOR 6","MUNICIPIUL BUCUREŞTI",179132,"BUCUREŞTI SECTORUL 6","ŞCOALA GIMNAZIALĂ NR.168",1237,"Alegeri Prezidentiale",1,1558,771,632,139,0,758,13,1700,929,599,159
47,"MUNICIPIUL BUCUREŞTI - SECTOR 6","MUNICIPIUL BUCUREŞTI",179132,"BUCUREŞTI SECTORUL 6","COLEGIUL TEHNIC ”CAROL I”",1238,"Alegeri Prezidentiale",2,1625,1052,692,360,0,1027,25,1700,648,728,299
47,"MUNICIPIUL BUCUREŞTI - SECTOR 6","MUNICIPIUL BUCUREŞTI",179132,"BUCUREŞTI SECTORUL 6","COLEGIUL TEHNIC ”CAROL I”",1239,"Alegeri Prezidentiale",2,1682,1023,770,253,0,994,29,1700,677,680,314
47,"MUNICIPIUL BUCUREŞTI - SECTOR 6","MUNICIPIUL BUCUREŞTI",179132,"BUCUREŞTI SECTORUL 6","COLEGIUL TEHNIC ”CAROL I”",1240,"Alegeri Prezidentiale",1,1788,851,761,89,1,830,21,1900,1049,540,290
47,"MUNICIPIUL BUCUREŞTI - SECTOR 6","MUNICIPIUL BUCUREŞTI",179132,"BUCUREŞTI SECTORUL 6","COLEGIUL TEHNIC ”CAROL I”",1241,"Alegeri Prezidentiale",1,1399,714,643,70,1,691,23,1600,886,447,244
47,"MUNICIPIUL BUCUREŞTI - SECTOR 6","MUNICIPIUL BUCUREŞTI",179132,"BUCUREŞTI SECTORUL 6","COLEGIUL TEHNIC ”CAROL I”",1242,"Alegeri Prezidentiale",1,1239,667,604,63,0,645,22,1300,633,445,200
47,"MUNICIPIUL BUCUREŞTI - SECTOR 6","MUNICIPIUL BUCUREŞTI",179132,"BUCUREŞTI SECTORUL 6","COLEGIUL TEHNIC ”CAROL I”",1243,"Alegeri Prezidentiale",1,1188,605,568,36,1,590,15,1308,703,396,194
47,"MUNICIPIUL BUCUREŞTI - SECTOR 6","MUNICIPIUL BUCUREŞTI",179132,"BUCUREŞTI SECTORUL 6","COLEGIUL TEHNIC ”CAROL I”",1244,"Alegeri Prezidentiale",1,1357,740,694,46,0,726,14,1400,660,507,219
47,"MUNICIPIUL BUCUREŞTI - SECTOR 6","MUNICIPIUL BUCUREŞTI",179132,"BUCUREŞTI SECTORUL 6","COLEGIUL TEHNIC ”CAROL I”",1245,"Alegeri Prezidentiale",1,1345,748,676,72,0,733,15,1400,652,522,211
47,"MUNICIPIUL BUCUREŞTI - SECTOR 6","MUNICIPIUL BUCUREŞTI",179132,"BUCUREŞTI SECTORUL 6","ŞCOALA GIMNAZIALĂ NR.163",1246,"Alegeri Prezidentiale",1,1691,834,760,72,2,818,16,1800,966,535,283
47,"MUNICIPIUL BUCUREŞTI - SECTOR 6","MUNICIPIUL BUCUREŞTI",179132,"BUCUREŞTI SECTORUL 6","ŞCOALA GIMNAZIALĂ NR.163",1247,"Alegeri Prezidentiale",1,1577,789,707,82,0,763,26,1600,811,521,242
47,"MUNICIPIUL BUCUREŞTI - SECTOR 6","MUNICIPIUL BUCUREŞTI",179132,"BUCUREŞTI SECTORUL 6","ŞCOALA GIMNAZIALĂ NR.163",1248,"Alegeri Prezidentiale",2,1194,657,538,119,0,646,11,1308,651,460,186
47,"MUNICIPIUL BUCUREŞTI - SECTOR 6","MUNICIPIUL BUCUREŞTI",179132,"BUCUREŞTI SECTORUL 6","ŞCOALA GIMNAZIALĂ NR.163",1249,"Alegeri Prezidentiale",1,1119,610,518,90,2,588,22,1200,590,413,175
47,"MUNICIPIUL BUCUREŞTI - SECTOR 6","MUNICIPIUL BUCUREŞTI",179132,"BUCUREŞTI SECTORUL 6","ŞCOALA GIMNAZIALĂ NR.163",1250,"Alegeri Prezidentiale",2,1262,687,630,56,1,658,29,1300,613,447,211
47,"MUNICIPIUL BUCUREŞTI - SECTOR 6","MUNICIPIUL BUCUREŞTI",179132,"BUCUREŞTI SECTORUL 6","ŞCOALA GIMNAZIALĂ NR.163",1251,"Alegeri Prezidentiale",1,1248,658,606,52,0,644,14,1292,634,421,223
47,"MUNICIPIUL BUCUREŞTI - SECTOR 6","MUNICIPIUL BUCUREŞTI",179132,"BUCUREŞTI SECTORUL 6","ŞCOALA GIMNAZIALĂ NR.163",1252,"Alegeri Prezidentiale",1,1425,740,690,50,0,728,12,1600,860,494,234
47,"MUNICIPIUL BUCUREŞTI - SECTOR 6","MUNICIPIUL BUCUREŞTI",179132,"BUCUREŞTI SECTORUL 6","ŞCOALA GIMNAZIALĂ NR.163",1253,"Alegeri Prezidentiale",1,1180,603,558,45,0,591,12,1200,597,384,207
47,"MUNICIPIUL BUCUREŞTI - SECTOR 6","MUNICIPIUL BUCUREŞTI",179132,"BUCUREŞTI SECTORUL 6","ŞCOALA GIMNAZIALĂ NR.163",1254,"Alegeri Prezidentiale",1,1227,616,592,24,0,606,10,1300,684,377,229
47,"MUNICIPIUL BUCUREŞTI - SECTOR 6","MUNICIPIUL BUCUREŞTI",179132,"BUCUREŞTI SECTORUL 6","LICEUL TEORETIC ”MARIN PREDA”",1255,"Alegeri Prezidentiale",1,1489,729,648,81,0,708,21,1600,871,476,232
47,"MUNICIPIUL BUCUREŞTI - SECTOR 6","MUNICIPIUL BUCUREŞTI",179132,"BUCUREŞTI SECTORUL 6","LICEUL TEORETIC ”MARIN PREDA”",1256,"Alegeri Prezidentiale",1,1334,845,632,213,0,830,15,1400,555,583,247
47,"MUNICIPIUL BUCUREŞTI - SECTOR 6","MUNICIPIUL BUCUREŞTI",179132,"BUCUREŞTI SECTORUL 6","LICEUL TEORETIC ”MARIN PREDA”",1257,"Alegeri Prezidentiale",2,1450,869,747,120,2,853,16,1592,723,578,275
47,"MUNICIPIUL BUCUREŞTI - SECTOR 6","MUNICIPIUL BUCUREŞTI",179132,"BUCUREŞTI SECTORUL 6","LICEUL TEORETIC ”MARIN PREDA”",1258,"Alegeri Prezidentiale",2,1459,769,695,74,0,753,16,1600,831,464,289
47,"MUNICIPIUL BUCUREŞTI - SECTOR 6","MUNICIPIUL BUCUREŞTI",179132,"BUCUREŞTI SECTORUL 6","ŞCOALA GIMNAZIALĂ NR.167",1259,"Alegeri Prezidentiale",1,1386,785,533,252,0,765,20,1400,615,557,208
47,"MUNICIPIUL BUCUREŞTI - SECTOR 6","MUNICIPIUL BUCUREŞTI",179132,"BUCUREŞTI SECTORUL 6","ŞCOALA GIMNAZIALĂ NR.167",1260,"Alegeri Prezidentiale",1,1514,751,631,120,0,737,14,1592,841,468,269
47,"MUNICIPIUL BUCUREŞTI - SECTOR 6","MUNICIPIUL BUCUREŞTI",179132,"BUCUREŞTI SECTORUL 6","ŞCOALA GIMNAZIALĂ NR.167",1261,"Alegeri Prezidentiale",1,1190,803,599,203,1,786,17,1300,497,560,226
47,"MUNICIPIUL BUCUREŞTI - SECTOR 6","MUNICIPIUL BUCUREŞTI",179132,"BUCUREŞTI SECTORUL 6","ŞCOALA GIMNAZIALĂ NR.167",1262,"Alegeri Prezidentiale",1,1089,621,477,144,0,608,13,1200,579,394,214
47,"MUNICIPIUL BUCUREŞTI - SECTOR 6","MUNICIPIUL BUCUREŞTI",179132,"BUCUREŞTI SECTORUL 6","ŞCOALA GIMNAZIALĂ NR.167",1263,"Alegeri Prezidentiale",1,1641,889,795,93,1,867,22,1700,811,612,255
47,"MUNICIPIUL BUCUREŞTI - SECTOR 6","MUNICIPIUL BUCUREŞTI",179132,"BUCUREŞTI SECTORUL 6","ŞCOALA GIMNAZIALĂ NR.167",1264,"Alegeri Prezidentiale",1,1527,811,722,89,0,798,13,1600,789,544,254
47,"MUNICIPIUL BUCUREŞTI - SECTOR 6","MUNICIPIUL BUCUREŞTI",179132,"BUCUREŞTI SECTORUL 6","ŞCOALA GIMNAZIALĂ NR.167",1265,"Alegeri Prezidentiale",1,1083,636,523,113,0,625,11,1200,564,454,171
47,"MUNICIPIUL BUCUREŞTI - SECTOR 6","MUNICIPIUL BUCUREŞTI",179132,"BUCUREŞTI SECTORUL 6","ŞCOALA GIMNAZIALĂ NR.167",1266,"Alegeri Prezidentiale",2,1176,653,556,97,0,636,17,1200,547,456,180
47,"MUNICIPIUL BUCUREŞTI - SECTOR 6","MUNICIPIUL BUCUREŞTI",179132,"BUCUREŞTI SECTORUL 6","ŞCOALA GIMNAZIALĂ NR.167",1267,"Alegeri Prezidentiale",1,1351,759,656,102,1,735,24,1400,641,509,226
47,"MUNICIPIUL BUCUREŞTI - SECTOR 6","MUNICIPIUL BUCUREŞTI",179132,"BUCUREŞTI SECTORUL 6","ŞCOALA GIMNAZIALĂ NR.162",1268,"Alegeri Prezidentiale",1,1060,540,487,53,0,527,13,1100,560,336,191
47,"MUNICIPIUL BUCUREŞTI - SECTOR 6","MUNICIPIUL BUCUREŞTI",179132,"BUCUREŞTI SECTORUL 6","ŞCOALA GIMNAZIALĂ NR.162",1269,"Alegeri Prezidentiale",2,1420,666,616,50,0,652,14,1599,933,404,248
47,"MUNICIPIUL BUCUREŞTI - SECTOR 6","MUNICIPIUL BUCUREŞTI",179132,"BUCUREŞTI SECTORUL 6","ŞCOALA GIMNAZIALĂ NR.153",1270,"Alegeri Prezidentiale",1,1042,423,365,57,1,408,15,1100,677,235,173
47,"MUNICIPIUL BUCUREŞTI - SECTOR 6","MUNICIPIUL BUCUREŞTI",179132,"BUCUREŞTI SECTORUL 6","ŞCOALA GIMNAZIALĂ NR.153",1271,"Alegeri Prezidentiale",1,1090,421,395,26,0,409,12,1200,779,226,183
47,"MUNICIPIUL BUCUREŞTI - SECTOR 6","MUNICIPIUL BUCUREŞTI",179132,"BUCUREŞTI SECTORUL 6","ŞCOALA GIMNAZIALĂ NR.153",1272,"Alegeri Prezidentiale",2,1471,603,572,31,0,590,13,1600,997,334,256
47,"MUNICIPIUL BUCUREŞTI - SECTOR 6","MUNICIPIUL BUCUREŞTI",179132,"BUCUREŞTI SECTORUL 6","ŞCOALA GIMNAZIALĂ NR.161",1273,"Alegeri Prezidentiale",2,1096,383,332,51,0,377,6,1200,817,188,189
47,"MUNICIPIUL BUCUREŞTI - SECTOR 6","MUNICIPIUL BUCUREŞTI",179132,"BUCUREŞTI SECTORUL 6","SCOALA NR. 161",1274,"Alegeri Prezidentiale",1,1193,541,521,20,0,517,24,1300,759,331,186
47,"MUNICIPIUL BUCUREŞTI - SECTOR 6","MUNICIPIUL BUCUREŞTI",179132,"BUCUREŞTI SECTORUL 6","CLUBUL SENIORILOR MIHAI EMINESCU",1275,"Alegeri Prezidentiale",2,865,987,465,286,236,965,22,1200,213,617,348
