"Cod birou electoral",Județ,Uat,Siruta,Localitate,Secție,Nr,Tip,Versiune,a,b,b1,b2,b3,c,d,e,f,g1,g2
48,STRĂINĂTATE,AFGANISTAN,9999,KABUL/HKIA,KABUL/HKIA,1,"Alegeri Prezidentiale",1,0,246,0,246,0,239,7,591,345,202,37
48,STRĂINĂTATE,AFGANISTAN,9999,KANDAHAR/KAF,KANDAHAR/KAF,2,"Alegeri Prezidentiale",2,0,455,0,455,0,437,18,597,142,357,80
48,STRĂINĂTATE,"AFRICA DE SUD",9999,PRETORIA,PRETORIA,3,"Alegeri Prezidentiale",1,0,104,0,104,0,104,0,409,305,93,11
48,STRĂINĂTATE,"AFRICA DE SUD",9999,"CAPE TOWN","CAPE TOWN",4,"Alegeri Prezidentiale",1,0,94,0,94,0,94,0,200,106,85,9
48,STRĂINĂTATE,ALBANIA,9999,TIRANA,TIRANA,5,"Alegeri Prezidentiale",1,0,41,0,41,0,41,0,315,274,35,6
48,STRĂINĂTATE,ALGERIA,9999,ALGER,ALGER,6,"Alegeri Prezidentiale",1,0,28,0,28,0,28,0,100,72,25,3
48,STRĂINĂTATE,ANGOLA,9999,LUANDA,LUANDA,7,"Alegeri Prezidentiale",1,0,8,0,8,0,8,0,100,92,7,1
48,STRĂINĂTATE,"ARABIA SAUDITA",9999,RIAD,RIAD,8,"Alegeri Prezidentiale",1,0,165,0,165,0,164,1,503,338,152,12
48,STRĂINĂTATE,ARGENTINA,9999,"BUENOS AIRES","BUENOS AIRES",9,"Alegeri Prezidentiale",1,0,134,0,134,0,131,3,200,66,112,19
48,STRĂINĂTATE,ARMENIA,9999,EREVAN,EREVAN,10,"Alegeri Prezidentiale",1,0,23,0,23,0,23,0,200,177,21,2
48,STRĂINĂTATE,AUSTRALIA,9999,CANBERRA,CANBERRA,11,"Alegeri Prezidentiale",1,0,33,0,33,0,33,0,360,327,27,6
48,STRĂINĂTATE,AUSTRALIA,9999,MELBOURNE,MELBOURNE,12,"Alegeri Prezidentiale",1,0,448,0,448,0,446,2,2000,1552,404,42
48,STRĂINĂTATE,AUSTRALIA,9999,ADELAIDE,ADELAIDE,13,"Alegeri Prezidentiale",1,0,75,0,75,0,74,1,500,425,70,4
48,STRĂINĂTATE,AUSTRALIA,9999,PERTH,PERTH,14,"Alegeri Prezidentiale",1,0,221,0,221,0,220,1,1008,787,205,15
48,STRĂINĂTATE,AUSTRALIA,9999,SYDNEY,SYDNEY,15,"Alegeri Prezidentiale",1,0,356,0,356,0,355,1,1600,1244,331,24
48,STRĂINĂTATE,AUSTRALIA,9999,BRISBANE,BRISBANE,16,"Alegeri Prezidentiale",1,0,170,0,170,0,169,1,1600,1430,157,12
48,STRĂINĂTATE,"NOUA ZEELANDA",9999,AUCKLAND,AUCKLAND,17,"Alegeri Prezidentiale",1,0,206,0,206,0,205,1,1000,794,185,20
48,STRĂINĂTATE,AUSTRIA,9999,VIENA,VIENA,18,"Alegeri Prezidentiale",1,0,3261,0,3261,0,3241,20,7000,3739,3018,223
48,STRĂINĂTATE,AUSTRIA,9999,VIENA,VIENA,19,"Alegeri Prezidentiale",1,0,3128,0,3128,0,3101,27,7000,3872,2897,204
48,STRĂINĂTATE,AUSTRIA,9999,VIENA,VIENA,20,"Alegeri Prezidentiale",1,0,723,0,723,0,717,6,7001,6278,665,52
48,STRĂINĂTATE,AUSTRIA,9999,VIENA,VIENA,21,"Alegeri Prezidentiale",1,0,769,0,769,0,764,5,7001,6232,719,45
48,STRĂINĂTATE,AUSTRIA,9999,VIENA,VIENA,22,"Alegeri Prezidentiale",1,0,1886,0,1886,0,1858,28,6995,5109,1732,126
48,STRĂINĂTATE,AUSTRIA,9999,VIENA,VIENA,23,"Alegeri Prezidentiale",1,0,2197,0,2197,0,2183,14,6900,4703,2025,158
48,STRĂINĂTATE,AUSTRIA,9999,KLAGENFURT,KLAGENFURT,24,"Alegeri Prezidentiale",1,0,999,0,999,0,991,8,7000,6001,939,52
48,STRĂINĂTATE,AUSTRIA,9999,SALZBURG,SALZBURG,25,"Alegeri Prezidentiale",1,0,1399,0,1399,0,1394,5,7000,5601,1315,79
48,STRĂINĂTATE,AUSTRIA,9999,SALZBURG,SALZBURG,26,"Alegeri Prezidentiale",1,0,1422,0,1422,0,1413,9,7000,5578,1348,65
48,STRĂINĂTATE,AUSTRIA,9999,GRAZ,GRAZ,27,"Alegeri Prezidentiale",1,0,2083,0,2083,0,2074,9,7000,4917,1963,111
48,STRĂINĂTATE,AUSTRIA,9999,GRAZ,GRAZ,28,"Alegeri Prezidentiale",1,0,2074,0,2074,0,2064,10,7002,4928,1981,83
48,STRĂINĂTATE,AUSTRIA,9999,LINZ,LINZ,29,"Alegeri Prezidentiale",1,0,1801,0,1801,0,1781,20,6998,5197,1667,114
48,STRĂINĂTATE,AUSTRIA,9999,LINZ,LINZ,30,"Alegeri Prezidentiale",1,0,2415,0,2415,0,2387,28,7000,4585,2258,129
48,STRĂINĂTATE,AUSTRIA,9999,INNSBRUCK,INNSBRUCK,31,"Alegeri Prezidentiale",1,0,1172,0,1172,0,1162,10,7000,5828,1102,60
48,STRĂINĂTATE,AUSTRIA,9999,"SANKT PÖLTEN","SANKT PÖLTEN",32,"Alegeri Prezidentiale",1,0,1352,0,1352,0,1335,17,7000,5648,1229,106
48,STRĂINĂTATE,AUSTRIA,9999,EISENSTADT,EISENSTADT,33,"Alegeri Prezidentiale",1,0,1007,0,1007,0,1004,3,7000,5993,952,52
48,STRĂINĂTATE,AUSTRIA,9999,BREGENZ,BREGENZ,34,"Alegeri Prezidentiale",1,0,1224,0,1224,0,1215,9,7000,5776,1145,70
48,STRĂINĂTATE,AZERBAIDJAN,9999,BAKU,BAKU,35,"Alegeri Prezidentiale",1,0,37,0,37,0,37,0,400,363,30,7
48,STRĂINĂTATE,BELARUS,9999,MINSK,MINSK,36,"Alegeri Prezidentiale",1,0,31,0,31,0,31,0,100,69,23,8
48,STRĂINĂTATE,BELGIA,9999,BRUXELLES,BRUXELLES,37,"Alegeri Prezidentiale",1,0,1917,0,1917,0,1876,41,10000,8083,1688,188
48,STRĂINĂTATE,BELGIA,9999,BRUXELLES,BRUXELLES,38,"Alegeri Prezidentiale",1,0,1918,0,1918,0,1885,33,10000,8082,1754,131
48,STRĂINĂTATE,BELGIA,9999,BRUXELLES,BRUXELLES,39,"Alegeri Prezidentiale",1,0,2047,0,2047,0,2037,10,10000,7953,1886,151
48,STRĂINĂTATE,BELGIA,9999,BRUXELLES,BRUXELLES,40,"Alegeri Prezidentiale",1,0,1576,0,1576,0,1560,16,10000,8424,1468,92
48,STRĂINĂTATE,BELGIA,9999,BRUXELLES,BRUXELLES,41,"Alegeri Prezidentiale",1,0,6188,0,6188,0,6141,47,10000,3812,5671,470
48,STRĂINĂTATE,BELGIA,9999,BRUXELLES,BRUXELLES,42,"Alegeri Prezidentiale",1,0,1104,0,1104,0,1095,9,10000,8896,1007,88
48,STRĂINĂTATE,BELGIA,9999,BRUXELLES,BRUXELLES,43,"Alegeri Prezidentiale",1,0,951,0,951,0,945,6,10008,9057,885,60
48,STRĂINĂTATE,BELGIA,9999,BRUXELLES,BRUXELLES,44,"Alegeri Prezidentiale",1,0,825,0,825,0,817,8,10000,9175,774,43
48,STRĂINĂTATE,BELGIA,9999,BRUXELLES,BRUXELLES,45,"Alegeri Prezidentiale",1,0,827,0,827,0,824,3,10000,9173,777,47
48,STRĂINĂTATE,BELGIA,9999,BRUXELLES,BRUXELLES,46,"Alegeri Prezidentiale",1,0,922,0,922,0,914,8,9999,9077,871,43
48,STRĂINĂTATE,BELGIA,9999,BRUXELLES,BRUXELLES,47,"Alegeri Prezidentiale",1,0,1160,0,1160,0,1150,10,10000,8840,1097,53
48,STRĂINĂTATE,BELGIA,9999,BRUXELLES,BRUXELLES,48,"Alegeri Prezidentiale",2,0,1025,0,1025,0,1016,9,10000,8975,952,64
48,STRĂINĂTATE,BELGIA,9999,LIEGE,LIEGE,49,"Alegeri Prezidentiale",1,0,1193,0,1193,0,1185,8,10000,8807,1124,61
48,STRĂINĂTATE,BELGIA,9999,LIEGE,LIEGE,50,"Alegeri Prezidentiale",1,0,1194,0,1194,0,1189,5,1200,6,1130,59
48,STRĂINĂTATE,BELGIA,9999,ANTWERP,ANTWERP,51,"Alegeri Prezidentiale",1,0,2928,0,2928,0,2909,19,9993,7065,2771,138
48,STRĂINĂTATE,BELGIA,9999,ANTWERP,ANTWERP,52,"Alegeri Prezidentiale",1,0,3079,0,3079,0,3044,35,10000,6921,2903,141
48,STRĂINĂTATE,BELGIA,9999,MONS,MONS,53,"Alegeri Prezidentiale",1,0,573,0,573,0,564,9,10000,9427,527,37
48,STRĂINĂTATE,BELGIA,9999,MONS,MONS,54,"Alegeri Prezidentiale",2,0,391,0,391,0,389,2,10000,9609,361,28
48,STRĂINĂTATE,BELGIA,9999,CHARLEROI,CHARLEROI,55,"Alegeri Prezidentiale",2,0,553,0,553,0,552,1,10000,9447,526,26
48,STRĂINĂTATE,BELGIA,9999,CHARLEROI,CHARLEROI,56,"Alegeri Prezidentiale",1,0,683,0,683,0,675,8,10000,9317,624,51
48,STRĂINĂTATE,BELGIA,9999,BRUGES,BRUGES,57,"Alegeri Prezidentiale",1,0,1752,0,1752,0,1734,18,10000,8248,1646,88
48,STRĂINĂTATE,BELGIA,9999,BRUGES,BRUGES,58,"Alegeri Prezidentiale",1,0,1592,0,1592,0,1566,26,10000,8408,1491,75
48,STRĂINĂTATE,BELGIA,9999,GENT,GENT,59,"Alegeri Prezidentiale",2,0,1667,0,1667,0,1644,23,10000,8333,1544,100
48,STRĂINĂTATE,"BOSNIA SI HERTEGOVINA",9999,SARAJEVO,SARAJEVO,60,"Alegeri Prezidentiale",1,0,58,0,58,0,53,5,401,343,45,8
48,STRĂINĂTATE,BRAZILIA,9999,BRASILIA,BRASILIA,61,"Alegeri Prezidentiale",1,0,10,0,10,0,10,0,200,190,10,0
48,STRĂINĂTATE,BRAZILIA,9999,"RIO DE JANEIRO","RIO DE JANEIRO",62,"Alegeri Prezidentiale",2,0,38,0,38,0,36,2,200,162,35,1
48,STRĂINĂTATE,BULGARIA,9999,SOFIA,SOFIA,63,"Alegeri Prezidentiale",1,0,310,0,310,0,305,5,4000,3690,281,24
48,STRĂINĂTATE,CANADA,9999,OTTAWA,OTTAWA,64,"Alegeri Prezidentiale",1,0,395,0,395,0,393,2,4000,3605,354,39
48,STRĂINĂTATE,CANADA,9999,CALGARY,CALGARY,65,"Alegeri Prezidentiale",1,0,461,0,461,0,461,0,5000,4539,436,25
48,STRĂINĂTATE,CANADA,9999,QUEBEC,QUEBEC,66,"Alegeri Prezidentiale",2,0,70,0,70,0,70,0,1000,930,63,7
48,STRĂINĂTATE,CANADA,9999,DIEPPE,DIEPPE,67,"Alegeri Prezidentiale",1,0,71,0,71,0,70,1,500,429,63,7
48,STRĂINĂTATE,CANADA,9999,VANCOUVER,VANCOUVER,68,"Alegeri Prezidentiale",1,0,574,0,574,0,573,1,10001,9427,532,41
48,STRĂINĂTATE,CANADA,9999,MONTREAL,MONTREAL,69,"Alegeri Prezidentiale",1,0,836,0,836,0,833,3,3500,2664,776,57
48,STRĂINĂTATE,CANADA,9999,MONTREAL,MONTREAL,70,"Alegeri Prezidentiale",1,0,551,0,551,0,547,4,3500,2949,504,43
48,STRĂINĂTATE,CANADA,9999,TORONTO,TORONTO,71,"Alegeri Prezidentiale",1,0,946,0,946,0,943,3,12000,11054,875,68
48,STRĂINĂTATE,CANADA,9999,TORONTO,TORONTO,72,"Alegeri Prezidentiale",1,0,944,0,944,0,939,5,12000,11056,848,91
48,STRĂINĂTATE,"REPUBLICA CEHA",9999,PRAGA,PRAGA,73,"Alegeri Prezidentiale",1,0,949,0,949,0,939,10,10000,9051,894,45
48,STRĂINĂTATE,"REPUBLICA CEHA",9999,PRAGA,PRAGA,74,"Alegeri Prezidentiale",1,0,1003,0,1003,0,992,11,10000,8997,935,57
48,STRĂINĂTATE,COLUMBIA,9999,BOGOTA,BOGOTA,75,"Alegeri Prezidentiale",1,0,43,0,43,0,42,1,600,557,41,1
48,STRĂINĂTATE,"REPUBLICA POPULARA DEMOCRATA COREEANA",9999,PHENIAN,PHENIAN,76,"Alegeri Prezidentiale",1,0,7,0,7,0,6,1,51,44,5,1
48,STRĂINĂTATE,"REPUBLICA COREEA",9999,SEOUL,SEOUL,77,"Alegeri Prezidentiale",1,0,101,0,101,0,100,1,2500,2399,91,9
48,STRĂINĂTATE,CHILE,9999,"SANTIAGO DE CHILE","SANTIAGO DE CHILE",78,"Alegeri Prezidentiale",1,0,100,0,100,0,98,2,500,400,86,12
48,STRĂINĂTATE,CHILE,9999,COPIAPO,COPIAPO,79,"Alegeri Prezidentiale",1,0,22,0,22,0,22,0,502,480,22,0
48,STRĂINĂTATE,CHINA,9999,BEIJING,BEIJING,80,"Alegeri Prezidentiale",1,0,113,0,113,0,111,2,301,188,88,23
48,STRĂINĂTATE,CHINA,9999,SHANGHAI,SHANGHAI,81,"Alegeri Prezidentiale",1,0,150,0,150,0,147,3,1000,850,137,10
48,STRĂINĂTATE,CHINA,9999,"HONG KONG","HONG KONG",82,"Alegeri Prezidentiale",1,0,112,0,112,0,110,2,400,288,105,5
48,STRĂINĂTATE,CIPRU,9999,NICOSIA,NICOSIA,83,"Alegeri Prezidentiale",1,0,1814,0,1814,0,1802,12,5016,3202,1659,143
48,STRĂINĂTATE,CIPRU,9999,NICOSIA,NICOSIA,84,"Alegeri Prezidentiale",1,0,192,0,192,0,191,1,5001,4809,179,12
48,STRĂINĂTATE,CIPRU,9999,PAFOS,PAFOS,85,"Alegeri Prezidentiale",1,0,972,0,972,0,968,4,2984,2012,879,89
48,STRĂINĂTATE,CIPRU,9999,LIMASSOL,LIMASSOL,86,"Alegeri Prezidentiale",1,0,1552,0,1552,0,1538,14,5000,3448,1426,112
48,STRĂINĂTATE,CIPRU,9999,LARNACA,LARNACA,87,"Alegeri Prezidentiale",1,0,906,0,906,0,903,3,2911,2005,818,85
48,STRĂINĂTATE,CIPRU,9999,DHERINYA,DHERINYA,88,"Alegeri Prezidentiale",1,0,281,0,281,0,280,1,2000,1719,260,20
48,STRĂINĂTATE,CROATIA,9999,ZAGREB,ZAGREB,89,"Alegeri Prezidentiale",1,0,71,0,71,0,70,1,1000,929,69,1
48,STRĂINĂTATE,CUBA,9999,HAVANA,HAVANA,90,"Alegeri Prezidentiale",1,0,65,0,65,0,62,3,200,135,58,4
48,STRĂINĂTATE,DANEMARCA,9999,COPENHAGA,COPENHAGA,91,"Alegeri Prezidentiale",1,0,1252,0,1252,0,1239,13,2998,1746,1186,53
48,STRĂINĂTATE,DANEMARCA,9999,COPENHAGA,COPENHAGA,92,"Alegeri Prezidentiale",1,0,1205,0,1205,0,1190,15,3000,1795,1137,53
48,STRĂINĂTATE,DANEMARCA,9999,AALBORG,AALBORG,93,"Alegeri Prezidentiale",1,0,1357,0,1357,0,1340,17,2500,1143,1296,44
48,STRĂINĂTATE,DANEMARCA,9999,AARHUS,AARHUS,94,"Alegeri Prezidentiale",1,0,1810,0,1810,0,1786,24,2492,682,1674,112
48,STRĂINĂTATE,DANEMARCA,9999,ESBJERG,ESBJERG,95,"Alegeri Prezidentiale",1,0,842,0,842,0,835,7,2500,1658,809,26
48,STRĂINĂTATE,DANEMARCA,9999,NÆSTVED,NÆSTVED,96,"Alegeri Prezidentiale",1,0,355,0,355,0,350,5,2508,2153,326,24
48,STRĂINĂTATE,DANEMARCA,9999,ODENSE,ODENSE,97,"Alegeri Prezidentiale",1,0,814,0,814,0,806,8,2500,1686,786,20
48,STRĂINĂTATE,DANEMARCA,9999,RINGKØBING,RINGKØBING,98,"Alegeri Prezidentiale",1,0,909,0,909,0,895,14,2500,1591,866,29
48,STRĂINĂTATE,DANEMARCA,9999,SØNDERBORG,SØNDERBORG,99,"Alegeri Prezidentiale",1,0,968,0,968,0,956,12,2500,1532,917,39
48,STRĂINĂTATE,DANEMARCA,9999,TAASTRUP,TAASTRUP,100,"Alegeri Prezidentiale",1,0,1026,0,1026,0,1006,20,2500,1474,962,44
48,STRĂINĂTATE,DANEMARCA,9999,VEJLE,VEJLE,101,"Alegeri Prezidentiale",1,0,1442,0,1442,0,1426,16,2501,1059,1379,47
48,STRĂINĂTATE,DANEMARCA,9999,VIBORG,VIBORG,102,"Alegeri Prezidentiale",1,0,741,0,741,0,730,11,2500,1759,695,35
48,STRĂINĂTATE,EGIPT,9999,CAIRO,CAIRO,103,"Alegeri Prezidentiale",1,0,108,0,108,0,108,0,700,592,89,19
48,STRĂINĂTATE,ELVETIA,9999,GENEVA,GENEVA,104,"Alegeri Prezidentiale",1,0,425,0,425,0,421,4,5000,4575,392,29
48,STRĂINĂTATE,ELVETIA,9999,GENEVA,GENEVA,105,"Alegeri Prezidentiale",1,0,748,0,748,0,740,8,5000,4252,686,54
48,STRĂINĂTATE,ELVETIA,9999,BERNA,BERNA,106,"Alegeri Prezidentiale",2,0,908,0,908,0,892,16,5000,4092,839,53
48,STRĂINĂTATE,ELVETIA,9999,ZÜRICH,ZÜRICH,107,"Alegeri Prezidentiale",1,0,942,0,942,0,938,4,2995,2053,901,37
48,STRĂINĂTATE,ELVETIA,9999,ZÜRICH,ZÜRICH,108,"Alegeri Prezidentiale",1,0,940,0,940,0,930,10,2992,2052,894,36
48,STRĂINĂTATE,ELVETIA,9999,BASEL,BASEL,109,"Alegeri Prezidentiale",1,0,1423,0,1423,0,1414,9,4000,2577,1362,52
48,STRĂINĂTATE,ELVETIA,9999,LAUSANNE,LAUSANNE,110,"Alegeri Prezidentiale",1,0,974,0,974,0,961,13,4000,3026,927,34
48,STRĂINĂTATE,ELVETIA,9999,BELLINZONA,BELLINZONA,111,"Alegeri Prezidentiale",1,0,238,0,238,0,237,1,4000,3762,211,26
48,STRĂINĂTATE,"EMIRATELE ARABE UNITE",9999,"ABU DHABI","ABU DHABI",112,"Alegeri Prezidentiale",1,0,649,0,649,0,644,5,3606,2957,587,57
48,STRĂINĂTATE,"EMIRATELE ARABE UNITE",9999,DUBAI,DUBAI,113,"Alegeri Prezidentiale",1,0,1049,0,1049,0,1040,9,4000,2951,957,83
48,STRĂINĂTATE,"EMIRATELE ARABE UNITE",9999,DUBAI,DUBAI,114,"Alegeri Prezidentiale",1,0,744,0,744,0,740,4,2400,1656,695,45
48,STRĂINĂTATE,ESTONIA,9999,TALLINN,TALLINN,115,"Alegeri Prezidentiale",1,0,109,0,109,0,107,2,800,691,94,13
48,STRĂINĂTATE,ETIOPIA,9999,"ADDIS ABEBA","ADDIS ABEBA",116,"Alegeri Prezidentiale",1,0,26,0,26,0,23,3,100,74,22,1
48,STRĂINĂTATE,FILIPINE,9999,MANILA,MANILA,117,"Alegeri Prezidentiale",1,0,44,0,44,0,42,2,400,356,39,3
48,STRĂINĂTATE,FINLANDA,9999,HELSINKI,HELSINKI,118,"Alegeri Prezidentiale",1,0,796,0,796,0,791,5,3191,2395,766,25
48,STRĂINĂTATE,FINLANDA,9999,TURKU,TURKU,119,"Alegeri Prezidentiale",3,0,536,0,536,0,532,4,1998,1462,516,16
48,STRĂINĂTATE,FINLANDA,9999,MARIEHAMN,MARIEHAMN,120,"Alegeri Prezidentiale",1,0,148,0,148,0,148,0,1200,1052,138,10
48,STRĂINĂTATE,FRANTA,9999,PARIS,PARIS,121,"Alegeri Prezidentiale",1,0,1863,0,1863,0,1835,28,10000,8137,1718,117
48,STRĂINĂTATE,FRANTA,9999,PARIS,PARIS,122,"Alegeri Prezidentiale",1,0,1570,0,1570,0,1554,16,10000,8430,1431,123
48,STRĂINĂTATE,FRANTA,9999,PARIS,PARIS,123,"Alegeri Prezidentiale",1,0,1085,0,1085,0,1071,14,10000,8915,992,79
48,STRĂINĂTATE,FRANTA,9999,PARIS,PARIS,124,"Alegeri Prezidentiale",1,0,840,0,840,0,832,8,9999,9159,779,53
48,STRĂINĂTATE,FRANTA,9999,PARIS,PARIS,125,"Alegeri Prezidentiale",1,0,834,0,834,0,820,14,10000,9166,769,51
48,STRĂINĂTATE,FRANTA,9999,ATHIS-MONS,ATHIS-MONS,126,"Alegeri Prezidentiale",2,0,1868,0,1868,0,1855,13,10000,8132,1766,89
48,STRĂINĂTATE,FRANTA,9999,BRY-SUR-MARNE,BRY-SUR-MARNE,127,"Alegeri Prezidentiale",1,0,2413,0,2413,0,2400,13,9992,7579,2303,97
48,STRĂINĂTATE,FRANTA,9999,DRANCY,DRANCY,128,"Alegeri Prezidentiale",1,0,2068,0,2068,0,2060,8,10000,7932,1987,73
48,STRĂINĂTATE,FRANTA,9999,FONTAINEBLEAU,FONTAINEBLEAU,129,"Alegeri Prezidentiale",1,0,566,0,566,0,561,5,10000,9434,516,45
48,STRĂINĂTATE,FRANTA,9999,ISSY-LES-MOULINEAUX,ISSY-LES-MOULINEAUX,130,"Alegeri Prezidentiale",1,0,954,0,954,0,944,10,10000,9046,880,64
48,STRĂINĂTATE,FRANTA,9999,"LA COURNEUVE","LA COURNEUVE",131,"Alegeri Prezidentiale",1,0,1368,0,1368,0,1356,12,10000,8632,1298,58
48,STRĂINĂTATE,FRANTA,9999,"LE BLANC-MESNIL","LE BLANC-MESNIL",132,"Alegeri Prezidentiale",1,0,1922,0,1922,0,1914,8,10000,8078,1841,73
48,STRĂINĂTATE,FRANTA,9999,"LE BLANC-MESNIL","LE BLANC-MESNIL",133,"Alegeri Prezidentiale",1,0,1891,0,1891,0,1887,4,9999,8108,1810,77
48,STRĂINĂTATE,FRANTA,9999,MONTREUIL,MONTREUIL,134,"Alegeri Prezidentiale",1,0,803,0,803,0,795,8,9999,9196,748,47
48,STRĂINĂTATE,FRANTA,9999,MONTREUIL,MONTREUIL,135,"Alegeri Prezidentiale",1,0,686,0,686,0,684,2,10000,9314,637,47
48,STRĂINĂTATE,FRANTA,9999,PANTIN,PANTIN,136,"Alegeri Prezidentiale",1,0,762,0,762,0,762,0,10000,9238,742,20
48,STRĂINĂTATE,FRANTA,9999,PANTIN,PANTIN,137,"Alegeri Prezidentiale",1,0,1328,0,1328,0,1324,4,10000,8672,1246,78
48,STRĂINĂTATE,FRANTA,9999,RUEIL-MALMAISON,RUEIL-MALMAISON,138,"Alegeri Prezidentiale",1,0,1423,0,1423,0,1415,8,10000,8577,1355,60
48,STRĂINĂTATE,FRANTA,9999,TRAPPES,TRAPPES,139,"Alegeri Prezidentiale",1,0,272,0,272,0,271,1,10000,9728,242,29
48,STRĂINĂTATE,FRANTA,9999,TRAPPES,TRAPPES,140,"Alegeri Prezidentiale",1,0,754,0,754,0,750,4,10000,9246,702,48
48,STRĂINĂTATE,FRANTA,9999,"ALLONNES/LE MANS MÉTROPOLE","ALLONNES/LE MANS MÉTROPOLE",141,"Alegeri Prezidentiale",2,0,446,0,446,0,437,9,10000,9554,416,21
48,STRĂINĂTATE,FRANTA,9999,BORDEAUX,BORDEAUX,142,"Alegeri Prezidentiale",1,0,1057,0,1057,0,1050,7,10000,8943,995,55
48,STRĂINĂTATE,FRANTA,9999,BREST,BREST,143,"Alegeri Prezidentiale",1,0,260,0,260,0,260,0,10000,9740,242,18
48,STRĂINĂTATE,FRANTA,9999,CAEN,CAEN,144,"Alegeri Prezidentiale",1,0,354,0,354,0,344,10,10000,9646,328,16
48,STRĂINĂTATE,FRANTA,9999,CALAIS,CALAIS,145,"Alegeri Prezidentiale",1,0,276,0,276,0,273,3,10000,9724,254,19
48,STRĂINĂTATE,FRANTA,9999,LILLE,LILLE,146,"Alegeri Prezidentiale",1,0,558,0,558,0,555,3,10000,9442,517,38
48,STRĂINĂTATE,FRANTA,9999,LILLE,LILLE,147,"Alegeri Prezidentiale",1,0,571,0,571,0,564,7,10000,9429,529,35
48,STRĂINĂTATE,FRANTA,9999,LOUDEAC,LOUDEAC,148,"Alegeri Prezidentiale",1,0,1001,0,1001,0,994,7,10000,8999,940,54
48,STRĂINĂTATE,FRANTA,9999,PESSAC,PESSAC,149,"Alegeri Prezidentiale",1,0,437,0,437,0,429,8,10000,9563,406,23
48,STRĂINĂTATE,FRANTA,9999,RENNES,RENNES,150,"Alegeri Prezidentiale",1,0,675,0,675,0,663,12,10000,9325,614,49
48,STRĂINĂTATE,FRANTA,9999,REZE/NANTES,REZE/NANTES,151,"Alegeri Prezidentiale",1,0,673,0,673,0,666,7,10000,9327,632,34
48,STRĂINĂTATE,FRANTA,9999,"SAINT-HERBLAIN/NANTES MÉTROPOLE","SAINT-HERBLAIN/NANTES MÉTROPOLE",152,"Alegeri Prezidentiale",1,0,881,0,881,0,864,17,10000,9119,808,56
48,STRĂINĂTATE,FRANTA,9999,MONACO,MONACO,153,"Alegeri Prezidentiale",1,0,240,0,240,0,237,3,9995,9755,219,18
48,STRĂINĂTATE,FRANTA,9999,LYON,LYON,154,"Alegeri Prezidentiale",1,0,1534,0,1534,0,1518,16,5000,3466,1433,85
48,STRĂINĂTATE,FRANTA,9999,LYON,LYON,155,"Alegeri Prezidentiale",1,0,286,0,286,0,279,7,5000,4714,262,17
48,STRĂINĂTATE,FRANTA,9999,"GRENOBLE-SAINT MARTIN D'HERES","GRENOBLE-SAINT MARTIN D'HERES",156,"Alegeri Prezidentiale",1,0,644,0,644,0,636,8,5000,4356,589,47
48,STRĂINĂTATE,FRANTA,9999,CLERMONT-FERRAND,CLERMONT-FERRAND,157,"Alegeri Prezidentiale",1,0,417,0,417,0,413,4,5000,4583,378,35
48,STRĂINĂTATE,FRANTA,9999,DIJON,DIJON,158,"Alegeri Prezidentiale",2,0,322,0,322,0,320,2,5000,4678,303,17
48,STRĂINĂTATE,FRANTA,9999,ANNEMASSE,ANNEMASSE,159,"Alegeri Prezidentiale",1,0,679,0,679,0,672,7,5000,4321,623,49
48,STRĂINĂTATE,FRANTA,9999,STRASBOURG,STRASBOURG,160,"Alegeri Prezidentiale",1,0,841,0,841,0,831,10,2400,1559,776,55
48,STRĂINĂTATE,FRANTA,9999,STRASBOURG,STRASBOURG,161,"Alegeri Prezidentiale",1,0,541,0,541,0,537,4,2400,1859,509,28
48,STRĂINĂTATE,FRANTA,9999,NANCY,NANCY,162,"Alegeri Prezidentiale",1,0,415,0,415,0,411,4,2400,1985,377,34
48,STRĂINĂTATE,FRANTA,9999,MARSILIA,MARSILIA,163,"Alegeri Prezidentiale",1,0,1311,0,1311,0,1306,5,4999,3688,1229,77
48,STRĂINĂTATE,FRANTA,9999,MARSILIA,MARSILIA,164,"Alegeri Prezidentiale",1,0,270,0,270,0,270,0,5000,4730,261,9
48,STRĂINĂTATE,FRANTA,9999,MARSILIA,MARSILIA,165,"Alegeri Prezidentiale",1,0,520,0,520,0,514,6,5000,4480,501,13
48,STRĂINĂTATE,FRANTA,9999,NISA,NISA,166,"Alegeri Prezidentiale",1,0,456,0,456,0,453,3,4990,4534,423,30
48,STRĂINĂTATE,FRANTA,9999,NISA,NISA,167,"Alegeri Prezidentiale",1,0,1679,0,1679,0,1660,19,5000,3321,1530,130
48,STRĂINĂTATE,FRANTA,9999,TOULOUSE,TOULOUSE,168,"Alegeri Prezidentiale",2,0,1256,0,1256,0,1242,14,5000,3744,1177,65
48,STRĂINĂTATE,FRANTA,9999,AJACCIO,AJACCIO,169,"Alegeri Prezidentiale",1,0,395,0,395,0,391,4,4000,3605,365,26
48,STRĂINĂTATE,FRANTA,9999,BASTIA,BASTIA,170,"Alegeri Prezidentiale",1,0,779,0,779,0,774,5,4000,3221,734,40
48,STRĂINĂTATE,GEORGIA,9999,TBILISI,TBILISI,171,"Alegeri Prezidentiale",1,0,82,0,82,0,82,0,200,118,75,7
48,STRĂINĂTATE,GERMANIA,9999,BERLIN,BERLIN,172,"Alegeri Prezidentiale",1,0,1394,0,1394,0,1379,15,7000,5606,1301,78
48,STRĂINĂTATE,GERMANIA,9999,BERLIN,BERLIN,173,"Alegeri Prezidentiale",1,0,1375,0,1375,0,1362,13,7000,5625,1274,88
48,STRĂINĂTATE,GERMANIA,9999,BERLIN,BERLIN,174,"Alegeri Prezidentiale",1,0,1748,0,1748,0,1731,17,7000,5252,1602,129
48,STRĂINĂTATE,GERMANIA,9999,HAMBURG,HAMBURG,175,"Alegeri Prezidentiale",1,0,3844,0,3844,0,3816,28,8000,4156,3585,231
48,STRĂINĂTATE,GERMANIA,9999,HANNOVRA,HANNOVRA,176,"Alegeri Prezidentiale",1,0,1853,0,1853,0,1836,17,7000,5147,1724,112
48,STRĂINĂTATE,GERMANIA,9999,DRESDA,DRESDA,177,"Alegeri Prezidentiale",1,0,849,0,849,0,844,5,7000,6151,792,52
48,STRĂINĂTATE,GERMANIA,9999,LEIPZIG,LEIPZIG,178,"Alegeri Prezidentiale",1,0,1435,0,1435,0,1425,10,7004,5569,1370,55
48,STRĂINĂTATE,GERMANIA,9999,BRAUNSCHWEIG,BRAUNSCHWEIG,179,"Alegeri Prezidentiale",1,0,1067,0,1067,0,1058,9,7000,5933,994,64
48,STRĂINĂTATE,GERMANIA,9999,ERFURT,ERFURT,180,"Alegeri Prezidentiale",1,0,1293,0,1293,0,1280,13,6999,5706,1213,67
48,STRĂINĂTATE,GERMANIA,9999,SOGEL,SOGEL,181,"Alegeri Prezidentiale",1,0,2161,0,2161,0,2140,21,6996,4835,2052,88
48,STRĂINĂTATE,GERMANIA,9999,QUAKENBRUCK,QUAKENBRUCK,182,"Alegeri Prezidentiale",1,0,3244,0,3244,0,3229,15,7005,3761,3068,161
48,STRĂINĂTATE,GERMANIA,9999,BREMEN,BREMEN,183,"Alegeri Prezidentiale",1,0,1538,0,1538,0,1528,10,7001,5463,1449,79
48,STRĂINĂTATE,GERMANIA,9999,LUBECK,LUBECK,184,"Alegeri Prezidentiale",1,0,670,0,670,0,664,6,6999,6329,639,25
48,STRĂINĂTATE,GERMANIA,9999,KIEL,KIEL,185,"Alegeri Prezidentiale",1,0,551,0,551,0,546,5,7000,6449,521,25
48,STRĂINĂTATE,GERMANIA,9999,BONN,BONN,186,"Alegeri Prezidentiale",1,0,1442,0,1442,0,1431,11,6000,4558,1365,66
48,STRĂINĂTATE,GERMANIA,9999,BONN,BONN,187,"Alegeri Prezidentiale",1,0,1424,0,1424,0,1420,4,6000,4576,1335,85
48,STRĂINĂTATE,GERMANIA,9999,KOLN,KOLN,188,"Alegeri Prezidentiale",1,0,2946,0,2946,0,2925,21,6000,3054,2785,140
48,STRĂINĂTATE,GERMANIA,9999,"OFFENBACH AM MAIN","OFFENBACH AM MAIN",189,"Alegeri Prezidentiale",1,0,1099,0,1099,0,1091,8,6000,4901,1031,60
48,STRĂINĂTATE,GERMANIA,9999,"OFFENBACH AM MAIN","OFFENBACH AM MAIN",190,"Alegeri Prezidentiale",1,0,4329,0,4329,0,4304,25,5997,1668,4098,206
48,STRĂINĂTATE,GERMANIA,9999,"FRANKFURT AM MAIN","FRANKFURT AM MAIN",191,"Alegeri Prezidentiale",1,0,3324,0,3324,0,3296,28,6000,2676,3087,209
48,STRĂINĂTATE,GERMANIA,9999,DUSSELDORF,DUSSELDORF,192,"Alegeri Prezidentiale",1,0,2672,0,2672,0,2664,8,6000,3328,2521,143
48,STRĂINĂTATE,GERMANIA,9999,BOCHUM,BOCHUM,193,"Alegeri Prezidentiale",1,0,2066,0,2066,0,2049,17,5999,3933,1930,119
48,STRĂINĂTATE,GERMANIA,9999,HERNE,HERNE,194,"Alegeri Prezidentiale",1,0,2451,0,2451,0,2439,12,6000,3549,2265,174
48,STRĂINĂTATE,GERMANIA,9999,NEUBECKUM-WARENDORF,NEUBECKUM-WARENDORF,195,"Alegeri Prezidentiale",1,0,1526,0,1526,0,1513,13,6000,4474,1439,74
48,STRĂINĂTATE,GERMANIA,9999,GUTERSLOCH,GUTERSLOCH,196,"Alegeri Prezidentiale",2,0,3796,0,3796,0,3772,24,6000,2204,3596,176
48,STRĂINĂTATE,GERMANIA,9999,MÖNCHENGLADBACH,MÖNCHENGLADBACH,197,"Alegeri Prezidentiale",2,0,2481,0,2481,0,2458,22,5999,3519,2327,131
48,STRĂINĂTATE,GERMANIA,9999,HARSEWINKEL,HARSEWINKEL,198,"Alegeri Prezidentiale",2,0,1107,0,1107,0,1105,2,6000,4893,1064,41
48,STRĂINĂTATE,GERMANIA,9999,HOCHTAUNUS-USINGEN,HOCHTAUNUS-USINGEN,199,"Alegeri Prezidentiale",1,0,562,0,562,0,559,3,6000,5438,541,18
48,STRĂINĂTATE,GERMANIA,9999,GIEßEN,GIEßEN,200,"Alegeri Prezidentiale",1,0,1896,0,1896,0,1885,11,6001,4105,1799,86
48,STRĂINĂTATE,GERMANIA,9999,"LUDWIGSHAFEN AM RHEIN","LUDWIGSHAFEN AM RHEIN",201,"Alegeri Prezidentiale",1,0,2450,0,2450,0,2429,21,6000,3550,2321,108
48,STRĂINĂTATE,GERMANIA,9999,TRIER,TRIER,202,"Alegeri Prezidentiale",1,0,1815,0,1815,0,1787,28,6000,4185,1704,83
48,STRĂINĂTATE,GERMANIA,9999,MAINZ,MAINZ,203,"Alegeri Prezidentiale",1,0,3116,0,3116,0,3101,15,6000,2884,2967,134
48,STRĂINĂTATE,GERMANIA,9999,SAARBRÜCKEN,SAARBRÜCKEN,204,"Alegeri Prezidentiale",1,0,1701,0,1701,0,1694,7,6000,4299,1575,119
48,STRĂINĂTATE,GERMANIA,9999,"NEUSTADT AN DER WEINSTRASSE","NEUSTADT AN DER WEINSTRASSE",205,"Alegeri Prezidentiale",1,0,1225,0,1225,0,1219,6,6008,4783,1149,70
48,STRĂINĂTATE,GERMANIA,9999,STUTTGART,STUTTGART,206,"Alegeri Prezidentiale",1,0,1479,0,1479,0,1472,7,8000,6521,1406,66
48,STRĂINĂTATE,GERMANIA,9999,STUTTGART,STUTTGART,207,"Alegeri Prezidentiale",1,0,1465,0,1465,0,1459,6,8000,6535,1383,76
48,STRĂINĂTATE,GERMANIA,9999,STUTTGART,STUTTGART,208,"Alegeri Prezidentiale",1,0,490,0,490,0,485,5,8000,7510,459,26
48,STRĂINĂTATE,GERMANIA,9999,STUTTGART,STUTTGART,209,"Alegeri Prezidentiale",1,0,728,0,728,0,723,5,8000,7272,689,34
48,STRĂINĂTATE,GERMANIA,9999,KARLSRUHE,KARLSRUHE,210,"Alegeri Prezidentiale",1,0,1877,0,1877,0,1859,18,8000,6123,1761,98
48,STRĂINĂTATE,GERMANIA,9999,KARLSRUHE,KARLSRUHE,211,"Alegeri Prezidentiale",1,0,1945,0,1945,0,1938,7,7992,6047,1863,75
48,STRĂINĂTATE,GERMANIA,9999,ULM,ULM,212,"Alegeri Prezidentiale",1,0,2322,0,2322,0,2301,21,7984,5662,2215,86
48,STRĂINĂTATE,GERMANIA,9999,ULM,ULM,213,"Alegeri Prezidentiale",1,0,2022,0,2022,0,2002,20,8008,5986,1945,57
48,STRĂINĂTATE,GERMANIA,9999,EPPELHEIM,EPPELHEIM,214,"Alegeri Prezidentiale",2,0,1483,0,1483,0,1465,18,7000,5517,1395,70
48,STRĂINĂTATE,GERMANIA,9999,"ESSLINGEN AM NECKAR","ESSLINGEN AM NECKAR",215,"Alegeri Prezidentiale",1,0,2099,0,2099,0,2078,21,6993,4894,1996,82
48,STRĂINĂTATE,GERMANIA,9999,"FREIBURG IM BREISGAU","FREIBURG IM BREISGAU",216,"Alegeri Prezidentiale",1,0,2740,0,2740,0,2720,20,9000,6260,2564,156
48,STRĂINĂTATE,GERMANIA,9999,KONSTANZ,KONSTANZ,217,"Alegeri Prezidentiale",1,0,1293,0,1293,0,1278,15,7000,5707,1173,105
48,STRĂINĂTATE,GERMANIA,9999,"LAUFFEN AM NECKAR","LAUFFEN AM NECKAR",218,"Alegeri Prezidentiale",1,0,3704,0,3704,0,3678,26,9000,5296,3513,165
48,STRĂINĂTATE,GERMANIA,9999,LUDWIGSBURG,LUDWIGSBURG,219,"Alegeri Prezidentiale",2,0,2156,0,2156,0,2141,15,7000,4844,2000,141
48,STRĂINĂTATE,GERMANIA,9999,MANNHEIM,MANNHEIM,220,"Alegeri Prezidentiale",1,0,2290,0,2290,0,2271,19,7006,4716,2176,95
48,STRĂINĂTATE,GERMANIA,9999,OFFENBURG,OFFENBURG,221,"Alegeri Prezidentiale",1,0,1717,0,1717,0,1705,12,7000,5283,1632,73
48,STRĂINĂTATE,GERMANIA,9999,PFORZHEIM,PFORZHEIM,222,"Alegeri Prezidentiale",1,0,2691,0,2691,0,2671,20,6984,4293,2546,125
48,STRĂINĂTATE,GERMANIA,9999,RASTATT,RASTATT,223,"Alegeri Prezidentiale",1,0,2299,0,2299,0,2260,39,7000,4701,2137,123
48,STRĂINĂTATE,GERMANIA,9999,REUTLINGEN,REUTLINGEN,224,"Alegeri Prezidentiale",1,0,2352,0,2352,0,2335,17,6999,4647,2239,96
48,STRĂINĂTATE,GERMANIA,9999,"SCHWÄBISCH HALL","SCHWÄBISCH HALL",225,"Alegeri Prezidentiale",1,0,2619,0,2619,0,2611,8,7000,4381,2493,118
48,STRĂINĂTATE,GERMANIA,9999,TROSSINGEN,TROSSINGEN,226,"Alegeri Prezidentiale",1,0,3891,0,3891,0,3856,35,9000,5109,3664,192
48,STRĂINĂTATE,GERMANIA,9999,"WANGEN IM ALLGÄU","WANGEN IM ALLGÄU",227,"Alegeri Prezidentiale",1,0,2311,0,2311,0,2298,12,6985,4674,2209,89
48,STRĂINĂTATE,GERMANIA,9999,MÜNCHEN,MÜNCHEN,228,"Alegeri Prezidentiale",2,0,1496,0,1496,0,1486,10,5993,4497,1415,71
48,STRĂINĂTATE,GERMANIA,9999,MÜNCHEN,MÜNCHEN,229,"Alegeri Prezidentiale",1,0,1489,0,1489,0,1482,7,6000,4511,1427,55
48,STRĂINĂTATE,GERMANIA,9999,MÜNCHEN,MÜNCHEN,230,"Alegeri Prezidentiale",1,0,1486,0,1486,0,1469,17,6000,4514,1400,69
48,STRĂINĂTATE,GERMANIA,9999,MÜNCHEN,MÜNCHEN,231,"Alegeri Prezidentiale",1,0,1486,0,1486,0,1481,5,5993,4507,1417,64
48,STRĂINĂTATE,GERMANIA,9999,MÜNCHEN,MÜNCHEN,232,"Alegeri Prezidentiale",2,0,1487,0,1487,0,1471,16,6000,4513,1406,65
48,STRĂINĂTATE,GERMANIA,9999,MÜNCHEN,MÜNCHEN,233,"Alegeri Prezidentiale",1,0,1486,0,1486,0,1475,11,6001,4515,1406,69
48,STRĂINĂTATE,GERMANIA,9999,KÖNIGSBRUNN,KÖNIGSBRUNN,234,"Alegeri Prezidentiale",1,0,1056,0,1056,0,1046,10,7000,5944,1007,39
48,STRĂINĂTATE,GERMANIA,9999,LANDSHUT,LANDSHUT,235,"Alegeri Prezidentiale",1,0,2252,0,2252,0,2233,19,7000,4748,2093,140
48,STRĂINĂTATE,GERMANIA,9999,NÜRNBERG,NÜRNBERG,236,"Alegeri Prezidentiale",1,0,1613,0,1613,0,1599,14,6000,4387,1523,76
48,STRĂINĂTATE,GERMANIA,9999,NÜRNBERG,NÜRNBERG,237,"Alegeri Prezidentiale",1,0,1627,0,1627,0,1621,6,6000,4373,1545,76
48,STRĂINĂTATE,GERMANIA,9999,NÜRNBERG,NÜRNBERG,238,"Alegeri Prezidentiale",1,0,1683,0,1683,0,1665,18,6000,4317,1589,76
48,STRĂINĂTATE,GERMANIA,9999,NÜRNBERG,NÜRNBERG,239,"Alegeri Prezidentiale",1,0,1740,0,1740,0,1720,20,6000,4260,1624,96
48,STRĂINĂTATE,GERMANIA,9999,NÜRNBERG,NÜRNBERG,240,"Alegeri Prezidentiale",1,0,1492,0,1492,0,1487,5,6000,4508,1422,65
48,STRĂINĂTATE,GERMANIA,9999,NÜRNBERG,NÜRNBERG,241,"Alegeri Prezidentiale",1,0,1706,0,1706,0,1688,18,6000,4294,1614,74
48,STRĂINĂTATE,GERMANIA,9999,FREISING,FREISING,242,"Alegeri Prezidentiale",1,0,1214,0,1214,0,1207,7,7000,5786,1142,65
48,STRĂINĂTATE,GERMANIA,9999,WÜRZBURG,WÜRZBURG,243,"Alegeri Prezidentiale",1,0,2551,0,2551,0,2526,25,6999,4448,2427,99
48,STRĂINĂTATE,GERMANIA,9999,KARLSFELD,KARLSFELD,244,"Alegeri Prezidentiale",1,0,1445,0,1445,0,1438,7,7000,5555,1380,58
48,STRĂINĂTATE,GERMANIA,9999,INGOLSTADT,INGOLSTADT,245,"Alegeri Prezidentiale",1,0,3062,0,3062,0,3019,43,7000,3938,2894,125
48,STRĂINĂTATE,GERMANIA,9999,"VILSHOFEN BEI PASSAU","VILSHOFEN BEI PASSAU",246,"Alegeri Prezidentiale",1,0,1475,0,1475,0,1469,6,7003,5528,1388,81
48,STRĂINĂTATE,GERMANIA,9999,DONAUWÖRTH,DONAUWÖRTH,247,"Alegeri Prezidentiale",1,0,1035,0,1035,0,1027,8,7000,5965,978,49
48,STRĂINĂTATE,GERMANIA,9999,STRAUBING,STRAUBING,248,"Alegeri Prezidentiale",1,0,3655,0,3655,0,3629,26,6998,3343,3461,168
48,STRĂINĂTATE,GERMANIA,9999,ERDING,ERDING,249,"Alegeri Prezidentiale",1,0,1549,0,1549,0,1545,4,6999,5450,1485,60
48,STRĂINĂTATE,GERMANIA,9999,AUGSBURG,AUGSBURG,250,"Alegeri Prezidentiale",1,0,2885,0,2885,0,2867,18,7000,4115,2753,114
48,STRĂINĂTATE,GERMANIA,9999,AFFING,AFFING,251,"Alegeri Prezidentiale",1,0,747,0,747,0,743,4,7000,6253,702,41
48,STRĂINĂTATE,GRECIA,9999,ATENA,ATENA,252,"Alegeri Prezidentiale",1,0,301,0,301,0,300,1,8000,7699,265,35
48,STRĂINĂTATE,GRECIA,9999,ATENA,ATENA,253,"Alegeri Prezidentiale",1,0,308,0,308,0,305,3,8000,7692,268,37
48,STRĂINĂTATE,GRECIA,9999,ATENA,ATENA,254,"Alegeri Prezidentiale",1,0,351,0,351,0,347,4,8000,7649,313,34
48,STRĂINĂTATE,GRECIA,9999,ATENA,ATENA,255,"Alegeri Prezidentiale",1,0,2089,0,2089,0,2078,11,8000,5911,1915,163
48,STRĂINĂTATE,GRECIA,9999,PATRA,PATRA,256,"Alegeri Prezidentiale",1,0,142,0,142,0,141,1,5000,4858,122,19
48,STRĂINĂTATE,GRECIA,9999,SPARTI,SPARTI,257,"Alegeri Prezidentiale",1,0,361,0,361,0,360,1,5000,4639,320,40
48,STRĂINĂTATE,GRECIA,9999,IRAKLIO,IRAKLIO,258,"Alegeri Prezidentiale",1,0,219,0,219,0,218,1,4999,4780,182,36
48,STRĂINĂTATE,GRECIA,9999,CHANIA,CHANIA,259,"Alegeri Prezidentiale",1,0,249,0,249,0,245,4,5000,4751,218,27
48,STRĂINĂTATE,GRECIA,9999,THIVA,THIVA,260,"Alegeri Prezidentiale",1,0,246,0,246,0,244,2,5000,4754,228,16
48,STRĂINĂTATE,GRECIA,9999,SALONIC,SALONIC,261,"Alegeri Prezidentiale",1,0,230,0,230,0,225,5,2500,2270,182,43
48,STRĂINĂTATE,GRECIA,9999,SALONIC,SALONIC,262,"Alegeri Prezidentiale",1,0,100,0,100,0,98,2,2500,2400,86,12
48,STRĂINĂTATE,IORDANIA,9999,AMMAN,AMMAN,263,"Alegeri Prezidentiale",1,0,264,0,264,0,264,0,800,536,228,36
48,STRĂINĂTATE,INDIA,9999,"NEW DELHI","NEW DELHI",264,"Alegeri Prezidentiale",1,0,75,0,75,0,75,0,200,125,57,18
48,STRĂINĂTATE,"REPUBLICA INDONEZIA",9999,JAKARTA,JAKARTA,265,"Alegeri Prezidentiale",1,0,67,0,67,0,64,3,250,183,37,27
48,STRĂINĂTATE,IRLANDA,9999,DUBLIN,DUBLIN,266,"Alegeri Prezidentiale",1,0,2040,0,2040,0,2032,8,4048,2008,1959,73
48,STRĂINĂTATE,IRLANDA,9999,DUBLIN,DUBLIN,267,"Alegeri Prezidentiale",1,0,1557,0,1557,0,1546,11,4000,2443,1490,56
48,STRĂINĂTATE,IRLANDA,9999,DUBLIN,DUBLIN,268,"Alegeri Prezidentiale",1,0,1178,0,1178,0,1170,8,3980,2802,1127,43
48,STRĂINĂTATE,IRLANDA,9999,DUBLIN,DUBLIN,269,"Alegeri Prezidentiale",1,0,1600,0,1600,0,1588,12,4000,2400,1544,44
48,STRĂINĂTATE,IRLANDA,9999,DUBLIN,DUBLIN,270,"Alegeri Prezidentiale",1,0,985,0,985,0,979,6,4000,3015,943,36
48,STRĂINĂTATE,IRLANDA,9999,DUBLIN,DUBLIN,271,"Alegeri Prezidentiale",1,0,916,0,916,0,910,6,4000,3084,869,41
48,STRĂINĂTATE,IRLANDA,9999,DUBLIN,DUBLIN,272,"Alegeri Prezidentiale",1,0,750,0,750,0,738,12,4000,3250,714,24
48,STRĂINĂTATE,IRLANDA,9999,DUBLIN,DUBLIN,273,"Alegeri Prezidentiale",1,0,755,0,755,0,749,6,4000,3245,717,32
48,STRĂINĂTATE,IRLANDA,9999,DUBLIN,DUBLIN,274,"Alegeri Prezidentiale",1,0,744,0,744,0,741,3,4000,3256,696,45
48,STRĂINĂTATE,IRLANDA,9999,DUBLIN,DUBLIN,275,"Alegeri Prezidentiale",1,0,819,0,819,0,815,4,4000,3181,779,36
48,STRĂINĂTATE,IRLANDA,9999,CORK,CORK,276,"Alegeri Prezidentiale",1,0,651,0,651,0,646,5,1101,450,617,29
48,STRĂINĂTATE,IRLANDA,9999,DROGHEDA,DROGHEDA,277,"Alegeri Prezidentiale",1,0,1088,0,1088,0,1083,5,3502,2414,1011,72
48,STRĂINĂTATE,IRLANDA,9999,GALWAY,GALWAY,278,"Alegeri Prezidentiale",2,0,542,0,542,0,536,6,3500,2958,501,35
48,STRĂINĂTATE,IRLANDA,9999,KILKENNY,KILKENNY,279,"Alegeri Prezidentiale",1,0,572,0,572,0,570,2,3500,2928,538,32
48,STRĂINĂTATE,IRLANDA,9999,LIMERICK,LIMERICK,280,"Alegeri Prezidentiale",1,0,465,0,465,0,464,1,3500,3035,444,20
48,STRĂINĂTATE,IRLANDA,9999,WATERFORD,WATERFORD,281,"Alegeri Prezidentiale",2,0,267,0,267,0,261,6,3490,3223,257,4
48,STRĂINĂTATE,ISRAEL,9999,"TEL AVIV","TEL AVIV",282,"Alegeri Prezidentiale",1,0,527,0,527,0,525,2,4000,3473,470,55
48,STRĂINĂTATE,ISRAEL,9999,"TEL AVIV","TEL AVIV",283,"Alegeri Prezidentiale",1,0,252,0,252,0,251,1,4001,3749,216,35
48,STRĂINĂTATE,ISRAEL,9999,IERUSALIM,IERUSALIM,284,"Alegeri Prezidentiale",1,0,1251,0,1251,0,1197,54,4000,2749,713,484
48,STRĂINĂTATE,ISRAEL,9999,HAIFA,HAIFA,285,"Alegeri Prezidentiale",1,0,364,0,364,0,360,4,4000,3636,272,88
48,STRĂINĂTATE,ISLANDA,9999,REYKJAVIK,REYKJAVIK,286,"Alegeri Prezidentiale",1,0,697,0,697,0,688,9,2000,1303,660,28
48,STRĂINĂTATE,ITALIA,9999,ROMA,ROMA,287,"Alegeri Prezidentiale",1,0,1081,0,1081,0,1062,19,10001,8920,976,86
48,STRĂINĂTATE,ITALIA,9999,ROMA,ROMA,288,"Alegeri Prezidentiale",1,0,4031,0,4031,0,4010,21,8000,3969,3718,292
48,STRĂINĂTATE,ITALIA,9999,ROMA,ROMA,289,"Alegeri Prezidentiale",1,0,3065,0,3065,0,3046,19,8000,4935,2861,185
48,STRĂINĂTATE,ITALIA,9999,ROMA,ROMA,290,"Alegeri Prezidentiale",1,0,3316,0,3316,0,3282,34,8400,5084,2993,289
48,STRĂINĂTATE,ITALIA,9999,ROMA,ROMA,291,"Alegeri Prezidentiale",1,0,1943,0,1943,0,1930,13,8400,6457,1731,199
48,STRĂINĂTATE,ITALIA,9999,OSTIA,OSTIA,292,"Alegeri Prezidentiale",1,0,2385,0,2385,0,2364,21,8400,6015,2198,166
48,STRĂINĂTATE,ITALIA,9999,GUIDONIA,GUIDONIA,293,"Alegeri Prezidentiale",1,0,3278,0,3278,0,3271,7,8000,4722,3031,240
48,STRĂINĂTATE,ITALIA,9999,LADISPOLI,LADISPOLI,294,"Alegeri Prezidentiale",1,0,3042,0,3042,0,3032,10,6000,2958,2881,151
48,STRĂINĂTATE,ITALIA,9999,NAPOLI,NAPOLI,295,"Alegeri Prezidentiale",2,0,884,0,884,0,879,5,4000,3116,813,66
48,STRĂINĂTATE,ITALIA,9999,OLBIA,OLBIA,296,"Alegeri Prezidentiale",1,0,878,0,878,0,871,7,4800,3922,811,60
48,STRĂINĂTATE,ITALIA,9999,PERUGIA,PERUGIA,297,"Alegeri Prezidentiale",1,0,2056,0,2056,0,2036,20,10000,7944,1844,192
48,STRĂINĂTATE,ITALIA,9999,PESCARA,PESCARA,298,"Alegeri Prezidentiale",1,0,1835,0,1835,0,1825,10,6001,4166,1716,109
48,STRĂINĂTATE,ITALIA,9999,TERNI,TERNI,299,"Alegeri Prezidentiale",1,0,1445,0,1445,0,1433,12,5991,4546,1350,83
48,STRĂINĂTATE,ITALIA,9999,VITERBO,VITERBO,300,"Alegeri Prezidentiale",1,0,1486,0,1486,0,1482,4,10000,8514,1374,108
48,STRĂINĂTATE,ITALIA,9999,MONTEROTONDO,MONTEROTONDO,301,"Alegeri Prezidentiale",1,0,2516,0,2516,0,2506,10,6000,3484,2346,160
48,STRĂINĂTATE,ITALIA,9999,PALESTRINA,PALESTRINA,302,"Alegeri Prezidentiale",1,0,2547,0,2547,0,2534,13,5000,2453,2379,155
48,STRĂINĂTATE,ITALIA,9999,"ALBANO LAZIALE","ALBANO LAZIALE",303,"Alegeri Prezidentiale",1,0,2583,0,2583,0,2571,12,4992,2409,2407,164
48,STRĂINĂTATE,ITALIA,9999,FROSIONE,FROSIONE,304,"Alegeri Prezidentiale",1,0,835,0,835,0,830,5,6000,5165,769,61
48,STRĂINĂTATE,ITALIA,9999,CAGLIARI,CAGLIARI,305,"Alegeri Prezidentiale",1,0,438,0,438,0,432,6,3200,2762,367,65
48,STRĂINĂTATE,ITALIA,9999,LATINA,LATINA,306,"Alegeri Prezidentiale",1,0,2595,0,2595,0,2581,14,7000,4405,2427,154
48,STRĂINĂTATE,ITALIA,9999,TIVOLI,TIVOLI,307,"Alegeri Prezidentiale",1,0,1390,0,1390,0,1381,9,7000,5610,1276,105
48,STRĂINĂTATE,ITALIA,9999,"RIGNANO FLAMINIO","RIGNANO FLAMINIO",308,"Alegeri Prezidentiale",1,0,1518,0,1518,0,1512,6,8000,6482,1391,121
48,STRĂINĂTATE,ITALIA,9999,TRIESTE,TRIESTE,309,"Alegeri Prezidentiale",1,0,974,0,974,0,965,9,6000,5026,851,114
48,STRĂINĂTATE,ITALIA,9999,VENETIA,VENETIA,310,"Alegeri Prezidentiale",1,0,818,0,818,0,812,6,4000,3182,743,69
48,STRĂINĂTATE,ITALIA,9999,"CERVIGNANO DEL FRIULI","CERVIGNANO DEL FRIULI",311,"Alegeri Prezidentiale",1,0,929,0,929,0,922,7,4008,3079,875,47
48,STRĂINĂTATE,ITALIA,9999,UDINE,UDINE,312,"Alegeri Prezidentiale",2,0,1833,0,1833,0,1826,7,6000,4167,1661,165
48,STRĂINĂTATE,ITALIA,9999,PORDENONE,PORDENONE,313,"Alegeri Prezidentiale",2,0,2065,0,2065,0,2050,15,6000,3935,1866,184
48,STRĂINĂTATE,ITALIA,9999,"PRATA DI PORDENONE","PRATA DI PORDENONE",314,"Alegeri Prezidentiale",1,0,830,0,830,0,826,4,4000,3170,766,60
48,STRĂINĂTATE,ITALIA,9999,"VIILLAFRANCA DI VERONA","VIILLAFRANCA DI VERONA",315,"Alegeri Prezidentiale",1,0,1685,0,1685,0,1678,7,6000,4315,1559,119
48,STRĂINĂTATE,ITALIA,9999,TREVISO,TREVISO,316,"Alegeri Prezidentiale",1,0,1891,0,1891,0,1879,12,6008,4117,1740,139
48,STRĂINĂTATE,ITALIA,9999,"CASTELFRANCO VENETO","CASTELFRANCO VENETO",317,"Alegeri Prezidentiale",1,0,3751,0,3751,0,3738,13,6000,2249,3553,185
48,STRĂINĂTATE,ITALIA,9999,ODERZO,ODERZO,318,"Alegeri Prezidentiale",1,0,2163,0,2163,0,2143,20,4000,1837,1991,152
48,STRĂINĂTATE,ITALIA,9999,"SAN DONA DI PIAVE","SAN DONA DI PIAVE",319,"Alegeri Prezidentiale",1,0,1021,0,1021,0,1012,9,4000,2979,947,65
48,STRĂINĂTATE,ITALIA,9999,PADOVA,PADOVA,320,"Alegeri Prezidentiale",1,0,1566,0,1566,0,1546,20,6000,4434,1419,127
48,STRĂINĂTATE,ITALIA,9999,PADOVA,PADOVA,321,"Alegeri Prezidentiale",1,0,1113,0,1113,0,1104,9,6000,4887,1025,79
48,STRĂINĂTATE,ITALIA,9999,CADONEGHE,CADONEGHE,322,"Alegeri Prezidentiale",1,0,3628,0,3628,0,3614,14,4015,387,3426,188
48,STRĂINĂTATE,ITALIA,9999,ALBIGNASEGO,ALBIGNASEGO,323,"Alegeri Prezidentiale",1,0,1315,0,1315,0,1307,8,4000,2685,1238,69
48,STRĂINĂTATE,ITALIA,9999,VICENZA,VICENZA,324,"Alegeri Prezidentiale",1,0,1560,0,1560,0,1545,15,6000,4440,1434,111
48,STRĂINĂTATE,ITALIA,9999,SCHIO,SCHIO,325,"Alegeri Prezidentiale",1,0,760,0,760,0,754,6,4000,3240,726,28
48,STRĂINĂTATE,ITALIA,9999,VERONA,VERONA,326,"Alegeri Prezidentiale",1,0,3512,0,3512,0,3496,16,6000,2488,3300,196
48,STRĂINĂTATE,ITALIA,9999,VERONA,VERONA,327,"Alegeri Prezidentiale",1,0,1432,0,1432,0,1424,8,6000,4568,1336,88
48,STRĂINĂTATE,ITALIA,9999,"VALEGGIO SUL MINCIO","VALEGGIO SUL MINCIO",328,"Alegeri Prezidentiale",1,0,895,0,895,0,891,4,4000,3105,841,50
48,STRĂINĂTATE,ITALIA,9999,BARI,BARI,329,"Alegeri Prezidentiale",1,0,230,0,230,0,224,6,5000,4770,193,31
48,STRĂINĂTATE,ITALIA,9999,BARI,BARI,330,"Alegeri Prezidentiale",1,0,326,0,326,0,317,9,5001,4675,267,50
48,STRĂINĂTATE,ITALIA,9999,FOGGIA,FOGGIA,331,"Alegeri Prezidentiale",1,0,493,0,493,0,490,3,10000,9507,459,31
48,STRĂINĂTATE,ITALIA,9999,LECCE,LECCE,332,"Alegeri Prezidentiale",1,0,330,0,330,0,325,5,10000,9670,292,33
48,STRĂINĂTATE,ITALIA,9999,TARANTO,TARANTO,333,"Alegeri Prezidentiale",1,0,280,0,280,0,279,1,4000,3720,248,31
48,STRĂINĂTATE,ITALIA,9999,"TRANI (REGIUNEA PUGLIA)","TRANI (REGIUNEA PUGLIA)",334,"Alegeri Prezidentiale",2,0,247,0,247,0,247,0,4000,3753,191,56
48,STRĂINĂTATE,ITALIA,9999,GINOSA,GINOSA,335,"Alegeri Prezidentiale",1,0,251,0,251,0,248,3,1001,750,226,22
48,STRĂINĂTATE,ITALIA,9999,COSENZA,COSENZA,336,"Alegeri Prezidentiale",1,0,308,0,308,0,305,3,10000,9692,278,27
48,STRĂINĂTATE,ITALIA,9999,"REGGIO CALABRIA","REGGIO CALABRIA",337,"Alegeri Prezidentiale",1,0,462,0,462,0,457,5,7000,6538,410,47
48,STRĂINĂTATE,ITALIA,9999,CROTONE,CROTONE,338,"Alegeri Prezidentiale",1,0,146,0,146,0,146,0,3001,2855,125,21
48,STRĂINĂTATE,ITALIA,9999,CATANZARO,CATANZARO,339,"Alegeri Prezidentiale",1,0,184,0,184,0,184,0,4001,3817,173,11
48,STRĂINĂTATE,ITALIA,9999,"VIBO VALENTIA","VIBO VALENTIA",340,"Alegeri Prezidentiale",1,0,147,0,147,0,147,0,4000,3853,123,24
48,STRĂINĂTATE,ITALIA,9999,POTENZA,POTENZA,341,"Alegeri Prezidentiale",1,0,192,0,192,0,192,0,4000,3808,173,19
48,STRĂINĂTATE,ITALIA,9999,MATERA,MATERA,342,"Alegeri Prezidentiale",1,0,206,0,206,0,201,5,5000,4794,174,27
48,STRĂINĂTATE,ITALIA,9999,CAMPOBASSO,CAMPOBASSO,343,"Alegeri Prezidentiale",1,0,249,0,249,0,246,3,2000,1751,220,26
48,STRĂINĂTATE,ITALIA,9999,ISERNIA,ISERNIA,344,"Alegeri Prezidentiale",1,0,108,0,108,0,105,3,2000,1892,95,10
48,STRĂINĂTATE,ITALIA,9999,BOLOGNA,BOLOGNA,345,"Alegeri Prezidentiale",1,0,2479,0,2479,0,2450,29,10000,7521,2206,244
48,STRĂINĂTATE,ITALIA,9999,"BORGO PANIGALE","BORGO PANIGALE",346,"Alegeri Prezidentiale",1,0,1385,0,1385,0,1381,4,10008,8623,1270,111
48,STRĂINĂTATE,ITALIA,9999,MALALBERGO,MALALBERGO,347,"Alegeri Prezidentiale",1,0,669,0,669,0,665,4,10001,9332,628,37
48,STRĂINĂTATE,ITALIA,9999,IMOLA,IMOLA,348,"Alegeri Prezidentiale",1,0,2023,0,2023,0,2009,14,10000,7977,1861,148
48,STRĂINĂTATE,ITALIA,9999,PIACENZA,PIACENZA,349,"Alegeri Prezidentiale",2,0,1844,0,1844,0,1832,12,10000,8156,1724,108
48,STRĂINĂTATE,ITALIA,9999,PARMA,PARMA,350,"Alegeri Prezidentiale",1,0,1420,0,1420,0,1412,8,10000,8580,1312,100
48,STRĂINĂTATE,ITALIA,9999,"REGGIO EMILIA","REGGIO EMILIA",351,"Alegeri Prezidentiale",1,0,876,0,876,0,871,5,10000,9124,816,55
48,STRĂINĂTATE,ITALIA,9999,MODENA,MODENA,352,"Alegeri Prezidentiale",1,0,1759,0,1759,0,1751,8,10000,8241,1627,124
48,STRĂINĂTATE,ITALIA,9999,RIMINI,RIMINI,353,"Alegeri Prezidentiale",1,0,1034,0,1034,0,1029,5,10000,8966,944,85
48,STRĂINĂTATE,ITALIA,9999,CESENA,CESENA,354,"Alegeri Prezidentiale",1,0,818,0,818,0,811,7,10000,9182,759,52
48,STRĂINĂTATE,ITALIA,9999,FORLI,FORLI,355,"Alegeri Prezidentiale",1,0,1386,0,1386,0,1379,7,10001,8615,1264,115
48,STRĂINĂTATE,ITALIA,9999,PESARO,PESARO,356,"Alegeri Prezidentiale",1,0,691,0,691,0,684,7,10000,9309,639,45
48,STRĂINĂTATE,ITALIA,9999,ANCONA,ANCONA,357,"Alegeri Prezidentiale",1,0,1672,0,1672,0,1655,17,10000,8328,1507,148
48,STRĂINĂTATE,ITALIA,9999,MACERATA,MACERATA,358,"Alegeri Prezidentiale",1,0,833,0,833,0,827,6,10000,9167,779,48
48,STRĂINĂTATE,ITALIA,9999,PRATO,PRATO,359,"Alegeri Prezidentiale",1,0,1414,0,1414,0,1407,7,10000,8586,1315,92
48,STRĂINĂTATE,ITALIA,9999,FLORENȚA,FLORENȚA,360,"Alegeri Prezidentiale",1,0,2391,0,2391,0,2370,21,10000,7609,2160,210
48,STRĂINĂTATE,ITALIA,9999,PISTOIA,PISTOIA,361,"Alegeri Prezidentiale",1,0,1069,0,1069,0,1052,17,10006,8937,946,106
48,STRĂINĂTATE,ITALIA,9999,AREZZO,AREZZO,362,"Alegeri Prezidentiale",1,0,2406,0,2406,0,2392,14,10000,7594,2204,188
48,STRĂINĂTATE,ITALIA,9999,GROSSETO,GROSSETO,363,"Alegeri Prezidentiale",1,0,1086,0,1086,0,1083,3,10000,8914,983,100
48,STRĂINĂTATE,ITALIA,9999,SIENA,SIENA,364,"Alegeri Prezidentiale",1,0,917,0,917,0,911,6,10000,9083,824,87
48,STRĂINĂTATE,ITALIA,9999,MASSA,MASSA,365,"Alegeri Prezidentiale",1,0,1327,0,1327,0,1320,7,10000,8673,1239,81
48,STRĂINĂTATE,ITALIA,9999,LUCCA,LUCCA,366,"Alegeri Prezidentiale",1,0,1388,0,1388,0,1376,12,10000,8612,1258,118
48,STRĂINĂTATE,ITALIA,9999,LIVORNO,LIVORNO,367,"Alegeri Prezidentiale",1,0,1276,0,1276,0,1271,5,10000,8724,1170,101
48,STRĂINĂTATE,ITALIA,9999,SESTO-FIORENTINO,SESTO-FIORENTINO,368,"Alegeri Prezidentiale",1,0,945,0,945,0,933,12,10002,9057,857,76
48,STRĂINĂTATE,ITALIA,9999,RAVENNA,RAVENNA,369,"Alegeri Prezidentiale",1,0,1401,0,1401,0,1394,7,10000,8599,1294,100
48,STRĂINĂTATE,ITALIA,9999,FERRARA,FERRARA,370,"Alegeri Prezidentiale",1,0,1116,0,1116,0,1112,4,10000,8884,1029,83
48,STRĂINĂTATE,ITALIA,9999,CATANIA,CATANIA,371,"Alegeri Prezidentiale",1,0,602,0,602,0,600,2,3000,2398,554,46
48,STRĂINĂTATE,ITALIA,9999,CATANIA,CATANIA,372,"Alegeri Prezidentiale",1,0,477,0,477,0,472,5,3000,2523,404,68
48,STRĂINĂTATE,ITALIA,9999,PALERMO,PALERMO,373,"Alegeri Prezidentiale",1,0,952,0,952,0,942,10,3000,2048,820,122
48,STRĂINĂTATE,ITALIA,9999,VITTORIA,VITTORIA,374,"Alegeri Prezidentiale",1,0,555,0,555,0,546,9,3000,2445,492,54
48,STRĂINĂTATE,ITALIA,9999,ALCAMO,ALCAMO,375,"Alegeri Prezidentiale",1,0,460,0,460,0,459,1,3000,2540,416,43
48,STRĂINĂTATE,ITALIA,9999,CANICATTI,CANICATTI,376,"Alegeri Prezidentiale",1,0,486,0,486,0,482,4,3000,2514,424,58
48,STRĂINĂTATE,ITALIA,9999,MILANO,MILANO,377,"Alegeri Prezidentiale",1,0,865,0,865,0,856,9,7008,6143,783,73
48,STRĂINĂTATE,ITALIA,9999,MILANO,MILANO,378,"Alegeri Prezidentiale",1,0,746,0,746,0,735,11,7000,6254,669,66
48,STRĂINĂTATE,ITALIA,9999,MILANO,MILANO,379,"Alegeri Prezidentiale",1,0,2694,0,2694,0,2673,21,7001,4307,2455,218
48,STRĂINĂTATE,ITALIA,9999,COMO,COMO,380,"Alegeri Prezidentiale",1,0,1546,0,1546,0,1535,11,3500,1954,1400,135
48,STRĂINĂTATE,ITALIA,9999,VARESE,VARESE,381,"Alegeri Prezidentiale",1,0,1060,0,1060,0,1050,10,3499,2439,972,78
48,STRĂINĂTATE,ITALIA,9999,LODI,LODI,382,"Alegeri Prezidentiale",2,0,2125,0,2125,0,2113,12,4500,2375,1968,145
48,STRĂINĂTATE,ITALIA,9999,CREMA,CREMA,383,"Alegeri Prezidentiale",2,0,793,0,793,0,788,5,3500,2707,708,80
48,STRĂINĂTATE,ITALIA,9999,CREMONA,CREMONA,384,"Alegeri Prezidentiale",1,0,1648,0,1648,0,1636,12,3501,1853,1508,128
48,STRĂINĂTATE,ITALIA,9999,PAVIA,PAVIA,385,"Alegeri Prezidentiale",1,0,1806,0,1806,0,1801,5,3502,1696,1711,90
48,STRĂINĂTATE,ITALIA,9999,BERGAMO,BERGAMO,386,"Alegeri Prezidentiale",2,0,2624,0,2624,0,2604,20,3500,876,2445,159
48,STRĂINĂTATE,ITALIA,9999,"ROMANO DI LOMBARDIA","ROMANO DI LOMBARDIA",387,"Alegeri Prezidentiale",1,0,1628,0,1628,0,1613,15,3500,1872,1500,113
48,STRĂINĂTATE,ITALIA,9999,BRESCIA,BRESCIA,388,"Alegeri Prezidentiale",1,0,2610,0,2610,0,2597,13,5001,2391,2428,169
48,STRĂINĂTATE,ITALIA,9999,MONTICHIARI,MONTICHIARI,389,"Alegeri Prezidentiale",1,0,2051,0,2051,0,2036,15,3600,1549,1919,117
48,STRĂINĂTATE,ITALIA,9999,MANTOVA,MANTOVA,390,"Alegeri Prezidentiale",1,0,1066,0,1066,0,1059,7,3600,2534,991,68
48,STRĂINĂTATE,ITALIA,9999,ROVERETO,ROVERETO,391,"Alegeri Prezidentiale",2,0,577,0,577,0,576,1,3600,3023,523,53
48,STRĂINĂTATE,ITALIA,9999,CLES,CLES,392,"Alegeri Prezidentiale",1,0,864,0,864,0,861,3,3600,2736,790,71
48,STRĂINĂTATE,ITALIA,9999,TRENTO,TRENTO,393,"Alegeri Prezidentiale",1,0,1226,0,1226,0,1212,14,4491,3265,1137,75
48,STRĂINĂTATE,ITALIA,9999,BOLZANO,BOLZANO,394,"Alegeri Prezidentiale",1,0,914,0,914,0,902,12,3600,2686,836,66
48,STRĂINĂTATE,ITALIA,9999,MONZA,MONZA,395,"Alegeri Prezidentiale",1,0,4287,0,4287,0,4269,18,5000,713,4014,255
48,STRĂINĂTATE,ITALIA,9999,"SESTO SAN GIOVANNI","SESTO SAN GIOVANNI",396,"Alegeri Prezidentiale",1,0,1373,0,1373,0,1304,69,5000,3627,1218,86
48,STRĂINĂTATE,ITALIA,9999,TORINO,TORINO,397,"Alegeri Prezidentiale",1,0,4084,0,4084,0,4052,31,10000,5916,3669,383
48,STRĂINĂTATE,ITALIA,9999,TORINO,TORINO,398,"Alegeri Prezidentiale",2,0,2989,0,2989,0,2972,17,10000,7011,2734,238
48,STRĂINĂTATE,ITALIA,9999,TORINO,TORINO,399,"Alegeri Prezidentiale",1,0,381,0,381,0,378,3,9998,9617,352,26
48,STRĂINĂTATE,ITALIA,9999,TORINO,TORINO,400,"Alegeri Prezidentiale",1,0,805,0,805,0,800,5,9995,9190,740,60
48,STRĂINĂTATE,ITALIA,9999,TORINO,TORINO,401,"Alegeri Prezidentiale",2,0,2173,0,2173,0,2158,15,10008,7835,2032,126
48,STRĂINĂTATE,ITALIA,9999,MONCALIERI,MONCALIERI,402,"Alegeri Prezidentiale",1,0,1195,0,1195,0,1189,6,10000,8805,1119,70
48,STRĂINĂTATE,ITALIA,9999,CHIERI,CHIERI,403,"Alegeri Prezidentiale",1,0,952,0,952,0,939,13,9999,9047,877,62
48,STRĂINĂTATE,ITALIA,9999,NICHELINO,NICHELINO,404,"Alegeri Prezidentiale",1,0,1054,0,1054,0,1048,6,5000,3946,964,84
48,STRĂINĂTATE,ITALIA,9999,"SETTIMO TORINESE","SETTIMO TORINESE",405,"Alegeri Prezidentiale",1,0,890,0,890,0,888,2,4999,4109,825,63
48,STRĂINĂTATE,ITALIA,9999,PINEROLO,PINEROLO,406,"Alegeri Prezidentiale",1,0,1262,0,1262,0,1251,11,5000,3738,1166,85
48,STRĂINĂTATE,ITALIA,9999,CARMAGNOLA,CARMAGNOLA,407,"Alegeri Prezidentiale",1,0,1078,0,1078,0,1073,5,5000,3922,984,89
48,STRĂINĂTATE,ITALIA,9999,COLLEGNO,COLLEGNO,408,"Alegeri Prezidentiale",1,0,2082,0,2082,0,2072,10,5000,2918,1944,128
48,STRĂINĂTATE,ITALIA,9999,CHIVASSO,CHIVASSO,409,"Alegeri Prezidentiale",1,0,876,0,876,0,871,5,5000,4124,820,51
48,STRĂINĂTATE,ITALIA,9999,IVREA,IVREA,410,"Alegeri Prezidentiale",1,0,1060,0,1060,0,1051,9,5000,3940,983,68
48,STRĂINĂTATE,ITALIA,9999,CIRIE,CIRIE,411,"Alegeri Prezidentiale",2,0,876,0,876,0,872,4,5000,4124,823,49
48,STRĂINĂTATE,ITALIA,9999,SUSA,SUSA,412,"Alegeri Prezidentiale",1,0,481,0,481,0,477,4,5000,4519,450,27
48,STRĂINĂTATE,ITALIA,9999,CUNEO,CUNEO,413,"Alegeri Prezidentiale",1,0,1037,0,1037,0,1032,5,5000,3963,954,78
48,STRĂINĂTATE,ITALIA,9999,ALBA,ALBA,414,"Alegeri Prezidentiale",1,0,1409,0,1409,0,1402,7,5000,3591,1301,101
48,STRĂINĂTATE,ITALIA,9999,MONDOVI,MONDOVI,415,"Alegeri Prezidentiale",1,0,393,0,393,0,393,0,5000,4607,353,40
48,STRĂINĂTATE,ITALIA,9999,BIELLA,BIELLA,416,"Alegeri Prezidentiale",1,0,432,0,432,0,428,4,5000,4568,390,38
48,STRĂINĂTATE,ITALIA,9999,VERBANIA,VERBANIA,417,"Alegeri Prezidentiale",1,0,305,0,305,0,304,1,5000,4695,276,28
48,STRĂINĂTATE,ITALIA,9999,VERCELLI,VERCELLI,418,"Alegeri Prezidentiale",1,0,537,0,537,0,535,2,5001,4464,485,50
48,STRĂINĂTATE,ITALIA,9999,ALESSANDRIA,ALESSANDRIA,419,"Alegeri Prezidentiale",1,0,1020,0,1020,0,1012,8,5000,3980,925,87
48,STRĂINĂTATE,ITALIA,9999,TORTONA,TORTONA,420,"Alegeri Prezidentiale",1,0,1547,0,1547,0,1531,16,5000,3453,1430,101
48,STRĂINĂTATE,ITALIA,9999,NOVARA,NOVARA,421,"Alegeri Prezidentiale",1,0,945,0,945,0,939,6,5002,4057,853,86
48,STRĂINĂTATE,ITALIA,9999,ASTI,ASTI,422,"Alegeri Prezidentiale",1,0,1086,0,1086,0,1080,6,5000,3914,990,90
48,STRĂINĂTATE,ITALIA,9999,GENOVA,GENOVA,423,"Alegeri Prezidentiale",1,0,1451,0,1451,0,1441,10,5004,3553,1348,93
48,STRĂINĂTATE,ITALIA,9999,"LA SPEZIA","LA SPEZIA",424,"Alegeri Prezidentiale",1,0,1259,0,1259,0,1248,11,5000,3741,1163,85
48,STRĂINĂTATE,ITALIA,9999,SANREMO,SANREMO,425,"Alegeri Prezidentiale",1,0,640,0,640,0,637,3,5000,4360,589,48
48,STRĂINĂTATE,ITALIA,9999,IMPERIA,IMPERIA,426,"Alegeri Prezidentiale",1,0,309,0,309,0,307,2,5000,4691,285,22
48,STRĂINĂTATE,ITALIA,9999,SAVONA,SAVONA,427,"Alegeri Prezidentiale",1,0,338,0,338,0,335,3,5000,4662,306,29
48,STRĂINĂTATE,ITALIA,9999,AOSTA,AOSTA,428,"Alegeri Prezidentiale",1,0,627,0,627,0,621,6,5000,4373,589,32
48,STRĂINĂTATE,IRAK,9999,BAGDAD,BAGDAD,429,"Alegeri Prezidentiale",1,0,21,0,21,0,17,4,149,128,14,3
48,STRĂINĂTATE,IRAK,9999,ERBIL,ERBIL,430,"Alegeri Prezidentiale",1,0,35,0,35,0,34,1,150,115,26,8
48,STRĂINĂTATE,IRAN,9999,TEHERAN,TEHERAN,431,"Alegeri Prezidentiale",1,0,31,0,31,0,31,0,200,169,27,4
48,STRĂINĂTATE,JAPONIA,9999,TOKYO,TOKYO,432,"Alegeri Prezidentiale",1,0,281,0,281,0,277,4,800,519,261,16
48,STRĂINĂTATE,KAZAHSTAN,9999,NUR-SULTAN,NUR-SULTAN,433,"Alegeri Prezidentiale",1,0,23,0,23,0,23,0,200,177,20,3
48,STRĂINĂTATE,KENYA,9999,NAIROBI,NAIROBI,434,"Alegeri Prezidentiale",1,0,34,0,34,0,34,0,201,167,32,2
48,STRĂINĂTATE,KUWEIT,9999,KUWEIT,KUWEIT,435,"Alegeri Prezidentiale",1,0,248,0,248,0,246,2,800,552,220,26
48,STRĂINĂTATE,LIBAN,9999,BEIRUT,BEIRUT,436,"Alegeri Prezidentiale",1,0,157,0,157,0,155,2,500,343,135,20
48,STRĂINĂTATE,LITUANIA,9999,VILNIUS,VILNIUS,437,"Alegeri Prezidentiale",1,0,85,0,85,0,83,2,501,416,73,10
48,STRĂINĂTATE,LETONIA,9999,RIGA,RIGA,438,"Alegeri Prezidentiale",1,0,87,0,87,0,87,0,499,412,80,7
48,STRĂINĂTATE,LUXEMBURG,9999,LUXEMBURG,LUXEMBURG,439,"Alegeri Prezidentiale",1,0,1555,0,1555,0,1548,7,4000,2445,1451,97
48,STRĂINĂTATE,LUXEMBURG,9999,LUXEMBURG,LUXEMBURG,440,"Alegeri Prezidentiale",1,0,1097,0,1097,0,1085,12,4000,2903,1015,70
48,STRĂINĂTATE,LUXEMBURG,9999,LUXEMBURG,LUXEMBURG,441,"Alegeri Prezidentiale",1,0,448,0,448,0,443,5,4000,3552,417,26
48,STRĂINĂTATE,"MACEDONIA DE NORD",9999,SKOPJE,SKOPJE,442,"Alegeri Prezidentiale",1,0,56,0,56,0,53,3,400,344,45,8
48,STRĂINĂTATE,MALAEZIA,9999,"KUALA LUMPUR","KUALA LUMPUR",443,"Alegeri Prezidentiale",1,0,90,0,90,0,90,0,500,410,83,7
48,STRĂINĂTATE,"REPUBLICA MALI",9999,GAO,GAO,444,"Alegeri Prezidentiale",1,0,115,0,115,0,111,4,400,285,95,16
48,STRĂINĂTATE,MALTA,9999,"SAN PAWL IL-BAHAR","SAN PAWL IL-BAHAR",445,"Alegeri Prezidentiale",1,0,847,0,847,0,830,17,3200,2353,786,44
48,STRĂINĂTATE,MAROC,9999,RABAT,RABAT,446,"Alegeri Prezidentiale",1,0,121,0,121,0,118,3,800,679,100,18
48,STRĂINĂTATE,MEXIC,9999,"CIUDAD DE MÉXICO","CIUDAD DE MÉXICO",447,"Alegeri Prezidentiale",1,0,99,0,99,0,96,3,401,302,79,17
48,STRĂINĂTATE,"REPUBLICA MOLDOVA",9999,CHIȘINĂU,CHIȘINĂU,448,"Alegeri Prezidentiale",1,0,4610,0,4610,0,4596,14,6000,1390,4376,220
48,STRĂINĂTATE,"REPUBLICA MOLDOVA",9999,CHIȘINĂU,CHIȘINĂU,449,"Alegeri Prezidentiale",1,0,2912,0,2912,0,2803,109,7000,4088,2743,60
48,STRĂINĂTATE,"REPUBLICA MOLDOVA",9999,CHIȘINĂU,CHIȘINĂU,450,"Alegeri Prezidentiale",1,0,2108,0,2108,0,2103,5,4000,1892,2051,52
48,STRĂINĂTATE,"REPUBLICA MOLDOVA",9999,CHIȘINĂU,CHIȘINĂU,451,"Alegeri Prezidentiale",1,0,4588,0,4588,0,4582,6,7000,2412,4447,135
48,STRĂINĂTATE,"REPUBLICA MOLDOVA",9999,CHIȘINĂU,CHIȘINĂU,452,"Alegeri Prezidentiale",1,0,1861,0,1861,0,1851,10,6001,4140,1764,87
48,STRĂINĂTATE,"REPUBLICA MOLDOVA",9999,CHIȘINĂU,CHIȘINĂU,453,"Alegeri Prezidentiale",1,0,1915,0,1915,0,1909,6,5000,3085,1861,48
48,STRĂINĂTATE,"REPUBLICA MOLDOVA",9999,CHIȘINĂU,CHIȘINĂU,454,"Alegeri Prezidentiale",1,0,2251,0,2251,0,2248,3,5000,2749,2170,78
48,STRĂINĂTATE,"REPUBLICA MOLDOVA",9999,CHIȘINĂU,CHIȘINĂU,455,"Alegeri Prezidentiale",1,0,1306,0,1306,0,1305,1,4000,2694,1265,40
48,STRĂINĂTATE,"REPUBLICA MOLDOVA",9999,CHIȘINĂU,CHIȘINĂU,456,"Alegeri Prezidentiale",1,0,1057,0,1057,0,1052,5,4000,2943,1018,34
48,STRĂINĂTATE,"REPUBLICA MOLDOVA",9999,CHIȘINĂU,CHIȘINĂU,457,"Alegeri Prezidentiale",1,0,2013,0,2013,0,2011,2,5000,2987,1956,55
48,STRĂINĂTATE,"REPUBLICA MOLDOVA",9999,CHIȘINĂU,CHIȘINĂU,458,"Alegeri Prezidentiale",1,0,1282,0,1282,0,1279,3,5000,3718,1232,47
48,STRĂINĂTATE,"REPUBLICA MOLDOVA",9999,CHIȘINĂU,CHIȘINĂU,459,"Alegeri Prezidentiale",1,0,762,0,762,0,761,1,5000,4238,740,21
48,STRĂINĂTATE,"REPUBLICA MOLDOVA",9999,HÎNCEȘTI,HÎNCEȘTI,460,"Alegeri Prezidentiale",1,0,1435,0,1435,0,1431,4,5000,3565,1386,45
48,STRĂINĂTATE,"REPUBLICA MOLDOVA",9999,IALOVENI,IALOVENI,461,"Alegeri Prezidentiale",1,0,2727,0,2727,0,2722,5,7000,4273,2637,85
48,STRĂINĂTATE,"REPUBLICA MOLDOVA",9999,NISPORENI,NISPORENI,462,"Alegeri Prezidentiale",1,0,1119,0,1119,0,1116,3,2500,1381,1040,76
48,STRĂINĂTATE,"REPUBLICA MOLDOVA",9999,ORHEI,ORHEI,463,"Alegeri Prezidentiale",1,0,2235,0,2235,0,2234,1,4997,2762,2167,67
48,STRĂINĂTATE,"REPUBLICA MOLDOVA",9999,CĂUȘENI,CĂUȘENI,464,"Alegeri Prezidentiale",1,0,1087,0,1087,0,1084,3,5006,3919,1044,40
48,STRĂINĂTATE,"REPUBLICA MOLDOVA",9999,"ANENII NOI","ANENII NOI",465,"Alegeri Prezidentiale",1,0,776,0,776,0,770,6,5000,4224,740,30
48,STRĂINĂTATE,"REPUBLICA MOLDOVA",9999,BARDAR,BARDAR,466,"Alegeri Prezidentiale",1,0,475,0,475,0,475,0,3600,3125,459,16
48,STRĂINĂTATE,"REPUBLICA MOLDOVA",9999,CĂLĂRAȘI,CĂLĂRAȘI,467,"Alegeri Prezidentiale",1,0,1230,0,1230,0,1230,0,4998,3768,1186,44
48,STRĂINĂTATE,"REPUBLICA MOLDOVA",9999,DURLEȘTI,DURLEȘTI,468,"Alegeri Prezidentiale",1,0,1561,0,1561,0,1559,2,6000,4439,1507,52
48,STRĂINĂTATE,"REPUBLICA MOLDOVA",9999,STRĂȘENI,STRĂȘENI,469,"Alegeri Prezidentiale",1,0,1417,0,1417,0,1416,1,6000,4583,1355,61
48,STRĂINĂTATE,"REPUBLICA MOLDOVA",9999,BĂLȚI,BĂLȚI,470,"Alegeri Prezidentiale",1,0,985,0,985,0,984,1,3200,2215,949,35
48,STRĂINĂTATE,"REPUBLICA MOLDOVA",9999,BĂLȚI,BĂLȚI,471,"Alegeri Prezidentiale",1,0,1055,0,1055,0,1051,4,3200,2145,1018,33
48,STRĂINĂTATE,"REPUBLICA MOLDOVA",9999,UNGHENI,UNGHENI,472,"Alegeri Prezidentiale",1,0,1596,0,1596,0,1595,1,3200,1604,1524,71
48,STRĂINĂTATE,"REPUBLICA MOLDOVA",9999,SOROCA,SOROCA,473,"Alegeri Prezidentiale",1,0,733,0,733,0,733,0,3200,2467,692,41
48,STRĂINĂTATE,"REPUBLICA MOLDOVA",9999,DROCHIA,DROCHIA,474,"Alegeri Prezidentiale",1,0,689,0,689,0,686,3,3200,2511,658,28
48,STRĂINĂTATE,"REPUBLICA MOLDOVA",9999,EDINEŢ,EDINEŢ,475,"Alegeri Prezidentiale",1,0,708,0,708,0,706,2,3200,2492,659,47
48,STRĂINĂTATE,"REPUBLICA MOLDOVA",9999,FĂLEȘTI,FĂLEȘTI,476,"Alegeri Prezidentiale",1,0,382,0,382,0,379,3,3200,2818,364,15
48,STRĂINĂTATE,"REPUBLICA MOLDOVA",9999,FLOREȘTI,FLOREȘTI,477,"Alegeri Prezidentiale",1,0,453,0,453,0,452,1,3200,2747,425,27
48,STRĂINĂTATE,"REPUBLICA MOLDOVA",9999,TELENEȘTI,TELENEȘTI,478,"Alegeri Prezidentiale",1,0,705,0,705,0,705,0,3200,2495,686,19
48,STRĂINĂTATE,"REPUBLICA MOLDOVA",9999,CAHUL,CAHUL,479,"Alegeri Prezidentiale",3,0,1714,0,1714,0,1710,4,7000,5286,1619,91
48,STRĂINĂTATE,"REPUBLICA MOLDOVA",9999,CANTEMIR,CANTEMIR,480,"Alegeri Prezidentiale",1,0,619,0,619,0,619,0,5001,4382,594,25
48,STRĂINĂTATE,"REPUBLICA MOLDOVA",9999,LEOVA,LEOVA,481,"Alegeri Prezidentiale",1,0,557,0,557,0,556,1,5001,4444,528,28
48,STRĂINĂTATE,"REPUBLICA MOLDOVA",9999,CIMIȘLIA,CIMIȘLIA,482,"Alegeri Prezidentiale",1,0,677,0,677,0,675,2,4999,4322,651,24
48,STRĂINĂTATE,"REPUBLICA MOLDOVA",9999,CARABETOVCA,CARABETOVCA,483,"Alegeri Prezidentiale",1,0,213,0,213,0,213,0,2998,2785,205,8
48,STRĂINĂTATE,"REPUBLICA MOLDOVA",9999,GIURGIULEȘTI,GIURGIULEȘTI,484,"Alegeri Prezidentiale",1,0,462,0,462,0,461,1,5007,4545,419,42
48,STRĂINĂTATE,MUNTENEGRU,9999,PODGORICA,PODGORICA,485,"Alegeri Prezidentiale",1,0,25,0,25,0,24,1,400,375,20,4
48,STRĂINĂTATE,NORVEGIA,9999,OSLO,OSLO,486,"Alegeri Prezidentiale",1,0,917,0,917,0,907,10,3501,2584,861,46
48,STRĂINĂTATE,NORVEGIA,9999,OSLO,OSLO,487,"Alegeri Prezidentiale",1,0,959,0,959,0,946,13,3500,2541,900,46
48,STRĂINĂTATE,NORVEGIA,9999,OSLO,OSLO,488,"Alegeri Prezidentiale",1,0,226,0,226,0,223,3,3501,3275,205,18
48,STRĂINĂTATE,NORVEGIA,9999,OPPÅKERMOEN,OPPÅKERMOEN,489,"Alegeri Prezidentiale",1,0,248,0,248,0,245,3,3500,3252,235,10
48,STRĂINĂTATE,NORVEGIA,9999,KRISTIANSAND,KRISTIANSAND,490,"Alegeri Prezidentiale",1,0,212,0,212,0,207,5,3500,3288,191,16
48,STRĂINĂTATE,NORVEGIA,9999,STAVANGER,STAVANGER,491,"Alegeri Prezidentiale",1,0,768,0,768,0,753,15,3501,2733,727,26
48,STRĂINĂTATE,NORVEGIA,9999,BERGEN,BERGEN,492,"Alegeri Prezidentiale",1,0,891,0,891,0,878,13,3500,2609,828,50
48,STRĂINĂTATE,NORVEGIA,9999,VATNE,VATNE,493,"Alegeri Prezidentiale",1,0,571,0,571,0,569,2,3500,2929,543,26
48,STRĂINĂTATE,NORVEGIA,9999,TRONDHEIM,TRONDHEIM,494,"Alegeri Prezidentiale",1,0,199,0,199,0,197,2,3500,3301,182,15
48,STRĂINĂTATE,NORVEGIA,9999,TROMSØ,TROMSØ,495,"Alegeri Prezidentiale",2,0,192,0,192,0,192,0,3500,3308,185,7
48,STRĂINĂTATE,NIGERIA,9999,ABUJA,ABUJA,496,"Alegeri Prezidentiale",1,0,21,0,21,0,21,0,200,179,19,2
48,STRĂINĂTATE,OLANDA,9999,AMSTERDAM,AMSTERDAM,497,"Alegeri Prezidentiale",1,0,969,0,969,0,963,6,3600,2631,926,37
48,STRĂINĂTATE,OLANDA,9999,AMSTERDAM,AMSTERDAM,498,"Alegeri Prezidentiale",1,0,1168,0,1168,0,1164,4,3600,2432,1122,42
48,STRĂINĂTATE,OLANDA,9999,AMSTERDAM,AMSTERDAM,499,"Alegeri Prezidentiale",1,0,800,0,800,0,793,7,3600,2800,766,27
48,STRĂINĂTATE,OLANDA,9999,AMSTERDAM,AMSTERDAM,500,"Alegeri Prezidentiale",2,0,888,0,888,0,871,17,3600,2712,844,27
48,STRĂINĂTATE,OLANDA,9999,AMSTERDAM,AMSTERDAM,501,"Alegeri Prezidentiale",1,0,716,0,716,0,701,15,3600,2884,685,16
48,STRĂINĂTATE,OLANDA,9999,HAGA,HAGA,502,"Alegeri Prezidentiale",1,0,381,0,381,0,377,4,3600,3219,350,27
48,STRĂINĂTATE,OLANDA,9999,HAGA,HAGA,503,"Alegeri Prezidentiale",1,0,476,0,476,0,472,4,3600,3124,453,19
48,STRĂINĂTATE,OLANDA,9999,HAGA,HAGA,504,"Alegeri Prezidentiale",1,0,455,0,455,0,449,6,3592,3137,428,21
48,STRĂINĂTATE,OLANDA,9999,HAGA,HAGA,505,"Alegeri Prezidentiale",1,0,438,0,438,0,432,6,3605,3167,414,18
48,STRĂINĂTATE,OLANDA,9999,ROTTERDAM,ROTTERDAM,506,"Alegeri Prezidentiale",1,0,1219,0,1219,0,1207,12,3590,2371,1152,55
48,STRĂINĂTATE,OLANDA,9999,ROTTERDAM,ROTTERDAM,507,"Alegeri Prezidentiale",1,0,532,0,532,0,522,10,3600,3068,505,17
48,STRĂINĂTATE,OLANDA,9999,ROTTERDAM,ROTTERDAM,508,"Alegeri Prezidentiale",1,0,564,0,564,0,559,5,3600,3036,542,17
48,STRĂINĂTATE,OLANDA,9999,ROTTERDAM,ROTTERDAM,509,"Alegeri Prezidentiale",1,0,336,0,336,0,333,3,3600,3264,307,26
48,STRĂINĂTATE,OLANDA,9999,ROTTERDAM,ROTTERDAM,510,"Alegeri Prezidentiale",1,0,325,0,325,0,322,3,3600,3275,304,18
48,STRĂINĂTATE,OLANDA,9999,GRONINGEN,GRONINGEN,511,"Alegeri Prezidentiale",1,0,247,0,247,0,245,2,3600,3353,235,10
48,STRĂINĂTATE,OLANDA,9999,GRONINGEN,GRONINGEN,512,"Alegeri Prezidentiale",1,0,374,0,374,0,371,3,3599,3225,359,12
48,STRĂINĂTATE,OLANDA,9999,GRONINGEN,GRONINGEN,513,"Alegeri Prezidentiale",1,0,376,0,376,0,373,3,3598,3222,359,14
48,STRĂINĂTATE,OLANDA,9999,GRONINGEN,GRONINGEN,514,"Alegeri Prezidentiale",1,0,240,0,240,0,236,4,3600,3360,226,10
48,STRĂINĂTATE,OLANDA,9999,EINDHOVEN,EINDHOVEN,515,"Alegeri Prezidentiale",2,0,680,0,680,0,672,8,3600,2920,640,32
48,STRĂINĂTATE,OLANDA,9999,EINDHOVEN,EINDHOVEN,516,"Alegeri Prezidentiale",1,0,688,0,688,0,678,10,3600,2912,649,29
48,STRĂINĂTATE,OLANDA,9999,EINDHOVEN,EINDHOVEN,517,"Alegeri Prezidentiale",1,0,689,0,689,0,679,10,3600,2911,664,15
48,STRĂINĂTATE,OLANDA,9999,EINDHOVEN,EINDHOVEN,518,"Alegeri Prezidentiale",1,0,697,0,697,0,695,2,3600,2903,666,29
48,STRĂINĂTATE,OLANDA,9999,HAGA,HAGA,519,"Alegeri Prezidentiale",1,0,590,0,590,0,585,5,3596,3006,565,20
48,STRĂINĂTATE,OLANDA,9999,HAGA,HAGA,520,"Alegeri Prezidentiale",1,0,554,0,554,0,549,5,3599,3045,521,28
48,STRĂINĂTATE,OLANDA,9999,HAGA,HAGA,521,"Alegeri Prezidentiale",1,0,525,0,525,0,521,4,3600,3075,505,16
48,STRĂINĂTATE,"SULTANATUL OMAN",9999,MUSCAT,MUSCAT,522,"Alegeri Prezidentiale",2,0,132,0,132,0,132,0,800,668,124,8
48,STRĂINĂTATE,PAKISTAN,9999,ISLAMABAD,ISLAMABAD,523,"Alegeri Prezidentiale",1,0,20,0,20,0,20,0,100,80,20,0
48,STRĂINĂTATE,PALESTINA,9999,RAMALLAH,RAMALLAH,524,"Alegeri Prezidentiale",1,0,46,0,46,0,45,1,400,354,36,9
48,STRĂINĂTATE,PERU,9999,LIMA,LIMA,525,"Alegeri Prezidentiale",1,0,60,0,60,0,59,1,500,440,55,4
48,STRĂINĂTATE,POLONIA,9999,VARŞOVIA,VARŞOVIA,526,"Alegeri Prezidentiale",1,0,634,0,634,0,616,18,2000,1366,557,59
48,STRĂINĂTATE,POLONIA,9999,CRACOVIA,CRACOVIA,527,"Alegeri Prezidentiale",1,0,379,0,379,0,365,14,1200,821,348,17
48,STRĂINĂTATE,POLONIA,9999,WROCLAW,WROCLAW,528,"Alegeri Prezidentiale",1,0,143,0,143,0,142,1,1199,1056,135,7
48,STRĂINĂTATE,POLONIA,9999,GDANSK,GDANSK,529,"Alegeri Prezidentiale",1,0,121,0,121,0,120,1,1200,1079,114,6
48,STRĂINĂTATE,PORTUGALIA,9999,LISABONA,LISABONA,530,"Alegeri Prezidentiale",1,0,639,0,639,0,634,5,3600,2961,587,47
48,STRĂINĂTATE,PORTUGALIA,9999,LISABONA,LISABONA,531,"Alegeri Prezidentiale",1,0,609,0,609,0,606,3,2500,1891,573,33
48,STRĂINĂTATE,PORTUGALIA,9999,LISABONA,LISABONA,532,"Alegeri Prezidentiale",1,0,376,0,376,0,367,9,2500,2124,329,38
48,STRĂINĂTATE,PORTUGALIA,9999,PORTO,PORTO,533,"Alegeri Prezidentiale",1,0,225,0,225,0,221,4,2500,2275,210,11
48,STRĂINĂTATE,PORTUGALIA,9999,LEIRIA,LEIRIA,534,"Alegeri Prezidentiale",1,0,121,0,121,0,118,3,2500,2379,104,14
48,STRĂINĂTATE,PORTUGALIA,9999,SETUBAL,SETUBAL,535,"Alegeri Prezidentiale",1,0,376,0,376,0,374,2,2492,2116,346,28
48,STRĂINĂTATE,PORTUGALIA,9999,LAGOS,LAGOS,536,"Alegeri Prezidentiale",1,0,231,0,231,0,229,2,2500,2269,212,17
48,STRĂINĂTATE,PORTUGALIA,9999,LOULÉ,LOULÉ,537,"Alegeri Prezidentiale",1,0,662,0,662,0,660,2,2500,1838,592,68
48,STRĂINĂTATE,PORTUGALIA,9999,TAVIRA,TAVIRA,538,"Alegeri Prezidentiale",1,0,157,0,157,0,155,2,2501,2344,140,15
48,STRĂINĂTATE,QATAR,9999,DOHA,DOHA,539,"Alegeri Prezidentiale",1,0,577,0,577,0,572,5,2400,1823,536,36
48,STRĂINĂTATE,"REGATUL UNIT AL MARII BRITANII SI IRLANDEI DE NORD",9999,LONDRA,LONDRA,540,"Alegeri Prezidentiale",1,0,2505,0,2505,0,2470,35,12000,9495,2345,125
48,STRĂINĂTATE,"REGATUL UNIT AL MARII BRITANII SI IRLANDEI DE NORD",9999,LONDRA,LONDRA,541,"Alegeri Prezidentiale",1,0,2048,0,2048,0,2028,20,12000,9952,1940,88
48,STRĂINĂTATE,"REGATUL UNIT AL MARII BRITANII SI IRLANDEI DE NORD",9999,LONDRA,LONDRA,542,"Alegeri Prezidentiale",1,0,537,0,537,0,533,4,12000,11463,503,30
48,STRĂINĂTATE,"REGATUL UNIT AL MARII BRITANII SI IRLANDEI DE NORD",9999,LONDRA,LONDRA,543,"Alegeri Prezidentiale",1,0,2197,0,2197,0,2183,14,12000,9803,2065,118
48,STRĂINĂTATE,"REGATUL UNIT AL MARII BRITANII SI IRLANDEI DE NORD",9999,LONDRA,LONDRA,544,"Alegeri Prezidentiale",4,0,2684,0,2684,0,2652,32,12000,9316,2547,105
48,STRĂINĂTATE,"REGATUL UNIT AL MARII BRITANII SI IRLANDEI DE NORD",9999,LONDRA/BRENT,LONDRA/BRENT,545,"Alegeri Prezidentiale",2,0,2766,0,2766,0,2749,17,12000,9234,2634,115
48,STRĂINĂTATE,"REGATUL UNIT AL MARII BRITANII SI IRLANDEI DE NORD",9999,LONDRA/BRENT,LONDRA/BRENT,546,"Alegeri Prezidentiale",1,0,1650,0,1650,0,1644,6,12000,10350,1547,97
48,STRĂINĂTATE,"REGATUL UNIT AL MARII BRITANII SI IRLANDEI DE NORD",9999,LONDRA/BRENT,LONDRA/BRENT,547,"Alegeri Prezidentiale",1,0,2846,0,2846,0,2824,22,12000,9154,2711,113
48,STRĂINĂTATE,"REGATUL UNIT AL MARII BRITANII SI IRLANDEI DE NORD",9999,LONDRA/STRATFORD,LONDRA/STRATFORD,548,"Alegeri Prezidentiale",1,0,8514,0,8514,0,8417,97,12000,3486,8061,356
48,STRĂINĂTATE,"REGATUL UNIT AL MARII BRITANII SI IRLANDEI DE NORD",9999,LONDRA/STRATFORD,LONDRA/STRATFORD,549,"Alegeri Prezidentiale",2,0,8044,0,8044,0,7973,71,12000,3956,7635,338
48,STRĂINĂTATE,"REGATUL UNIT AL MARII BRITANII SI IRLANDEI DE NORD",9999,LONDRA/CAMDEN,LONDRA/CAMDEN,550,"Alegeri Prezidentiale",2,0,1972,0,1972,0,1954,18,12000,10028,1851,103
48,STRĂINĂTATE,"REGATUL UNIT AL MARII BRITANII SI IRLANDEI DE NORD",9999,LONDRA/HARROW,LONDRA/HARROW,551,"Alegeri Prezidentiale",1,0,4167,0,4167,0,4143,24,12000,7833,3958,185
48,STRĂINĂTATE,"REGATUL UNIT AL MARII BRITANII SI IRLANDEI DE NORD",9999,LONDRA/HARROW,LONDRA/HARROW,552,"Alegeri Prezidentiale",1,0,5098,0,5098,0,5063,35,12000,6902,4850,213
48,STRĂINĂTATE,"REGATUL UNIT AL MARII BRITANII SI IRLANDEI DE NORD",9999,"LONDRA EDGWARE","LONDRA EDGWARE",553,"Alegeri Prezidentiale",1,0,4282,0,4282,0,4257,25,11975,7693,4076,181
48,STRĂINĂTATE,"REGATUL UNIT AL MARII BRITANII SI IRLANDEI DE NORD",9999,LONDRA/WATFORD,LONDRA/WATFORD,554,"Alegeri Prezidentiale",1,0,3889,0,3889,0,3856,33,12000,8111,3676,180
48,STRĂINĂTATE,"REGATUL UNIT AL MARII BRITANII SI IRLANDEI DE NORD",9999,LONDRA/BATTERSEA,LONDRA/BATTERSEA,555,"Alegeri Prezidentiale",2,0,1798,0,1798,0,1792,6,12000,10202,1719,73
48,STRĂINĂTATE,"REGATUL UNIT AL MARII BRITANII SI IRLANDEI DE NORD",9999,LONDRA/BARKING,LONDRA/BARKING,556,"Alegeri Prezidentiale",1,0,7379,0,7379,0,7331,48,12000,4621,7040,291
48,STRĂINĂTATE,"REGATUL UNIT AL MARII BRITANII SI IRLANDEI DE NORD",9999,LONDRA/WANDSWORTH,LONDRA/WANDSWORTH,557,"Alegeri Prezidentiale",1,0,2604,0,2604,0,2591,13,11984,9380,2499,92
48,STRĂINĂTATE,"REGATUL UNIT AL MARII BRITANII SI IRLANDEI DE NORD",9999,SLOUGH,SLOUGH,558,"Alegeri Prezidentiale",1,0,4410,0,4410,0,4374,36,10022,5612,4212,162
48,STRĂINĂTATE,"REGATUL UNIT AL MARII BRITANII SI IRLANDEI DE NORD",9999,PORTSMOUTH,PORTSMOUTH,559,"Alegeri Prezidentiale",1,0,1978,0,1978,0,1953,25,10000,8022,1848,105
48,STRĂINĂTATE,"REGATUL UNIT AL MARII BRITANII SI IRLANDEI DE NORD",9999,READING,READING,560,"Alegeri Prezidentiale",1,0,3023,0,3023,0,2994,29,10000,6977,2868,126
48,STRĂINĂTATE,"REGATUL UNIT AL MARII BRITANII SI IRLANDEI DE NORD",9999,WOKING,WOKING,561,"Alegeri Prezidentiale",1,0,2397,0,2397,0,2380,17,9991,7594,2276,104
48,STRĂINĂTATE,"REGATUL UNIT AL MARII BRITANII SI IRLANDEI DE NORD",9999,SOUTHAMPTON,SOUTHAMPTON,562,"Alegeri Prezidentiale",1,0,2549,0,2549,0,2533,16,9992,7443,2438,95
48,STRĂINĂTATE,"REGATUL UNIT AL MARII BRITANII SI IRLANDEI DE NORD",9999,CANTERBURY,CANTERBURY,563,"Alegeri Prezidentiale",2,0,3546,0,3546,0,3520,26,10000,6454,3394,126
48,STRĂINĂTATE,"REGATUL UNIT AL MARII BRITANII SI IRLANDEI DE NORD",9999,"INSULA JERSEY (JERSEY)","INSULA JERSEY (JERSEY)",564,"Alegeri Prezidentiale",2,0,716,0,716,0,714,2,7492,6776,690,24
48,STRĂINĂTATE,"REGATUL UNIT AL MARII BRITANII SI IRLANDEI DE NORD",9999,LUTON,LUTON,565,"Alegeri Prezidentiale",1,0,3011,0,3011,0,2969,42,10007,6996,2813,156
48,STRĂINĂTATE,"REGATUL UNIT AL MARII BRITANII SI IRLANDEI DE NORD",9999,LUTON,LUTON,566,"Alegeri Prezidentiale",1,0,2400,0,2400,0,2379,21,9991,7591,2275,104
48,STRĂINĂTATE,"REGATUL UNIT AL MARII BRITANII SI IRLANDEI DE NORD",9999,OXFORD,OXFORD,567,"Alegeri Prezidentiale",1,0,2156,0,2156,0,2133,23,9999,7843,2045,88
48,STRĂINĂTATE,"REGATUL UNIT AL MARII BRITANII SI IRLANDEI DE NORD",9999,"MILTON KEYNES/ BEDFORD","MILTON KEYNES/ BEDFORD",568,"Alegeri Prezidentiale",1,0,3834,0,3834,0,3801,33,4801,967,3633,168
48,STRĂINĂTATE,"REGATUL UNIT AL MARII BRITANII SI IRLANDEI DE NORD",9999,"REDDITCH / WARWICK / LEMINGTON SPA","REDDITCH / WARWICK / LEMINGTON SPA",569,"Alegeri Prezidentiale",2,0,1560,0,1560,0,1540,20,10000,8440,1468,72
48,STRĂINĂTATE,"REGATUL UNIT AL MARII BRITANII SI IRLANDEI DE NORD",9999,PETERBOROUGH,PETERBOROUGH,570,"Alegeri Prezidentiale",1,0,2990,0,2990,0,2957,33,10000,7010,2819,138
48,STRĂINĂTATE,"REGATUL UNIT AL MARII BRITANII SI IRLANDEI DE NORD",9999,COLCHESTER,COLCHESTER,571,"Alegeri Prezidentiale",1,0,3196,0,3196,0,3170,26,10400,7204,3003,167
48,STRĂINĂTATE,"REGATUL UNIT AL MARII BRITANII SI IRLANDEI DE NORD",9999,NORWICH,NORWICH,572,"Alegeri Prezidentiale",1,0,1151,0,1151,0,1141,10,10000,8849,1090,51
48,STRĂINĂTATE,"REGATUL UNIT AL MARII BRITANII SI IRLANDEI DE NORD",9999,CRAWLEY,CRAWLEY,573,"Alegeri Prezidentiale",1,0,2585,0,2585,0,2557,28,9991,7406,2414,143
48,STRĂINĂTATE,"REGATUL UNIT AL MARII BRITANII SI IRLANDEI DE NORD",9999,BRISTOL,BRISTOL,574,"Alegeri Prezidentiale",1,0,1610,0,1610,0,1588,22,10000,8390,1528,60
48,STRĂINĂTATE,"REGATUL UNIT AL MARII BRITANII SI IRLANDEI DE NORD",9999,BRISTOL,BRISTOL,575,"Alegeri Prezidentiale",1,0,1624,0,1624,0,1608,16,10000,8376,1533,75
48,STRĂINĂTATE,"REGATUL UNIT AL MARII BRITANII SI IRLANDEI DE NORD",9999,SWINDON,SWINDON,576,"Alegeri Prezidentiale",1,0,725,0,725,0,717,8,10000,9275,681,36
48,STRĂINĂTATE,"REGATUL UNIT AL MARII BRITANII SI IRLANDEI DE NORD",9999,SWINDON,SWINDON,577,"Alegeri Prezidentiale",1,0,719,0,719,0,712,7,10000,9281,674,38
48,STRĂINĂTATE,"REGATUL UNIT AL MARII BRITANII SI IRLANDEI DE NORD",9999,LONDRA,LONDRA,578,"Alegeri Prezidentiale",2,0,7401,0,7401,0,7365,36,9990,2589,7058,307
48,STRĂINĂTATE,"REGATUL UNIT AL MARII BRITANII SI IRLANDEI DE NORD",9999,PLYMOUTH,PLYMOUTH,579,"Alegeri Prezidentiale",1,0,1070,0,1070,0,1052,18,10000,8930,990,62
48,STRĂINĂTATE,"REGATUL UNIT AL MARII BRITANII SI IRLANDEI DE NORD",9999,EXETER,EXETER,580,"Alegeri Prezidentiale",1,0,1142,0,1142,0,1127,15,10000,8858,1073,54
48,STRĂINĂTATE,"REGATUL UNIT AL MARII BRITANII SI IRLANDEI DE NORD",9999,BRIGHTON,BRIGHTON,581,"Alegeri Prezidentiale",1,0,1375,0,1375,0,1365,10,10002,8627,1308,57
48,STRĂINĂTATE,"REGATUL UNIT AL MARII BRITANII SI IRLANDEI DE NORD",9999,CARDIFF,CARDIFF,582,"Alegeri Prezidentiale",1,0,940,0,940,0,937,3,10000,9060,892,45
48,STRĂINĂTATE,"REGATUL UNIT AL MARII BRITANII SI IRLANDEI DE NORD",9999,SWANSEA,SWANSEA,583,"Alegeri Prezidentiale",1,0,511,0,511,0,509,2,10000,9489,489,20
48,STRĂINĂTATE,"REGATUL UNIT AL MARII BRITANII SI IRLANDEI DE NORD",9999,HEREFORD,HEREFORD,584,"Alegeri Prezidentiale",1,0,1351,0,1351,0,1345,6,10000,8649,1284,61
48,STRĂINĂTATE,"REGATUL UNIT AL MARII BRITANII SI IRLANDEI DE NORD",9999,MANCHESTER,MANCHESTER,585,"Alegeri Prezidentiale",1,0,1685,0,1685,0,1673,12,10000,8315,1590,83
48,STRĂINĂTATE,"REGATUL UNIT AL MARII BRITANII SI IRLANDEI DE NORD",9999,MANCHESTER,MANCHESTER,586,"Alegeri Prezidentiale",1,0,1827,0,1827,0,1809,18,9997,8170,1717,92
48,STRĂINĂTATE,"REGATUL UNIT AL MARII BRITANII SI IRLANDEI DE NORD",9999,LIVERPOOL,LIVERPOOL,587,"Alegeri Prezidentiale",3,0,2764,0,2764,0,2744,20,5000,2236,2608,136
48,STRĂINĂTATE,"REGATUL UNIT AL MARII BRITANII SI IRLANDEI DE NORD",9999,PRESTON,PRESTON,588,"Alegeri Prezidentiale",2,0,1393,0,1393,0,1378,15,5000,3607,1272,106
48,STRĂINĂTATE,"REGATUL UNIT AL MARII BRITANII SI IRLANDEI DE NORD",9999,LEEDS,LEEDS,589,"Alegeri Prezidentiale",1,0,1462,0,1462,0,1453,9,10000,8538,1297,156
48,STRĂINĂTATE,"REGATUL UNIT AL MARII BRITANII SI IRLANDEI DE NORD",9999,LEEDS,LEEDS,590,"Alegeri Prezidentiale",2,0,1242,0,1242,0,1230,12,7500,6258,1153,77
48,STRĂINĂTATE,"REGATUL UNIT AL MARII BRITANII SI IRLANDEI DE NORD",9999,NORTHAMPTON,NORTHAMPTON,591,"Alegeri Prezidentiale",1,0,4168,0,4168,0,4126,42,10000,5832,3920,206
48,STRĂINĂTATE,"REGATUL UNIT AL MARII BRITANII SI IRLANDEI DE NORD",9999,NORTHAMPTON,NORTHAMPTON,592,"Alegeri Prezidentiale",1,0,1230,0,1230,0,1223,7,10000,8770,1173,50
48,STRĂINĂTATE,"REGATUL UNIT AL MARII BRITANII SI IRLANDEI DE NORD",9999,BIRMINGHAM,BIRMINGHAM,593,"Alegeri Prezidentiale",1,0,2418,0,2418,0,2387,31,10000,7582,2242,145
48,STRĂINĂTATE,"REGATUL UNIT AL MARII BRITANII SI IRLANDEI DE NORD",9999,BIRMINGHAM,BIRMINGHAM,594,"Alegeri Prezidentiale",1,0,2738,0,2738,0,2708,30,9997,7259,2543,165
48,STRĂINĂTATE,"REGATUL UNIT AL MARII BRITANII SI IRLANDEI DE NORD",9999,COVENTRY,COVENTRY,595,"Alegeri Prezidentiale",1,0,2259,0,2259,0,2232,26,7500,5242,2058,174
48,STRĂINĂTATE,"REGATUL UNIT AL MARII BRITANII SI IRLANDEI DE NORD",9999,COVENTRY,COVENTRY,596,"Alegeri Prezidentiale",2,0,1691,0,1691,0,1675,16,7555,5864,1571,104
48,STRĂINĂTATE,"REGATUL UNIT AL MARII BRITANII SI IRLANDEI DE NORD",9999,WOLVERHAMPTON,WOLVERHAMPTON,597,"Alegeri Prezidentiale",1,0,3141,0,3141,0,3110,30,7455,4315,2949,161
48,STRĂINĂTATE,"REGATUL UNIT AL MARII BRITANII SI IRLANDEI DE NORD",9999,LEICESTER,LEICESTER,598,"Alegeri Prezidentiale",1,0,2122,0,2122,0,2093,29,7500,5378,1986,107
48,STRĂINĂTATE,"REGATUL UNIT AL MARII BRITANII SI IRLANDEI DE NORD",9999,NOTTINGHAM,NOTTINGHAM,599,"Alegeri Prezidentiale",1,0,2286,0,2286,0,2264,22,7457,5171,2136,128
48,STRĂINĂTATE,"REGATUL UNIT AL MARII BRITANII SI IRLANDEI DE NORD",9999,DONCASTER,DONCASTER,600,"Alegeri Prezidentiale",1,0,3776,0,3776,0,3737,39,5048,1272,3585,152
48,STRĂINĂTATE,"REGATUL UNIT AL MARII BRITANII SI IRLANDEI DE NORD",9999,"NEWCASTLE UPON TYNE","NEWCASTLE UPON TYNE",601,"Alegeri Prezidentiale",2,0,1469,0,1469,0,1455,14,5000,3531,1380,75
48,STRĂINĂTATE,"REGATUL UNIT AL MARII BRITANII SI IRLANDEI DE NORD",9999,LOUGHBOROUGH,LOUGHBOROUGH,602,"Alegeri Prezidentiale",1,0,754,0,754,0,745,9,5000,4246,722,23
48,STRĂINĂTATE,"REGATUL UNIT AL MARII BRITANII SI IRLANDEI DE NORD",9999,"KINGSTON UPON HULL","KINGSTON UPON HULL",603,"Alegeri Prezidentiale",1,0,1331,0,1331,0,1320,11,5000,3669,1244,76
48,STRĂINĂTATE,"REGATUL UNIT AL MARII BRITANII SI IRLANDEI DE NORD",9999,EDINBURGH,EDINBURGH,604,"Alegeri Prezidentiale",2,0,1043,0,1043,0,1027,16,6000,4957,977,50
48,STRĂINĂTATE,"REGATUL UNIT AL MARII BRITANII SI IRLANDEI DE NORD",9999,EDINBURGH,EDINBURGH,605,"Alegeri Prezidentiale",1,0,271,0,271,0,266,5,5999,5728,256,10
48,STRĂINĂTATE,"REGATUL UNIT AL MARII BRITANII SI IRLANDEI DE NORD",9999,GLASGOW,GLASGOW,606,"Alegeri Prezidentiale",1,0,568,0,568,0,555,13,5998,5430,508,47
48,STRĂINĂTATE,"REGATUL UNIT AL MARII BRITANII SI IRLANDEI DE NORD",9999,GLASGOW,GLASGOW,607,"Alegeri Prezidentiale",1,0,795,0,795,0,789,6,5997,5202,751,38
48,STRĂINĂTATE,"REGATUL UNIT AL MARII BRITANII SI IRLANDEI DE NORD",9999,PERTH,PERTH,608,"Alegeri Prezidentiale",2,0,452,0,452,0,448,4,6000,5548,409,39
48,STRĂINĂTATE,"REGATUL UNIT AL MARII BRITANII SI IRLANDEI DE NORD",9999,ABERDEEN,ABERDEEN,609,"Alegeri Prezidentiale",1,0,887,0,887,0,875,12,5998,5111,833,42
48,STRĂINĂTATE,"REGATUL UNIT AL MARII BRITANII SI IRLANDEI DE NORD",9999,BELFAST,BELFAST,610,"Alegeri Prezidentiale",1,0,905,0,905,0,897,8,6000,5095,840,57
48,STRĂINĂTATE,"REGATUL UNIT AL MARII BRITANII SI IRLANDEI DE NORD",9999,BALLYMENA,BALLYMENA,611,"Alegeri Prezidentiale",1,0,848,0,848,0,845,3,5999,5151,804,41
48,STRĂINĂTATE,"FEDERATIA RUSA",9999,MOSCOVA,MOSCOVA,612,"Alegeri Prezidentiale",1,0,176,0,176,0,168,8,500,324,133,35
48,STRĂINĂTATE,"FEDERATIA RUSA",9999,"SANKT PETERSBURG","SANKT PETERSBURG",613,"Alegeri Prezidentiale",1,0,49,0,49,0,48,1,500,451,45,3
48,STRĂINĂTATE,"FEDERATIA RUSA",9999,"ROSTOV PE DON","ROSTOV PE DON",614,"Alegeri Prezidentiale",1,0,17,0,17,0,17,0,500,483,11,6
48,STRĂINĂTATE,SENEGAL,9999,DAKAR,DAKAR,615,"Alegeri Prezidentiale",1,0,27,0,27,0,25,2,100,73,21,4
48,STRĂINĂTATE,SERBIA,9999,BELGRAD,BELGRAD,616,"Alegeri Prezidentiale",1,0,175,0,175,0,174,1,1200,1025,154,20
48,STRĂINĂTATE,SERBIA,9999,VÂRȘEȚ,VÂRȘEȚ,617,"Alegeri Prezidentiale",1,0,112,0,112,0,110,2,800,688,94,16
48,STRĂINĂTATE,SERBIA,9999,ZAJEČAR,ZAJEČAR,618,"Alegeri Prezidentiale",1,0,24,0,24,0,20,4,508,484,19,1
48,STRĂINĂTATE,SERBIA,9999,PRIȘTINA,PRIȘTINA,619,"Alegeri Prezidentiale",1,0,101,0,101,0,100,1,500,399,91,9
48,STRĂINĂTATE,"REPUBLICA SINGAPORE",9999,SINGAPORE,SINGAPORE,620,"Alegeri Prezidentiale",1,0,354,0,354,0,352,2,800,446,333,19
48,STRĂINĂTATE,SIRIA,9999,DAMASC,DAMASC,621,"Alegeri Prezidentiale",1,0,35,0,35,0,35,0,401,366,30,5
48,STRĂINĂTATE,SLOVENIA,9999,LJUBLJANA,LJUBLJANA,622,"Alegeri Prezidentiale",2,0,149,0,149,0,144,5,2501,2352,129,15
48,STRĂINĂTATE,SLOVACIA,9999,BRATISLAVA,BRATISLAVA,623,"Alegeri Prezidentiale",1,0,545,0,545,0,539,6,1500,955,512,27
48,STRĂINĂTATE,SPANIA,9999,MADRID,MADRID,624,"Alegeri Prezidentiale",1,0,796,0,796,0,789,7,7000,6204,701,88
48,STRĂINĂTATE,SPANIA,9999,MADRID,MADRID,625,"Alegeri Prezidentiale",1,0,1061,0,1061,0,1057,4,7000,5939,950,107
48,STRĂINĂTATE,SPANIA,9999,MADRID,MADRID,626,"Alegeri Prezidentiale",1,0,2542,0,2542,0,2532,10,7106,4564,2336,196
48,STRĂINĂTATE,SPANIA,9999,MADRID,MADRID,627,"Alegeri Prezidentiale",1,0,2389,0,2389,0,2374,15,6992,4603,2206,168
48,STRĂINĂTATE,SPANIA,9999,MADRID,MADRID,628,"Alegeri Prezidentiale",1,0,1215,0,1215,0,1206,9,7000,5785,1130,76
48,STRĂINĂTATE,SPANIA,9999,MADRID,MADRID,629,"Alegeri Prezidentiale",1,0,134,0,134,0,132,2,6008,5874,122,10
48,STRĂINĂTATE,SPANIA,9999,MADRID,MADRID,630,"Alegeri Prezidentiale",1,0,81,0,81,0,81,0,5999,5918,74,7
48,STRĂINĂTATE,SPANIA,9999,MADRID,MADRID,631,"Alegeri Prezidentiale",1,0,78,0,78,0,78,0,6000,5922,73,5
48,STRĂINĂTATE,SPANIA,9999,MADRID,MADRID,632,"Alegeri Prezidentiale",1,0,97,0,97,0,97,0,6000,5903,91,6
48,STRĂINĂTATE,SPANIA,9999,COSLADA,COSLADA,633,"Alegeri Prezidentiale",1,0,1563,0,1563,0,1552,11,5992,4429,1413,139
48,STRĂINĂTATE,SPANIA,9999,COSLADA,COSLADA,634,"Alegeri Prezidentiale",1,0,2670,0,2670,0,2661,9,6016,3346,2352,309
48,STRĂINĂTATE,SPANIA,9999,"ALCALÁ DE HENARES","ALCALÁ DE HENARES",635,"Alegeri Prezidentiale",2,0,1799,0,1799,0,1779,19,5000,3201,1683,96
48,STRĂINĂTATE,SPANIA,9999,"ALCALÁ DE HENARES","ALCALÁ DE HENARES",636,"Alegeri Prezidentiale",1,0,976,0,976,0,970,6,5000,4024,934,36
48,STRĂINĂTATE,SPANIA,9999,"ALCALÁ DE HENARES","ALCALÁ DE HENARES",637,"Alegeri Prezidentiale",1,0,1764,0,1764,0,1755,9,5000,3236,1654,101
48,STRĂINĂTATE,SPANIA,9999,"SAN FERNANDO DE HENARES","SAN FERNANDO DE HENARES",638,"Alegeri Prezidentiale",1,0,1760,0,1760,0,1747,13,5000,3240,1615,132
48,STRĂINĂTATE,SPANIA,9999,"TORREJÓN DE ARDOZ","TORREJÓN DE ARDOZ",639,"Alegeri Prezidentiale",1,0,1460,0,1460,0,1447,13,5000,3540,1357,90
48,STRĂINĂTATE,SPANIA,9999,"TORREJÓN DE ARDOZ","TORREJÓN DE ARDOZ",640,"Alegeri Prezidentiale",1,0,1526,0,1526,0,1524,2,5000,3474,1408,116
48,STRĂINĂTATE,SPANIA,9999,"ARGANDA DEL REY","ARGANDA DEL REY",641,"Alegeri Prezidentiale",1,0,1674,0,1674,0,1662,12,5000,3326,1556,106
48,STRĂINĂTATE,SPANIA,9999,"ARGANDA DEL REY","ARGANDA DEL REY",642,"Alegeri Prezidentiale",2,0,1598,0,1598,0,1583,15,5000,3402,1507,76
48,STRĂINĂTATE,SPANIA,9999,MÓSTOLES,MÓSTOLES,643,"Alegeri Prezidentiale",2,0,1598,0,1598,0,1582,16,5999,4401,1444,138
48,STRĂINĂTATE,SPANIA,9999,ALCORCÓN,ALCORCÓN,644,"Alegeri Prezidentiale",2,0,1023,0,1023,0,1015,8,4000,2977,940,75
48,STRĂINĂTATE,SPANIA,9999,LEGANÉS,LEGANÉS,645,"Alegeri Prezidentiale",1,0,1249,0,1249,0,1242,7,4992,3743,1156,86
48,STRĂINĂTATE,SPANIA,9999,FUENLABRADA,FUENLABRADA,646,"Alegeri Prezidentiale",1,0,1054,0,1054,0,1048,6,4000,2946,962,86
48,STRĂINĂTATE,SPANIA,9999,GETAFE,GETAFE,647,"Alegeri Prezidentiale",1,0,1121,0,1121,0,1114,7,5008,3887,1052,62
48,STRĂINĂTATE,SPANIA,9999,GUADALAJARA,GUADALAJARA,648,"Alegeri Prezidentiale",1,0,1582,0,1582,0,1578,4,4992,3410,1499,79
48,STRĂINĂTATE,SPANIA,9999,PARLA,PARLA,649,"Alegeri Prezidentiale",1,0,1311,0,1311,0,1301,10,5992,4681,1209,92
48,STRĂINĂTATE,SPANIA,9999,"AZUQUECA DE HENARES","AZUQUECA DE HENARES",650,"Alegeri Prezidentiale",1,0,1018,0,1018,0,1013,5,4008,2990,947,66
48,STRĂINĂTATE,SPANIA,9999,"SAN SEBASTIAN DE LOS REYES","SAN SEBASTIAN DE LOS REYES",651,"Alegeri Prezidentiale",1,0,1359,0,1359,0,1354,5,4000,2641,1259,95
48,STRĂINĂTATE,SPANIA,9999,ARANJUEZ,ARANJUEZ,652,"Alegeri Prezidentiale",1,0,1011,0,1011,0,1006,5,5000,3989,936,70
48,STRĂINĂTATE,SPANIA,9999,VALDEMORO,VALDEMORO,653,"Alegeri Prezidentiale",1,0,1025,0,1025,0,1017,8,3000,1975,949,68
48,STRĂINĂTATE,SPANIA,9999,"SAN MARTIN DE LA VEGA","SAN MARTIN DE LA VEGA",654,"Alegeri Prezidentiale",1,0,872,0,872,0,866,6,2997,2125,822,44
48,STRĂINĂTATE,SPANIA,9999,BRUNETE,BRUNETE,655,"Alegeri Prezidentiale",1,0,1020,0,1020,0,1012,8,2999,1979,949,63
48,STRĂINĂTATE,SPANIA,9999,"RIVAS VACIAMADRID","RIVAS VACIAMADRID",656,"Alegeri Prezidentiale",1,0,1012,0,1012,0,1005,7,4000,2988,934,71
48,STRĂINĂTATE,SPANIA,9999,"COLLADO VILLALBA","COLLADO VILLALBA",657,"Alegeri Prezidentiale",1,0,1202,0,1202,0,1189,13,4000,2798,1097,92
48,STRĂINĂTATE,SPANIA,9999,"VELILLA DE SAN ANTONIO","VELILLA DE SAN ANTONIO",658,"Alegeri Prezidentiale",1,0,548,0,548,0,541,7,3000,2452,498,43
48,STRĂINĂTATE,SPANIA,9999,VALLADOLID,VALLADOLID,659,"Alegeri Prezidentiale",1,0,963,0,963,0,956,7,5000,4037,887,69
48,STRĂINĂTATE,SPANIA,9999,AVILA,AVILA,660,"Alegeri Prezidentiale",1,0,465,0,465,0,464,1,4000,3535,426,38
48,STRĂINĂTATE,SPANIA,9999,"LAS PALMAS DE GRAN CANARIA","LAS PALMAS DE GRAN CANARIA",661,"Alegeri Prezidentiale",1,0,190,0,190,0,187,3,2998,2808,172,15
48,STRĂINĂTATE,SPANIA,9999,MASPALOMAS,MASPALOMAS,662,"Alegeri Prezidentiale",1,0,304,0,304,0,304,0,3000,2696,289,15
48,STRĂINĂTATE,SPANIA,9999,"SANTA CRUZ DE TENERIFE","SANTA CRUZ DE TENERIFE",663,"Alegeri Prezidentiale",1,0,162,0,162,0,160,2,2999,2837,149,11
48,STRĂINĂTATE,SPANIA,9999,ADEJE,ADEJE,664,"Alegeri Prezidentiale",1,0,703,0,703,0,697,6,3000,2297,646,51
48,STRĂINĂTATE,SPANIA,9999,BARCELONA,BARCELONA,665,"Alegeri Prezidentiale",1,0,1440,0,1440,0,1425,15,7000,5560,1355,70
48,STRĂINĂTATE,SPANIA,9999,BARCELONA,BARCELONA,666,"Alegeri Prezidentiale",1,0,840,0,840,0,835,5,7000,6160,780,55
48,STRĂINĂTATE,SPANIA,9999,BARCELONA,BARCELONA,667,"Alegeri Prezidentiale",2,0,1528,0,1528,0,1516,12,7000,5472,1406,110
48,STRĂINĂTATE,SPANIA,9999,FIGUERES,FIGUERES,668,"Alegeri Prezidentiale",2,0,1053,0,1053,0,1045,8,5000,3947,987,58
48,STRĂINĂTATE,SPANIA,9999,LLEIDA,LLEIDA,669,"Alegeri Prezidentiale",1,0,1715,0,1715,0,1702,13,6407,4692,1601,101
48,STRĂINĂTATE,SPANIA,9999,LLEIDA,LLEIDA,670,"Alegeri Prezidentiale",1,0,1770,0,1770,0,1763,7,6407,4637,1636,127
48,STRĂINĂTATE,SPANIA,9999,GIRONA,GIRONA,671,"Alegeri Prezidentiale",1,0,1704,0,1704,0,1690,14,6000,4296,1590,100
48,STRĂINĂTATE,SPANIA,9999,GIRONA,GIRONA,672,"Alegeri Prezidentiale",1,0,409,0,409,0,407,2,6000,5591,382,25
48,STRĂINĂTATE,SPANIA,9999,GUISSONA,GUISSONA,673,"Alegeri Prezidentiale",1,0,839,0,839,0,835,4,5000,4161,791,44
48,STRĂINĂTATE,SPANIA,9999,"LLORET DEL MAR","LLORET DEL MAR",674,"Alegeri Prezidentiale",1,0,712,0,712,0,705,7,5000,4288,659,46
48,STRĂINĂTATE,SPANIA,9999,MANRESA,MANRESA,675,"Alegeri Prezidentiale",2,0,983,0,983,0,979,4,5000,4017,905,74
48,STRĂINĂTATE,SPANIA,9999,REUS,REUS,676,"Alegeri Prezidentiale",1,0,1330,0,1330,0,1321,9,5000,3670,1238,83
48,STRĂINĂTATE,SPANIA,9999,SABADELL,SABADELL,677,"Alegeri Prezidentiale",1,0,1685,0,1685,0,1676,9,5000,3315,1585,91
48,STRĂINĂTATE,SPANIA,9999,TARRAGONA,TARRAGONA,678,"Alegeri Prezidentiale",1,0,660,0,660,0,655,5,6000,5340,614,41
48,STRĂINĂTATE,SPANIA,9999,TARRAGONA,TARRAGONA,679,"Alegeri Prezidentiale",1,0,534,0,534,0,532,2,6000,5466,506,26
48,STRĂINĂTATE,SPANIA,9999,TARREGA,TARREGA,680,"Alegeri Prezidentiale",1,0,703,0,703,0,699,4,5000,4297,667,32
48,STRĂINĂTATE,SPANIA,9999,TORTOSA,TORTOSA,681,"Alegeri Prezidentiale",1,0,1214,0,1214,0,1211,3,5000,3786,1135,76
48,STRĂINĂTATE,SPANIA,9999,"VILANOVA I LA GELTRU","VILANOVA I LA GELTRU",682,"Alegeri Prezidentiale",1,0,805,0,805,0,795,10,5001,4196,748,47
48,STRĂINĂTATE,SPANIA,9999,"PALMA DE MALLORCA","PALMA DE MALLORCA",683,"Alegeri Prezidentiale",1,0,706,0,706,0,700,6,6000,5294,668,32
48,STRĂINĂTATE,SPANIA,9999,"PALMA DE MALLORCA","PALMA DE MALLORCA",684,"Alegeri Prezidentiale",1,0,685,0,685,0,681,4,6000,5315,652,29
48,STRĂINĂTATE,SPANIA,9999,IBIZA,IBIZA,685,"Alegeri Prezidentiale",1,0,1562,0,1562,0,1547,15,5000,3438,1450,97
48,STRĂINĂTATE,SPANIA,9999,SEVILLA,SEVILLA,686,"Alegeri Prezidentiale",2,0,587,0,587,0,582,5,6000,5413,513,69
48,STRĂINĂTATE,SPANIA,9999,SEVILLA,SEVILLA,687,"Alegeri Prezidentiale",1,0,101,0,101,0,100,1,6000,5899,93,7
48,STRĂINĂTATE,SPANIA,9999,CORDOBA,CORDOBA,688,"Alegeri Prezidentiale",1,0,301,0,301,0,298,3,6000,5699,277,21
48,STRĂINĂTATE,SPANIA,9999,ALMENDRALEJO,ALMENDRALEJO,689,"Alegeri Prezidentiale",1,0,308,0,308,0,307,1,6000,5692,254,53
48,STRĂINĂTATE,SPANIA,9999,ALMENDRALEJO,ALMENDRALEJO,690,"Alegeri Prezidentiale",2,0,276,0,276,0,273,3,6000,5724,229,44
48,STRĂINĂTATE,SPANIA,9999,LEPE,LEPE,691,"Alegeri Prezidentiale",1,0,382,0,382,0,378,4,6000,5618,338,40
48,STRĂINĂTATE,SPANIA,9999,LEPE,LEPE,692,"Alegeri Prezidentiale",2,0,246,0,246,0,242,4,5992,5746,220,22
48,STRĂINĂTATE,SPANIA,9999,"PALOS DE LA FRONTERA","PALOS DE LA FRONTERA",693,"Alegeri Prezidentiale",1,0,447,0,447,0,446,1,6000,5553,395,51
48,STRĂINĂTATE,SPANIA,9999,MALAGA,MALAGA,694,"Alegeri Prezidentiale",1,0,491,0,491,0,489,2,6000,5509,451,38
48,STRĂINĂTATE,SPANIA,9999,MALAGA,MALAGA,695,"Alegeri Prezidentiale",1,0,494,0,494,0,490,4,6000,5506,449,41
48,STRĂINĂTATE,SPANIA,9999,MOGUER,MOGUER,696,"Alegeri Prezidentiale",1,0,359,0,359,0,358,1,6000,5641,291,67
48,STRĂINĂTATE,SPANIA,9999,HUELVA,HUELVA,697,"Alegeri Prezidentiale",1,0,153,0,153,0,152,1,6000,5847,131,21
48,STRĂINĂTATE,SPANIA,9999,ALMONTE,ALMONTE,698,"Alegeri Prezidentiale",1,0,841,0,841,0,833,8,6000,5159,736,97
48,STRĂINĂTATE,SPANIA,9999,"ROCIANA DEL CONDADO","ROCIANA DEL CONDADO",699,"Alegeri Prezidentiale",1,0,383,0,383,0,380,3,6003,5620,339,41
48,STRĂINĂTATE,SPANIA,9999,MANILVA,MANILVA,700,"Alegeri Prezidentiale",2,0,520,0,520,0,519,1,6000,5480,496,23
48,STRĂINĂTATE,SPANIA,9999,MARBELLA,MARBELLA,701,"Alegeri Prezidentiale",1,0,626,0,626,0,611,15,6000,5374,567,44
48,STRĂINĂTATE,SPANIA,9999,BILBAO,BILBAO,702,"Alegeri Prezidentiale",1,0,598,0,598,0,591,7,3600,3002,557,34
48,STRĂINĂTATE,SPANIA,9999,BILBAO,BILBAO,703,"Alegeri Prezidentiale",1,0,840,0,840,0,836,4,3592,2752,789,47
48,STRĂINĂTATE,SPANIA,9999,BILBAO,BILBAO,704,"Alegeri Prezidentiale",1,0,920,0,920,0,894,26,3601,2681,807,87
48,STRĂINĂTATE,SPANIA,9999,LOGRONO,LOGRONO,705,"Alegeri Prezidentiale",1,0,1086,0,1086,0,1084,2,3600,2514,988,96
48,STRĂINĂTATE,SPANIA,9999,LOGRONO,LOGRONO,706,"Alegeri Prezidentiale",1,0,968,0,968,0,963,5,3600,2632,899,64
48,STRĂINĂTATE,SPANIA,9999,LOGRONO,LOGRONO,707,"Alegeri Prezidentiale",1,0,998,0,998,0,994,4,3600,2602,928,66
48,STRĂINĂTATE,SPANIA,9999,PAMPLONA-BARAÑAIN,PAMPLONA-BARAÑAIN,708,"Alegeri Prezidentiale",1,0,883,0,883,0,879,4,4000,3117,828,51
48,STRĂINĂTATE,SPANIA,9999,PAMPLONA-BARAÑAIN,PAMPLONA-BARAÑAIN,709,"Alegeri Prezidentiale",1,0,918,0,918,0,911,7,4000,3082,838,73
48,STRĂINĂTATE,SPANIA,9999,GIJON,GIJON,710,"Alegeri Prezidentiale",1,0,547,0,547,0,541,6,3992,3445,491,50
48,STRĂINĂTATE,SPANIA,9999,OVIEDO,OVIEDO,711,"Alegeri Prezidentiale",1,0,633,0,633,0,631,2,4000,3367,583,48
48,STRĂINĂTATE,SPANIA,9999,"SANTIAGO DE COMPOSTELA","SANTIAGO DE COMPOSTELA",712,"Alegeri Prezidentiale",1,0,276,0,276,0,272,4,2500,2224,258,14
48,STRĂINĂTATE,SPANIA,9999,BURGOS,BURGOS,713,"Alegeri Prezidentiale",1,0,616,0,616,0,610,6,3999,3383,556,54
48,STRĂINĂTATE,SPANIA,9999,BURGOS,BURGOS,714,"Alegeri Prezidentiale",1,0,623,0,623,0,618,5,4000,3377,549,69
48,STRĂINĂTATE,SPANIA,9999,SANTANDER,SANTANDER,715,"Alegeri Prezidentiale",1,0,490,0,490,0,489,1,4000,3510,456,33
48,STRĂINĂTATE,SPANIA,9999,SANTANDER,SANTANDER,716,"Alegeri Prezidentiale",1,0,260,0,260,0,257,3,4000,3740,247,10
48,STRĂINĂTATE,SPANIA,9999,ZARAGOZA,ZARAGOZA,717,"Alegeri Prezidentiale",1,0,1745,0,1745,0,1740,5,12000,10255,1585,155
48,STRĂINĂTATE,SPANIA,9999,ZARAGOZA,ZARAGOZA,718,"Alegeri Prezidentiale",1,0,1326,0,1326,0,1319,7,12000,10674,1216,103
48,STRĂINĂTATE,SPANIA,9999,ZARAGOZA,ZARAGOZA,719,"Alegeri Prezidentiale",1,0,1160,0,1160,0,1153,7,12000,10840,1068,85
48,STRĂINĂTATE,SPANIA,9999,ZARAGOZA,ZARAGOZA,720,"Alegeri Prezidentiale",1,0,1391,0,1391,0,1384,7,12000,10609,1290,94
48,STRĂINĂTATE,SPANIA,9999,ZARAGOZA,ZARAGOZA,721,"Alegeri Prezidentiale",1,0,1434,0,1434,0,1426,8,12000,10566,1306,120
48,STRĂINĂTATE,SPANIA,9999,CALATAYUD,CALATAYUD,722,"Alegeri Prezidentiale",2,0,1693,0,1693,0,1689,4,12000,10307,1583,106
48,STRĂINĂTATE,SPANIA,9999,"CIUDAD REAL","CIUDAD REAL",723,"Alegeri Prezidentiale",1,0,704,0,704,0,703,1,6000,5296,654,49
48,STRĂINĂTATE,SPANIA,9999,CUENCA,CUENCA,724,"Alegeri Prezidentiale",1,0,526,0,526,0,520,6,6000,5474,496,24
48,STRĂINĂTATE,SPANIA,9999,TARANCON,TARANCON,725,"Alegeri Prezidentiale",2,0,764,0,764,0,762,2,6000,5236,707,55
48,STRĂINĂTATE,SPANIA,9999,TOMELLOSO,TOMELLOSO,726,"Alegeri Prezidentiale",1,0,800,0,800,0,799,1,6000,5200,723,76
48,STRĂINĂTATE,SPANIA,9999,TOLEDO,TOLEDO,727,"Alegeri Prezidentiale",1,0,1205,0,1205,0,1194,11,6000,4795,1083,111
48,STRĂINĂTATE,SPANIA,9999,ALBACETE,ALBACETE,728,"Alegeri Prezidentiale",1,0,509,0,509,0,506,3,6000,5491,453,53
48,STRĂINĂTATE,SPANIA,9999,"ALCÁZAR DE SAN JUAN","ALCÁZAR DE SAN JUAN",729,"Alegeri Prezidentiale",2,0,726,0,726,0,723,3,6008,5282,673,50
48,STRĂINĂTATE,SPANIA,9999,VILLARROBLEDO,VILLARROBLEDO,730,"Alegeri Prezidentiale",1,0,407,0,407,0,404,3,6000,5593,377,27
48,STRĂINĂTATE,SPANIA,9999,"QUINTANAR DEL REY","QUINTANAR DEL REY",731,"Alegeri Prezidentiale",1,0,262,0,262,0,260,2,6000,5738,233,27
48,STRĂINĂTATE,SPANIA,9999,"TALAVERA DE LA REINA","TALAVERA DE LA REINA",732,"Alegeri Prezidentiale",1,0,914,0,914,0,911,3,6000,5086,830,81
48,STRĂINĂTATE,SPANIA,9999,"QUINTANAR DE LA ORDEN","QUINTANAR DE LA ORDEN",733,"Alegeri Prezidentiale",1,0,1134,0,1134,0,1129,5,6008,4874,1074,55
48,STRĂINĂTATE,SPANIA,9999,MADRIDEJOS,MADRIDEJOS,734,"Alegeri Prezidentiale",1,0,277,0,277,0,276,1,6000,5723,259,17
48,STRĂINĂTATE,SPANIA,9999,OCAÑA,OCAÑA,735,"Alegeri Prezidentiale",1,0,373,0,373,0,371,2,6000,5627,335,36
48,STRĂINĂTATE,SPANIA,9999,ALMERIA,ALMERIA,736,"Alegeri Prezidentiale",1,0,660,0,660,0,660,0,3607,2947,609,51
48,STRĂINĂTATE,SPANIA,9999,ALMERIA,ALMERIA,737,"Alegeri Prezidentiale",1,0,728,0,728,0,726,2,3608,2880,682,44
48,STRĂINĂTATE,SPANIA,9999,"ROQUETAS DE MAR","ROQUETAS DE MAR",738,"Alegeri Prezidentiale",1,0,869,0,869,0,866,3,3600,2731,810,56
48,STRĂINĂTATE,SPANIA,9999,"ROQUETAS DE MAR","ROQUETAS DE MAR",739,"Alegeri Prezidentiale",1,0,932,0,932,0,928,4,3594,2662,870,58
48,STRĂINĂTATE,SPANIA,9999,"ROQUETAS DE MAR","ROQUETAS DE MAR",740,"Alegeri Prezidentiale",1,0,552,0,552,0,546,6,3600,3048,518,28
48,STRĂINĂTATE,SPANIA,9999,"ROQUETAS DE MAR","ROQUETAS DE MAR",741,"Alegeri Prezidentiale",1,0,544,0,544,0,542,2,3592,3048,499,43
48,STRĂINĂTATE,SPANIA,9999,"EL EJIDO","EL EJIDO",742,"Alegeri Prezidentiale",1,0,508,0,508,0,507,1,3599,3091,456,51
48,STRĂINĂTATE,SPANIA,9999,"EL EJIDO","EL EJIDO",743,"Alegeri Prezidentiale",1,0,509,0,509,0,507,2,3590,3081,436,71
48,STRĂINĂTATE,SPANIA,9999,MOTRIL,MOTRIL,744,"Alegeri Prezidentiale",1,0,1133,0,1133,0,1131,2,5009,3876,1068,63
48,STRĂINĂTATE,SPANIA,9999,GRANADA,GRANADA,745,"Alegeri Prezidentiale",1,0,355,0,355,0,353,2,5008,4653,323,30
48,STRĂINĂTATE,SPANIA,9999,MURCIA,MURCIA,746,"Alegeri Prezidentiale",1,0,498,0,498,0,494,4,4993,4495,458,36
48,STRĂINĂTATE,SPANIA,9999,MURCIA,MURCIA,747,"Alegeri Prezidentiale",1,0,427,0,427,0,425,2,5000,4573,402,23
48,STRĂINĂTATE,SPANIA,9999,"CASTELLON DE LA PLANA","CASTELLON DE LA PLANA",748,"Alegeri Prezidentiale",1,0,3080,0,3080,0,3058,22,8000,4920,2822,236
48,STRĂINĂTATE,SPANIA,9999,"CASTELLON DE LA PLANA","CASTELLON DE LA PLANA",749,"Alegeri Prezidentiale",2,0,676,0,676,0,663,13,8000,7324,575,88
48,STRĂINĂTATE,SPANIA,9999,"CASTELLON DE LA PLANA","CASTELLON DE LA PLANA",750,"Alegeri Prezidentiale",1,0,2390,0,2390,0,2374,16,8100,5710,2089,285
48,STRĂINĂTATE,SPANIA,9999,VILA-REAL,VILA-REAL,751,"Alegeri Prezidentiale",2,0,845,0,845,0,835,10,8100,7255,760,75
48,STRĂINĂTATE,SPANIA,9999,PENISCOLA,PENISCOLA,752,"Alegeri Prezidentiale",1,0,1281,0,1281,0,1273,8,8100,6819,1177,96
48,STRĂINĂTATE,SPANIA,9999,ALMAZORA,ALMAZORA,753,"Alegeri Prezidentiale",1,0,479,0,479,0,476,3,8100,7621,450,26
48,STRĂINĂTATE,SPANIA,9999,BURRIANA,BURRIANA,754,"Alegeri Prezidentiale",1,0,642,0,642,0,638,4,8101,7459,584,54
48,STRĂINĂTATE,SPANIA,9999,"OROPESA DEL MAR","OROPESA DEL MAR",755,"Alegeri Prezidentiale",1,0,460,0,460,0,454,6,8100,7640,410,44
48,STRĂINĂTATE,SPANIA,9999,VALENCIA,VALENCIA,756,"Alegeri Prezidentiale",1,0,1302,0,1302,0,1289,13,8100,6798,1191,98
48,STRĂINĂTATE,SPANIA,9999,VALENCIA,VALENCIA,757,"Alegeri Prezidentiale",2,0,643,0,643,0,637,6,8100,7457,598,39
48,STRĂINĂTATE,SPANIA,9999,VALENCIA,VALENCIA,758,"Alegeri Prezidentiale",2,0,750,0,750,0,741,9,8100,7350,678,63
48,STRĂINĂTATE,SPANIA,9999,TORRENT,TORRENT,759,"Alegeri Prezidentiale",1,0,977,0,977,0,973,4,8100,7123,892,81
48,STRĂINĂTATE,SPANIA,9999,PATERNA,PATERNA,760,"Alegeri Prezidentiale",1,0,1202,0,1202,0,1197,5,8100,6898,1125,72
48,STRĂINĂTATE,SPANIA,9999,GANDIA,GANDIA,761,"Alegeri Prezidentiale",1,0,1197,0,1197,0,1193,4,8098,6901,1117,76
48,STRĂINĂTATE,SPANIA,9999,JÁTIVA/XATIVA,JÁTIVA/XATIVA,762,"Alegeri Prezidentiale",2,0,915,0,915,0,907,8,8000,7085,815,92
48,STRĂINĂTATE,SPANIA,9999,ALICANTE,ALICANTE,763,"Alegeri Prezidentiale",1,0,900,0,900,0,891,9,8000,7100,792,99
48,STRĂINĂTATE,SPANIA,9999,ELCHE,ELCHE,764,"Alegeri Prezidentiale",1,0,742,0,742,0,741,1,8000,7258,689,52
48,STRĂINĂTATE,SPANIA,9999,BENIDORM,BENIDORM,765,"Alegeri Prezidentiale",1,0,1280,0,1280,0,1274,6,8000,6720,1209,65
48,STRĂINĂTATE,SPANIA,9999,TORREVIEJA,TORREVIEJA,766,"Alegeri Prezidentiale",3,0,732,0,732,0,727,5,8000,7268,670,57
48,STRĂINĂTATE,"SRI LANKA",9999,COLOMBO,COLOMBO,767,"Alegeri Prezidentiale",1,0,15,0,15,0,15,0,100,85,13,2
48,STRĂINĂTATE,SUA,9999,"WASHINGTON D.C.","WASHINGTON D.C.",768,"Alegeri Prezidentiale",1,0,603,0,603,0,597,6,3600,2997,527,70
48,STRĂINĂTATE,SUA,9999,"CHARLOTTE, CAROLINA DE NORD","CHARLOTTE, CAROLINA DE NORD",769,"Alegeri Prezidentiale",1,0,190,0,190,0,184,6,2000,1810,172,12
48,STRĂINĂTATE,SUA,9999,"CLEVELAND, OHIO","CLEVELAND, OHIO",770,"Alegeri Prezidentiale",1,0,304,0,304,0,301,3,3001,2697,269,32
48,STRĂINĂTATE,SUA,9999,"NORFOLK, VIRGINIA","NORFOLK, VIRGINIA",771,"Alegeri Prezidentiale",1,0,65,0,65,0,65,0,2001,1936,59,6
48,STRĂINĂTATE,SUA,9999,"NASHVILLE, TENNESSEE","NASHVILLE, TENNESSEE",772,"Alegeri Prezidentiale",1,0,69,0,69,0,69,0,3000,2931,67,2
48,STRĂINĂTATE,SUA,9999,"CHICAGO , ILLINOIS","CHICAGO , ILLINOIS",773,"Alegeri Prezidentiale",1,0,200,0,200,0,198,2,4000,3800,188,10
48,STRĂINĂTATE,SUA,9999,"CHICAGO , ILLINOIS","CHICAGO , ILLINOIS",774,"Alegeri Prezidentiale",1,0,467,0,467,0,465,2,4000,3533,410,55
48,STRĂINĂTATE,SUA,9999,"CHICAGO , ILLINOIS","CHICAGO , ILLINOIS",775,"Alegeri Prezidentiale",1,0,224,0,224,0,224,0,4000,3776,215,9
48,STRĂINĂTATE,SUA,9999,"NILES, ILLINOIS","NILES, ILLINOIS",776,"Alegeri Prezidentiale",1,0,707,0,707,0,700,7,5000,4293,632,68
48,STRĂINĂTATE,SUA,9999,"WOOD DALE, ILLINOIS","WOOD DALE, ILLINOIS",777,"Alegeri Prezidentiale",1,0,229,0,229,0,228,1,3000,2771,215,13
48,STRĂINĂTATE,SUA,9999,"TROY, MICHIGAN","TROY, MICHIGAN",778,"Alegeri Prezidentiale",1,0,475,0,475,0,468,7,4000,3525,412,56
48,STRĂINĂTATE,SUA,9999,"PLYMOUTH, MICHIGAN","PLYMOUTH, MICHIGAN",779,"Alegeri Prezidentiale",1,0,289,0,289,0,288,1,4000,3711,265,23
48,STRĂINĂTATE,SUA,9999,"INDIANAPOLIS, INDIANA","INDIANAPOLIS, INDIANA",780,"Alegeri Prezidentiale",1,0,73,0,73,0,73,0,2001,1928,70,3
48,STRĂINĂTATE,SUA,9999,"MINNEAPOLIS, MINNESOTA","MINNEAPOLIS, MINNESOTA",781,"Alegeri Prezidentiale",1,0,63,0,63,0,62,1,1500,1437,60,2
48,STRĂINĂTATE,SUA,9999,"SAINT LOUIS, MISSOURI","SAINT LOUIS, MISSOURI",782,"Alegeri Prezidentiale",1,0,43,0,43,0,43,0,1500,1457,39,4
48,STRĂINĂTATE,SUA,9999,"LOS ANGELES , CALIFORNIA","LOS ANGELES , CALIFORNIA",783,"Alegeri Prezidentiale",1,0,335,0,335,0,332,3,5001,4666,318,14
48,STRĂINĂTATE,SUA,9999,"ANAHEIM, CALIFORNIA","ANAHEIM, CALIFORNIA",784,"Alegeri Prezidentiale",2,0,350,0,350,0,348,2,5000,4650,325,23
48,STRĂINĂTATE,SUA,9999,"SACRAMENTO, CALIFORNIA","SACRAMENTO, CALIFORNIA",785,"Alegeri Prezidentiale",1,0,205,0,205,0,202,3,4999,4794,178,24
48,STRĂINĂTATE,SUA,9999,"SAN FRANCISCO, CALIFORNIA","SAN FRANCISCO, CALIFORNIA",786,"Alegeri Prezidentiale",1,0,292,0,292,0,290,2,6000,5708,282,8
48,STRĂINĂTATE,SUA,9999,"SAN JOSE (SILICON VALLEY)","SAN JOSE (SILICON VALLEY)",787,"Alegeri Prezidentiale",1,0,369,0,369,0,365,4,5000,4631,349,16
48,STRĂINĂTATE,SUA,9999,"LAS VEGAS, NEVADA","LAS VEGAS, NEVADA",788,"Alegeri Prezidentiale",2,0,216,0,216,0,215,1,5000,4784,198,17
48,STRĂINĂTATE,SUA,9999,"PHOENIX, ARIZONA","PHOENIX, ARIZONA",789,"Alegeri Prezidentiale",1,0,379,0,379,0,375,4,5000,4621,351,24
48,STRĂINĂTATE,SUA,9999,"PORTLAND, OREGON","PORTLAND, OREGON",790,"Alegeri Prezidentiale",1,0,298,0,298,0,291,7,5000,4702,272,19
48,STRĂINĂTATE,SUA,9999,"SEATTLE, WASHINGTON","SEATTLE, WASHINGTON",791,"Alegeri Prezidentiale",2,0,572,0,572,0,567,5,5000,4428,542,25
48,STRĂINĂTATE,SUA,9999,"SALT LAKE CITY, UTAH","SALT LAKE CITY, UTAH",792,"Alegeri Prezidentiale",1,0,84,0,84,0,84,0,5000,4916,74,10
48,STRĂINĂTATE,SUA,9999,"DENVER, COLORADO","DENVER, COLORADO",793,"Alegeri Prezidentiale",2,0,133,0,133,0,131,2,5001,4868,114,17
48,STRĂINĂTATE,SUA,9999,"MIAMI, FLORIDA","MIAMI, FLORIDA",794,"Alegeri Prezidentiale",1,0,190,0,190,0,188,2,3001,2811,176,12
48,STRĂINĂTATE,SUA,9999,"HOLLYWOOD, FLORIDA","HOLLYWOOD, FLORIDA",795,"Alegeri Prezidentiale",1,0,569,0,569,0,564,5,3000,2431,504,60
48,STRĂINĂTATE,SUA,9999,"NAPLES, FLORIDA","NAPLES, FLORIDA",796,"Alegeri Prezidentiale",1,0,161,0,161,0,159,2,3000,2839,147,12
48,STRĂINĂTATE,SUA,9999,"DALLAS, TEXAS","DALLAS, TEXAS",797,"Alegeri Prezidentiale",1,0,217,0,217,0,215,2,3001,2784,205,10
48,STRĂINĂTATE,SUA,9999,"HOUSTON, TEXAS","HOUSTON, TEXAS",798,"Alegeri Prezidentiale",1,0,297,0,297,0,297,0,3001,2704,274,23
48,STRĂINĂTATE,SUA,9999,"LILBURN, GEORGIA","LILBURN, GEORGIA",799,"Alegeri Prezidentiale",1,0,620,0,620,0,616,4,3000,2380,558,58
48,STRĂINĂTATE,SUA,9999,"NEW YORK","NEW YORK",800,"Alegeri Prezidentiale",1,0,527,0,527,0,526,1,3200,2673,487,39
48,STRĂINĂTATE,SUA,9999,"NEW YORK","NEW YORK",801,"Alegeri Prezidentiale",1,0,528,0,528,0,521,7,7000,6472,479,42
48,STRĂINĂTATE,SUA,9999,"PHILADELPHIA, PENNSYLVANIA","PHILADELPHIA, PENNSYLVANIA",802,"Alegeri Prezidentiale",1,0,305,0,305,0,305,0,3000,2695,277,28
48,STRĂINĂTATE,SUA,9999,"BOSTON, MASSACHUSETTS","BOSTON, MASSACHUSETTS",803,"Alegeri Prezidentiale",1,0,371,0,371,0,369,2,5000,4629,350,19
48,STRĂINĂTATE,SUA,9999,QUEENS,QUEENS,804,"Alegeri Prezidentiale",1,0,692,0,692,0,686,6,3992,3300,637,49
48,STRĂINĂTATE,SUA,9999,VICTOR,VICTOR,805,"Alegeri Prezidentiale",1,0,56,0,56,0,55,1,3200,3144,46,9
48,STRĂINĂTATE,SUDAN,9999,KHARTOUM,KHARTOUM,806,"Alegeri Prezidentiale",1,0,19,0,19,0,19,0,100,81,18,1
48,STRĂINĂTATE,SUEDIA,9999,STOCKHOLM,STOCKHOLM,807,"Alegeri Prezidentiale",1,0,931,0,931,0,924,7,4000,3069,881,43
48,STRĂINĂTATE,SUEDIA,9999,STOCKHOLM,STOCKHOLM,808,"Alegeri Prezidentiale",1,0,887,0,887,0,882,5,3200,2313,841,41
48,STRĂINĂTATE,SUEDIA,9999,STOCKHOLM,STOCKHOLM,809,"Alegeri Prezidentiale",1,0,469,0,469,0,466,3,3200,2731,444,22
48,STRĂINĂTATE,SUEDIA,9999,GÖTEBORG,GÖTEBORG,810,"Alegeri Prezidentiale",1,0,1555,0,1555,0,1533,22,4800,3245,1468,65
48,STRĂINĂTATE,SUEDIA,9999,MALMÖ,MALMÖ,811,"Alegeri Prezidentiale",1,0,1357,0,1357,0,1345,12,4800,3443,1279,66
48,STRĂINĂTATE,SUEDIA,9999,SÖLVESBORG,SÖLVESBORG,812,"Alegeri Prezidentiale",1,0,360,0,360,0,360,0,2400,2040,348,12
48,STRĂINĂTATE,SUEDIA,9999,UPPSALA,UPPSALA,813,"Alegeri Prezidentiale",1,0,320,0,320,0,318,2,2400,2080,292,26
48,STRĂINĂTATE,"REGATUL THAILANDEI",9999,BANGKOK,BANGKOK,814,"Alegeri Prezidentiale",1,0,206,0,206,0,206,0,500,294,191,15
48,STRĂINĂTATE,TUNISIA,9999,TUNIS,TUNIS,815,"Alegeri Prezidentiale",1,0,67,0,67,0,66,1,598,531,53,13
48,STRĂINĂTATE,TURCIA,9999,ANKARA,ANKARA,816,"Alegeri Prezidentiale",1,0,124,0,124,0,122,2,500,376,100,22
48,STRĂINĂTATE,TURCIA,9999,IZMIR,IZMIR,817,"Alegeri Prezidentiale",2,0,62,0,62,0,60,2,400,338,48,12
48,STRĂINĂTATE,TURCIA,9999,ISTANBUL,ISTANBUL,818,"Alegeri Prezidentiale",1,0,262,0,262,0,256,6,2508,2246,182,74
48,STRĂINĂTATE,TURCIA,9999,ISTANBUL,ISTANBUL,819,"Alegeri Prezidentiale",1,0,431,0,431,0,424,7,2500,2069,331,93
48,STRĂINĂTATE,TURKMENISTAN,9999,ASHABAT,ASHABAT,820,"Alegeri Prezidentiale",1,0,24,0,24,0,23,1,100,76,23,0
48,STRĂINĂTATE,UCRAINA,9999,KIEV,KIEV,821,"Alegeri Prezidentiale",1,0,115,0,115,0,112,3,400,285,96,16
48,STRĂINĂTATE,UCRAINA,9999,ODESA,ODESA,822,"Alegeri Prezidentiale",1,0,50,0,50,0,50,0,398,348,40,10
48,STRĂINĂTATE,UCRAINA,9999,CERNĂUȚI,CERNĂUȚI,823,"Alegeri Prezidentiale",1,0,140,0,140,0,139,1,800,660,91,48
48,STRĂINĂTATE,UCRAINA,9999,SOLOTVINO,SOLOTVINO,824,"Alegeri Prezidentiale",1,0,35,0,35,0,35,0,500,465,22,13
48,STRĂINĂTATE,UNGARIA,9999,BUDAPESTA,BUDAPESTA,825,"Alegeri Prezidentiale",1,0,841,0,841,0,815,26,6001,5160,760,55
48,STRĂINĂTATE,UNGARIA,9999,BUDAPESTA,BUDAPESTA,826,"Alegeri Prezidentiale",1,0,558,0,558,0,547,11,6000,5442,500,47
48,STRĂINĂTATE,UNGARIA,9999,BUDAPESTA,BUDAPESTA,827,"Alegeri Prezidentiale",1,0,290,0,290,0,284,6,6000,5710,268,16
48,STRĂINĂTATE,UNGARIA,9999,BUDAPESTA,BUDAPESTA,828,"Alegeri Prezidentiale",1,0,300,0,300,0,299,1,6000,5700,291,8
48,STRĂINĂTATE,UNGARIA,9999,GYULA,GYULA,829,"Alegeri Prezidentiale",1,0,200,0,200,0,194,6,2000,1800,143,51
48,STRĂINĂTATE,UNGARIA,9999,SZEGED,SZEGED,830,"Alegeri Prezidentiale",1,0,199,0,199,0,187,12,2003,1804,155,32
48,STRĂINĂTATE,URUGUAY,9999,MONTEVIDEO,MONTEVIDEO,831,"Alegeri Prezidentiale",1,0,30,0,30,0,27,3,100,70,23,4
48,STRĂINĂTATE,UZBEKISTAN,9999,TAȘKENT,TAȘKENT,832,"Alegeri Prezidentiale",1,0,12,0,12,0,12,0,200,188,11,1
48,STRĂINĂTATE,VENEZUELA,9999,CARACAS,CARACAS,833,"Alegeri Prezidentiale",1,0,41,0,41,0,41,0,201,160,38,3
48,STRĂINĂTATE,VIETNAM,9999,HANOI,HANOI,834,"Alegeri Prezidentiale",1,0,123,0,123,0,115,8,396,273,95,20
48,STRĂINĂTATE,ZIMBABWE,9999,HARARE,HARARE,835,"Alegeri Prezidentiale",1,0,7,0,7,0,7,0,100,93,6,1
